,Name,Prep Time,Cook Time,Total Time,Ingredient,Number of Ingredient,Method,Number of cooking step
0,Sweet Corn Gnocchi Skillet Recipe,15,20,35,"['1 pound gnocchi', '2 tablespoons olive oil', 'Kernels from 3 ears sweet corn, or about 3 cups corn kernels', '1 small sweet onion, diced', '3 cloves garlic, minced', '1/2 cup heavy cream (optional)', '1/2 teaspoon salt', 'Ground black pepper', '8 ounces small mozzarella balls (also called pearls or ciliegine)', 'Fresh basil, minced']",10,"['1 Cook the gnocchi: Bring a pot of salted water to boil. Add gnocchi and cook until they float, about 4-5 minutes. Remove gnocchi and reserve 1/2 cup of the cooking water for the skillet.', '2 Cook the corn kernels: Heat a large skillet over medium-high heat, then add the olive oil. When the oil is shimmering, add the corn kernels. Let kernels cook in the skillet for 4-5 minutes until they are brown and blistered. Don\\xe2\\x80\\x99t stir them too much. Let them sit so they get some color.', '3 Add onions and garlic: Once the corn has blistered, add the sweet onions and garlic. Cook for a few minutes until the onions have softened and are translucent.', '4 Make the skillet sauce: Once the onions are soft, add the cooked gnocchi to the skillet and toss everything together. Turn the heat down to low and add 1/2 cup of the reserved gnocchi water, or 1/2 cup cream. Stir to combine ingredients, then let simmer until the sauce has thickened slightly. Taste and season with salt and pepper.', '5 Finish the dish: Right before serving, add the mozzarella balls to the skillet and garnish with fresh basil.', 'Leftovers will keep well in the fridge for a few days. Reheat it in a skillet over low heat with a little water. If you freeze the dish, make sure to thaw and reheat it gently. A microwave will ruin the sauce and the gnocchi texture.']",6
1,Skillet Peach Crisp with Ginger and Pecans Recipe,10,35,45,"['For the crisp topping:', '1/2 cup (66 grams) oat flour (See recipe note)', '1/2 cup (78 grams) all-purpose flour', '1/3 cup old-fashioned rolled oats', '1/4 cup light brown sugar', '1/2 teaspoon fine sea salt or table salt', '3/4 cups pecans, roughly chopped', '1/2 cup unsalted butter cut into small pieces, well chilled', 'For the peaches:', '2 pounds peaches, sliced 1/2-inch thick (about 6 medium, or 6 cups sliced)', '1/2 teaspoon ground ginger', '1/3 cup crystallized candied ginger, diced small', '1/4 cup granulated sugar', '2 tablespoons lemon juice (about 1/2 lemon)', '2 tablespoons unsalted butter, for the pan']",15,"['1 Preheat oven to 350\\xc2\\xb0F.', '2 Make the crisp topping: In a small bowl, combine the two flours with a fork\\xe2\\x80\\x94sometimes oat flour clumps together more than all-purpose. Add the rolled oats, brown sugar, and sea salt. Add the pecans and stir to combine.', 'Finally, rub the butter until topping is buttery and crumbly. It should clump together easily between your fingers.', '3 Prepare the peaches: In a medium bowl, combine the sliced peaches, ground ginger, crystalized ginger, and sugar, along with the lemon juice. Stir together gently with a spatula.', '4 Prepare the pan: Put the remaining 2 tablespoons of butter into the cast iron pan and place into the oven for about 5 minutes, just until the butter melts.', '5 Assemble the crisp: Remove the pan from the oven and add the peach-ginger combination, spreading it out evenly. Add little dabs of the crisp topping as evenly as you can across the top of the peaches.', '  6 Bake the crisp: Bake in the oven for 30 to 35 minutes, or until the filling is bubbling and the top is golden brown.', '7 Cool and serve: This is going to be hard, but you need to wait at least an hour before you scoop into this. Otherwise the juices will run everywhere, and you may burn your mouth.', 'Once it\\xe2\\x80\\x99s made, this keeps best covered, in the refrigerator, for 3 to 4 days. Simply reheat it in a low oven for about 10 minutes.']",9
2,Steak on the Stovetop Recipe,30,10,40,"['One 3/4- to 1-pound steak, 3/4- to 1-inch thick, such as ribeye, strip, or porterhouse', 'Kosher salt', '2 tablespoons unsalted butter, optional', 'A few sprigs fresh thyme or rosemary, optional', 'Flaky sea salt, for sprinkling, optional']",5,"['1 Pat the steak dry: Pat the steak dry with paper towels and season it liberally with salt all over; let rest at room temperature for 30 minutes.', '2 Heat the skillet: Heat a cast-iron or stainless-steel skillet large enough to hold the steak on the stove over medium-high heat until very hot and it just barely starts to smoke, about 3 minutes.', '3 Pat the steak dry (again) and cook: Pat the steak dry again with paper towels, add the steak, and cook, pressing down to make sure it gets good contact with the pan, until a nice sear starts to form, about 2 minutes; flip over and cook for 2 minutes more.', 'For a rare to medium-rare steak: Depending on the thickness of your steak, for a rare to medium-rare steak you should be able to remove the steak from the pan after 4 total minutes of cooking time.', 'For a medium to well-done steak: Reduce the heat to medium-low and continue to cook, flipping over every minute or so, to your desired temperature, anywhere from an additional 2 to 6 minutes (or more for extra well-done).', '4 Baste with butter and herbs (optional): If you want even more flavor, add the butter and herbs to the pan during the last couple minutes of cooking and baste it with the butter.', '5 Serve: Remove the steak from the pan and let rest for a couple of minutes before slicing. If desired, sprinkle with some flaky sea salt. Serve.']",7
3,One-Pan Paprika Chicken with Potatoes and Tomatoes Recipe,15,60,75,"['6 to 8 chicken thighs (about 3 pounds, bone-in, skin-on, trimmed of excess fat)', '2 tablespoons Dijon mustard', 'Juice of 1 lemon', '2 teaspoons paprika', '4 tablespoons olive oil', '1 1/2 pounds baby potatoes', '1 red onion, cut into 8 wedges', '6 garlic cloves, smashed', '1/2 pint cherry tomatoes', 'Handful of thyme sprigs', 'Leaves from 3 to 4 parsley sprigs, for garnish']",11,"['1 Heat the oven to 400\\xc2\\xb0F. Place a rack in the middle position.', '2 Prepare the chicken: With scissors or a sharp knife, trim the excess chicken skin and fat from the thighs. Sprinkle all over with salt and pepper.', '3 Marinate the chicken in the sauce: In a large bowl, stir together the mustard, lemon juice, paprika, 2 tablespoons of the oil, and additional salt and pepper to taste. Add the chicken thighs and toss to coat. Set aside while you chop the vegetables.', '4 Prepare the vegetables: Cut the baby potatoes into halves. Peel the red onion and cut it into 8 wedges through the root end. Cut the cherry tomatoes in half, but keep them separate from the other vegetables.', '5 Bake the chicken and vegetables: In a large baking dish (9x13-inch pan, 3-quart dish, or other similar sized baking dish), toss the potatoes, onion, and garlic with salt, pepper, and the remaining 2 tablespoons of olive oil. Spread them evenly in the pan and top with thyme sprigs.', 'Nestle the chicken into the vegetables and scrape any extra sauce over top. Bake at 400\\xc2\\xb0F for 30 minutes, uncovered.', '6 Add the tomatoes: Remove the pan from the oven, scatter the cherry tomatoes on top, and return the pan to the oven.', '7 Bake for another 25 to 30 minutes, or until the potatoes are tender and an instant-read thermometer inserted into the middle of a thigh registers 165\\xc2\\xb0F. Serve with a salad or crusty bread.']",8
4,Quick and Easy Pan-Fried Flank Steak Recipe,10,25,35,"['1 1/2 pound flank steak', 'Salt', 'Freshly ground black pepper', 'Dry mustard', 'Softened butter']",5,"['1 Tenderize the steak with shallow cuts: Remove the steak from the refrigerator a half hour before cooking.', 'Cut away any tough connective tissue on the surface of the steak.', 'Using the tip of a sharp knife, poke small cuts into the meat, almost all the way through. The cuts should be at an angle, in the direction of the grain of the meat as the knife tip is going in. The cuts should be about an inch apart from each other.', 'Turn the steak over and repeat the cuts on the other side. Make sure that the cuts you are making on this side are parallel with the cuts you made on the other side, otherwise you may cut across an existing cut, and end up poking a hole through the meat.', ""2 Rub with salt, pepper, dry mustard, and butter: Sprinkle one side of the steak with salt and freshly ground pepper. Sprinkle the steak with dry mustard. (You can use regular mustard if you don't have any dry mustard.)"", 'Rub a tablespoon of butter all over the side of the steak. Turn the steak over and repeat with the dry mustard, pepper, and butter.', '3 Sear steak in hot frying pan: Heat a large cast iron frying pan on high heat. Place steak in hot pan. Let sear for 2 to 3 minutes until well browned.', 'Use tongs to lift up to see if nicely browned. If so, flip to the other side and let sear for 2 to 3 minutes.', '4 Remove from heat: Remove the pan from the heat and let the steak continue to cook for 5 to 10 minutes in the residual heat of the pan (assuming you are using cast iron, if not, lower the heat to low).', '5 Check for doneness: Use your fingertips to check for doneness or insert a meat thermometer into the thickest part of the steak - 120\\xc2\\xb0F for very rare, 125\\xc2\\xb0F for rare, or 130\\xc2\\xb0F for medium rare. Flank steak should be served rare or medium rare, otherwise it may be too dry.', ""If the steak isn't done enough to your liking, return the steak and pan to medium high heat for a few minutes."", '6 Let the steak rest: Remove the steak from the pan to a cutting board and let rest for 10 minutes, covered with aluminum foil.', '7 Thinly slice: Cut the meat in very thin slices, at an angle, across the grain of the meat. (This way you break through the tough long muscle fibers.)', '8 Boil juices, deglaze pan, add butter to make sauce: Any juices that come out of the meat while cutting or resting, return to the pan. Return the pan to a burner on high heat and deglaze the pan with a little water, scraping up any browned bits. Once the water has mostly boiled down, add a little butter to the pan for a nice sauce.', 'Arrange the cut meat on a serving plate and pour the deglazed pan juices over the meat.']",15
5,Herbes de Provence Skillet Chicken with Potatoes and Greens Recipe,15,155,170,"['For the marinade:', '1 1/2 pounds boneless skinless chicken tenders, tenderloin, or thinly sliced chicken breasts', '1 1/2 tablespoons herbes de Provence', '1 1/4 teaspoons Kosher salt', '1 teaspoon freshly ground pepper', 'Zest of one lemon', '1 1/2 tablespoons lemon juice', '3 cloves minced garlic', '2 tablespoons olive oil', 'For the vegetables:', '2 teaspoons olive oil', '3 tablespoons butter, divided', '1 1/2 pounds B-sized or baby potatoes', '1/2 yellow onion', '1/2 teaspoon Kosher salt', 'A few cracks of freshly ground pepper', '2 handfuls (2 packed cups) Swiss chard or spinach', '1/3 cup halved pimento-stuffed Spanish olives', '1 teaspoon red wine vinegar']",19,"['1 Label the bag: Use a sharpie to write the date and title of the recipe on a gallon-sized zip top bag so you can easily find it on SimplyRecipes.com when you want to cook it. Alternatively, write the cooking instructions on the bag, and date it.', '2 Combine the ingredients: Roll down the opening of the bag a little just so you don\\xe2\\x80\\x99t accidently get raw chicken juices on the outside of the zip top. Add the chicken, spices, zest, lemon juice, garlic and olive oil.', 'Remove as much air as possible and seal the bag. Smoosh the chicken around so it\\xe2\\x80\\x99s coated in the marinade.', '3 Lay the chicken flat in the freezer and freeze for up to 6 months:', 'Alternatively, you could skip the freezer and let it marinade in the fridge for a couple of hours and up to two days, then cook it according to the directions below.', ' 4 Thaw the chicken before cooking: When ready to cook, take the chicken out of the freezer in the morning before you go to work, and it will be ready to cook by the end of the day.', '5 Prepare the vegetables: If the b-sized potatoes are larger than a golf ball, quarter them; if they are smaller just half them. Slice the onion. Wash the Swiss chard, remove the stems and chop them. Then cut the leaves into strips about an inch thick. Cut the olives in half.', '  6 Cook the chicken: Set a large skillet over medium heat add 2 teaspoons of olive oil and 1 tablespoon butter. Once the oil shimmers and the butter melts, add the chicken and any marinade in the bag.', 'If any chicken is folded up, unfold it so it lays flat in the pan. Cook the chicken for 2 minutes, then flip it.', '7 Add the vegetables: Add the potatoes, onion, and 1/4 cup water to the pan with the chicken. Cover with a lid. Let everything simmer together for about 10 minutes.', '8 Finish the potatoes and make the sauce: Remove the chicken to a plate (leaving the vegetables in the skillet) and tent with foil. Add the remaining 2 tablespoons of butter, 1/4 teaspoon of salt and a few cracks of freshly ground pepper to the skillet. Stir the potatoes, cover and cook for another 10 minutes.', 'Turn the heat up to medium high to reduce the liquid and finish cooking the potatoes uncovered. This should take about 2 to 3 minutes depending on how much liquid is in the pan.', 'When you can easily pierce the potatoes with a fork, add the chard leaves and chopped stems, olives, and red wine vinegar. Toss gently until the greens are just wilted.', '9 Serve: Nestle the chicken back into the pan. Bring the whole thing over to the table and serve.']",14
6,Quick Easy Fish Stew Recipe,10,20,30,"['6 tablespoons extra virgin olive oil', '1 medium onion, chopped (about 1 1/2 cups)', '3 large garlic cloves, minced', '2/3 cup fresh parsley, chopped', '1 1/2 cups of fresh chopped tomato (about 1 medium sized tomato) OR 1 14-ounce can of whole or crushed tomatoes with their juices', '2 teaspoons tomato paste (optional)', '8 oz of clam juice (or shellfish stock)', '1/2 cup dry white wine (like Sauvignon blanc)', '1 1/2 pound fish fillets (use a firm white fish such as halibut, cod, red snapper, or sea bass), cut into 2-inch pieces', 'Pinch of dry oregano', 'Pinch of dry thyme', '1/8 teaspoon Tabasco sauce (or more to taste)', '1/8 teaspoon freshly ground black pepper, plus more to taste', '1 teaspoon of salt, plus more to taste']",14,"['1 Heat olive oil in a large thick-bottomed pot over medium-high heat. Add onion and saut\\xc3\\xa9 4 minutes, add the garlic and cook a minute more. Add parsley and stir 2 minutes. Add tomato and tomato paste, and gently cook for 10 minutes or so.', '2 Add clam juice, dry white wine, and fish. Bring to a simmer and simmer until the fish is cooked through and easily flakes apart, about 3 to 5 minutes. Add seasoning \\xe2\\x80\\x94salt, pepper, oregano, thyme, Tabasco. Add more salt and pepper to taste. Ladle into bowls and serve.', 'Great served with crusty bread for dipping in the fish stew broth.']",3
7,Puerto Rican Salmorejo (Stewed Crab and Tomatoes with Rice) Recipe,10,20,30,"['1 tablespoon extra-virgin olive oil', '6 mini sweet peppers (or yellow, red, or orange bell pepper), diced (about 1/4 cup)', '1/2 green bell pepper, diced (about 1/2 cup)', '1 medium white onion, diced (about 1 cup)', '3 cloves garlic, minced', '3 large Roma tomatoes, diced (about 2 cups)', '1 (8-ounce) can of tomato sauce, about 1/4 cup', '2 tablespoons recaito, store-bought or homemade', '1 1/2 teaspoons Saz\\xc3\\xb3n con culantro y achiote seasoning, store-bought or homemade', '1 teaspoon dried oregano', '1 teaspoon kosher salt', '1/4 teaspoon black pepper', '1 bay leaf', '6 stuffed Manzanilla olives', '1 tablespoon capers, drained of brine', '1 pound crabmeat (lump, backfin, or claw, or a combination of these)', '1/2 cup water', 'To serve:', 'Cooked white rice', 'Fried green plantain chips (optional)']",20,"['1 Cook the veggies: In a large skillet with a lid, heat the oil over medium-high heat until the surface of the oil begins to ripple. Add the sweet peppers, bell pepper, onion, and garlic to the pan and saut\\xc3\\xa9 for 3 minutes, or until the vegetables look glossy and translucent.', 'Reduce the heat to medium, and add the tomatoes to the pan. Cook the mixture, stirring frequently, for 4 more minutes.', '2 Simmer the spices and seasonings: Stir in the tomato sauce, recao, Saz\\xc3\\xb3n, oregano, salt, pepper, bay leaf, olives, and capers. Bring the ingredients to a gentle simmer and then lower the heat to maintain the simmer\\xe2\\x80\\x94tiny bubbles should just barely break the surface of the liquid. Simmer for five minutes, uncovered.', '3 Fold in the crabmeat and simmer: Add the crabmeat and water to the pan, and gently fold the meat into the tomato sauce. Avoid stirring too aggressively: you want to keep the crabmeat in lumps.', 'Reduce the heat to medium-low, and cover the pan. Allow the salmorejo to simmer for 10 minutes without stirring.', '4 Serve: Serve the salmorejo over steamed white rice, or atop fried plantain chips. Leftovers will keep in the refrigerator for up to two days and reheat well over the stovetop or in the microwave.', 'You can also freeze the salmorejo for up to two months in a zip-top storage bag. Thaw overnight in the fridge, and warm it on the stove in a saucepan until it\\xe2\\x80\\x99s bubbling.']",7
8,Beef Steak Fajitas Recipe,70,15,85,"['1 tablespoon vegetable oil', '1 pound of flank steak, skirt steak or carne asada', '1 large yellow onion, peeled and sliced with the grain, not against the grain as one would normally slice an onion. Slice first in half, and then slice off sections a half inch wide at widest point.', '2-3 bell peppers of various colors, stemmed, seeded, de-ribbed, sliced lengthwise into strips', 'Salt', 'STEAK FAJITA MARINADE:', 'Juice of 1 lime', '2 tablespoons of extra virgin olive oil', '2 cloves garlic, peeled, minced', '1/2 teaspoon ground cumin', '1/2 fresh jalape\\xc3\\xb1o pepper, seeded, ribs removed, finely chopped (be careful not to touch your eyes or anywhere near your eyes after handling a jalape\\xc3\\xb1o pepper!)', '1/4 cup chopped fresh cilantro, including stems']",12,"['1 Marinate the steak: Mix all marinade ingredients. Coat the steak with the marinade and let it sit at room temperature for an hour, or longer in the fridge.', 'Before you cook the meat, wipe off most of the marinade and sprinkle the steak with salt.', '2 Sear the steak on both sides: Set a large cast iron pan or griddle over high heat and let this heat up for 1-2 minutes. Add the tablespoon of oil to the pan and let this heat up for 1 minute.', 'Add the steak, frying on each side for 3 minutes, or to desired doneness. 3 minutes per side will yield approximately medium rare doneness for an average cut of flank steak.', 'Carne asada and skirt steak will need less time. If the pan starts to smoke too much, reduce the heat to medium-high. You want the steak browned, not burned.', 'Remove from pan and let sit, tented with foil, for 5 minutes.', '3 Cook the vegetables while the meat is resting. Add a little more oil to the pan if necessary, then add the onions and bell peppers.', 'Let these sear for 1 minute before stirring, then stir every 90 seconds or so as the veggies sear. Cook for 5-6 minutes total.', '4 Slice the meat across the grain into thin slices. If you slice the meat at an angle, you will be able to get your slices pretty thin. These cuts of steak are flavorful but can be a little tough, so thin slices will really help make it easier to eat.', '5 Serve immediately with shredded cheese, salsa, shredded iceberg lettuce, sour cream, guacamole and warm flour tortillas. (Hint for warming tortillas - put in microwave over a paper towel for 20 seconds on high heat.)']",10
9,"Italian Skillet Chicken with Spinach, Tomatoes, and Onions Recipe",12,25,37,"['For the marinade', '1 1/2 pounds boneless skinless chicken tenders, tenderloin, or thinly sliced chicken breasts', '1 tablespoon dried oregano', '2 1/2 teaspoons dried thyme', '1 1/2 teaspoons Kosher salt', '1 teaspoon dried basil', '1 teaspoon freshly ground pepper', 'Zest from 1 lemon', '3 tablespoons lemon juice, from about 1 lemon', '3 cloves garlic, minced', '2 tablespoons olive oil', 'For the vegetables', '2 teaspoons olive oil', '1 pint cherry tomatoes', '1 medium red onion', '2 large handfuls spinach, about 2 packed cups', '1 teaspoon capers', '1 tablespoon butter', 'Crusty bread, to serve']",19,"['1 Label the bag: Use a sharpie to write the date and the title of the recipe on a gallon-sized zip top bag so you can easily find it on SimplyRecipes.com when you want to cook it. Alternatively, write the cooking instructions on the bag.', '2 Combine the ingredients: Roll down the opening of the bag a little just so you don\\xe2\\x80\\x99t accidently get raw chicken juices on the outside of the zip top. Add the chicken, spices, zest,  lemon juice, garlic and olive oil.', 'Remove as much air as possible and seal the bag. Smoosh the chicken around so it\\xe2\\x80\\x99s coated in the marinade.', '3 Lay the chicken flat in the freezer and freeze for up to 6 months.', 'Alternatively, you could skip the freezer and let it marinade in the fridge for a couple of hours and up to two days, then cook it according to the directions below.', '4 Thaw the chicken before cooking: Take the chicken out of the freezer in the morning before you go to work, and it will be ready to cook by the end of the day.', '5 Prepare the onion: Peel and trim the stem ends of the onion, but leave the stem intact so it can keep the onion layers together. Slice the onion in half. Then slice each half into 5 wedges leaving a little stem with each one.', '6 Cook the chicken: Set a large skillet over medium heat add 2 teaspoons of olive oil. Once the oil shimmers, add chicken and any marinade in the bag. If any chicken is folded up, unfolded it so it lays flat in the pan. Cook the chicken for 2 minutes, then flip it.', '7 Add the vegetables: Add the onion wedges, tomatoes, and capers. Cover with a lid. Let everything simmer together for 12 to 15 minutes. The tomatoes should be soft, and the onions dull in color.', '8 Check the chicken: Check the chicken to see if it\\xe2\\x80\\x99s cooked through by cutting a piece open. If the juices run clear, and you don\\xe2\\x80\\x99t see any pink the chicken is ready. Use a fork to remove the chicken to a plate and tent with foil.', '9 Finish the sauce: Turn the heat up to medium high. Add 1 tablespoon butter to the sauce. Stir it in and let the sauce reduce uncovered for about 2 minutes. Add the spinach stir to coat a couple of times until the spinach has wilted.', '10 To serve: Nestle the chicken back into the pan, and season to taste with salt and pepper.', 'Bring the skillet to the table. Spoon up chicken, vegetables and sauces into shallow bowls or plates. Serve with crusty bread to sop up the sauce.']",13
10,Best Ever Sloppy Joes Recipe,10,30,40,"['1 tablespoon extra virgin olive oil', '1/2 cup minced carrots (can sub chopped bell pepper)', '1 cup finely chopped onion (about 1 medium onion)', '1/2 cup finely chopped celery', '2 cloves garlic, minced', '1/2 teaspoon salt', '1 1/4 pound ground beef', '1/2 cup ketchup', '2 cups tomato sauce (or 1 15-ounce can whole tomatoes, pur\\xc3\\xa9ed)', '1 tablespoon Worcestershire sauce', '1 tablespoon red wine vinegar', '1 1/2 tablespoons brown sugar', 'Pinch ground cloves', '1/2 teaspoon dried thyme', 'Pinch cayenne pepper', '2 turns of freshly ground black pepper', '4 hamburger buns']",17,"['1 Saut\\xc3\\xa9 the carrots, onions, celery, and garlic: Heat olive oil in a large saut\\xc3\\xa9 pan on medium high heat. Add the minced carrots and saut\\xc3\\xa9 for 5 minutes. (If you are using bell pepper instead of carrots, add those at the same time as the onions.)', 'Add the chopped onion and celery. Cook, stirring occasionally until onions are translucent, about 5 more minutes.', 'Add the minced garlic and cook for 30 more seconds. Remove from heat. Remove vegetables from the pan to a medium sized bowl, set aside.', '2 Brown the ground beef: Using the same pan (or you can cook the meat at the same time as the vegetables in a separate pan to save time), crumble the ground beef into the pan. If you are using extra lean beef, you may need to add a tablespoon of olive oil to the pan. Sprinkle the meat with salt.', 'Do not stir the ground beef, just let it cook until it is well browned on one side. Then flip the pieces over and brown the second side.', ""If you're cooking in batches, use a slotted spoon to remove the ground beef from the pan (can add to the set-aside vegetables) and repeat with the rest of the ground beef."", 'When the meat is done cooking, strain off all but 1 tablespoon of any fat left in the pan.', '3 Make the sloppy joe mix: Return the cooked ground beef and vegetables to the pan. Use a wooden spoon to break up any chunks of ground beef into smaller bits.', 'Add the ketchup, tomato sauce, Worcestershire sauce, vinegar, and brown sugar to the pan. Stir to mix well. Add ground cloves, thyme, and cayenne pepper.', 'Lower the heat to medium low and let simmer for 10 minutes. Adjust seasonings to taste.', '4 Serve the sloppy joes: Serve immediately, or refrigerate to make ahead and reheat to serve. Serve with toasted hamburger buns.']",11
11,Poached Salmon Recipe,5,10,15,"['1 to 1\\xc2\\xbd pounds salmon fillets, pin bones removed', 'Salt', '\\xc2\\xbd cup dry white wine (a good Sauvignon Blanc)', '\\xc2\\xbd cup water', '1 shallot, peeled and thinly sliced or a few thin slices of onion', 'Several sprigs of fresh dill or sprinkle of dried dill', 'A sprig of fresh parsley', 'Freshly ground black pepper', 'A few slices of fresh lemon to serve']",9,"['1 Sprinkle the salmon fillets with a little salt. Put the wine, water, dill, parsley and shallots or onions in a saut\\xc3\\xa9 pan, and bring to a simmer on medium heat.', '2 Place salmon fillets, skin-side down on the pan. Cover.', '3 Cook 5 to 10 minutes, depending on the thickness of the fillet, or to desired done-ness. Do not overcook.', 'Serve sprinkled with freshly ground black pepper and a slice or two of lemon.']",4
12,Beef Brisket Pot Roast Recipe,35,255,290,"['4 to 5 pound (about 2 kg) beef brisket, flat cut or point cut', 'Salt', '1 to 2 tablespoons extra virgin olive oil', '3 large onions, sliced', '5 to 6 garlic cloves, minced', '1 sprig thyme', '1 sprig rosemary', '3 to 4 bay leaves', '2 cups beef stock', '2 to 3 large carrots, peeled and cut into 1 1/2-inch pieces', '1 tablespoon mustard (optional)']",11,"['1 Prepare the brisket: On one side of the brisket there should be a layer of fat, which you want. If there are any large chunks of fat, cut them off and discard them. Large pieces of fat will not be able to render out completely.', 'Using a sharp knife, score the fat in parallel lines, about 3/4-inch apart. Slice through the fat, not the beef. Repeat in the opposite direction to make a cross-hatch pattern.', 'Salt the brisket well and let it sit at room temperature for 30 minutes.', ""2 Sear the brisket: You\\'ll need an ovenproof, thick-bottomed pot with a cover, or Dutch oven, that is just wide enough to hold the brisket roast with a little room for the onions."", 'Pat the brisket dry and place it, fatty side down, into the pot and place it on medium high heat. Cook for 5 to 8 minutes, lightly sizzling, until the fat side is nicely browned. (If the roast seems to be cooking too fast, turn the heat down to medium. You want a steady sizzle, not a raging sear.)', 'Turn the brisket over and cook for a few minutes more to brown the other side.', '3 Saut\\xc3\\xa9 the onions and garlic: When the brisket has browned, remove it from the pot and set aside. There should be a couple tablespoons of fat rendered in the pot. If not, add some olive oil.', 'Add the chopped onions and increase the heat to high. Sprinkle a little salt on the onions. Saut\\xc3\\xa9, stirring often, until the onions are lightly browned, 5 to 8 minutes. Stir in the garlic and cook 1 to 2 more minutes.', '4 Simmer the brisket and roast it: Preheat the oven to 300\\xc2\\xb0F (150\\xc2\\xb0C). Use kitchen twine to tie together the bay leaves, rosemary and thyme.', 'Move the onions and garlic to the sides of the pot and nestle the brisket inside. Add the beef stock and the tied-up herbs. Bring the stock to a boil on the stovetop. Cover the pot, then place in the 300\\xc2\\xb0F (150\\xc2\\xb0C) oven. Cook for 3 hours. Carefully flip the brisket every hour so it cooks evenly.', '5 Add carrots, continue to cook: After 3 hours, add the carrots. Cover the pot and cook for 1 hour more, or until the carrots are cooked through and the brisket is falling-apart tender.', '6 Remove brisket: When the brisket is falling-apart tender, take the pot out of the oven and remove the brisket to a cutting board. Cover it with foil. Pull out and discard the herbs.', '7 Make sauce (optional): At this point you have two options. You can serve as is, or you can make a sauce with the drippings and some of the onions. If you serve as is, skip this step.', 'To make a sauce, remove the carrots and half of the onions, set aside and cover them with foil. Pour the ingredients that are remaining into a blender, and pur\\xc3\\xa9e until smooth. If you want, add 1 tablespoon of mustard to the mix. Put into a small pot and keep warm.', '8 Slice and serve: Notice the lines of the muscle fibers of the roast. This is the ""grain"" of the meat. Slice the meat perpendicular to these lines, or across the grain (cutting this way further tenderizes the meat), in 1/4-inch to 1/2-inch slices. (A sturdy bread knife works great for slicing roasts.)', 'Serve with the onions, carrots and gravy. Serve with mashed, roasted or boiled potatoes, egg noodles, or polenta.']",16
13,Sweet and Sour Chicken Recipe,15,15,30,"['1 pound of boneless and skinless chicken thighs or breasts, cut into 1"" chunks', '1 egg white', '1/2 teaspoon kosher salt (1/4 teaspoon table salt)', '2 teaspoons cornstarch', '1 10-ounce can pineapple chunks (reserve juice)', '1/4 cup juice from the canned pineapple', '1/4 cup white vinegar', '1/4 cup ketchup', '1/2 teaspoon kosher salt (1/4 teaspoon table salt)', '2-3 tablespoons brown sugar', '1 tablespoon + 1 teaspoon cooking oil', '1 red bell pepper, cut into 1 inch chunks', '1 yellow bell pepper, cut into 1 inch chunks', '1 teaspoon grated fresh ginger']",14,"['1 Coat chicken with egg white, salt, and cornstarch: In a bowl, combine the chicken with the egg white, salt and cornstarch. Stir to coat the chicken evenly. Let sit for 15 minutes at room temperature or up to overnight in the refrigerator.', '2 Make sweet sour sauce: Whisk together the pineapple juice, vinegar, ketchup, salt, and brown sugar.', ""3 Stir-fry chicken: Heat a large frying pan or wok over high heat until a bead of water instantly sizzles and evaporates. Pour in the 1 tablespoon of cooking oil and swirl to coat. It\\'s important that the pan is very hot."", 'Add the chicken and spread the chicken out in one layer. Let the chicken fry, untouched for 1 minute, until the bottoms are browned.', 'Flip and fry the other side the same for 1 minute. The chicken should still be pinkish in the middle. Dish out the chicken onto a clean plate, leaving as much oil in the pan as possible.', '4 Stir fry bell pepper and ginger: Turn the heat to medium and add the remaining 1 teaspoon of cooking oil. Let the oil heat up and then add the bell pepper chunks and ginger. Fry for 1 minute.', '5 Add pineapple, sweet sour sauce, let simmer, add chicken: Add the pineapple chunks and the sweet and sour sauce. Turn the heat to high and when the sauce is simmering, add the chicken pieces back in.', ""Let simmer for 1-2 minutes, until the chicken is cooked through. Timing depends on how thick you\\'ve cut your chicken. The best way to tell if the chicken is done is to take a piece out and cut into it. If it\\'s pink, add another minute to the cooking."", 'Taste the sauce and add more brown sugar if you\\xe2\\x80\\x99d like.']",9
14,Vegan Stuffed Squash with Brown Rice and Mushrooms Recipe,20,60,80,"['For the squash:', '4 small winter squash (about 1 1/2 pounds each), like kabocha, acorn squash, or pie pumpkins', '1/2 tablespoon olive oil', '1/4 teaspoon salt', '1/4 teaspoon pepper', 'For the filling:', '4 tablespoons olive oil, divided', '2 cups brown rice', '4 cups low-sodium vegetable broth or water', '1 cup diced carrot', '1 cup diced shallots', '1 cup diced celery', '1 1/4 pounds mushrooms, diced (I used a mix of creminis and wild mushrooms),', '3 cloves garlic, minced', '1/2 cup white wine', 'Pinch cinnamon', '1 cup chopped mixed herbs (parsley, chives, and chervil work beautifully here)']",17,"['1 Heat the oven to 400F and prepare the squash. Cut the squash in half and scrape out the seeds. Cut a small sliver from the bottom of each squash half to create a stable surface for the ""bowl."" Rub the squash halves inside and out with olive oil, then sprinkle generously with salt and pepper.', '2 Roast the squash: Roast the squash halves cut-side down for 30 minutes, then flip them over and roast cut-side up (like a bowl) for another 15 minutes. When done, the squash should be easily pierced with a fork and toasted golden-brown on the surface. (About 45 minutes total; if the squash finishes roasting before the filling is ready, turn the oven heat to its lowest temperature and keep them warm until needed.)', '3 While the squash roasts, begin preparing the rice stuffing: In a large pot over medium heat, toast the rice with 1 tablespoon of olive oil until the rice smells fragrant and nutty, 3 to 5 minutes. Stir frequently to avoid burning.', '4 Cook the rice: Pour the vegetable broth or water over the rice and give it a quick stir. Bring to a boil over high heat. Once the water reaches boiling, turn down heat to low, cover the pot, and cook for 25 to 30 minutes until the rice is tender. If the rice isn\\xe2\\x80\\x99t done, continue checking every five minutes.', '5 Cook the carrots, shallots, and celery: Warm 1 tablespoon of olive oil in a 12-inch skillet over medium heat. Saut\\xc3\\xa9 the carrot, shallot, and celery until the shallots become translucent, about 5 minutes. Transfer the veggies to a large bowl, and set aside.', '6 Cook the mushrooms in batches: In the same 12-inch skillet, add 1 tablespoon of olive oil and turn the heat to medium-high. Add a third of the mushrooms \\xe2\\x80\\x93 do not to overcrowd the pan. Sprinkle 1/8 teaspoon salt and a little pepper over the mushrooms, but do not stir.', 'Let the mushrooms cook without stirring for 2 to 3 minutes, until a caramelized crust forms on the bottom of the mushrooms. (Lift one up to check!) Once you see a brown crust, stir the mushrooms together. Continue cooking, stirring often, until the mushrooms have released all their liquid and look evenly browned on all sides.', 'Repeat with the remaining mushrooms, adding more oil to the pan as needed.', '7 Finish the vegetables: When all the mushrooms are cooked, return the cooked mushrooms, carrots, shallots, and celery to the pan over medium-high heat. Stir in the garlic and cook until fragrant, 30 seconds. Add the white wine and scrape any glazed bits from the bottom of the pan as the wine simmers. Cook for another 2 to 3 minutes, until most of the wine has evaporated. Remove from heat.', '(If the vegetables and rice are ready before the roasted squash, cover the pans to keep warm until needed. If necessary, re-warm briefly on the stovetop or the microwave before continuing with the recipe.)', '8 Set 6 of the roasted squash halves on plates for serving; scoop the flesh from the remaining 2 squash halves. Transfer the flesh to a food processor. Add the cinnamon and puree until very smooth.', '9 Finish the squash filling: In a large bowl, combine the mushrooms, vegetables, cooked rice, and squash puree and mix until well-combined. Taste and add more salt, pepper, or cinnamon if you like. Finally, stir in fresh herbs, reserving some herbs for sprinkling over top.', '10 Stuff the squashes and serve: Divide the filling equally between all the squash halves, mounding the filling slightly. Sprinkle with chopped herbs and serve immediately while piping hot.']",13
15,Roasted Winter Squash with Cilantro Chimichurri Recipe,10,30,40,"['For the squash:', '3 pounds acorn or delicata squash', '1 tablespoon olive oil', '1/4 teaspoon salt', 'Ground black pepper', 'For the cilantro chimichurri:', '1/2 cup olive oil', '1/2 cup finely chopped cilantro', '1/2 cup finely chopped parsley', '1 tablespoon finely chopped oregano leaves', '1 1/2 teaspoons urfa biber, or regular chili flakes', '1/4 teaspoon salt', '4 garlic cloves, minced', '1/4 cup red wine vinegar']",14,"['1 Preheat the oven to 375F. Line a baking sheet with aluminum foil, a silicon baking mat, or parchment paper.', '2 Prepare the squash: Cut the squash in half lengthwise. Scoop out and discard the strings and seeds (save and roast the seeds, if you like). Cut the squash into 1-inch slices.', 'Toss the squash with a 1 tablespoon of olive oil, 1/4 teaspoon or so of salt, and ground black pepper. Place on the prepared baking sheet.', '3 Roast the squash for 30 minutes or until easily pierced with a fork.', '4 While the squash is cooking prepare the chimichurri. In a medium bowl, stir together the olive oil, cilantro, parsley, oregano leaves, chili flakes, garlic, red wine vinegar and 1/4 teaspoon salt. Taste and add more salt if needed.', '5 Serve: Transfer the roasted squash to a serving platter or individual plates, top with a generous amount of chimichurri, and enjoy.']",6
16,Stuffed Squash with Turkey and Apples Recipe,10,45,55,"['1 medium (about 1 1/4 to 1 1/2 pound) acorn squash, halved lengthwise and seeded', '2 tablespoons plus 1 teaspoon olive oil', '1 teaspoon salt, divided', '1/8 teaspoon ground black pepper', '1/2 cup uncooked wild rice', '6 ounces ground turkey or ground breakfast sausage', '1 small shallot, finely chopped', '1 stalk celery, finely chopped', '1/2 large apple (Honeycrisp, Jonagold, or Braeburn), unpeeled, cored, and cut into small dice', '1 tablespoon chopped fresh sage leaves', '1 tablespoon chopped fresh rosemary', '2 tablespoons dried cranberries', '1 tablespoon fine, dry breadcrumbs']",13,"['1 Preheat the oven: Preheat the oven to 425\\xc2\\xbaF. Line a baking sheet with parchment.', '2 Roast the squash: Brush the squash with 1 tablespoon of the oil and sprinkle with 1/4 teaspoon salt and a pinch of pepper. With the cut sides down, place the squash on the baking sheet. Bake for 35 to 40 minutes, or until tender when pierced with the tip of a paring knife. Remove and cool briefly.', '3 While the squash roasts, cook the rice: In a small saucepan, bring 2 cups water and 1/4 teaspoon salt to a boil. Add the rice and adjust the heat to a simmer. Set a lid on top, slightly askew, and cook for 40 to 45 minutes, or until the rice \\xe2\\x80\\x9cgrains\\xe2\\x80\\x9d are tender (some grains may begin to separate or burst). Drain in a sieve or fine-mesh colander.', '4 Cook the turkey and vegetables: In a medium skillet over medium-high heat, add 1 tablespoon of the oil. Add the turkey and break it up into tablespoon-sized clumps using a stiff spatula or wooden spoon. Cook for 5 to 7 minutes, stirring often to further break up the meat, until it begins to brown.', 'Add the shallot, celery, apple, sage, rosemary, cranberries, 1/2 teaspoon salt, and a pinch of pepper. Cook and stir for another 3 to 4 minutes, or until the vegetables soften.', 'If the pan seems dry, add up to 1/4 cup water, 1 tablespoon at a time, and stir to scrape up any brown bits on the bottom of the skillet until the water evaporates. Stir in the cooked rice. Taste and add more salt and pepper, if you like.', '5 Stuff the squash: Turn the squash on the baking sheet so the cut side is up. Divide the filling between the halves.', '6 Bake the squash: In a small bowl, mix the breadcrumbs with 1 teaspoon of oil. Sprinkle on top of the squash halves.', 'Bake for 10 minutes, or until hot all the way through and the breadcrumbs are browned.']",9
17,Grilled Moroccan Chicken Recipe,5,135,140,"['1/2 cup plain yogurt', '1 Tbsp lemon juice', '1/2 cup chopped fresh cilantro', '1 tablespoon extra virgin olive oil', '2 cloves garlic, minced', '1 1/2 teaspoons ground cumin', '1 teaspoon paprika', '1/2 teaspoon ground cinnamon', '1/2 teaspoon salt', '1/2 teaspoon freshly ground black pepper', '1 1/2 pounds skinless, boneless chicken breasts']",11,"['1 Marinate the chicken: Mix the marinade ingredients (yogurt, lemon juice, cilantro, olive oil, garlic, cumin, paprika, cinnamon, salt, and pepper) together in a medium sized bowl.', 'Add the chicken pieces to the bowl and thoroughly coat with the marinade.', 'Cover with plastic wrap and chill in the refrigerator from 2 hours to overnight.', '2 Grill the chicken: Heat your grill on high heat if you are using a gas grill, or prepare coals for direct heat if you are using charcoal. Allow for one side of the grill to be the ""cool"" side. If you do not have a grill you can use a cast-iron grill pan on your stove.', 'Grill the chicken breasts over direct high heat a couple of minutes on one side. Then turn them over and move them to the cool side of the grill. Cover and cook for a few minutes more, until the chicken is cooked through.', '(The easiest way to test for doneness is with your fingertips. See The Finger Test to Check the Doneness of Meat. Or use a meat thermometer, remove the meat from the grill when the internal temperature of the chicken breast reaches 165\\xc2\\xb0F.)', 'Take care not to overcook, as chicken breasts can easily dry out.']",7
18,Chicken Peanut Curry Recipe,15,45,60,"['3 pounds boneless, skinless chicken pieces (or you can use bone-in for added flavor), cut into 1 1/2 inch wide chunks or strips', '2/3 cup all purpose flour', '4 tablespoons yellow curry powder', '1 1/2 teaspoons sea salt', '1/2 teaspoon freshly ground peppercorns', '1/3 cup extra virgin olive oil', '2 tablespoons fresh ginger, minced', '2 tablespoons garlic, minced', '2 serrano chili peppers, seeded, de-veined, minced', '4 cups chicken broth', '2/3 cup peanut butter (if using freshly ground peanuts, add 2 teaspoons of sugar)', '1 teaspoon ground coriander seeds', '8 green onions, chopped, greens included', '1/3 cup each finely chopped mint and cilantro', '3 tablespoons lime juice']",15,"['1 Coat chicken pieces in seasoned flour: Rinse chicken and pat dry. In a large bowl, combine the flour, curry powder, salt and pepper. Toss the chicken pieces to coat.', '2 Saut\\xc3\\xa9 chicken pieces: Heat oil in a large, heavy pot or Dutch oven on medium high heat. Add chicken pieces in batches, being careful to not crowd the pan. Cook 2-4 minutes per side, or until the coating sets and browns a little. Remove the chicken from the pot as it cooks and set aside in a bowl.', '3 Build curry base with ginger, garlic, chili, broth, peanut butter: When the chicken has all been browned, add the ginger, garlic, chili pepper and 1/2 cup of the chicken broth to the saucepan. Cook for a minute or two, scraping the pan with a spatula and stirring to combine everything well.', 'Whisk in the peanut butter, and the remaining 3 1/2 cups of broth slowly, stirring continuously to maintain an even texture.', '4 Add chicken to pot, simmer: Return the chicken to the pot and simmer for 15-25 minutes.', '5 Serve with coriander and garnishes: Right before serving, add the ground coriander, cilantro, mint and green onions. Add salt and lime juice to taste. Serve with rice.']",6
19,Skillet Chermoula Chicken Recipe,10,30,40,"['6 bone-in, skin-on chicken thighs (about 2 pounds), trimmed of excess fat', '1 teaspoon salt', '1 tablespoon extra virgin olive oil', 'Chermoula Sauce', '1 1/2 teaspoons whole cumin seed (or 1 teaspoon ground)', '1/2 teaspoon whole coriander seed (or 1/4 teaspoon ground)', '4 cloves garlic', '1 1/2 cups medium packed parsley leaves', '1 1/2 cups medium packed cilantro leaves and tender stems', '1/2 teaspoon salt', '1/2 teaspoon paprika', '1 teaspoon lemon zest', '1/2 cup extra virgin olive oil', '2 tablespoons lemon juice']",14,"['1 Salt chicken thighs on both sides and let rest while you prepare the sauce.', '2 If using whole cumin and coriander seeds, lightly toast the whole cumin and coriander in a small skillet on medium heat, until fragrant. Put into a mortar and pestle and grind until powdery.', '3 Make the chermoula sauce: Put 4 cloves garlic, parsley, cilantro, salt, cumin, coriander, paprika, and lemon zest in a food processor. Pulse several times. With the motor running, slowly add in 1/2 cup of olive oil, then the lemon juice. Process until you have a smooth paste. You should have almost a cup of chermoula sauce.', '4 Brown chicken thighs in skillet: Heat 1 Tbsp olive oil on medium high heat in a large cast iron pan and preheat oven to 350\\xc2\\xb0F.', 'Pat dry the chicken pieces and place them skin side down in the hot pan. Let them cook until deep golden brown, about 5 to 6 minutes.', 'Then turn them over and cook a few minutes more.', '5 Drain excess fat: Because you are working with skin-on thighs, you will likely render quite a bit of fat. Remove the chicken from the pan and pour off any excess fat. (Do not pour down the drain unless you want to clog your drain pipes.) Return the chicken to the pan.', '5 Spread chermoula on chicken, bake in oven: Spread most of the chermoula sauce on both sides of the chicken thighs, reserving 1/4 cup of the fresh sauce to add later.', 'With the chicken skin-side up, put the skillet in the 350\\xc2\\xb0F oven for 10 to 15 minutes, until the thighs are cooked through and the temperature near the bone is 165\\xc2\\xb0F when tested with a meat thermometer.', '6 Spoon remaining sauce over chicken: Stir the reserved fresh chermoula sauce in with the pan sauce. Spoon sauce over the chicken to serve.', 'Serve with couscous or with basmati rice for a gluten-free option.']",11
20,Vegetable Shakshuka with Pesto Recipe,20,30,50,"['4 plum tomatoes, cored and cut into 8 pieces', '1 medium beefsteak tomato, cored and cut into 8 pieces', '2 tablespoons olive oil', '1 bunch scallions, trimmed and thinly sliced', '1 medium clove garlic, chopped', '1/8 teaspoon black pepper', '1/8 teaspoon crushed red pepper', '1/2 teaspoon ground cumin', '1/2 teaspoon paprika', '1/4 cup water, or more if needed', '1 yellow pattypan squash, 1 medium summer squash, or 1/2 golden zucchini', '4 large eggs', '3/4 cup pesto, homemade or store-bought', 'Handful of fresh basil leaves, for garnish (optional)', 'Baguette or thick slices of bread, to serve', 'Equipment:', 'A blender or food processor']",17,"['1 Blend the tomatoes: Blend the plum and beefsteak tomatoes in a blender or food processor until they are saucy (you should have about 3 cups).', '2 Cook the tomato sauce: Heat the olive oil in a large saut\\xc3\\xa9 pan over medium heat. Add the scallions and cook, stirring often, for 5 minutes. Add garlic, salt, black pepper, red pepper, cumin, and paprika. Cook, stirring, for 1 minute more.', 'Add the tomatoes and cook, stirring, for 2 minutes or until they stop sizzling. Add 1/4 cup of water. Lower the heat and simmer the sauce for 5 minutes. If the mixture seems dry, add more water, 1 tablespoon at a time.', '3 Prepare the squash or pattypan: Trim top and bottom from the squash and cut into quarters. If using a yellow squash or zucchini, remove the column of seeds from the center (the pattypan has fewer seeds, so it\\xe2\\x80\\x99s OK to leave them in). Very thinly slice the vegetables.', '4 Add the squash to the tomato sauce. Stir well and continue cooking for 5 minutes, or until the vegetables are tender. Add more water, if needed.', '5 Cook the eggs: BUse the back of a spoon to make 4 indentations in the tomato mixture. Break one of the eggs into a measuring cup and then carefully pour it into an indentation, being careful not to break the yolk. Repeat with the remaining eggs. Cover the pan and cook over medium heat for 8 minutes or until the whites are set (the yolks will still be runny).', '6 Serve: Garnish the dish with dabs of pesto and fresh basil leaves. Serve straight from the pan to individual dishes.']",7
21,Agua de Jamaica (Hibiscus Tea) Recipe,10,25,35,"['2 quarts water', '3/4 to 1 cup sugar (depending on how sweet you would like it to be)', '1 cup dried hibiscus flowers', '1/2 cinnamon stick (optional)', 'A few thin slices ginger (optional)', 'Allspice berries (optional)', 'Lime juice (optional)', 'Orange or lime slices for garnish']",8,"['1 Boil water with sugar and spices: Put 4 cups of the water and the sugar in a medium saucepan. Add cinnamon, ginger slices, and/or a few allspice berries if you would like. Heat until boiling and the sugar has dissolved.', '2 Steep with dried hibiscus flowers: Remove from heat. Stir in the dried hibiscus flowers. Cover and let sit for 20 minutes.', '3 Strain:  Strain into a pitcher and discard the used hibiscus flowers, ginger, cinnamon, and/or allspice berries.', '(At this point you can store ahead the concentrate, chilled, until ready to make the drink.)', '4 Add water: Add remaining 4 cups of water (or if you want to chill the drink quickly, ice and water) to the concentrate, and chill.', 'Alternatively you can add ice and chilled soda water for a bubbly version.', 'Add a little lime juice for a more punch-like flavor.', 'Serve over ice with a slice of orange or lime.']",8
22,Seared Tuna with Avocado Recipe,10,6,16,"['1/2 cup chopped fresh cilantro leaves', '2 jalape\\xc3\\xb1o chiles, seeded, de-ribbed, minced (if very hot, use only 1 chile)', '2 tablespoons of peeled and minced fresh ginger', '4 garlic cloves, minced', '4 tablespoons freshly squeezed lime juice (from 2 to 4 limes, depending on how juicy your limes are)', '1/3 cup soy sauce (use gluten-free soy sauce if you need to avoid gluten)', '1-2 tablespoons sugar', 'Salt and freshly ground black pepper', '1 teaspoon dark sesame oil', '1/4 cup extra-virgin olive oil', '2 tablespoons canola oil or extra virgin olive oil', '4 (6 ounce) blocks sashimi-quality tuna', '2 ripe avocados, halved, pitted, peeled and sliced']",13,"['1 Make the sauce: In a bowl, combine the cilantro, jalape\\xc3\\xb1o, ginger, garlic, lime juice, soy sauce, sugar, salt, sesame oil and olive oil. If you want, you can pur\\xc3\\xa9e the sauce in a blender or food processor.', '2 Sear the tuna steaks: Heat a large skillet on high heat for one minute. Coat the pan with the canola oil or EVOO and let heat up for 30 to 45 seconds. Sprinkle the tuna pieces with salt. Sear the tuna for a minute on each side.', '3 Serve the tuna with sauce and avocado: Transfer the seared tuna to a bowl and coat with some of the sauce. Pour some sauce on the plates, top with the tuna and serve with the sliced avocado and a wedge of lime.']",3
23,Air Fryer Crispy Cauliflower Recipe,5,12,17,"['For the blue cheese dip:', '1/4 cup Greek yogurt', '1/4 cup mayonnaise', '1/4 cup crumbled blue cheese', 'Pinch of ground black pepper', 'Dash of hot sauce', 'For the crispy cauliflower:', '1 head cauliflower', '1 teaspoon kosher salt', '1/2 teaspoon chili powder', '1/2 teaspoon garlic powder', '2 large eggs + 1/4 cup water', '1 cup breadcrumbs', 'Nonstick spray, for air fryer', 'Special equipment:', 'Air Fryer']",16,"['1 Make the blue cheese dip: Stir together ingredients in a medium bowl. Keep in fridge until needed.', '2 Prepare the cauliflower: Cut the cauliflower into florets. It\\xe2\\x80\\x99s okay to have a few different sizes, but try to make sure there are no florets bigger than about 1 1/2 inches.', '3 Bread the cauliflower: In a medium bowl toss florets with salt, chili powder, and garlic powder. In a separate small bowl, add eggs and water and whisk together. Add the egg mixture to the bowl with the cauliflower and toss to coat. Once the cauliflower is coated with the egg mixture, toss with breadcrumbs and coat well.', '3 Air-fry the cauliflower: Spray the basket of an air fryer with nonstick spray and place as many cauliflower florets in the basket as will fit in a single layer. Return the basket to the fryer and cook at 350\\xcb\\x9aF for 7 minutes. Then flip the florets and fry for another 7 minutes.', 'Repeat until all cauliflower is done.', '4 Serve! Serve cauliflower immediately once all batches are done, or serve on a rolling basis as the batches come out of the fryer. Cauliflower is best right out of the fryer! Serve with the blue cheese dip as an appetizer or side dish.']",6
24,Air Fryer Chicken Wings Recipe,20,0,20,"['For the wings:', '3 pounds chicken wing drumettes and flats', '3 teaspoons baking powder', '2 teaspoons kosher salt', 'For the sauce:', '2 tablespoons gochujang', '2 tablespoons soy sauce', '1 tablespoon rice wine vinegar', '2 teaspoons sesame oil', '1 teaspoon sugar', '3 tablespoons butter, melted and kept warm', 'For the sesame mayonnaise dipping sauce:', '1 cup mayonnaise', '1 tablespoon toasted sesame oil', '3/4 teaspoon sugar', '1/8 teaspoon sriracha', 'To garnish:', 'Thinly sliced scallions, for garnish', 'Toasted sesame seeds, for garnish', 'Thin spears of cucumber', 'Thin slices of radish', 'Special equipment:', 'Air Fryer']",23,"['1 Season and rest the wings: Pat the wings dry, if needed. In a large bowl, add the wings and toss them with the baking powder and salt until evenly coated.', 'Spread the wings around the bowl so they are in a single layer and refrigerate them, uncovered, for at least 6 hours and up to 24 hours.', '2 Air fry the wings: Heat the air fryer to 380\\xc2\\xb0F. Open the drawer and fit as many wings as you can in it without crowding them (for my 4.4-quart air fryer, this was 1-1/2 pounds of wings, or half the batch). Close the drawer. Cook for 25 minutes, shaking the drawer every 5 minutes to shuffle the wings around.', '3 Make the sauce: As the wings cook, make the sauce. In a medium bowl, whisk together the gochujang, soy sauce, rice wine vinegar, sesame oil, and sugar. Set aside.', '4 Make the sesame mayonnaise: In a small bowl, whisk together the mayonnaise, sesame oil, sugar, and sriracha until smooth. Set aside.', '5 Increase the air fryer temp: Once the wings have cooked for 25 minutes, increase the temperature of the air fryer to 400\\xc2\\xb0F. Cook the wings for another 5 minutes. This gets them nice and brown and especially crispy.', '6 Sauce and serve the wings: Mix the melted butter with the sauce (it might solidify a bit, but the heat of the wings will re-melt it). Add the wings to a large bowl, pour over half the sauce and toss the wings in the sauce.', '7 Serve and eat: Transfer to a serving platter and sprinkle with scallions and sesame seeds, if you like. Serve immediately, accompanied by the cucumbers, radishes, and sesame mayonnaise for dipping.', '8 Cook the remaining wings: Reduce the temperature of your air fryer back to 380\\xc2\\xb0F. Repeat steps 2 and 4. Toss them with the remaining sauce.']",9
25,How to Make Crispy Air Fryer French Fries,70,20,90,"['1 1/2 pounds russet potatoes (peeled if you want)', '2 teaspoons canola oil or other vegetable oil', '1 tablespoon chopped fresh rosemary or 1 teaspoon dried rosemary', '1/2 teaspoon fine sea salt (or regular salt)', '1/4 teaspoon freshly cracked black pepper', 'Special equipment:', 'Air fryer']",7,"['1 Soak the potatoes. Scrub the potatoes clean and slice them long ways, 1/4 to 1/2-inch thick. Soak them in a bowl of ice water for at least an hour, or up to 24 hours (in the fridge) if need be.', '2 Preheat the air fryer: Preheat the air fryer to 390\\xc2\\xb0F for about 15 minutes.', '3 Dry and season potatoes: Remove the potatoes from the bowl and lay them out on a paper towel or clean kitchen towel. Dry them thoroughly, and then transfer them to a medium bowl and toss them with the oil, rosemary, salt, and pepper.', '4 Air fry the potatoes: Remove the air fryer basket and add the potatoes, positioning them as evenly as you can. Set the timer for 10 minutes and fry the potatoes.', 'Slide the basket out, toss the potatoes to redistribute them\\xe2\\x80\\x94you may notice some spots look more air fried than others.', 'Fry for another 10 to 12 minutes, until they start to look dry and crispy. (If any pieces seem excessively brown, remove them before you turn the fryer back on.)', '5 Serve: Remove from the fryer and place in a serving bowl. Let them cool for a few minutes (I know it\\xe2\\x80\\x99s hard, they\\xe2\\x80\\x99re French fries!) and taste. They should crisp up a little bit as they cool. Toss with additional rosemary, salt, and/or pepper if desired.', 'If for some reason you find yourself in a situation with leftovers, you can refrigerate them, covered for a few days. Simply reheat them in a little oil in a hot cast iron pan or skillet and they\\xe2\\x80\\x99ll perk right back up.']",8
26,Crispy Air Fryer Chickpeas Recipe,5,10,15,"['For the chickpeas:', '1 (15-ounce) can chickpeas, drained and rinsed', '1 tablespoon canola or vegetable oil', ""Za'atar seasoning:"", '2 teaspoons fresh thyme, minced', '1 teaspoon za\\xe2\\x80\\x99atar seasoning', '1/2 teaspoon sea salt', '1/4 teaspoon cracked black pepper', 'Spicy seasoning:', '1/2 teaspoon sea salt', '1/2 teaspoon chili powder', '1/2 teaspoon paprika', '1/4 teaspoon cayenne', 'French herb seasoning:', '1 teaspoon Herbs de Provence', '1/2 teaspoon sea salt', '1/4 teaspoon freshly cracked black pepper', '1 teaspoon lemon zest', 'Italian seasoning:', '1 teaspoon finely grated Parmesan or Pecorino Romano cheese', '1 teaspoon Italian seasoning or equal parts oregano, thyme, basil, and marjoram', '1/2 teaspoon sea salt', '1/4 teaspoon freshly cracked black pepper', 'Special equipment:', 'Air fryer, such as the Phillips Air Fryer']",25,"[""1 Preheat the air fryer to 390\\xc2\\xb0F for 10 minutes, or according to the manufacturer's instructions."", '2 Prep the chickpeas: Dry the chickpeas thoroughly on a paper towels or a clean kitchen towel. You can even dry them in a salad spinner, but you might lose a few depending on the design of your spinner. Discard any skins that come off of the chickpeas during this step.', '3 Season the chickpeas: Combine the oil and spice mix in a bowl and whisk to combine. Gently incorporate the chickpeas until coated.', ""4 Air fry the chickpeas: Transfer to the preheated air fryer and air fry for 8 to 10 minutes until crispy. Taste one of the chickpeas; if it's not as crispy as you'd like, then continue to cook for another 1 to 3 minutes."", 'Some of the chickpeas may look as though they have \\xe2\\x80\\x9cpopped.\\xe2\\x80\\x9d Don\\xe2\\x80\\x99t fret if that happens!', '5 Season and serve: Remove from the basket to a bowl, taste, and add more salt, pepper or seasoning to your liking. Serve immediately; the crispy chickpeas will not keep.']",6
27,Air Fryer Bacon-Wrapped Figs Recipe,10,30,40,"['12 dried Turkish or mission figs', '6 strips regular center-cut bacon (not thick cut)', 'Goat cheese or blue cheese for stuffing, optional', 'Salted, roasted almonds for stuffing, optional', 'Honey, for serving', 'Nonstick spray, for air fryer', 'Special equipment:', 'Air fryer']",8,"['1 Reconstitute the figs: Add the dried figs to a bowl filled with steaming hot water. Let them sit for 20 minutes to reconstitute. Drain the figs and cut off the stems. Cut a small slit in each fig and spoon in a little blue cheese or goat cheese, or half an almond, if desired. You could also do a mix of fillings.', '2 Wrap the bacon around the figs: Cut the strips of bacon in half and trim them down to about 1/2 to 3/4 inches wide. Wrap one bacon strip around each fig. Secure with a toothpick.', '3 Air fry the figs: Spray the basket of your air fryer with nonstick spray. Add bacon-wrapped figs in a single layer so they aren\\xe2\\x80\\x99t touching. Air fry the figs at 350\\xcb\\x9aF for 8-9 minutes, flipping once halfway through.', 'If you don\\xe2\\x80\\x99t have an air fryer, broil the figs on high for about 3 minutes per side.', '4 Serve the figs: Once the figs have cooled slightly, serve them drizzled with honey.', 'Leftover figs (yeah right!) will keep in the fridge for up to 5 days. Reheat in a 350\\xcb\\x9aF oven, or reheat in the air fryer for a few minutes before eating.']",6
28,Almond Crescent Cookies Recipe,15,20,35,"['1 cup of butter, room temperature', '2/3 cup of sugar', '1 teaspoon of vanilla extract', '1 teaspoon of almond extract', '2 1/2 cups of flour', '1 cup of almond flour (can substitute ground almonds*)', '1/4 cup of powdered sugar for sprinkling', '*You can use slivered, blanched almonds and grind them up, but you will have a very crumbly, hard to work with dough. It\\xe2\\x80\\x99ll still taste good though.']",8,"['1 Beat the butter and the sugar together until light and fluffy. Add the vanilla and almond extracts and mix.', '2 Add the flour and almond flour. Mix thoroughly.', '3 Take generous tablespoons of the dough (it will be slightly crumbly) and roll it into a small ball, about an inch in diameter, and then shape into a crescent shape. Place onto a parchment paper lined baking sheet.', '4 Bake at 350\\xc2\\xb0F for 15-20 minutes or until a light golden brown.', '5 Dust with powdered sugar.', 'For added decadence let the cookies cool and dip one end of them into some melted chocolate, then let the chocolate harden.']",6
29,Chinese Almond Cookies Recipe,20,135,155,"['1 1/3 cups of almond flour, lightly packed', '1 cup of unsalted butter, chilled and cut into cubes', 'Pinch of kosher salt', '2 eggs', '1 teaspoon of almond extract', '1 3/4 cups of flour', '1 cup + 2 tablespoons of sugar', '1/2 teaspoon of baking soda', 'Thinly sliced almonds']",9,"['1 Beat almond flour, salt, butter: Place the almond flour, salt, and butter into an electric mixer with a paddle attachment and beat on medium speed for three minutes. The mixture will become coarse and chunky looking.', '2 Add one of the eggs, reserving the other for later, and the almond extract. Mix on low speed until just incorporated.', '3 Sift together the flour, sugar, and baking soda then add to the butter mixture at low speed. Mix until just combined.', '4 Chill the dough: Take the dough and flatten it into a disc and wrap in plastic wrap. Place it in the refrigerator for two hours to chill.', '5 Prep oven, baking sheet, egg: Preheat the oven to 325\\xc2\\xb0F. Line a baking sheet with parchment paper. Place the other egg into a bowl and beat it.', '6 Flatten balls of dough onto cookie sheet: Take pieces of dough and roll them into balls about three-quarters-of-an-inch wide. Place them on the sheet about an inch apart and then press them down slightly with your palm to make a coin shape.', '7 Place a slivered almond onto each cookie and lightly press it into place, then paint the surface of the cookie with some of the beaten egg using a pastry brush or your finger (this will give the cookie a lacquered appearance once it bakes).', '8 Bake at 325\\xc2\\xb0F for 13-15 minutes or until the edges just begin to tan. Cool on the sheet on a wire rack.']",8
30,Herb-Spiced Mixed Nuts Recipe,5,15,20,"['3 to 4 cups (283 to 354g) pecans, walnuts, and almonds', '2 tablespoons unsalted butter, olive oil, or coconut oil', '1 tablespoon chopped rosemary', '1 tablespoon chopped sage', '1 tablespoon chopped thyme', '1/8 to 1/4 teaspoon cayenne pepper', '2 tablespoons maple syrup', '1 teaspoon kosher salt']",8,"['1 Preheat the oven to 350\\xc2\\xb0F.', '2 Toast the nuts: Place the nuts on an ungreased, rimmed baking sheet and toast them for about 8 to 10 minutes. Remove from the oven to cool slightly.', '3 Combine the butter, herbs, and maple syrup: Melt the butter over low heat in a small saucepan. Remove from the heat and add the rosemary, sage, thyme, cayenne, maple syrup, and salt. (If you are using oil, you should gently and briefly warm it as well.)', '4 Toss the nuts with the butter and herbs: Using a spatula, toss the warm nuts in a medium bowl with the melted herbs and butter until the nuts are coated.', '5 Serve! These are best consumed immediately, while warm. They may make your hands a little messy, but it\\xe2\\x80\\x99s worth it. Trust me.']",5
31,Almond Flour Waffles Recipe,15,10,25,"['1 1/2 cups almond flour or almond meal', '1/2 cup tapioca flour', '1 teaspoon baking soda', '1 teaspoon baking powder', 'Pinch of salt', '3 tablespoons sugar', '3 large eggs', '3 tablespoons coconut oil, warmed to liquid state', '1 cup almond milk, room temperature', '1 teaspoon almond extract', '1 teaspoon vanilla extract', 'Special equipment:', 'Waffle maker']",13,"['1 Preheat your waffle maker: Turn on your waffle maker and let it warm for 5 to 10 minutes, until hot enough that a flick of water evaporates on contact. Heat the oven to 250\\xc2\\xb0F.', '2 Make the waffle batter: Whisk together the dry ingredients in a medium bowl. In a separate bowl, whisk together the wet ingredients. Add the wet ingredients to the dry ingredients and thoroughly whisk together.', '3 Rest the batter: Allow the mixture to sit for 5 minutes to give the flour time to absorb the liquid.', '4 Make the waffles: Grease the waffle maker and make waffles according to manufacturer\\xe2\\x80\\x99s instructions. After cooking, place the finished waffles in the oven for 5 to 10 minutes to stay warm and to crisp them up a little. Serve immediately.']",4
32,Ginger Almond Biscotti Recipe,30,110,140,"['1 cup blanched slivered almonds', '3/4 cup (170 g) sugar', '1/2 cup (1 stick) butter', ""1/2 cup molasses (NOT blackstrap molasses, it's too bitter)"", '3 large eggs', '1/4 cup minced fresh ginger', '3 cups (400 g) all purpose flour', '1 teaspoon baking powder', '1 teaspoon cinnamon and nutmeg', '1/2 teaspoon each ground cloves and allspice']",10,"['1 Bake the almonds: Spread the almonds out on a sheet pan and bake them at 350\\xc2\\xb0F for 10 minutes. Let cool, then roughly chop.', '2 Make the biscotti dough base: Beat together the sugar and butter until light and fluffy (about 3 to 4 minutes). Add the molasses and beat a minute more.', 'Add eggs one at a time, beating for 1 minute after each addition. Mix in the minced ginger.', '3 Mix in the dry ingredients and the almonds: Whisk together the flour, baking powder, cinnamon, nutmeg, ground cloves and allspice.', 'Add the flour mixture into the butter and eggs mixture, one third at a time. Stir in the almonds.', '4 Refrigerate the dough for 1 hour.', '5 Shape into long rectangles: Turn the dough out onto a well-floured board, and divide in half. With floured hands, shape into long rectangles about 10-12 inches long, 2 1/2 inches wide and 1/2 inch high. Transfer to a parchment or silicone lined baking sheet.', '6 Bake: Bake at 350\\xc2\\xb0F until golden brown and firm to the touch in the center, 25 to 30 minutes. Remove from oven, and let stand until cool enough to handle.', '7 Cut diagonally: Transfer the rectangles to a cutting board. Using a serrated bread knife, cut the rectangles on the diagonal into 1/2-inch-thick slices.', '8 Bake again: Return pieces cut side down to baking sheet. Re-bake 15-18 minutes, turning the biscotti over half way through baking.', 'Cool on wire rack. Store in airtight container.', 'Dip in wine after dinner (classic Italian fashion) or coffee, tea, or hot cocoa.']",12
33,Almond Pound Cake with Orange Glaze Recipe,10,75,85,"['Cake:', '5 ounces (140 g) almond paste (we recommend Odense almond paste), grated', '1 1/2 cups (300 g) white granulated sugar', '4 ounces (1/2 cup or 1 stick) butter, room temperature', '4 large eggs', '1 teaspoon orange zest', '1 teaspoon vanilla', '1/2 cup (120 g) plain (full fat) Greek yogurt (or sour cream)', '1 1/2 cups (200 g) all purpose flour', '1 teaspoon baking powder', '1/2 teaspoon salt (if using unsalted butter)', 'Glaze:', '1/3 cup (43 g) powdered sugar', '2 teaspoons orange juice', '1/2 teaspoon lemon juice', '1/2 teaspoon orange zest', 'Special equipment:', '5x9x3-inch loaf pan']",18,"['1 Preheat oven, prepare loaf pan: Preheat oven to 325\\xc2\\xb0F. Grease the inside of a 5x9x3-inch loaf pan with butter or with non-stick spray.', '2 Beat almond paste, add sugar, butter, eggs, zest, vanilla, yogurt: Using a stand mixer, beat the almond paste, starting at a low speed.', 'Slowly add the sugar to the almond paste while beating, gradually increasing the speed, until incorporated.', 'Add the butter, and beat until fluffy, smooth, and almost white, about 5-6 minutes, on high speed.', 'Add the eggs, one at a time, beating a minute after each addition.', 'Beat in the orange zest, vanilla, and Greek yogurt.', '3 Whisk dry ingredients: In a medium bowl, vigorously whisk together the flour, baking powder, and salt.', '4 Stir the flour mixture into the butter, almond paste, egg mixture, a third at a time, until well blended.', '5 Bake: Pour batter into prepared loaf pan. Place on lower middle rack of your oven.', ""Bake at 325\\xc2\\xb0F for 50-55 minutes, until golden brown, and if you press down lightly on the top it springs back at you, and a tester inserted into the center comes out clean. While it's baking, if you notice it getting too browned, tent it lightly with aluminum foil."", '6 Cool on a rack: Remove from oven and let cool on a rack for 5 to 10 minutes. Then carefully remove from the pan to cool completely on a rack.', '7 Make orange glaze: While the cake is cooling, make the glaze. Sift the powdered sugar through a sieve to remove any lumps and place in a medium bowl. Whisk in the orange juice and lemon juice. Stir in the the zest. Add more sugar if the glaze is too runny, add more juice if it is too thick for your taste.', '8 Drizzle cake with glaze: When the cake has cooled, place it on a serving plate and use a spoon to drizzle the glaze all over it.']",13
34,Oatmeal Almond Butter Breakfast Cookies Recipe,10,18,28,"['2 cups rolled oats (not quick-cooking oats)', '1 cup all-purpose flour', '1 cup whole wheat flour', '1/2 cup wheat germ', '2 teaspoons baking soda', '1 teaspoon kosher salt', '1 teaspoon ground cinnamon', '1 1/2 cups almond butter, room temperature (see Recipe Note)', '1 1/3 cups light brown sugar, packed', '2 teaspoons vanilla extract', '2 large eggs', '1/3 cup water', '1 cup semi-sweet chocolate chips']",13,"['1 Preheat the oven: Preheat your oven to 350\\xc2\\xb0F. Line a sheet pan with parchment paper or a silicone baking mat.', '2 Mix the dry ingredients: Combine the rolled oats, flours, wheat germ, baking soda, salt, and cinnamon together in a large mixing bowl. Set aside.', '   3 Make the cookie dough: In the bowl of a stand mixer using the paddle attachment (or using a hand mixer), mix the almond butter, brown sugar, and vanilla extract at low speed until smooth.', 'With the mixer still on low, add the eggs, one at a time, to the bowl. Scrape down the bowl after each egg is blended into the batter. This helps the mixture to stay smooth and uniform.', 'Add the water to the bowl and mix on low until the batter no longer looks soupy. Gradually add the flour mixture to the batter, stopping the mixer to scrape down the sides of the bowl. Mix again for one minute to make sure the flour is completely blended in.', 'Gradually add the chocolate chips to the dough. Mix for 30 seconds more still on low speed.', '4 Scoop the cookies: Using a large (2 ounce) ice cream scoop, or a lightly greased 1/4 measuring cup, scoop the dough onto your prepared sheet pan.', 'Slightly flatten each cookie with the back of your scoop or measuring cup.', '5 Bake the cookies: Bake for 15 to 18 minutes, or until the outer edges of the cookies are slightly browned and the centers are puffed.', '6 Cool and store the cookies: Remove the pan from the oven and allow the cookies to cool slightly (about 5 minutes) before enjoying. Store the cookies in an airtight container for up to 48 hours. (See headnotes for freezing instructions.']",10
35,Chewy Almond Squares (Blondies) Recipe,15,30,45,"['1/2 cup butter (1 stick, 112 g), melted, plus butter for greasing the pan', '1 cup tightly packed light brown sugar', '1 egg, lightly beaten', '1 tablespoon of almond extract', '1 cup (128 g) all purpose flour', '1/2 teaspoon baking powder', '1/8 teaspoon baking soda', 'Pinch of salt', '1/3 cup toasted, blanched almonds, chopped', 'Whole almond halves for decoration', '  One 8x8-inch baking pan']",11,"['1 Preheat oven, prep pan, toast almonds: Preheat your oven to 350\\xc2\\xb0F. Grease an 8x8-inch baking pan with butter. Toast blanched almonds if you have not already done so, and when cool, roughly chop them.', '2 Mix wet ingredients: In a mixing bowl, whisk together the melted butter and brown sugar until there are no more lumps of brown sugar. Whisk in the beaten egg and almond extract.', '3 Whisk dry ingredients: In a separate bowl, whisk together the flour, baking powder, baking soda, and pinch of salt.', '4 Make batter: Add the dry mixture to the wet mixture and mix until smooth. Stir in the chopped almonds.', '5 Pour into baking pan, add almond halves: Pour into the prepared baking pan and smooth the surface. You can ""cut"" the surface with a knife to make it easier to see where you will want to make cuts once the squares are done. Place an almond half, cut side down, in the middle of each square.', '6 Bake: Bake at 350\\xc2\\xb0F for 20 to 25 minutes or until a tester comes out clean. Cool completely before cutting into squares.']",6
36,Ginger Chicken with Almonds Recipe,15,15,30,"['4 boneless, skinless chicken breast halves (1 1/2 - 2 pounds total)', '2 teaspoons ground coriander', '1 teaspoon grated fresh ginger plus \\xc2\\xbc cup julienned fresh ginger (see How to Peel, Chop, and Grate Ginger)', '4 teaspoons canola oil or vegetable oil', '2 teaspoons white-wine vinegar', '1 teaspoon of cornstarch', '1/2 teaspoon kosher salt', '1/4 teaspoon freshly ground pepper', '4 large scallions (or 6 small), trimmed', '1/2 cup mango chutney, large pieces chopped', '1/4 cup chicken broth', '1 teaspoon minced garlic', '1/4 cup sliced almonds, toasted']",13,"['1 Slice chicken crosswise into \\xc2\\xbd-inch-thick pieces.', '2 Marinate chicken strips: Whisk the ground coriander, grated ginger, 2 teaspoons of the oil, vinegar, corn starch, salt, and pepper in a medium bowl, making sure there are no lumps of corn starch.', 'Add the chicken and marinate at room temperature for 15 minutes.', '3 Prepare scallions: Thinly slice white parts of scallions. Julienne green parts; set aside.', '4 Stir together chutney, broth, and garlic in a small bowl.', '5 Stir-fry: Heat remaining 2 teaspoons oil in a 12-inch nonstick skillet (or wok) over medium-high heat. Add scallion whites and julienned ginger; stir-fry 30 seconds.', 'Add chicken and stir-fry until thoroughly cooked, 4 to 6 minutes.', 'Add scallion greens and chutney mixture; cook, stirring, 2 minutes.', '6 Serve: Transfer to shallow bowls with hot cooked rice (or without rice, for low-carb version). Sprinkle with toasted almond slices and serve.']",9
37,Cherry Almond Granola with Vanilla Crumbles Recipe,10,50,60,"['For the vanilla crumbles (makes about 1 cup of crumbles):', '6 tablespoons instant nonfat dry milk (such as Carnation)', '1/4 cup all-purpose flour', '2 tablespoons sugar', '2 tablespoons cornstarch', '1/8 teaspoon salt', '3 tablespoons melted butter', '1 tablespoon vanilla extract, or the 1 vanilla bean, seeded and scraped', 'For the granola:', '3 cups old-fashioned rolled oats, divided', '3 tablespoons oil', '2 tablespoons maple syrup', '1/3 cup brown sugar', '1 teaspoon vanilla extract', '1 teaspoon almond extract', '1/2 teaspoon cinnamon', '1/2 teaspoon salt', '1/4 cup slivered almonds', '3/4 cup dried cherries']",19,"['1 Heat the oven to 250\\xc2\\xb0F.', '2 Mix the crumbles: Whisk together dry ingredients\\xe2\\x80\\x94the powdered milk through salt\\xe2\\x80\\x94in a bowl. If using vanilla bean add the scraped seeds to the dry ingredients. If using vanilla extract add it to the melted butter.', 'Slowly pour the butter over the dry ingredients while tossing with a fork until it forms clumps and all the dry ingredients have been incorporated. It will look like sandy gravel. Your largest pieces should be no larger than the size of a pea.', '3 Bake the crumbles: Scatter the crumbles evenly on a parchment-lined cookie sheet and bake at for 25 minutes until they are dry, but still pale in color. Cool completely on the cookie sheet.', 'Store in an airtight container for up to one week, or cool and use stir into granola.', '4 Increase the oven temperature to 325\\xc2\\xb0F.', '5 Mix the granola: Combine oil, syrup, sugar, extracts, cinnamon, and salt in a medium sized bowl. Stir in oats and almonds making sure they are well coated. (Reserve the dried cherries for adding later.)', '6 Bake the granola: Spread mixture evenly onto a parchment-lined baking sheet. Bake in the oven for 10 min. Stir and bake for 10 more minutes. Stir and bake for 5 to 7 minutes more. The granola should be dry and golden. Remove from oven. Let cool completely.', '7 Finish and store: Once the granola is cool, stir in cherries and vanilla crumbles. Store in an airtight container at room temp for 2 weeks. (Alternatively, store the vanilla crumbles separately at room temperature, covered, for up to two weeks, and the granola will keep for 1 month.)', 'Serve over your favorite yogurt with sliced bananas and a drizzle of honey.']",10
38,Peach Frangipane Puff Pastry Tarts Recipe,20,35,55,"['1 sheet all-butter puff pastry (14 to 16 ounces), thawed', '1 cup almond flour', '1/2 cup sugar', '1/8 teaspoon salt', '5 tablespoons unsalted butter, at room temperature, cut into slices', '1 large egg', '2 tablespoons all-purpose flour', '1 tablespoon amaretto or 1 teaspoon pure almond extract', '1 teaspoon vanilla', '1 1/2 pounds (about 4 medium) ripe peaches, cut into 1-inch wedges', '2 tablespoons turbinado sugar', '3 tablespoons apple jelly or apricot jam', '1 tablespoon water']",13,"['1 Preheat the oven: Line a baking sheet with parchment and preheat the oven to 375\\xc2\\xbaF.', '2 Prepare the dough: On a lightly floured work surface, unfold the puff pastry. Lightly roll it with a rolling pin to even it out if there are any gaps or wrinkles. Transfer the dough to the parchment-lined baking sheet.', 'With a pizza cutter or knife, cut the dough into 9 pieces to make four-inch squares or similar size rectangles. The exact size depends upon the original shape of the dough. Spread them apart on the baking sheet. Refrigerate while you make the filling.', '3 Make the frangipane: In a food processor fitted with the metal blade, pulse the almond flour, sugar, and salt for a few seconds to mix. Add the butter pieces and pulse until the butter is incorporated with no large visible pieces.', 'Add the egg, all-purpose flour, amaretto (or almond extract), and vanilla and process until the frangipane is smooth. It should have the consistency of natural almond butter, thick but runny.', '4 Assemble the tarts: On each square of pastry, spoon about 1 tablespoon of the frangipane. It will spread out naturally on the pastry, and even further once you add peaches. If some spills over the edges that\\xe2\\x80\\x99s fine. If your frangipane doesn\\xe2\\x80\\x99t spread, feel free to push it around the tart with the back of your spoon. You may have some frangipane left over, depending on the size of your pastry squares.', 'Set 5 to 6 wedges of fruit on top of each tart\\xe2\\x80\\x94no need to be too fussy about their arrangement. Sprinkle each with the turbinado sugar.', '5 Bake the tarts: Bake for 35 to 40 minutes, or until the peaches are soft and the frangipane and pastry are golden.', '6 Glaze the tarts: In a small microwave-safe bowl, heat the jelly or jam and water for 30 seconds, or until liquefied. Brush the warm glaze over the peaches. Serve the tarts on the same day that they are made.']",9
39,Grain-Free Apple Honey Cake Recipe,20,75,95,"['For the cake:', '1 1/2 cups (6 ounces) almond flour', '1 teaspoon ground cinnamon', '1/4 teaspoon ground nutmeg', '3/4 teaspoon salt', '3 large eggs', '1/4 cup honey', '2 tablespoons neutral-tasting oil (I use avocado oil)', '1 medium (7-ounce) Granny Smith apple, peeled and cut into thin matchsticks, or grated coarsely', 'For the glaze and topping:', '1/2 cup powdered sugar', '2 tablespoons honey', '1 tablespoon almond milk or water', '1/4 cup sliced almonds', 'Special equipment:', '8-inch cake pan']",16,"['1 Preheat the oven and prepare a cake pan: Preheat the oven to 325\\xc2\\xbaF. Grease an 8-inch cake pan and place a round of parchment in the bottom of the pan.', '2 Make the cake batter: In a medium mixing bowl, whisk together the almond flour, cinnamon, nutmeg, and salt. Make a well in the center of the flour, then add in the eggs, honey, and oil. Whisk wet ingredients together in the middle, then gradually whisk in the flour from the sides of the bowl. Continue whisking until the batter is smooth. Stir in the julienned or grated apple.', '3 Pour the batter into the pan and bake the cake: Pour the batter into the cake pan, taking care not to move the parchment around. Spread out the batter in an even layer using an offset spatula or butter knife, then tap the cake pan against the countertop to remove any air bubbles.', '4 Bake the cake: Bake the cake for 30 minutes, until it is browned around the edges and a toothpick inserted in the middle comes out clean. You may also use a probe thermometer to test for doneness\\xe2\\x80\\x94the center of the cake should be 210\\xc2\\xbaF.', '5 While the cake is baking, make the glaze and toast the almonds: In a small bowl, stir together the sugar, honey, and almond milk. Cover the bowl and set it aside until needed.', 'Toast the sliced almonds in a skillet over medium heat until they are lightly browned, about five minutes. Shake the pan often so that the almonds are browned evenly. When they are done, immediately transfer to bowl to cool.', '6 Transfer the cake to a cooling rack: Allow the finished cake rest for 5 minutes, then run a knife around the edge of the pan to and invert the cake to a cooling rack. Peel the parchment off the bottom of the cake and flip it right side up.', '7 While the cake is still warm, pour the glaze over the top. Spread the glaze so that it drips over the edges of the cake. While the glaze is still wet, sprinkle the almonds on top.', '8 Let the cake cool to room temperature and serve. The cake can also be made and glazed up to a day ahead.']",9
40,Spicy Paleo Pumpkin Muffins Recipe,20,20,40,"['2 1/2 cups almond flour', '3/4 cup tapioca starch', '1 1/2 tablespoons coconut flour', '1 teaspoon baking soda', '1 1/2 teaspoons baking powder', '1/2 tablespoon smoked paprika', '1 teaspoon crushed chili flakes (I used chipotle chili flakes)', '1 1/2 teaspoons ground cumin', '1/2 teaspoon salt', '4 large eggs', '1/2 cup olive oil, melted ghee, or melted butter', '2 tablespoons honey', '1 tablespoon red wine vinegar', '1 packed cup grated raw sugar or pie pumpkin (avoid jack-o-lantern pumpkins)', '1/2 cup diced red bell pepper', '1/2 cup diced onion', '3/4 cups toasted pepitas or pumpkin seeds (divided)', 'Special equipment:', '12-cup muffin tin']",19,"['1 Preheat oven to 350F. Line a muffin tin with muffin papers', '2 Sift together the dry ingredients: Sift together the almond flour, tapioca starch, coconut flour, baking soda, baking powder, spices, and salt. I like to sift at least twice with Paleo baked goods to make sure there are no clumps and everything is well-mixed.', '3 Mix together the wet ingredients: In a separate bowl, beat the eggs, then whisk in the oil, honey, and vinegar.', '4 Pour the wet ingredients into the dry and mix gently until combined.', '5 Gently stir in the grated pumpkin, bell pepper, onion, and 1/2 cup of pepitas. Save the rest of the pepitas for topping. Rest the batter for at least 10 minutes so that the flours can hydrate.', '6 Fill each muffin wells up to the top. Top each muffin with a few of the remaining 1/4 cup of pepitas.', '7 Bake for 18 to 20 minutes. When done, the muffins should look toasted around the edges, be dry on top, and a toothpick inserted in the middle will come out clean.', '8 Cool and serve (or store): Transfer the muffins to a cooling rack. Cool briefly before serving, or cool completely and store in an airtight container at room temperature for 3 days (or refrigerate for up to a week).']",8
41,Classic Pasta Primavera Recipe,20,10,30,"['1/2 pound angel hair pasta or spaghetti', '1 small bunch broccoli, about 1 heaping cup of florets', '1 small zucchini, diced', '4 asparagus spears', '1/2 cup peas, fresh or frozen', '1/2 cup snow peas', '3 minced garlic cloves', '3 Roma or other paste tomatoes, seeded and diced', '12 basil leaves, chopped', '4 tablespoons butter', '1/4 cup chicken broth (use vegetable broth for vegetarian option)', '1/2 cup heavy cream', '1/2 cup grated parmesan cheese', 'Salt']",14,"['1 Blanch the broccoli, asparagus, snow peas: Get a large pot of water boiling. Salt it well. It should taste like the sea. Fill a large bowl with ice water. Boil the broccoli for 1 minute.', 'Add the asparagus and boil another minute. Add the snow peas and boil for 30 more seconds.', 'Remove all the vegetables and plunge them into the ice water. Once they\\xe2\\x80\\x99re cool, drain in a colander.', 'If you want, you can boil your pasta in the same pot you boiled the vegetables in, or you can start over and boil new water; I use the same water.', '2 Saut\\xc3\\xa9 zucchini and garlic, then add tomatoes: In a large saut\\xc3\\xa9 pan, heat the butter over medium-high heat. When the butter is hot, add the garlic and zucchini and saut\\xc3\\xa9 1 minute.', 'Add the diced tomatoes and saut\\xc3\\xa9 another 2 minutes, stirring often.', '3 Add broth, cream, blanched vegetables, peas: Pour in the chicken or vegetable broth and turn the heat to high to bring it to a boil.', 'Add the cream and toss in all the vegetables you boiled, plus the peas. Stir to combine.', 'Turn the heat down until the cream-chicken broth mixture is just simmering, not boiling.', '4 Add Parmesan: Add the Parmesan cheese and stir to combine. If the sauce seems too thick \\xe2\\x80\\x93 it should be pretty thick, but not gloppy \\xe2\\x80\\x93 add some more chicken broth, cream or water.', '5 Boil the angel hair pasta: If you are using spaghetti, you will want to start cooking it before you begin saut\\xc3\\xa9ing the garlic and zucchini. Angel hair will only need 1-2 minutes to cook, vermicelli or spaghetti can take 8-12 minutes.', '6 Transfer cooked pasta to sauce and vegetables: As soon as the pasta is done, transfer it with tongs into the sauce and stir to combine.', 'Add the basil now, and taste for salt. Add salt if needed. Grind some black pepper over everything and serve immediately.', 'You will want a dry white wine with this, ideally a dry French white.']",14
42,"Angel Hair Pasta with Garlic, Herbs, and Parmesan Recipe",15,10,25,"['8 ounces angel hair pasta', 'Salt', '1/4 cup extra virgin olive oil', '2 Tbsp finely chopped fresh herbs such as rosemary, thyme, oregano', '1/4 cup chopped fresh parsley', '3 cloves of garlic, sliced', '1/8 teaspoon chili pepper flakes (or more to taste)', '1/2 to 1 teaspoon of freshly ground black pepper (to taste)', '1/2 cup grated Parmesan cheese']",9,"['1 Prepare boiling water for pasta: Bring a large pot of salted water to a boil. (1 tablespoon of salt for every 2 quarts of water).', '2 Cook garlic and herbs: While the water is heating in step 1, heat the olive oil in a small saucepan on medium heat.  Add the sliced garlic, chili pepper flakes, finely chopped herbs, and chopped parsley to the oil.  Cook for one minute or until the parsley has wilted and the garlic is emitting a strong fragrance.  Remove from heat.', '3 Cook the pasta: The angel hair past will cook in about 2 minutes once it starts, so get everything ready. Once the water is at a rolling boil, add the pasta.  Cook at a rolling boil until al dente. Remove 1/2 a cup of the pasta cooking water and set aside. Drain the pasta and rinse briefly with cold water, just enough to stop the cooking, but not so much as to make the pasta cold. The pasta should still be quite warm.', '4 Combine pasta and herbs: Place pasta in a large bowl. Pour herbed garlic sauce over the pasta and gently toss to combine. Sprinkle Parmesan cheese  and freshly ground black pepper over the pasta and gently toss to combine. If the pasta is a little sticky, add back a little of the pasta cooking water to loosen.', 'Serve immediately as a side dish. Reheats well if you make ahead.']",5
43,Pasta Pomodoro with Shrimp Recipe,10,20,30,"['1/2 pound angel hair pasta', '3/4 pound raw, peeled, deveined shrimp (medium sized)', '4 medium ripe tomatoes', '3 cloves garlic, minced', '1/3 cup torn fresh basil leaves', '3 tablespoons extra virgin olive oil (divided, 1 Tbsp and 2 Tbsp)', 'Salt', 'Pepper']",8,"['1 Blanch and peel the tomatoes: Fill a large pot with 2 quarts of water. Bring to a boil. (You will be using this water to both blanch the tomatoes and boil the pasta.)', 'Core the tomatoes and use a sharp knife to cut a small X into the bottom end of each tomato. When the water is boiling, use a slotted spoon to lower the tomatoes into the water.', 'Blanch for no more than one minute, just enough to loosen the skins. Remove tomatoes with a slotted spoon to a bowl of icy water, saving the blanching water.', 'Peel off the tomato skins from the tomatoes. Cut the tomatoes crosswise in half, and squeeze out most of the seeds and juices.', 'Chop the tomatoes into 1-inch pieces.', '2 Saut\\xc3\\xa9 the shrimp: Heat 1 Tbsp of olive oil in a large saut\\xc3\\xa9 pan on medium high heat. Add the shrimp to the pan and cook for 1 minute. Turn the shrimp over in the pan. Lower the heat to medium.', '3 Add garlic, tomatoes, basil: Add the garlic, cook a minute more. Add the chopped tomatoes and basil. Sprinkle with salt. Cook for a minute more and remove from heat.', '4 Cook the angel hair pasta: Add a tablespoon of salt to the water you used to blanch the tomatoes. Bring to a boil again. Add the angel hair pasta and cook for 3 minutes.', '5 Add cooked pasta to shrimp and tomatoes: Drain the pasta and immediately add to pot with the shrimp and tomatoes. Drizzle the pasta with 2 Tbsp of olive oil. Then stir the pasta in with the shrimp and tomatoes.', 'Serve immediately or at room temp.']",10
44,Quick and Easy Shrimp with Angel Hair Pasta Recipe,15,15,30,"['1/2 cup extra virgin olive olive', '2 cups finely diced red and green bell peppers (3 to 4 bell peppers)', '2 Tbsp grated fresh ginger root', '2 cloves garlic, minced (about 2 teaspoons)', 'Salt', '1 pound peeled and deveined medium sized shrimp (31-40 count)', '4 Tbsp fresh lime juice (can sub lemon juice)', '1/2 teaspoon black pepper', '3 Tbsp chopped chives (or green onion greens)', '3/4 pound angel hair pasta']",10,"['1 Heat salted water for pasta: Put a large pot of salted water (4 quarts of water, 2 Tbsp salt) on high heat. While the water is heating, continue with the recipe.', '2 Saut\\xc3\\xa9 bell peppers, ginger, garlic: Heat 3 Tbsp olive oil in a large saut\\xc3\\xa9 pan on medium high heat. Add the diced bell peppers and cook until softened, about 4 to 5 minutes. Add the grated ginger and minced garlic, and cook for 1 to 2 minutes more.', '3 Add shrimp: Add the shrimp and cook until just cooked through and no longer translucent, about 2 to 3 minutes. Sprinkle with lime juice, the remaining olive oil, and black pepper. Remove from heat.', '4 Cook pasta: When the pasta water is boiling, add the angel hair pasta and cook for 2 minutes or until cooked through, but still slightly al dente. Drain, reserving 1/2 cup of the pasta water.', '5 Add pasta to shrimp: Add the drained pasta back to the pan with the shrimp. Add the reserved pasta cooking water to the pot. Stir to combine all of the ingredients. Sprinkle with chopped chives to serve.']",5
45,Sopa Seca de Fideo (Mexican-style Angel Hair Nests) Recipe,5,25,30,"['1/2 pound angel hair nests or vermicelli (vermicelli usually comes in 1 pound packages, so about 1/2 a package)', '1/4 cup extra virgin olive oil', '1/2 yellow onion, chopped (about 3/4 cup)', '2 fresh tomatoes, peeled and chopped, or 1/2 cup crushed canned tomatoes', '2 cups chicken broth or stock', 'Salt and pepper']",6,"['1 Brown the angle hair nests: Choose a frying pan with a lid in which the angel hair nests will all tightly fit in a single layer (about 9 or 10-inches wide, depending on the brand of angel hair nests you use). In the pan, heat the oil until shimmering hot.', 'Working in batches, fry the vermicelli angel hair nests on both sides in the hot oil until golden brown in color. Remove from pan.', '2 Saut\\xc3\\xa9 tomatoes and onion, add broth: Add the chopped onions to the pan and saut\\xc3\\xa9 until lightly browned, about 5 minutes. Add the chopped tomatoes. Add the chicken broth. Season with salt and pepper to taste.', '3 Cook angel hair nests in simmering broth: Bring the broth mixture to a simmer. When broth is simmering, place the browned angel hair nests or vermicelli in a single layer in the pan, nestled into the broth. The nests should cover the whole pan. Turn them over in the broth so that they get moistened on all sides.', 'Cover and cook until the vermicelli has soaked up the liquid, about 5 minutes. If after 5 minutes the top of the vermicelli is dry, flip over the individual angel hair nests and cook a minute longer.', '4 Serve: Remove from heat and let sit for 5 minutes before serving.']",6
46,"Angel Hair Pasta with Clams, Cherry Tomatoes, and Basil Recipe",15,15,30,"['30 cherry tomatoes, sliced in half', '1/4 teaspoon salt', '4 Tbsp chopped fresh basil, divided', '1/4 cup extra virgin olive oil', '1/2 cup sliced shallots', '2 cloves minced garlic', '2 6-ounce cans chopped clams (and their juices)', '8 ounces capellini or angel hair pasta', 'Salt for the pasta water']",9,"['1 Toss cherries with salt and basil: Place sliced cherry tomatoes in a bowl. Toss with 1/4 teaspoon of salt and 2 Tbsp of the chopped fresh basil. Set aside.', '2 Boil salted water, prep shallots and garlic: Bring a large pot of salted water to a boil (4 quarts of water, 2 Tbsp salt). While the water is coming to a boil, prep the shallots and garlic and start the sauce.', '3 Make tomato clam sauce: Heat the olive oil in a large saut\\xc3\\xa9 pan on medium heat. Add the sliced shallots and cook until translucent, stirring often. Add the garlic and cook for 30 seconds more.', 'Add the tomatoes and cook for 2 minutes. Add the chopped clams with their juices.', 'Reduce the heat to low and let simmer at a low temperature while the pasta is cooking in the next step.', '4 Cook the pasta: Once the salted pasta water comes to a rolling boil, add pasta and cook, uncovered at high heat until al dente, no more than 2 minutes.', 'Drain the pasta, reserving 1/4 cup of the pasta water. Add the 1/4 cup of pasta water to the sauce in the saut\\xc3\\xa9 pan.', '5 Combine pasta and sauce: Add the pasta to the cherry tomato mixture and toss to combine. Stir in the remaining 2 Tbsp chopped fresh basil.', 'Serve immediately.']",9
47,Mozzarella and Basil Stuffed Tomatoes Recipe,20,15,35,"['4 medium tomatoes with firm, fleshy walls, 2 1/2 inches wide', '1 cup shredded mozzarella cheese', '1/3 cup grated parmesan cheese, divided', '1/4 cup packed fresh basil, chopped, plus more for garnish', '1 slice of bread (enough to make 1/4 cup breadcrumbs)', '1 tablespoon melted salted butter', '1 teaspoon minced garlic', '1/4 teaspoon salt', '1/8 teaspoon pepper', 'Olive oil for drizzling']",10,"['1 Preheat oven to 400\\xc2\\xb0F.', '2 Make the soft breadcrumbs: To make the 1/4 cup soft breadcrumbs, remove the crust from 1 slice of bread (preferably stale) and either pulse in a small food processor or shred with a fork until the bread resembles fine, sand-like crumbs.', '3 Prepare the tomatoes: Slice the tomatoes in half horizontally around the equator and use a spoon to scoop out the flesh. Be careful not to puncture the walls of the tomato, but if you do, the filling will plug the hole. Place empty tomato halves in a casserole dish and season with salt and pepper.', 'Using your hands or a spoon, separate the seeds from the scooped out tomato flesh and transfer the flesh to a cutting board. Discard the seeds and the tomato water. Chop the flesh and set aside for the stuffing.', '4 Make the stuffing: In a medium bowl, add the mozzarella cheese, 1/4 cup of the parmesan cheese, basil, breadcrumbs, butter, garlic, salt, and pepper and stir to thoroughly combine.', '5 Bake: Using two spoons, fill the tomato halves with the stuffing. Sprinkle filled tomatoes with the remaining parmesan cheese and drizzle with olive oil. Bake for 15 minutes, or until tomatoes are tender, then broil on high for 1 minute until the filling begins to bubble and brown.', '6 Serve: Garnish with a few torn basil leaves and serve hot.']",7
48,The Best Nachos Recipe,15,15,30,"['For the spice mix:', '2 tablespoons chili powder', '1 1/2 teaspoons kosher salt', '1 teaspoon granulated garlic', '1 teaspoon granulated onion', '1 teaspoon ground cumin', '1/2 teaspoon dried oregano', '1/4 teaspoon black pepper', 'Pinch of cayenne pepper (optional)', 'For the nachos:', '1 teaspoon vegetable oil', '1 pound ground beef (80:20 lean-to-fat ratio)', '16 ounces (2 cups) refried beans, canned or homemade', '1/4 cup water', '1 large bag of tortilla chips', '4 ounces cheddar cheese, grated (about 2 cups), plus more for topping', '4 ounces Colby Jack cheese, grated (about 2 cups), plus more for topping', '1 cup pico de gallo, store-bought or homemade, plus more for topping', '1/4 cup chopped cilantro', '1 sliced jalape\\xc3\\xb1o (pickled or fresh)', 'Optional toppings:', 'Guacamole', 'Salsa', 'Sour cream', 'Canned black olives', 'Sliced green onions', 'Shredded lettuce', 'Corn', 'Hot sauce']",29,"['1 Preheat the oven to 350\\xc2\\xb0F.', '2 Make the taco spice blend: Combine all of the spices (chili powder through cayenne) together in a small bowl.', '3 Make the beef and bean topping: Heat the vegetable oil on medium high heat until it begins to shimmer. Add the ground beef to the pan and season it with all of the taco spice blend. As the meat cooks, use a spoon to break the meat up into crumbles.', 'Cook for about 8 minutes until the meat has browned and drain the fat using a colander.', 'Return the meat to the pan and add the refried beans and the water. Heat the mixture until the beans are smooth and warmed through. Reduce the heat to low and keep the beef-bean mixture warm while you prepare the chips.', '4 Toast the chips: On a 13x18-inch oven-safe platter or sheet pan, arrange the tortilla chips in a single layer, overlapping them slightly. Toast the chips in the preheated oven for 5 minutes, or just until you begin to smell their aroma.', '5 Assemble and bake the nachos: Carefully remove the pan from the oven and top with one half of the shredded cheeses. Allow the heat from the chips to melt the cheese slightly before topping the chips with the beef and bean mixture.', 'Sprinkle the remaining cheese over the beef and return the pan to the oven for 5 minutes, or until the cheese has fully melted.', '6 Top and serve: Top the nachos with the pico de gallo, chopped cilantro, jalape\\xc3\\xb1o slices, or any of your preferred toppings. Serve hot.']",9
49,How to Make Naan,15,370,385,"['1 cup lukewarm milk', '1 1/2 teaspoons active dry yeast', '2 teaspoons sugar', '4 cups all-purpose flour + extra for dusting', '2 teaspoons kosher salt', '2 tablespoons olive oil or canola oil + extra for greasing the bowl', '1/2 cup plain yogurt']",7,"['1 Prepare a bowl: Lightly grease a large bowl with a little bit of oil. You will put your dough in this bowl to let it rise. Set the bowl aside.', '2 Prepare the dough: In a Pyrex liquid measuring cup or a small mixing bowl, combine the lukewarm milk, sugar, and active dry yeast. The milk should be just warm to the touch. If it\\xe2\\x80\\x99s too hot you can kill the yeast. Let it sit for 5 minutes.', 'In another large mixing bowl, whisk the flour and salt together. Add yogurt, oil and milk-yeast mixture. Use a wooden spoon or your hands to combine the dough. The dough should be soft and sticky at this point.', '3 Knead the dough: Dust your countertop with flour. Transfer the dough to the counter. Knead together until a soft dough forms, about 5 minutes. If the dough feels dry and is too tough to knead, add about 1-2 tablespoons of water, a little bit at a time, until the dough is easier to work with.', '4 Let the dough rise: Transfer the dough to the greased bowl. Cover the bowl with plastic wrap or a damp towel. Place in a dark, warm, dry place. I place it in my oven (it\\xe2\\x80\\x99s not on) to let it rise, but your countertop is fine. Let the dough rise for 3-4 hours or until it more than doubles in size.', '5 Punch down the dough and let it rise again: Punch the risen dough down. Knead for another minute. Return the dough to the bowl, cover it again and let it rise for another 45 minutes to 1 hour.', '6 Divide the dough: Dust your countertop with flour. Turn the dough out onto the counter and knead it for another minute or two until its smooth. Divide the dough into 16 smaller balls of equal size (about 2 ounces each).', 'Using a rolling pin, roll the balls into a teardrop shape. About 2-3 inches wide, 6-7 inches long, and about 1/8 inch thick. They don\\xe2\\x80\\x99t have to be perfectly uniform.', '7 Cook the naan: If using herbs or spices, sprinkle one side of the bread with those now. Brush the other side with water. Set a medium-sized heavy pan or cast iron skillet with a lid over medium-high heat.', 'Check the heat of the pan by flicking water on it. If it evaporates on contact, it\\xe2\\x80\\x99s ready. Once the pan is hot, place the naan wet side down into the skillet.', 'Cover it with a lid. Let it cook for about 30 seconds or until you see bubbles on it. Flip the naan, brush it with butter or ghee, and cook it uncovered for another 10 seconds. Serve it hot.']",11
50,Boursin Stuffed Mushrooms Recipe,15,10,25,"['24 cremini mushroom caps, about 1 1/2 inches wide (with stems about 3/4  pound total)', '5 ounces Boursin garlic and herb cheese at room temperature', '1/2 to 1 teaspoon of smoked paprika']",3,"['1 Remove stems from mushrooms: Brush any dirt off the mushrooms and remove the stems.', '2 Stuff caps with cheese: Use a spoon to stuff the mushrooms with the cheese mixture, so that it mounds a little in the center.', '3 Sprinkle with paprika: Place the mushrooms on a rimmed baking pan (to prevent the mushrooms from rolling off the pan). Sprinkle the tops with a little smoked paprika.', '4 Bake: Bake at 350\\xc2\\xb0F (175\\xc2\\xb0C) for 8 minutes, or until a pool of water forms at the base of each mushroom as the mushrooms sweat out their moisture.', 'Remove and cool a minute or two, then serve.']",5
51,Honey Hazelnut Baked Brie Recipe,5,20,25,"['1 (8-ounce, 225 g) round of brie (we recommend President brand, it melts well)', '1/4 cup toasted hazelnuts (skins removed), lightly chopped', '1/2 cup (120 ml) sherry vinegar or apple cider vinegar', '5 Tbsp honey', 'Pinch of salt', '1 small sprig rosemary']",6,"['1 Make the sauce: Place the vinegar, honey, salt, and 5 or 6 needles from the rosemary sprig into a small saucepan. Stir to combine. Heat on medium high heat until simmering. Then lower the heat to low and simmer until the mixture starts to darken in color and the consistency thickens to a thin syrup, about 5 to 10 minutes. (Note if you find that you have over-reduced the sauce, resulting in hard candy not syrup, you can add water to it and heat it again.)', 'Remove from heat and stir in the hazelnuts.', '2 Bake the brie: While the sauce is simmering, start on the brie. Preheat the oven to 350\\xc2\\xb0F (175\\xc2\\xb0C). Use a serrated knife to slice off the very top of the brie round, exposing the cheese on one side. Place on a parchment paper or Silpat lined baking sheet (cut side up). Bake until just soft and bubbly, about 15 minutes. (Jiggle the pan to see if the cheese has melted all the way through.)', '3 Drizzle the brie with sauce: Remove the brie from the oven and let it cool for a minute or two. Use a metal spatula (or two) to carefully transfer it to a serving dish. Drizzle the honey vinegar hazelnut sauce over the brie. Garnish with the sprig of rosemary.', 'Serve with sliced tart apples.']",5
52,Grilled Artichokes Recipe,15,45,60,"['1 tablespoon chopped fresh herbs such as rosemary, oregano, thyme', '1/3 cup extra virgin olive oil', '2 cloves garlic, cut in half (no need to peel)', '1 bay leaf', '1 lemon, cut into wedges', '2 to 4 large globe artichokes', 'Salt']",7,"['1 Steep herbs in warm olive oil: Place chopped fresh herbs in a small bowl (not the bay leaf), cover with olive oil. Microwave on high heat for 30 seconds (or heat oil and herbs on the stovetop until warm). Let the herbs steep in the warm olive oil while you prepare the artichokes.', '2 Prep the artichokes: Prepare a large pot with an inch of water at the bottom. Add the cut cloves of garlic and the bay leaf, and place a steamer rack in the pot.', 'To prepare the artichokes, have lemon wedges ready. If you want a nice presentation, use scissors to snip away the pointy tips of the artichoke leaves. As you trim the artichokes, rub the cut areas with juice from the lemon wedges to prevent the artichokes from turning brown from oxidation.', 'Use a vegetable peeler to cut away the thick outer layer of the artichoke stems. Trim the stems to 2 inches from the base of the artichoke. Cut off and discard the top 1/2 inch of the artichokes. Cut the artichokes in half.', 'Use a strong metal spoon to scoop out the fuzzy chokes and the small inner artichoke leaves. Rub lemon juice all over the inside and exposed cut areas of the artichokes.', '', '3 Steam the artichokes: Heat the water in the large pot with a steamer rack on high. When it comes to a boil, reduce the heat to medium high and place the artichoke halves, cut side down on the steam rack.', 'Cover. Steam for 20 minutes (less or more, depending on the size of the artichokes), until you can easily pull off the outer leaves, and you can pierce the heart easily with a knife.', 'The artichokes can be just a tiny bit less cooked than would be typically perfect for steamed artichokes, as you will be cooking them further on the grill.', '4 Grill the artichokes: Prepare your grill for direct, high heat. Use a pastry brush to brush the artichoke all over with the herb infused oil. Sprinkle all over with salt.', 'Place the artichoke halves cut-side-down on the grill grates. Cover, and grill for 5 to 10 minutes, until you have nice grill mark on the cut sides of the artichokes.', 'To serve, sprinkle the cut sides with more lemon juice. Serve alone or with mayonnaise, remoulade, or aioli.']",12
53,Spanish Roasted Potatoes with Tomato Sauce (Patatas Bravas) Recipe,5,60,65,"['2 pounds Yukon gold potatoes, or other waxy potato (peeled or un-peeled, your choice), cut into 1 to 1 1/2-inch chunks', 'Extra virgin olive oil', 'Salt', '1/2 medium yellow onion, chopped', '3 garlic cloves, chopped', '1/2 cup white wine (can substitute stock)', '2 tablespoons tomato paste', 'A 14-ounce can of crushed tomatoes', '2 teaspoons Tabasco or other hot sauce', '1 teaspoon smoked paprika', '1 teaspoon salt', '1 teaspoon sugar']",12,"['1 Roast the potatoes: Preheat oven to 375\\xc2\\xb0F. Toss the potatoes with 3 tablespoons of olive oil and salt well. Arrange in one layer in a casserole pan or rimmed baking tray and roast until browned, about 50 minutes.', '2 Saut\\xc3\\xa9 onions and garlic: While the potatoes are roasting, make the sauce. Heat 2 tablespoons of olive oil in a medium pot set over medium-high heat. Saut\\xc3\\xa9 the chopped onions, stirring occasionally, for 4-5 minutes, or until they begin to brown on the edges. Add the garlic and saut\\xc3\\xa9 another 2 minutes.', '3 Make the sauce: Add the white wine to the pan and turn the heat to high. Boil on a high boil until the wine is reduced by half, then add the tomato paste and stir to combine. Add the crushed tomatoes, Tabasco sauce, salt, sugar and smoked paprika. Stir well and reduce the heat to a bare simmer. Let the sauce cook slowly while the potatoes roast. If you want, you can use a blender or an immersion blender to pur\\xc3\\xa9e the sauce until smooth.', '4 Toss potatoes with sauce, continue to roast: When the potatoes are well browned, toss with the tomato sauce and return to the casserole pan. Continue to roast until the tomato sauce dries out a bit on the potatoes and caramelizes, about 10 minutes.', 'Serve with the remaining tomato sauce as an appetizer or side dish.']",5
54,Honey Mustard Chicken Wings Recipe,7,90,97,"['8 cloves garlic, peeled and crushed', '2 tablespoons honey', '2 tablespoons Dijon mustard', '1 tablespoon tamari soy sauce (or 1 1/2 Tbsp regular soy sauce, use gluten-free soy sauce or tamari for gluten-free version)', '2 tablespoons lemon juice', '1/4 cup extra virgin olive oil', '2 teaspoons salt', '1 teaspoon freshly ground pepper', '20 chicken wing drummettes']",9,"['1 Marinate the chicken wings: Rinse and pat dry the chicken wings. Place them in a large bowl or marinade bag.', 'Mix together the marinade ingredients\\xe2\\x80\\x94crushed garlic cloves, honey, mustard, soy sauce, lemon juice, olive oil, salt and pepper\\xe2\\x80\\x94and pour over the chicken wings to coat.', 'Chill for at least an hour or up to 24 hours.', '2 Roast the wings: Preheat oven to 400\\xc2\\xb0F. Line a roasting pan with foil and place a baking rack over it.', 'Place the chicken wings in on the rack in a single layer with some space between the wings.', 'Bake for 25-35 minutes, depending on the size of the chicken wings, until cooked through and well browned.']",6
55,Angels on Horseback Recipe,10,20,30,"['16-32 small oysters (or scallops), or larger ones cut in half, shucked', '8-16 slices of thin-cut bacon', '16-32 wooden toothpicks', '3-4 limes or lemons']",4,"['1 Pre-cook the bacon slices: Working in batches if necessary, cook the bacon slices on medium low heat in a large frying pan, until only about halfway cooked, but not crispy.', 'You need to pre-cook the bacon a bit or else when you cook them with the oysters the oysters will be overcooked by the time the bacon is crispy. Set the bacon aside to cool.', '2 Heat the grill: Get a grill or broiler good and hot while you wrap the oysters.', '3 Wrap bacon around oysters: To make an angel on horseback, you wrap 1/2 a piece of bacon around the small oyster and secure it with the toothpick. Overlap the edges of the bacon by about an inch if you can.', '4 Grill or broil: Grill or broil over high heat to cook the oyster and crisp the bacon, about 5-6 minutes on the first side, another 2-4 once you turn them over. You will need to turn them once or twice to get a good crispiness on all sides.', '5 Sprinkle with lemon or lime juice: As soon as they come off the heat, squirt with the lemon or lime juice and serve hot.']",6
56,Spinach Artichoke Dip with Bacon Recipe,15,20,35,"['6 slices bacon (about 1/3 pound), chopped', '2 cloves garlic, minced', '1 14-ounce can artichoke hearts, drained and chopped', '1 10-ounce package frozen spinach, thawed, drained, and chopped, or 1 12-ounce bunch fresh spinach, finely chopped', '1/4 teaspoon crushed red pepper flakes', '1/2 teaspoon kosher salt (or slightly less table salt)', '1 8-ounce package cream cheese, at room temperature', '8 ounces shredded Italian cheese blend', '1/2 cup sour cream', 'Pita chips, tortilla chips, crackers, or celery sticks, for serving']",10,"['1 Preheat the oven to 400\\xcb\\x9aF.', '2 Cook the bacon: Place the chopped bacon in a skillet and cook over medium heat until crispy, 7 to 10 minutes. Transfer the bacon to a plate lined with paper towels to drain, leaving the rendered bacon fat in the skillet. Set some of the bacon aside for sprinkling over top the dip.', '3 Cook the vegetables: Add the garlic to the pan and cook until fragrant, about 30 seconds. Add the artichoke hearts, spinach, red pepper flakes, and salt. Cook, stirring occasionally, until artichokes are warmed through and the spinach has wilted, about 5 minutes.', '4 Combine with the cheeses: In a medium bowl, mix the cream cheese, shredded Italian cheese blend, sour cream, reserved bacon, and spinach-artichoke mixture until thoroughly combined.', '5 Bake and serve: Transfer the mixture to a 1- to 2-quart baking dish and bake until bubbling around the edges, about 20 minutes. Let cool slightly, then sprinkle with reserved bacon and serve with pita chips.', 'This dip is best eaten right away while hot. If it cools a bit and starts to firm up, microwave it for a minute or two to melt the cheese again.']",6
57,Ginger Honey Chicken Wings Recipe,10,30,40,"['3 pounds chicken wing drummettes', '1 green onion, thinly sliced on the diagonal', '2 Tbsp toasted sesame seeds', 'Marinade:', '1/4 cup soy sauce (use gluten-free soy sauce if cooking gluten-free)', '3 Tbsp honey', '1-inch piece of ginger, peeled and grated', '3 cloves garlic, finely minced', '1/8 teaspoon sriracha hot sauce (or other hot sauce)']",9,"['1 Preheat oven, prepare roasting pan: Preheat the oven to 425\\xc2\\xb0F with a rack on the upper third of the oven. Line a roasting pan or thick baking sheet with foil. Rub some olive oil or canola oil over the foil to keep the wings from sticking.', '2 Prepare marinade sauce: Whisk together the marinade ingredients\\xe2\\x80\\x94soy sauce, honey, grated ginger, garlic, hot sauce\\xe2\\x80\\x94in a bowl. Set aside half of the marinade to be used as a sauce (about 1/4 cup).', '3 Toss wings with marinade, place on pan: Place the chicken wings in a bowl and toss with the remaining marinade. Arrange the wings, skin-side down, on the foil lined roasting pan, taking care not to crowd the pan.', ""4 Roast in oven: Roast for 15 minutes, then remove from oven, use tongs to turn the wings over so that they are now skin-side up, and roast for another 10 minutes, until nicely browned. Check while roasting to make sure they aren't getting too dark. If so, place on a lower rack or cover with foil to finish cooking."", '5 Toss with reserved marinade sauce: Place cooked wings in a bowl and toss with the reserved marinade sauce.', '6 Garnish: Sprinkle with toasted sesame seeds and thinly sliced green onions to serve.']",6
58,Cranberry Apple Stuffed Pork Loin Recipe,25,60,85,"['1 boneless pork loin (about 3 to 4 pounds)', 'Sea salt and freshly ground pepper', '1/2 cup panko or homemade breadcrumbs', '1/2 cup chicken stock', '1 cup peeled, chopped tart green apples', '1/3 cup dried cranberries', '1/3 cup chopped walnuts, toasted', '1/4 cup minced shallots', '2 Tbsp pure maple syrup', '1 teaspoon minced rosemary', 'Special equipment:', 'Kitchen string']",12,"['1 Preheat oven to 450\\xc2\\xb0F.', '2 How to butterfly the pork loin: Place the pork loin roast fat side down on a cutting board. Note that one long side of the pork loin roast will be thicker, and one side thinner.', 'Using a sharp knife, make a long cut an inch or so from the edge from the thinner long side of the roast at about a 45\\xc2\\xb0 degree angle, stopping a half inch from reaching the bottom of the roast.', 'Then angle the knife so that it is flat, parallel to the cutting board, and make slow, shallow cuts into the roast, along the same line.', 'As you cut, you can open up the top part of the roast like a book. Keep making slow, even cuts until you have ""rolled"" the roast out completely.', '3 Pound the butterflied roast to an even thickness: With the pork roast unfolded, cover with 2 layers of of plastic wrap.', 'Pound with a meat mallet to flatten to a somewhat even thickness. Remove plastic wrap. Sprinkle the pork with salt and pepper and set aside.', '4 Make the filling: Place the panko and stock in a small bowl and stir to combine.', 'Stir in the apples, walnuts, cranberries, shallots, maple syrup and rosemary.', '5 Roll up pork roast with filling: Spread the filling over surface of the pork, leaving an inch margin around all sides except for the fat layer side\\xe2\\x80\\x94with that side leave a 2-inch margin.', 'Starting with the end of the roast rectangle that does not have the fat layer on the bottom, roll up the roast.', '6 Secure with kitchen string. Tie the roast in 1 to 2 inch intervals with cotton kitchen string.', 'At this point you can wrap in plastic wrap and refrigerate if you are making ahead.', '7 Bake: Coat the bottom of a roasting pan with cooking spray or a little olive oil. Place the roast in the pan and cook at 450\\xc2\\xb0F for 15 minutes to brown the top, then reduce the oven temperature to 325\\xc2\\xb0F. Cook uncovered, for about 30 to 40 minutes, or until the pork reaches an internal temperature of 140\\xc2\\xb0F.', '8 Rest and serve: Tent the roast with foil and let it rest for 10 minutes. Remove the kitchen string and slice into 1/2-inch thick slices to serve.', 'Save the pan drippings! Serve with pan drippings or use the pan drippings to make gravy. See How to Make Gravy.']",16
59,Sour Cream Apple Pie Recipe,20,50,70,"['Filling:', '1 cup sour cream', '2/3 cup sugar (can easily reduce to 1/2 cup if you like your apple pies a little less sweet)', '2 Tablespoons flour', '1/4 teaspoon salt', '1 teaspoon vanilla', '1 egg', '3 cups peeled, sliced tart apples (about 1 1/4 pounds of slices, cut 1/4-inch to a 1/2-inch thick)', '1 Tablespoon lemon juice or apple cider vinegar', 'One 9"" unbaked pie shell, frozen or chilled in the freezer for at least 30 minutes (see sour cream pie crust recipe, use a single crust recipe)', 'Topping:', '1/2 cup brown sugar, packed', '1/2 cup flour', '1/4 cup butter (1/2 a stick), chilled, cut into cubes', '1/2 teaspoon cinnamon', 'Mix together all ingredients until the mixture resembles coarse crumbs. Chill until needed in the recipe.']",16,"['1 Make the streusel topping: Place the streusel topping ingredients in a medium bowl and mix with a fork or your hands until the mixture resembles coarse crumbs.', 'Chill in the refrigerator until the topping is needed half-way through the baking.', '2 Preheat oven to 400\\xc2\\xb0F with a rack in the middle and another rack below it. Place a large rimmed baking sheet on the lower rack to catch any of the drippings from the pie.', '3 Mix sour cream with sugar, flour, salt, vanilla, egg, and coat apple slices with it: In a large bowl put the sour cream, sugar, flour, salt, vanilla, and egg. Use a wooden spoon and beat by hand until smooth. Fold in the apples and stir until all of the apples are coated with the sour cream filling mixture.', '4 Put the filling into a frozen pie shell. For the first stage of baking, bake the pie for 25 minutes at 400\\xc2\\xb0F.', '5 After the first 25 minutes, remove the pie from the oven and sprinkle the top with the brown sugar butter flour topping mixture. You may also want to put a pie protector or foil around the outer crust edges to keep them from getting too browned. Bake for another 20 minutes at 400\\xc2\\xb0F.', '6 Cool: Let the pie cool on a rack for one hour before cutting and serving.']",7
60,Bisquick Apple Coffee Cake Recipe,5,20,25,"['Cake:', '2 cups Bisquick mix', '2/3 cup of milk or water', '2 Tbsp sugar', '1 egg', '1 tart green apple, cored, peeled, sliced', 'Topping:', '1/3 cup Bisquick mix', '1/3 cup packed brown sugar', '1/2 tsp ground cinnamon', '4 Tbsp butter']",11,"['1 Preheat oven to 400\\xc2\\xb0F.', '2 Grease 8"" square pan or 9"" round pan. Mix cake ingredients. Spread cake batter in pan. Insert apple slices into the batter evenly throughout the cake.', '3 Mix the topping ingredients of Bisquick, brown sugar and cinnamon. Spread topping mix over top of batter in pan. Add slices of butter all over the top.', '4 Bake 20 minutes or until golden brown, testing with a toothpick.']",4
61,Apple Coffee Cake Recipe,25,30,55,"['2 cups (280 g) all purpose flour', '2 teaspoons baking powder', '1 teaspoon salt', '1/4 cup (50 g) of white granulated sugar plus 2 Tbsp sugar', '1 teaspoon ground cinnamon', '10 Tbsp unsalted butter (140 g), room temperature', '2 eggs, beaten', '1 cup (235 ml) whole milk', '1 medium tart green apple, cored, peeled and sliced into 1/4-inch thick slices', 'Streusel topping:', '4 Tbsp brown sugar', '4 Tbsp flour', '1/4 teaspoon cinnamon', '1 Tbsp butter, cut into small cubes']",14,"['1 Preheat oven, prepare pie dish: Preheat the oven to 375\\xc2\\xb0F (190\\xc2\\xb0C). Grease a 9-inch pie pan (can use a springform pan or square baking pan)', '2 Whisk flour, baking powder, salt: In a medium bowl, whisk vigorously together the flour, baking powder, and salt.', '3 Make cinnamon sugar: In a separate small bowl, mix 2 Tbsp of the sugar with the cinnamon, set aside.', '4 Beat butter and sugar, add eggs, add flour mixture and milk: Using an electric mixer, beat the butter with the remaining 1/4 cup sugar. Beat in the eggs until blended. Add the flour mixture in three additions, alternating with the milk, beating after each addition until just combined.', '5 Pour batter into baking dish, top with apple slices, cinnamon sugar: Pour half of the batter in the bottom of the baking dish. Lay the apple slices on the batter so they just cover the batter (you may have to overlap some slices). Sprinkle the apples with the cinnamon-sugar mixture. Spread the rest of the batter over the apples.', '6 Top with streusel topping: In a small bowl mix together the brown sugar, flour, and cinnamon for the streusel topping. Sprinkle over the cake and dot with butter.', '7 Bake: Bake the cake at 375\\xc2\\xb0F (190\\xc2\\xb0C) for 30-35 minutes or until it is golden brown and a tester inserted into the center comes out clean.']",7
62,Best Fresh Apple Bundt Cake Recipe,20,60,80,"['Cake:', '1 1/2 cups vegetable oil', '2 cups of sugar', '3 eggs, slightly beaten', '3 cups of white flour', '1 1/2 teaspoon baking soda', '1 teaspoon vanilla', '1 teaspoon salt', '1 teaspoon cinnamon', '3 cups chopped, peeled apples (varieties that are good for baking - i.e. Granny Smith, Gravenstein, Fuji)', '1 cup of sweetened shredded coconut', '1 cup of chopped nuts - walnuts or pecans', 'Glaze:', '1/2 stick sweet butter', '1 cup brown sugar', '3 tablespoons milk']",16,"['1 Preheat oven to 350\\xc2\\xb0 F.', '2 Make the cake batter: Beat together the sugar and oil. Add the eggs. In a separate bowl, sift together the flour, baking soda, salt and cinnamon.', 'Add dry ingredients to oil sugar eggs mixture in thirds, beating to incorporate after each addition.', 'Mix in the vanilla, apples, coconut, and chopped nuts.', '3 Bake: Bake at 350\\xc2\\xb0F in a greased and floured bundt cake pan about 1 hour.', 'Test around the centers with a long thin bamboo skewer or toothpick to make sure the cake is done.', '4 Cool and remove from pan: When cool enough to handle, gently remove from pan. Let sit on a rack to cool completely. If the dough has raised substantially around the middle areas of the bundt ring, you may need to use a bread knife to gently level off the cake so that it sits even.', '5 Glaze the cake: Blend glaze ingredients and cook until melted. Place the cake on its serving dish.', 'Prick all around the top of the cake with a fork so that when the glaze is applied it easily seeps into the cake.', 'Use a pastry brush to apply the glaze liberally around the surface areas of the cake, or use a spoon to dribble the glaze on the cake.']",10
63,Apple Carrot Cupcakes Recipe,20,25,45,"['For the cupcakes:', '2 cups (260 g) all-purpose flour', '1 1/4 (250 g) cups sugar', '2 teaspoons baking soda', '1 1/2 teaspoons baking powder', '1 1/2 teaspoons cinnamon', '1/4 teaspoon ground nutmeg', '1/8 teaspoon ground cloves', '1/4 teaspoon salt', '1 cup (236 ml) vegetable oil (light olive oil or canola oil)', '4 large eggs, lightly beaten', '1 1/2 cups packed coarsely grated carrots (about 3 medium)', '1 1/2 cups packed coarsely grated tart apples, such as Granny Smith (about 2 medium)', '1 cup (125 g) coarsely chopped pecans (or walnuts)', '1/4 cup (15 g) sweetened shredded coconut', 'For the frosting:', '8 ounces (225 g) cream cheese, at room temperature', '4 tablespoons unsalted butter, at room temperature', '1 teaspoon vanilla extract', '2 cups (260 g) powdered sugar, sifted']",20,"['1 Prep the oven: Preheat oven to 350\\xc2\\xb0F and place the rack in the center of the oven.', '2 Make the batter: In a large bowl, whisk together the flour, granulated sugar, baking soda, baking powder, cinnamon, nutmeg, cloves, and salt.', 'Stir in oil and eggs. Stir in carrots, apples, pecans, and coconut.', '3 Bake the cupcakes: Place paper liners in muffin tins. Spoon the batter into the paper cups, three quarters of the way to the top. Bake at 350\\xc2\\xb0F for 20 to 25 minutes (testing after 20 min), or until a tester inserted in the middle comes out clean. Let cool completely before frosting.', '4 Make the frosting: Beat the cream cheese, butter, and vanilla until smooth and fluffy, about 3 minutes. Gradually add powdered sugar and mix until combined.', 'Once the cupcakes are cool, apply frosting.']",6
64,Apple Upside Down Cake Recipe,15,90,105,"['8 Tbsp (1 stick) unsalted butter, softened', '1 1/4 cups white, granulate sugar divided (1/2 cup and 3/4 cup)', '1 1/2 pounds Braeburn, Jonagold, or Golden Delicious apples (about 4 medium), peeled, quartered, cored, each quarter cut into 2 wedges', '3/4 cup flour', '1/2 teaspoon salt', '2 teaspoons baking powder', '1/3 cup cornmeal', '1/2 cup boiling water', '1 teaspoon vanilla extract', '2 large eggs', '1/3 cup whole milk', 'Special equipment needed:', '1-9-inch cake pan with 1 1/2-inch high sides']",13,"['1 Preheat the oven and prep the cake pan: Preheat your oven to 350\\xc2\\xb0F. Butter the sides of the cake pan. Line the pan with a 10-inch round of parchment paper. The paper will come up 1/2-inch up the sides of the pan. Butter the parchment paper.', '2 Make the caramel sauce base: Melt 2 Tbsp butter in a non-stick skillet on medium heat. Add 1/2 cup sugar and cook until sugar dissolves and mixture turns golden brown, stirring occasionally (use a wooden spoon), about 6 minutes.', '3 Add the apple wedges and cook in the caramel sauce: Add apple wedges to the pan and gently stir to distribute the caramel evenly across the apples. Cover the pan and cook until apples release their juices, about 5 minutes. Uncover and cook until apples are tender and caramel thickens and coats the apples, stirring occasionally, about 13 minutes more.', '4 Remove apples and caramel sauce and spread evenly in the prepared cake pan.', '5 Make the batter: Whisk together the flour, salt, and baking powder in a small bowl and set aside. Place cornmeal in a large mixing bowl. Pour 1/2 cup boiling water over the cornmeal and stir to blend.', 'Add 3/4 cup sugar and 6 Tbsps (3/4 stick) butter to the cornmeal mixture. Beat until well blended. Beat in vanilla and eggs.', 'Beat in the flour, salt, baking powder mixture alternating with the milk. Pour the batter over the apples in the cake pan.', '6 Bake: Bake at 350\\xc2\\xb0F until top is golden and a tester inserted into the center comes out clean, about 40 minutes.', 'Cool cake in the pan for 5 minutes. Then run a knife around the edges of the cake to loosen it from the sides of the pan. Carefully invert the cake onto a serving plate or dish, and remove the parchment paper. Cool for 15 minutes.', 'Serve with vanilla ice cream.']",10
65,Buttery Apple Torte Recipe,15,45,60,"['1/2 cup (8 Tbsp, 1 stick, 4 oz or 125 g) plus 1 Tbsp of unsalted butter', '3 Fuji, Jonagold, or Golden Delicious apples, peeled, cored, and cut into slices 1/4 inch (6 mm) thick', '2/3 cup (3 1/2 oz or 105 g) all-purpose flour', '1/2 teaspoon baking powder (See How to Tell if Your Baking Powder is Still Good)', '1/2 teaspoon salt', '2 large eggs, plus 1 egg yolk', '1 teaspoon vanilla extract', '3/4 cup (6 oz or 185 g) granulated sugar', '1/2 teaspoon grated lemon zest']",9,"['1 Preheat oven and prep cake pan: Preheat an oven to 375\\xc2\\xb0F (190\\xc2\\xb0C). Generously butter an 8 or 9-inch (23 cm) round cake pan with 2 inch (5 cm) sides. Line the bottom of the pan with parchment paper and butter the top of it as well.', '2 Cook the apple slices: Melt the butter in the microwave or on the stovetop. Pour 6 Tbsp (3 fl oz or 90 ml) of it into a small bowl or cup and set aside.', 'Add the apple slices and the remaining butter to a large frying pan and cook on medium low heat, stirring occasionally, until the apples are tender, about 10 minutes. Remove from the heat.', '3 Make the batter: In a small bowl, stir together the flour, baking powder, and salt. In a large bowl, beat the whole eggs and egg yolk until blended.', 'Add the 6 Tbsp of melted butter, the vanilla, the granulated sugar, and the lemon zest.', 'Stir in the flour mixture and the apples.', '4 Spoon batter into the prepared pan, smoothing the top.', '5 Bake: Bake at 375\\xc2\\xb0F 30-35 minutes. The cake is done when it is browned, and when you press into the top, it bounces back. After about 20 minutes of baking or so, if the top is getting well browned, tent the cake with aluminum foil.', 'Transfer to a wire rack and let cool in the pan for 5 minutes.', 'Invert the cake onto a plate and lift off the pan, then invert the cake again onto the rack and let cool completely.']",10
66,Apple Cider Glazed Donut Holes Recipe,15,25,40,"['For the donut holes:', '2 cups (255g) all-purpose flour', '1 1/2 teaspoons baking powder', '3/4 teaspoon kosher salt', '1/2 cup (100g) sugar', '1 large egg', '3/4 cup (6oz/170g) sour cream', '1/2 cup apple cider', '2 tablespoons unsalted butter, melted', '1 1/2 quarts canola oil for frying', 'For the apple cider glaze:', '2 cups powdered sugar', '4 tablespoons apple cider', 'Pinch of kosher salt']",14,"['1 Prepare your drying station: Set a wire cooling rack over a baking sheet. You will let the donut holes dry here after you\\xe2\\x80\\x99ve dipped them in the glaze.', '2 Make the batter: In a large mixing bowl whisk together the flour, baking powder, salt, and sugar.', 'In medium bowl, whisk together the egg, sour cream, and apple cider.', 'Add the wet mixture to the dry mixture, followed by the melted butter, and fold to combine until you get a very thick batter.', '3 Prepare to fry the donut holes: Heat the oil in a 3-quart saucepan until the temperature reads 350\\xc2\\xb0F. Use a medium cookie scoop (about 1 1/2 tablespoons), to scoop up the batter. Fry the donut holes in batches, cooking each side for about 2 minutes, until the donut holes float to the surface and turn golden brown. Drain on paper towels. Repeat until all the batter is used up.', '4 Make the glaze: In a medium bowl whisk the powdered sugar with 2 tablespoons of apple cider and pinch of salt, adding more cider a few teaspoons at a time, until you get a thick, heavy glaze. You may not need all 4 tablespoons of cider. Remember that the glaze will thin as it hits the hot warm donuts.', '5 Dip the donut holes: Pour the glaze into a deep bowl or mug, this will help with glazing the donuts. Dip the warm (or even hot) donuts into the glaze, using a spoon to coat the donut hole completely.', 'Lift the donut hole from the glaze using a fork. Let the glaze set and drain by placing the dipped donut holes on the wire rack set over a baking sheet. Enjoy immediately!']",8
67,Apple Cider Chicken Thighs Recipe,10,50,60,"['4 or 5 bone-in skin-on chicken thighs (about 2 pounds)', '2 medium sweet potatoes, diced (about 2 cups diced)', '1/2 white onion, sliced thin', '1/2 teaspoon kosher salt', '1/2 teaspoon black pepper', '1 cup apple cider', '1/2 cup chicken stock', '1 tablespoon fresh rosemary', 'Cooked rice or orzo for serving (optional)', 'Special equipment:', 'Large cast iron skillet']",11,"['1 Preheat oven to 350\\xcb\\x9aF.', '2 Sear the chicken thighs: Season the chicken thighs on both sides with kosher salt and pepper. Add chicken thighs skin-side down to a large, cold cast iron skillet. Place the skillet over medium heat and let the thighs cook, untouched, for 15 minutes, until the skin is deeply golden and crispy.', '3 Add the remaining ingredients: After the chicken thighs have cooked for 15 minutes, carefully flip them. Add the sweet potatoes, onion, apple cider, chicken stock, and fresh rosemary to the skillet. Stir gently to make sure ingredients are distributed evenly. The thighs should only be submerged halfway in the liquid so the skin stays crispy while baking.', '4 Cook the chicken thighs in the oven: Transfer the skillet to the oven and cook for 30-35 minutes, or until sweet potatoes are fork-tender and the chicken is cooked through. (It should reach at least 165\\xcb\\x9aF in the thickest part.) It\\xe2\\x80\\x99s very hard to overcook chicken thighs in this environment, so don\\xe2\\x80\\x99t worry if they register much hotter than that.', '5 Serve the chicken thighs: Divide the chicken thighs between four plates and add cooked rice or orzo to the side, which is great for soaking up the juices. Spoon sweet potatoes and onions on top.', 'Leftovers will keep in the fridge for 4-5 days. To reheat, microwave the thighs for about 90 seconds on high. To regain some of the crispiness, reheat the thighs in the oven until warmed through.']",6
68,New England Apple Cheddar Galette Recipe,40,30,70,"['Crust:', '1 1/2 cups (200g) of all purpose flour', '1/2 teaspoon salt', '1 1/2 teaspoons sugar', '1 1/2 sticks (3/4 cups, 6 ounces, 170 g) unsalted butter', '1/4 cup plus 2 Tbsp (85 ml) sour cream (full fat, not light)', '2 Tbsp finely grated sharp cheddar cheese', 'Filling:', '4 good cooking apples, such as McIntosh, Courtland, Jonagold, Pippin, Golden Delicious, Jonathan, Fuji, or a mixture of various cooking apples (NOT red delicious)', '1/2 teaspoon lemon zest', '1 half of a lemon, or the juice of half a lemon (to acidulate the water for holding the apples while you peel them to keep them from discoloring)', '1 Tbsp maple syrup', '2 teaspoons minute tapioca or instant tapioca for thickener (can substitute corn starch)', '1 teaspoon ground cinnamon', '1/2 cup lightly packed grated cheddar cheese', 'Finishing:', '1 egg for egg wash', 'Coarse sugar for sprinkling on the crust']",18,"['Make the pastry dough', '1 Cut the butter into cubes. In a large bowl whisk together the flour, salt, and sugar. Sprinkle the butter cubes over the flour.', '2 Use your clean hands to squish the flour and butter together, breaking up the butter into smaller pieces until the mixture resembles a rather shaggy coarse meal with a few pea-sized pieces of butter. Add the sour cream and a couple tablespoons of finely grated sharp cheddar cheese and stir with a fork until incorporated.', '3 Gather the mixture with your hands and form a ball. Shape the ball into a disk. Sprinkle with a little flour, wrap in plastic wrap, and chill in the refrigerator for at least 30 minutes and up to a day ahead.', '  Prepare the galette', '1 Peel, core, quarter the apples, place in water with lemon juice: Preheat oven to 400\\xc2\\xb0F (205\\xc2\\xb0C). Prepare a large bowl half filled with water. Squeeze into it the juice of half a lemon (and put the squeezed lemon in too if you want). Peel, quarter, and core the apples, and place into the acidulated water while you work to keep the apples from discoloring.', '2 Slice the apple quarters: Remove the apple quarters from the water. Slice each apple quarter into 4 or 5 slices, lengthwise, about 1/4 inch to 3/8 inch thick at the widest end. Return the apple slices to the acidulated water.', '3 Drain apple slices, sprinkle with maple syrup, cinnamon, minute tapioca, zest: Drain the apple slices. Place the apple slices back in the now empty bowl. Sprinkle with maple syrup and cinnamon and gently toss so that the apple slices are lightly coated with both. Add the minute tapioca and the lemon zest. Gently toss again.', '4 Roll out the dough, transfer to lined baking sheet: On a clean, lightly floured, flat surface, place the disk of dough. Roll out with a rolling pin to an even thickness and about 14 inches wide. Gently move the rolled out pastry dough to a parchment lined baking sheet.', ""5 Arrange apple slices on the dough: Starting from 2 inches from the perimeter of the pastry round, arrange the apple slices, side by side, in a circular pattern, filling the circle. It's okay if some of the apple slices overlap a little."", '6 Sprinkle with cheese, fold edges over in pleats: Sprinkle the top of the apples with grated cheddar cheese. Gently fold the dough up over the apple slices, forming pleats with the dough every few inches.', ""7 Brush with egg wash, sprinkle with coarse sugar: Place an egg in a small bowl with a teaspoon of water, beat with a fork or whisk until smooth. Use a pastry brush to brush the egg wash over the exposed border of the dough (don't put on the apples, just the dough). Sprinkle the egg washed crust with coarse sugar."", '8 Bake: Bake for 10 to 15 minutes (until beginning to brown) at 400\\xc2\\xb0F (205\\xc2\\xb0C). Then lower the temperature to 375\\xc2\\xb0F (190\\xc2\\xb0C) and bake for 15 to 20 minutes more, until the apples are cooked through and the crust is nicely browned.', 'Cool until just lightly warm before serving.']",14
69,Apple Cranberry Currant Crumble Pie Recipe,20,180,200,"['Topping:', '3/4 cup flour', '1/2 cup packed brown sugar (light or dark)', '6 Tbsp butter', 'Filling:', '6 cups sliced peeled Granny Smith apples (about 2 1/4 pounds)', '2 teaspoons lemon juice or apple cider vinegar', '1/4 cup brandy', '1/4 cup dried currants', '1 cup fresh or thawed frozen cranberries, rinsed and drained', '3/4 cup granulated sugar', '4 Tbsp all-purpose flour', '1 Tbsp finely grated orange zest', '1/2 teaspoon ground cinnamon', '1/8 teaspoon nutmeg', '1/4 teaspoon salt', '  9-inch frozen pie shell (I recommend our super easy, super flaky, sour cream pastry crust)']",17,"['1 Peel and slice the apples: Peel and slice the apples. Put the slices into a bowl and sprinkle them with lemon juice (or apple cider vinegar) as you work to make them a little more tart (it will intensify their flavor) and keep them from discoloring as you work. Add the cranberries to the bowl.', '2 Soak the currants in brandy: Place the brandy and the currants in a small bowl. Let sit for at least an hour, until currants are plump. While the currants are soaking in the brandy, peel and slice the apples.', '3 Make streusel topping: Mix together 1 cup of flour and 2/3 cup of brown sugar in a bowl. Add the butter, cutting it in either with your fingers or a pastry blender until the mixture forms small lumps.', '4 Preheat oven to 375\\xc2\\xb0F.', '5 Toss apple slices with sugar, flour, zest, spices, brandy, currants: In a separate large bowl mix 1 cup white sugar with 6 Tbsp flour, orange zest, cinnamon, nutmeg, and salt.', 'Add the apples and cranberries to the sugar mixture and toss to coat. Add the currants and brandy to the mixture.', '6 Put apple filling into pie shell, top with streusel topping: Heap filling into unbaked pie pastry. Sprinkle topping over the filling. Set pie on a baking sheet to catch the juices.', '7 Bake: Bake on bottom rack until juices bubble, 55 to 65 minutes. If pie browns too quickly, cover loosely with foil.', 'Set pie on rack, uncovered, to cool for 2 to 3 hours.']",9
70,Apricot Cherry Galette Recipe,30,120,150,"['Crust:', '1 cup (130 g) all purpose flour', '1 teaspoon sugar', '1/2 teaspoon salt', '1/2 teaspoon crushed fennel seeds', '4 ounces butter (1 stick, 8 Tbsp, 112 g), cut into cubes', '1/4 cup (57 ml) sour cream', '1 egg, beaten, for egg wash', '1 teaspoon cream for egg wash', 'Coarse sugar for sprinkling', 'Filling:', '1 pound apricots (about 12 apricots, 450 g), pitted and quartered, skin on, recommend Blenheims', '8 pitted cherries, sliced in half', '1/4 cup (50 g) sugar', '1 teaspoon lemon zest', '1 teaspoon minute tapioca for thickening (can sub same amount of cornstarch)', '1/4 teaspoon vanilla extract']",17,"['1 Make the dough: To make the dough, whisk together the flour, sugar, salt, and fennel seeds in a large bowl. Add the butter and work the butter into the flour with your (clean) hands until the mixture resembles crumbs and no piece of butter is bigger than a pea.', 'Make a well in the center and add the sour cream. Use a fork to work the flour into sour cream.', 'Form the dough into a ball and flatten into a disk. Refrigerate for 1 hour before rolling out.', '2 Toss apricots with sugar, lemon zest, tapioca, vanilla: Put the apricots and cherries into separate bowls. In the bowl with the apricots add the sugar, lemon zest, minute tapioca, and vanilla extract. Gently toss to combine.', '3 Roll out the dough: Roll out the dough and transfer to a parchment lined baking sheet.', '4 Arranged apricots and cherries on rolled out dough: Arrange the apricot quarters in a circular pattern in the center of the rolled out pastry dough, leaving a border of 2 1/2 inches from the edge. Dot with cherry halves.', '5 Fold dough edges over: Fold up the edges of the dough round over the outer edge of the fruit.', 'If at this point the dough has become sticky, put chill the pastry for 10 minutes before proceeding.', '6 Preheat oven to 375\\xc2\\xb0F (190\\xc2\\xb0C).', '7 Brush egg wash on crust edges, sprinkle with coarse sugar: Whisk together the beaten egg and the cream for the egg wash. Gently apply the egg wash with a pastry brush to outer edge of the crust (note you will only use a little bit of the egg wash). Sprinkle with a little coarse sugar.', '8 Bake: Bake for 40 to 45 minutes, tenting with foil halfway through the baking process if the crust is getting too browned. The galette is done when the filling is bubbly and thickened, and the crust is nicely browned.']",11
71,Apricot Berry Cobbler Recipe,30,45,75,"['Cobbler Filling:', '5 cups pitted, quartered apricots (Blenheims if you can get a hold of some)', '3 cups blackberries (or boysenberries or blueberries)', '1 cup white granulated sugar', '2 Tbsp flour (for thickening)', 'Cobbler Topping:', '2 cups all purpose flour', '2 teaspoons baking powder', '1/2 teaspoon baking soda', '1/2 teaspoon salt', '1 Tbsp white granulated sugar', '1/2 cup (1 stick or 4 ounces) butter softened plus 1/4 cup melted butter', '1 cup buttermilk', '1/2 teaspoon almond extract', '2 Tbsp brown sugar']",15,"['1 Toss the apricots with sugar and flour, place in baking dish: In medium bowl toss the apricots, berries, 1 cup white sugar, and 2 Tbsp flour together.', 'Place filling into baking dish (one 9x13x2 baking dish, or two smaller baking dishes).', '2 Whisk flour, baking powder, baking soda, salt, sugar, then work in butter: Whisk together the 2 cups of flour, baking powder, baking soda, salt, 1 Tbsp white sugar in a medium bowl.', 'Cut the butter into small cubes and toss into the flour mixture. Work the butter with your fingers to smear it and crumble it into the flour, until the mixture resembles a coarse cornmeal.', 'Tip: at this point, if you briefly heat the apricot berry mixture in the microwave or oven, until it is warm, it will help the biscuit topping to rise.', '3 Add almond extract and buttermilk: Add almond extract to the buttermilk, then form a well in the middle of the flour mixture and pour in the buttermilk.', 'Gently mix (with wooden spoon or your hands) until the dough just comes together. Do not over-mix.', '4 Form ""cobblestone"" shapes of the dough and arrange on the top of the apricot berry mixture. (You can also just crumble the dough over the top.) Sprinkle brown sugar over the top of the dough. Drizzle melted butter over the top (aim for the fruit more than the biscuits).', '5 Preheat oven to 425\\xc2\\xb0F. Let the cobbler sit and rise for 10-20 minutes before baking.', '6 Bake: Bake at 425\\xc2\\xb0F for 10-15 minutes or until the top is just beginning to brown, then reduce the heat to 350\\xc2\\xb0F. Cook for an additional 30 to 40 more minutes, until the center fruit is thickened and bubbly.', 'Check during cooking, if the topping is getting too brown, cover it with foil and turn the heat down to 325\\xc2\\xb0F.']",11
72,Apricot Hamantaschen Recipe,90,12,102,"['For the apricot filling:', '1-1/4 cups (7 ounces) dried apricots, preferably Turkish', '2 tablespoons honey', 'For the dough:', '2 cups (262 grams) all-purpose flour', '3/4 cup (156 grams) sugar', '1/2 teaspoon baking powder', '1/2 teaspoon salt', '1/2 cup (1 stick) unsalted butter or margarine, chilled', '1 teaspoon finely grated lemon zest', '1 teaspoon finely grated orange zest', '1 large egg, lightly beaten', 'Special equipment:', 'Food processor', 'Box grater']",15,"['1 Make the filling: Put the apricots in a small saucepan and add enough water to cover. Put on the lid, bring to a boil, reduce the heat, and simmer until the fruit is tender, about 10-15 minutes.', 'Remove the apricots from the saucepan with a slotted spoon and place in a food processor. Reserve the cooking water.', 'Add the honey and 1 tablespoon of the cooking water to the food processor, and puree until very smooth, scraping down the sides of the food processor from time to time. If the fruit is too thick for the machine to puree it, add 1 to 2 more tablespoons of cooking water.', 'Scrape the filling into a container, let it cool, cover with plastic wrap, and refrigerate overnight or up to 3 days before baking.', '2 Make the dough: Lay a large sheet of plastic wrap on the counter.', 'In a large bowl, whisk together the flour, sugar, baking powder, and salt. Using the large holes of a box grater, grate the margarine or butter into the bowl (work quickly so the butter does not melt). Add the lemon and orange zest.', 'Work the grated butter into the flour with a pastry cutter or your fingertips until the mixture resembles coarse cornmeal. Add the egg and knead with your hands for a minute or 2, until the dough is smooth and no longer crumbly.', 'Lay the dough on the plastic wrap, press into a flat rectangle, and wrap tightly. Chill in the refrigerator overnight, or up to 3 days.', '3 Heat the oven and prepare the baking sheets: Preheat the oven to 400\\xc2\\xb0F and position racks in the upper and lower thirds of the oven. Line 2 baking sheets with parchment paper or silicone baking mats. Take the dough out of the refrigerator and let it come to temperature for 10 minutes.', '4 Roll out the dough Lightly flour your countertop. Cut the dough in half; return one half to the refrigerator.', 'Dust both sides of the dough lightly with flour. Roll out to an even 1/8-inch thickness. Use a dry pastry brush or your hands to brush off the excess flour. Using a 3-inch biscuit or cookie cutter or a drinking glass, cut the dough into rounds.', 'Place the rounds on the baking sheets as you go. Once your first sheet is filled, pop it in the fridge so the cookies keep their shape while you work on the second baking sheet. Save and refrigerate the dough scraps.', 'Repeat with remaining half of dough, then re-roll scraps and get as many rounds as you can out of them. (You\\xe2\\x80\\x99ll have anywhere between 26 to 36 rounds).', '5 Fill the cookies: Transfer the chilled filling to a piping bag or a zip-top sandwich bag with the corner snipped off.', 'Working with one baking sheet at a time, pipe a circle of filling (about 1-1/2 teaspoons) on the center of each dough round. (You will likely have extra filling. Store it in the refrigerator and use it to spread on toast or stir into yogurt.)', '6 Shape the cookies: Start by folding one edge over. Fold the second edge over so one corner overlaps the other and forms a 60-degree angle. Fold the third edge over, creating the three distinct corners of a triangle. The first few cookies you shape might not be perfect, but you\\xe2\\x80\\x99ll get the hang of it quickly. There is no need to press, pinch or seal the edges.', '7 Bake the cookies: Arrange the cookies so they are about 2 inches apart (they should all fit on two baking sheets). Bake and set your timer for 6 minutes.', 'When the timer goes off, rotate the sheets front to back and top to bottom. Reset the timer, and bake the cookies for an additional 5 to 10 minutes, or until the edges are golden brown. Total baking time will be 12 to 16 minutes.', '8 Cool the cookies: Cool the cookies on sheets for 2 minutes, then transfer to cooling racks with a metal spatula. You may serve the cookies warm, but they are best at room temperature.', 'The cookies are crispiest on the day you bake them, but they will last up to 3 days in a tightly covered container.']",20
73,"Kale with Seaweed, Sesame and Ginger Recipe",15,15,30,"['1/2 cup dried arame sea vegetables (food-grade seaweed)', '3 Tbsp vegetable oil', '1 teaspoons dark (roasted) sesame oil', '1 Tbsp peeled and minced ginger', '1 bunch kale (we used dinosaur kale)', '1 Tbsp minced garlic', '1 Tbsp soy sauce (can sub with Bragg Liquid Aminos)', '1 Tbsp Toasted sesame seeds']",8,"['1 Prepare the seaweed: Rinse the seaweed in water and let soak, covered in water for 5-7 minutes.', 'Drain seaweed and place in a large bowl. Add 1 teaspoon of dark sesame oil and the minced ginger.', '2 Prepare kale by soaking in water to loosen any dirt, rinsing thoroughly. Chop cross-wise into 1-inch by 2-inch pieces.', '3 Saut\\xc3\\xa9 garlic, then seaweed and ginger: In a large covered skillet, uncover and heat 1 Tbsp of vegetable oil on medium heat. Add garlic and gently saut\\xc3\\xa9 for one minute, until fragrant. Add the seaweed and ginger, gently cook for 1 minute. Remove seaweed/ginger/garlic from pan back to the bowl and set aside.', '4 Saut\\xc3\\xa9 kale: Add another 1 Tbsp oil to the skillet. When the oil is hot, add the chopped kale. Add 1 Tbsp soy sauce. Gently mix in the pan to coat the kale with the oil and soy sauce. Cover; lower heat to low; let cook for 5-10 minutes or until kale is wilted - soft enough to eat easily, but not so soft as to be mushy.', 'Remove cover and let cook a minute more to evaporate any excess moisture. Remove from heat.', '5 Mix in the kale with the seaweed ginger mixture. Add more dark sesame oil and soy sauce to taste. Garnish with toasted sesame seeds.']",7
74,How to Cook and Eat an Artichoke,5,0,5,"['1 or more large globe artichokes', '1-2 cloves of garlic, cut in half (can leave skin on)', '1 bay leaf', '1 slice of lemon']",4,"['HOW TO COOK AN ARTICHOKE', '1 Cut of the tips of the leaves: If the artichokes have little thorns on the ends of their leaves, take a kitchen scissors and cut off the tips. This step is mostly for aesthetics as the thorns soften with cooking and pose no threat to the person eating the artichoke. But snipping them off will make the artichokes easier to handle.', '2 Slice off the top of the artichoke: Slice about 3/4 inch to an inch off the tip of the artichoke. A serrated bread knife works great for this.', '3 Remove small leaves at the base: Pull off any smaller leaves towards the base and on the stem.', '4 Cut off excess stem: Cut off excess stem, leaving up to an inch on the artichoke. The stems can be more bitter than the rest of the artichoke, but some people like to eat them. The inner cores of the stems taste like the heart.', 'Alternatively you can leave the whole long stem on the artichoke, just cut off the very end of the stem, and peel the tough outside layer of the stem with a vegetable peeler.', '5 Rinse the artichokes: Rinse the artichokes in running cold water. While you rinse them, open up the leaves a little so that the water gets inside more easily. (This is where it helps to have cut off the thorny tips, it makes the artichoke easier to open without getting poked!)', '6 Set up a pot with some water, aromatics, and a steaming basket: In a large pot, put a couple inches of water, the garlic, a slice of lemon, and a bay leaf (this adds wonderful flavor to the artichokes). Insert a steaming basket.', '7 Steam the artichokes: Place artichokes on top of the steaming basket. Cover the pot. Bring to a boil and reduce heat to simmer.', 'Cook for 25 to 35 minutes or longer, until the outer leaves can easily be pulled off.', 'Note: artichokes can also be cooked in a pressure cooker (about 5-15 minutes at high pressure). Cooking time depends on how large the artichokes are. The larger, the longer they take to cook.', 'HOW TO EAT AN ARTICHOKE', 'Artichokes may be eaten cold or hot, but I think they are much better hot. They are served with a dip, either melted butter or mayonnaise. My favorite dip is mayo with a little bit of balsamic vinegar mixed in.', '1 Pull off the leaves and dip: Pull off the outer leaves, one at a time. Dip the white fleshy end in melted butter, a vinaigrette, or sauce.', ""2 Place light end in mouth, dip side down, pull, scraping through your teeth: Tightly grip the other end of the petal. Place in mouth, dip side down, and pull through teeth to remove soft, pulpy, delicious portion of the petal. (Why dip-side down? Your tongue is where most of your taste buds are, so you\\'ll get a fuller flavor if you strip the leaves that way.) Discard remaining petal."", 'Continue until all of the petals are removed.', 'When you get to the tender inner leaves with the purple tips, you can remove them all at once. Dip and eat just the light colored parts of these leaves.', '3 Scrape out the choke: With a knife or spoon, scrape out and discard the inedible fuzzy part (called the ""choke"") covering the artichoke heart.', '4 Cut the heart into pieces and eat: Underneath the artichoke choke is the heart. Cut the heart into pieces and dip into melted butter, a vinaigrette, or a sauce to eat.', 'My favorite artichoke dipping sauce? Some mayonnaise with a little balsamic vinegar stirred in.']",20
75,"Pasta with Spinach, Artichokes and Ricotta Recipe",10,20,30,"['3 tablespoons olive oil, divided', '3/4 cup Panko breadcrumbs', '1/4 cup coarsely chopped toasted almonds', '1/2 teaspoon salt, divided', '3/4 pound medium shaped pasta, such as penne, medium shells, lumache, or fusilli', '1 clove garlic, minced', '1 (12-ounce) package frozen artichoke hearts, partially thawed if time allows (See Recipe Note)', '3 ounces (3 packed cups) baby spinach', '2 teaspoons finely grated lemon zest', '1/3 cup grated Parmesan', '2 tablespoons lemon juice', '3/4 cup ricotta cheese', '2 tablespoons chopped fresh parsley, to garnish']",13,"['1 Make the breadcrumb topping:  In a small skillet over medium heat, heat 1 tablespoon of the oil. Add the breadcrumbs and chopped almonds, and cook, stirring, for 2 to 3 minutes, or until brown and crisp. Add 1/4 teaspoon salt, or to taste. Set aside.', '2 Cook the pasta: Bring a large pot of salted water to a boil. Add the pasta and cook for 8 to 10 minutes, or until al dente. (Check the package for recommended cooking time and cook one minute less.)', 'Scoop out and set aside 1 cup of the pasta cooking water. Drain the pasta in a colander.', '3 While the pasta cooks, cook the artichokes: In a large skillet over medium-high heat, heat the remaining 2 tablespoons of oil. Add the garlic and cook, stirring, for 30 seconds. Add the artichokes and stir and cook for 3 to 4 minutes, or until lightly browned.', 'Stir in the spinach and cook for another 30 seconds, or until it has wilted very slightly. Stir in the lemon zest and 1/4 teaspoon salt. Taste and add additional salt if needed.', '4 Toss the pasta with the artichokes: Add the drained pasta to the skillet with the artichokes. Add the Parmesan and lemon juice, and toss to combine. Dollop the ricotta over the pasta by the spoonful. Toss together. If the pasta seems dry, add a little of the pasta cooking water. Taste and add salt and freshly ground black pepper.', '5 Serve the pasta: Divide the pasta among 4 bowls and top with the toasted breadcrumbs and almonds. Sprinkle with parsley and serve.']",7
76,Spinach and Artichoke Quiche Recipe,20,160,180,"['Crust:', '1 cup all purpose flour', '1/2 teaspoon salt', '1/2 cup (1 stick, 4 ounces, 8 Tbsp) butter', '2 to 2 1/2 Tbsp of water', 'One 9-inch pie dish', 'Quiche: ', '1/2 cup, packed, finely chopped artichoke hearts (cooked fresh or canned artichoke hearts packed in water)', '6 ounces cooked spinach (if using frozen, thaw first), squeezed to remove excess water (wrap in clean tea towel or several layers of paper towels and squeeze), finely chopped', '1 Tbsp butter', '1/2 cup minced shallots', '2 teaspoons grated lemon zest', '4 eggs (large)', '1 cup milk', '1/2 cup heavy whipping cream', '4 ounces goat cheese', '1 teaspoon salt', '1/4 teaspoon black pepper', '2 Tbsp minced chives or green onion greens']",19,"['1a Make the dough for the quiche crust: In a medium bowl, whisk together the flour and salt.', 'Cut the butter into cubes and use your (clean) hands to work the butter into the flour until you have a mixture that looks like a coarse meal with pieces of butter no bigger than a pea.', 'Sprinkle water onto the flour mixture a little at a time, and work the dough with your hands until the dough can be formed into a ball.', 'Flatten the ball into a disk and wrap with plastic wrap. Chill for at least 1 hour.', '1b Roll out the dough: When you are ready to roll out the dough, remove the disk from the refrigerator and let come to room temp for 10 minutes.', 'Roll out the dough on a lightly floured surface to a diameter 2 inches wider than your pie or tart pan. Drape the rolled out dough over the pie or tart pan and press the dough into the sides of the pan. Trim and crimp the edges.', 'Place in freezer for 30 minutes to an hour.', '2 (Optional) Pre-bake the crust: At this point, if you want, you can ""blind bake"" or pre-bake the crust. Pre-baking the crust will ensure that the bottom crust is browned and won\\\'t get soggy. I often skip this step and find that although the bottom crust might not get browned, it\\\'s usually perfectly palatable.', 'To pre-bake a store-bought crust, just follow the directions on the crust package.', 'To pre-bake the homemade crust in this recipe, line the inside with aluminum foil and fill it with pie weights such as beans. The foil and the pie weights will help keep the sides of the crust from sliding down as it bakes.', 'Bake for 15 minutes at 375\\xc2\\xb0F, then remove the foil and weights, prick the bottom of the crust with the tines of a fork , and bake for another 10 minutes. Let cool down a bit before filling with the quiche custard filling.', '3 Cook the shallots: Melt butter in a small saucepan on medium heat. Add the minced shallots and cook 3 to 4 minutes until translucent. Remove from heat.', '4 Prepare the filling: Preheat oven to 375\\xc2\\xb0F. Beat the eggs in a large bowl. Add the goat cheese and whisk until smooth. Whisk in the milk, cream, salt, pepper, chopped spinach, chopped artichokes, the cooked shallots, lemon zest, and the chives.', '5 Bake the quiche: Pour filling into the frozen pie crust. (If you are using a tart pan with a removable bottom, you may want to put the pan on a foil lined or rimmed sheet pan.)', 'Place in oven. Bake at 375\\xc2\\xb0F for 10 minutes, then reduce the heat to 350\\xc2\\xb0F and cook for 30 minutes, or until the center of the quiche has set.', '6 Let cool before serving: Remove from oven and let sit and cool to room temperature before slicing and serving.']",16
77,Sauteed Baby Artichokes Recipe,20,10,30,"['2 pounds baby artichokes', '4 cups of water, divided 3 cups and 1 cup', '4 Tbsp lemon juice (from 1 to 2 lemons) divided', '1/2 cup extra virgin olive oil', '1 medium yellow onion, chopped', '2 green onions (scallions), thinly sliced, including the green ends', '3 cloves garlic, finely chopped', '1 pinch of Herbes de Provence', '1/2 teaspoon salt', '1 pinch black pepper', '1/4 to 1/2 cup freshly grated Parmesan, or to taste', '2 Tbsp chopped fresh parsley (for garnish)']",12,"['1 Prep the artichokes: Rinse the baby artichokes. Fill a bowl with 3 cups of water and add 3 tablespoons of the lemon juice to it.', 'Cut off the stem of each artichoke to 1/4-inch from the base. Peel back and remove the petals until only the top third of the cone tip is pale green. Cut off the pale green tips.', 'Trim off any remaining green from base of artichoke. Halve or quarter the artichokes, depending on their size and drop them into the bowl of acidified water (to prevent discoloration).', '2 Steam the artichokes: Drain artichokes in a colander. In a large skillet, bring one cup of the water to a boil. Add the artichokes, cover and simmer for 3 to 5 minutes, depending on the size of the artichokes. Drain well.', '3 Saut\\xc3\\xa9 the artichokes: Wipe out the skillet to remove excess water. Heat to medium high and add the olive oil. Add the artichokes, onions, garlic, and herbes de Provence. Cook, stirring occasionally, for five minutes.', 'Stir in the remaining 1 tablespoon of lemon juice, the salt and pepper.', '4 Serve: Transfer to a serving bowl and sprinkle with freshly grated Parmesan and parsley on top.']",7
78,Asparagus Artichoke Breakfast Casserole Recipe,25,40,65,"['6 cups of 1 to 1 1/2-inch cubed rustic bread (about half a loaf), or 6 slices of bread', '2 ounces bacon (2 to 3 thick-cut slices), roughly chopped', '1 medium onion, chopped (about 1 1/2 cups)', '1 pound of asparagus, trimmed of tough bottoms, spears sliced on the diagonal, in 1-inch long pieces', '1 15-ounce can of artichoke hearts (packed in water), drained, chopped', '2 Tbsp minced chives or green onion greens', '6 eggs', '2 cups milk', '8 ounces cheddar cheese, grated', '1 1/2 teaspoons salt', '1/4 teaspoon black pepper']",11,"['1 Dry cubed bread in oven: Place cubed bread on a baking sheet, put in a 200\\xc2\\xb0F for 10 to 15 minutes, until somewhat dry. OR you can use stale bread that is no longer soft. Drying the bread in the oven will help keep it from falling apart when you add the egg mixture later.', '2 Cook the chopped bacon: Place bacon in medium skillet on medium high heat. Cook until bacon is lightly browned and much of the fat rendered. Remove bacon from pan with a slotted spoon, place on a paper towel lined plate to drain. Pour off all but enough bacon fat to coat the bottom of the pan (do not put down the drain, it will clog your pipes).', '3 Saut\\xc3\\xa9 onions: Add chopped onions to the pan with bacon fat. Cook on medium high heat until lightly browned, about 5 to 6 minutes. Add the bacon back to the pan with the onions, stir, remove from heat.', '4 Blanch the asparagus: While the onions are cooking, bring a small pot of lightly salted water to a boil. Add the asparagus and blanch for 2 minutes. Drain and shock the asparagus in ice water to stop the cooking.', '5 Mix eggs, milk, cheese: In a large bowl, beat the eggs with a fork or whisk. Whisk in the milk. Stir in the 1 1/2 teaspoons salt, and 1/4 teaspoon pepper. Stir in the grated cheddar cheese.', '6 Preheat oven to 350\\xc2\\xb0F.', '7 Place bread in egg milk mixture, fold in bacon and vegetables: Place the cubed bread in the egg milk mixture and press down with your hands so that the bread cubes absorb most of the egg milk mixture. Gently fold in the onions, bacon, asparagus, chopped artichoke hearts, and chives. (Be gentle as to not break up the bread.)', '8 Assemble the casserole: Generously butter the inside of a 2 1/2 to 3 quart (8 x 13 inch) casserole dish. Gently pour the bread egg milk vegetable mixture into the casserole dish and spread out in an even layer.', 'At this point you can make up to a day ahead. Cover and refrigerate until ready to cook.', '9 Bake: Bake uncovered at 350\\xc2\\xb0F for 4o minutes. If the casserole starts to get too browned while cooking, cover with foil. Remove from oven and let rest for 5 minutes before serving.']",10
79,Shrimp and Artichoke Pasta Recipe,15,15,30,"['1/2 pound linguine, fettuccine, spaghetti, or other pasta', '1/4 cup prepared basil pesto (or spinach, arugula, or kale pesto)', '2 tablespoons extra virgin olive oil', '1 clove garlic, finely minced', '1 pound raw shrimp (21 to 30 count), peeled, deveined', '1 cup frozen peas', '8 ounces frozen artichoke heart quarters, thawed, cut in half lengthwise', '1/3 cup thinly sliced green onions, including the greens', '1/3 cup minced fresh parsley', 'Salt and freshly ground black pepper to taste']",10,"['1 Boil the pasta: Heat a large pot of salted water (4 quarts of water, 2 tablespoons salt) on high heat until boiling.', 'Add the pasta. Cook uncovered on high heat with a vigorous boil until al dente (cooked but still a little firm), about 10 minutes or whatever your pasta package says is appropriate for al dente.', '2 Reserve some pasta cooking liquid, drain pasta. Once the pasta is done, and before draining the pasta, scoop out one cup of the pasta cooking liquid and reserve. Drain the pasta.', '3 Toss the pasta with the pesto and keep it warm.', '4 Saut\\xc3\\xa9 the shrimp and garlic: Heat oil in a large skillet over medium-high heat. Add the garlic and shrimp and cook, stirring, for 1 minute, until the shrimp is pink but not quite cooked through.', '5 Add the peas and artichokes, lower the heat to medium, cover and cook for an additional minute.', '6 Add green onions, parsley, pasta: Add the green onions and parsley, reduce the heat to low. Add the pasta and about a third of a cup of the reserved cooking water.', 'Toss to coat evenly. Add more cooking water if the pasta is still a little too dry.', 'Season with salt and pepper. Serve immediately.']",9
80,Asparagus Artichoke Salad Recipe,10,12,22,"['1 large shallot, sliced thin (can sub a few thin slices of red onion or some sliced spring onion)', '2-3 tablespoons lemon juice', '2 pounds thick asparagus, rinsed, tough ends broken off and discarded (or saved for stock)', '2 tablespoons extra virgin olive oil, divided', 'Salt', '1 teaspoon garlic powder', '1 pint grape or cherry tomatoes, sliced in half', '1 15-ounce jar of good quality marinated artichoke hearts, quartered or cut in half (depending on the size of the artichokes)']",8,"['1 Soak the sliced shallots in the lemon juice as you get ready to make the rest of the salad.', '2 Roast or Grill the asparagus:', 'To roast the asparagus, preheat the oven to 400\\xc2\\xb0F. Coat the asparagus spears with 1 Tbsp of olive oil, and salt them well. Lay in a single layer in a foil-lined roasting pan, and cook for 8-10 minutes until lightly browned and fork tender.', 'To grill the asparagus, prepare your charcoal or gas grill for high direct heat. Coat the asparagus with 1 Tbsp of olive oil and sprinkle with salt. Grill them until nicely charred and fork tender, between 5 to 10 minutes.', 'Remove the asparagus from the oven or grill and cut into bite-sized pieces.', '3 Put the asparagus and all the remaining ingredients into a large bowl and mix to combine. Add as much of the marinating liquid from the jarred artichokes as you like. Serve chilled or at room temperature.']",6
81,Artichoke and Shrimp Risotto Recipe,7,35,42,"['12 ounces raw shrimp (26-30 size), about 18 pieces', '1/2 teaspoon paprika', 'Salt', '1/8 teaspoon freshly ground black pepper', '1 Tbsp butter + 2 Tbsp butter', '1/3 cup minced shallots', '1 Tbsp minced garlic', '1 1/2 cup risotto rice (recommend carnaroli, can also use arborio)', '1/2 cup dry white wine (like a Sauvignon Blanc)', '8 ounces clam juice', '1 14-ounce can artichoke hearts packed in water, drained (reserve the water!), and finely chopped', '2-3 cups water', '2 Tbsp chopped fresh parsley']",13,"['1 Toss shrimp with paprika, salt, pepper: Pat dry the peeled and deveined shrimp and place them in a medium bowl, toss to coat with 1/2 teaspoon salt, the paprika, and pepper.', ""2 Saut\\xc3\\xa9 shrimp: Heat 1 Tbsp butter in a small saut\\xc3\\xa9 pan on high heat. Add the shrimp and saut\\xc3\\xa9 for 1 to 2 minutes on each side, until they are cooked on the outside, but not quite cooked through (they\\'ll continue to cook as they sit outside of the pan). Then remove to a bowl and set aside."", '3 Simmer salted water: Put 3 cups of water with about a teaspoon of salt in a small saucepan. Heat until simmering and keep warm while you start the risotto.', '4 Saut\\xc3\\xa9 shallots, garlic: Heat 2 Tbsp butter in a 3 to 4-quart thick-bottomed pot on medium heat. Add the minced shallots and cook until translucent, about 3 to 4 minutes.', 'Add the garlic and cook a minute more.', '5 Add risotto rice: Add the risotto rice to the pot, stir to coat. Let cook for a minute or two for the rice to just barely begin to brown.', '6 Add 1/2 cup dry white wine. Let come to a low simmer and slowly stir until the wine has been absorbed by the rice.', '7 Add clam juice, artichoke can water: Add the clam juice and the reserved water from the can of artichokes, a half cup at a time, slowly stirring and allowing the rice to absorb the liquid before adding more liquid.', '8 Start adding hot salted water, 1/2 cup at a time: Once the rice as absorbed the wine, clam juice, and artichoke water, you can start adding the hot, lightly salted water from step one.', ""Add it 1/2 cup at a time, again stirring slowly allowing the rice to absorb it for a minute or two before adding any more. You\\'ll need between 2 and 3 cups of water."", 'You\\\'ll want to stop adding water when the rice is cooked through, but still a little firm to the bite, ""al dente"".', '9 Stir in the chopped artichoke hearts. Fold in the shrimp and chopped parsley. Serve immediately.']",12
82,Oil-Poached Artichoke Heart Salad Recipe,25,45,70,"['3 large artichoke hearts', 'Salt', 'Lots of extra virgin olive oil', '2 smashed garlic cloves', 'Juice of 2 lemons', '1 tablespoon minced parsley', '1 tablespoon minced chives', 'Black pepper']",8,"['1 Trim your artichokes: (see How to Trim an Artichoke). Once they are trimmed, slice lengthwise into pieces roughly \\xc2\\xbc inch thick. You want them to look like silhouettes of an artichoke heart.', '2 Bathe the slices in a bowl of lemon juice.', '3 Heat garlic in olive oil: Get a large, heavy pot with a lid and pour in a layer of olive oil. Add the smashed garlic cloves and turn the heat to low.', '4 Add salted artichoke heart slices to the oil: Take some artichoke heart slices out of the lemon juice and salt them well. Slip them into the olive oil in layers, adding more olive oil to cover. You will probably need about a pint or so of olive oil \\xe2\\x80\\x93 it is very important they are completely covered.', 'Do not use cheap vegetable oil (corn, canola, etc) as a substitute because you will definitely taste the olive oil in the final dish. You could use melted butter, though\\xe2\\x80\\xa6', '5 Heat on low: Cover the pot and cook on the lowest heat of your weakest burner for 45 minutes. Turn off the heat and let the oil cool for another 20-30 minutes.', '6 Remove from oil and toss with remaining ingredients: To make the salad, just remove the artichokes from the oil and toss with the remaining ingredients. You can eat the garlic or not, but it is just there to flavor the oil.', 'Serve at room temperature. It keeps for several days in the fridge.']",8
83,Creamy Basil Artichoke Mac and Cheese Recipe,15,10,25,"['For the mac and cheese:', 'Salt for the pasta water', '3/4 pound pasta, such as elbows or cavatappi', '1/3 cup packed fresh basil leaves', '2 cups heavy cream', '1/2 cup whole milk', '4 ounces cream cheese, softened at room temperature and cut into chunks', '1 cup grated Fontina (about 3 ounces)', '3/4 cup grated sharp cheddar (about 3 ounces)', '1/2 cup grated Parmesan (about 2 ounces)', '1 (8-ounce) jar marinated artichoke hearts, drained and cut into bite size pieces', 'Pinch cayenne pepper', 'For the toasted breadcrumbs (optional):', '1 cup soft, fresh breadcrumbs', '2 to 3 tablespoons olive oil', 'Pinch of salt']",16,"['1 Cook the pasta: Bring a large pot of salted water to a boil. Add the pasta and cook for 6 to 8 minutes, or until al dente. Drain the pasta in a colander and reserve the pot. You are going to return the pot to the stove after making the basil cream.', '2 Make the basil cream: Combine basil, heavy cream, milk, and cream cheese in the blender. Puree until smooth. Return the pot used to boil the pasta to the stove, and set it over medium heat. Add the basil cream to the pot, and bring it to a low simmer.', '3 Make the sauce: Add the Fontina, cheddar, Parmesan, and cayenne pepper to the basil cream sauce, stirring until melted. Stir in the cooked pasta and artichokes. Continue to cook and stir until the mixture is heated all the way through.', '4 Toast the breadcrumbs (optional): In a skillet over medium heat, combine the breadcrumbs, oil, and salt. Stir for 2 to 3 minutes, or until browned and crisp.', '5 Serve the mac and cheese: Transfer the pasta to bowls and sprinkle with the toasted breadcrumbs, or don\\xe2\\x80\\x99t. It\\xe2\\x80\\x99s your call.']",5
84,Golden Beet and Pomegranate Salad Recipe,5,75,80,"['3 golden beets (about 1 pound)', '1 cup diced red onion', '1/4 cup red wine vinegar', '1/4 cup water', '1/4 cup orange juice ( can sub with 3 Tbsp Triple Sec)', '1 tablespoon sugar', '1 teaspoon orange zest', '1 cup pomegranate seeds', '1 teaspoon extra virgin olive oil for the salad, plus 1/2 teaspoon more for roasting the beets', '1/2 teaspoon salt', '1/8 teaspoon black or white pepper', '2 cups arugula and/or butter lettuce leaves', '1/4 cup crumbled feta cheese']",13,"['1 Roast the beets: Rub the beets with a little olive oil, wrap them together in foil, place them in a roasting pan, and roast them at 400\\xc2\\xb0F for an hour or until tender when poked with the tines of a fork.', 'Remove from oven. Remove the peels from the beets. Dice the beets into bite-sized pieces.', '2 Make the glaze: Put the diced cooked beets, onions, vinegar, water, orange juice, orange zest, sugar, salt, and pepper, in a skillet on high heat.', 'Heat the mixture to a boil, and continue to boil, stirring often, until the liquid is reduced to a glaze, about 2 tablespoons (5 minutes or so). Remove from heat and let cool to room temperature.', '3 Assemble the salad: Stir pomegranate seeds and olive oil into the beet mixture and add more salt and pepper to taste.', 'Serve on top of salad greens and sprinkle with feta cheese.']",6
85,"Quinoa, Arugula, and Feta Salad Recipe",5,15,20,"['1/2 cup (165 g) red quinoa', 'Scant 1 cup water (1 cup minus 1 tablespoon)', '1/4 teaspoon salt', '3 tablespoons olive oil', '5 ounces (8 loosely packed cups, 165 g) baby arugula', '2 tablespoons (30 ml) lemon juice, or more to taste', '8 ounces (110 g) firm feta, cut into 1/2-inch cubes', '1/4 teaspoon ground black pepper']",8,"['1 Toast the quinoa: In a dry sauce pan over low heat, toast the quinoa, shaking the pan often, for 5 minutes, or until some of the grains start to turn a darker color.', '2 Cook the quinoa: Add the water and salt to the pan with the quinoa. Turn the heat to high and bring to a boil. Reduce the heat to low and cover the pan. Simmer for 15 minutes, or until the quinoa is tender when tasted and all the water is absorbed. If there\\xe2\\x80\\x99s water in the pan, let the quinoa cook 2 minutes more.', '3 Cool the quinoa: Tip the quinoa into a large bowl and sprinkle with 1 tablespoon of the olive oil. Stir well and leave to cool, stirring occasionally. (Once cooled, the quinoa can be refrigerated for a few days before using.)', '4 Dress the arugula: In another bowl, toss the arugula with the remaining 2 tablespoons olive oil, 2 tablespoons of the lemon juice, and pepper.', '5 Toss the salad: Add the cooled quinoa and feta cubes to the bowl with the greens. Toss well and taste for seasoning. Add more salt or lemon juice, if you like. Serve immediately.']",5
86,Chicken Apple Arugula Goat Cheese Salad Recipe,10,15,25,"['2 Tbsp extra virgin olive oil, plus more for dressing', '1 large shallot, peeled and sliced', '1 1/2 lb skinless, boneless chicken breast, cut into 1 inch cubes', 'Salt', '1 tart green apple, thinly sliced and roughly chopped', 'Baby arugula leaves - enough for a salad for four', '1/4 cup toasted walnuts, roughly chopped', '1/4 cup goat cheese - broken up into little pieces', 'Lemon juice', 'Salt and pepper']",10,"['1 Saut\\xc3\\xa9 shallots: Heat a tablespoon of olive oil in a stick-free frying pan on medium heat. When the oil is hot, add the shallot slices and lightly saut\\xc3\\xa9 them until translucent. Remove shallots from pan and set aside.', '2 Saut\\xc3\\xa9 chicken pieces: Heat another tablespoon of olive oil in the pan and when the oil is hot, add the chicken breast pieces. Cook, stirring occasionally, until just cooked through, 5 to 10 minutes. Sprinkle some salt on the chicken while you are cooking it. Remove from pan and chill.', '3 Assemble salad: When chicken has cooled, toss together in a serving bowl the shallots, chicken, sliced green apple, arugula, toasted walnuts and goat cheese.', '4 Dress with olive oil, lemon juice, salt and pepper to taste.']",4
87,Strawberry Arugula Quinoa Salad Recipe,0,30,30,"['1 cup uncooked quinoa', '2 cups water', '10 strawberries, cored and quartered', '1/4 cup slivered almonds, toasted', '2-3 green onions, thinly sliced', '2 tablespoons thinly sliced fresh mint', '2 cups of baby arugula greens', 'Vinaigrette ingredients:', '1 Tbsp orange zest', '3 tablespoons orange juice', '1 tablespoon balsamic vinegar', 'Pinch of salt', '2 tablespoons extra virgin olive oil']",13,"['1 Cook the quinoa: Cook the quinoa according to the package instructions. (If no package instructions, put 1 cup of uncooked quinoa into a saucepan with 2 cups of water and a pinch of salt. Bring to a boil, cover, reduce heat to a low simmer and cook for 15 minutes. Remove from heat, let sit for 5 minutes covered, then fluff with a fork.)', '2 Make vinaigrette: Place the vinaigrette ingredients into a jar and shake to emulsify.', '3 Cool the quinoa: When the quinoa is cooked, spread it out on a baking sheet to cool quickly.', '4 Toss quinoa with vinaigrette, add remaining ingredients: When the quinoa has cooled, place into a large bowl and toss with the vinaigrette. Then toss with the strawberries, almonds, green onions, mint, and arugula.', 'Serve immediately. If making in advance, you can dress the quinoa in advance, and then toss in the rest of the ingredients right before serving.']",5
88,Mozzarella Grilled Cheese Sandwich Recipe,5,15,20,"['8 slices sourdough bread', 'Butter, soft and at room temperature', 'Dijon mustard, to taste', 'Mayonnaise, to taste', 'Salt', 'Pepper', '18 ounces jarred roasted peppers (oil- or water-packed), patted dry of excess moisture', '12 ounces low-moisture mozzarella, cut into 1/4-inch slices (or shredded, if that\\xe2\\x80\\x99s how you roll)', '2 cups arugula']",9,"['1 Prepare the sandwiches: Butter one side of each slice of bread. On the unbuttered sides, spread Dijon mustard, mayonnaise, and a sprinkling of salt and pepper. Place two slices of bread (or as many as you can fit), buttered side down, in a skillet over medium-low heat.', 'Add about 4 ounces of the peppers, 3 ounces of mozzarella, and a good handful of arugula. Press down to keep slightly together, then place slices of bread on top, buttered side out.', '2 Grill that cheese: Let the sandwiches cook over medium-low heat for about 3 to 4 minutes per side, flipping halfway through, making sure they don\\xe2\\x80\\x99t get too browned. After about 6 to 8 minutes total, the cheese in the sandwich should be well melted and the bread toasted. Repeat with remaining sandwiches.']",3
89,Baked Asparagus with Parmesan Recipe,10,10,20,"['1 pound asparagus', '2 tablespoons extra virgin olive oil', '1/2 teaspoon salt, less or more', '1/8 teaspoon black pepper, less or more taste', '1/2 cup loosely packed (about 1.5 ounces or 40g) shredded or grated parmesan cheese,  or to taste']",5,"['1 Prep the asparagus: Preheat oven to 400\\xc2\\xb0F (205\\xc2\\xb0C). Break or cut off the woody ends of the asparagus spears. For an added touch, if you want you can use a vegetable peeler to peel the skins off the base of the asparagus spears for a more elegant presentation.', '2 Toss with olive oil, salt, pepper, Parm: Arrange the asparagus spears on a foil-lined baking sheet and coat with the olive oil. Sprinkle with salt, pepper and the Parmesan.', '3 Bake: Bake at 400\\xc2\\xb0F until the cheese begins to brown, about 8-10 minutes.']",3
90,Grilled Asparagus Recipe,15,7,22,"['1 pound asparagus (estimate 1/4 pound per person), thick spears', '1-2 tablespoons extra virgin olive oil', 'Kosher salt']",3,"['1 Preheat your grill for high, direct heat.', '2 Prep asparagus, coat with olive oil, sprinkle with salt: Prepare the asparagus by breaking or cutting off any tough bottom ends (can save for stock, or discard).', 'Place the asparagus in a pan (to contain the spears while you put them on and take them off the grill).', 'Coat them with olive oil and sprinkle salt over them.', '3 Grill on high, direct heat: Brush the grill grates lightly with olive oil. Place the asparagus spears on the grill so that the thickest ends are aimed toward the hottest part of the grill.', 'Alternatively, you can use a grill pan, heat on high.', 'Grill the asparagus spears for 2-4 minutes, until lightly charred and just fork tender, turning them often so that they brown on all sides.', 'Remove from grill and serve.']",8
91,Roasted Asparagus Recipe,6,12,18,"['1 pound asparagus spears (thick spears are best for roasting)', '1-2 tablespoons extra virgin olive oil', '2 cloves garlic, minced', 'Kosher Salt', 'Freshly grated black pepper', 'Lemon juice (or balsamic vinegar)']",6,"['1 Preheat oven and prep asparagus: Preheat your oven to 400\\xc2\\xb0F (205\\xc2\\xb0C). Rinse the asparagus spears. If the ends are tough, break them off and either discard or save for stock. You can also use a vegetable peeler to peel away the tough outer skin of the fatter ends of the asparagus if you want.', '2 Drizzle asparagus with olive oil, salt, pepper, garlic: Line a roasting pan with foil. Arrange the asparagus spears in a single layer on the lined roasting pan.', 'Drizzle with olive oil and rub the spears all over with the olive oil to coat. Sprinkle with salt, pepper, and minced garlic, and rub over the asparagus spears to evenly distribute.', '3 Roast in oven: Roast at 400\\xc2\\xb0F (205\\xc2\\xb0C) for 10 minutes, more or less, depending on your particular oven and how thick the spears are, until the asparagus are just lightly browned and tender when you pierce them with a fork.', '4 Drizzle with lemon juice or balsamic to serve: To serve, drizzle with fresh lemon juice or balsamic vinegar, and if you want, a sprinkling of grated Parmesan cheese (skip if cooking vegan).']",5
92,Asparagus Frittata Recipe,15,20,35,"['2 tablespoons unsalted butter', '1/2 cup sliced shallots', '1 pound thin spear asparagus, tough ends snapped off, spears cut diagonally into 1-inch lengths', '6 large eggs', '3/4 cup ricotta cheese (can sub cottage cheese)', '1/2 teaspoon salt', '1 Tbsp minced fresh chives', '1/4 teaspoon dried tarragon', '1 cup shredded Gruyere or Swiss cheese (can sub an Italian blend)']",9,"['1 Cook shallots in butter: Heat butter into a 10-inch oven-proof frying pan over medium heat.', 'Add shallots and cook, stirring occasionally, until they soften and turn translucent, about 3 minutes.', '2 Add asparagus and cook for an additional 3 minutes.', '3 Add egg mixture: Beat the eggs, ricotta cheese together, and salt, stir in the chives and tarragon.', 'Pour the egg mixture into the pan and cook until almost set, but still runny on top, about 4 to 5 minutes. While cooking, pre-heat oven broiler.', '4 Top with cheese and broil: Sprinkle Gruyere cheese over the eggs and put in oven to broil until cheese is melted and browned, and the center is set, about 6 to 8 minutes.', 'Remove pan from oven with oven mitts and slide frittata onto a serving plate. Cut into wedges. (Be very careful with the hot pan handle! I usually ice down the handle of any long handled pan I take out of the oven so that no one mistakenly tries to pick up the pan by the hot handle.)']",7
93,Flank Steak Stir Fry with Asparagus and Red Pepper Recipe,15,25,40,"['3 Tbsp canola or peanut oil', '1/2 lb asparagus, trimmed, cut on the diagonal into 1 1/2 inch lengths (about 1 1/2 cups)', '1 lb of flank steak, sliced in half lengthwise (along the grain) and then cut into thin strips (across the grain), 2 inches long and 1/4 inch wide (put the steak in the freezer for 15 minutes before slicing to make it easier to slice)', '1 red bell pepper, seeded, de-ribbed, and cut into thin strips 2 inches long and 1/4 inch wide', '2 teaspoons of cornstarch dissolved into 3 Tablespoons of water', 'Stir Fry Sauce', '3 Tbsp soy sauce (use gluten-free soy sauce for gluten-free version)', '1 teaspoon finely chopped, peeled, fresh ginger', '1 small clove garlic, minced', '1 green onion, including green tops, chopped', '1/2 teaspoon chili oil']",11,"['1 Blanch the asparagus: Fill a medium sized saucepan halfway with water and bring to a boil. Blanch the cut asparagus for 2 minutes. Drain, rinse with cold water to stop the cooking, and set aside.', '2 Assemble stir fry sauce: In a small dish, stir together the stir fry sauce ingredients\\xe2\\x80\\x94soy sauce, chopped ginger, minced garlic, chopped green onion, chili oil\\xe2\\x80\\x94and set aside.', '3 Stir fry asparagus: Heat 1 tablespoon of oil in a wok (or a thick-bottomed pot that can handle high heat) on high heat until shimmery. Add the asparagus and fry, stirring constantly, for 2 minutes or until lightly browned. Remove the asparagus from the pan and set aside.', '4 Stir fry beef strips: Heat another tablespoon of oil in the pan on high heat until shimmery. Stir fry the beef strips in batches, for 2 to 3 minutes per batch, until they are browned but still a little pink inside.', '5 Stir fry bell pepper: Return the first batches of beef strips to the pan along with the bell pepper strips. Stir and toss over high heat until the bell pepper strips are just beginning to wilt, 1-2 minutes.', '6 Add cornstarch slurry and stir fry sauce: Quickly stir the cornstarch liquid and add it to the pan along with the stir fry sauce. Cook until sauce thickens, 1-2 minutes.', 'Return the asparagus to the pan, toss to evenly coat and serve with steamed white rice (unless you are going low-carb, in which case, leave out the rice).']",7
94,Asparagus Risotto Recipe,10,35,45,"['About 4 cups chicken stock (or vegetable stock for vegetarian option)', '2 Tbsp unsalted butter, divided', '1/2 cup chopped shallots', '1 cup arborio rice', '1/4 cup dry white wine (or 1 Tbsp lemon juice and 3 Tbsp water)', '1/2 pound asparagus, trimmed, tips cut off, tough skins of the spears peeled (if working with thick apparatus spears), and the spears cut into thin disks', '1/2 cup freshly grated Parmesan cheese', 'Salt and pepper']",8,"['1 Heat the stock: Heat the stock in a small saucepan until it comes to a low simmer.', '2 Cook shallots in butter to soften, then add rice: In a separate 3 or 4 quart saucepan, heat 1 tablespoon butter on medium heat. Add the shallots and cook for a minute or two, until translucent. Add the arborio rice and cook for 2 minutes more, stirring until nicely coated.', '3 Add the white wine: Add the white wine. Slowly stir, allowing the rice to absorb the wine.', '4 Add the stock, 1/2 cup at a time, adding only after the previous addition has been absorbed by the rice: Once the wine is almost completely absorbed, add 1/2 cup of hot stock to the rice. Continue to stir until the liquid is almost completely absorbed, adding more stock in 1/2 cup increments. Stir often to prevent the rice from sticking to the bottom of the pan.', 'Continue cooking and stirring rice, adding a little bit of broth at a time, cooking and stirring until it is absorbed, until the rice is tender, but still firm to the bite, about 20-25 minutes.', '5 Add the asparagus: With the last ladle of stock, add the asparagus. Stir and cook for a couple of minutes, until the risotto has absorbed the stock, but is still loose, and the asparagus are just cooked through.', 'Note the stock amount given is approximate. You may need a little more or less. If you end up needing more stock and you find yourself without, just use water.', '6 Stir in the Parmesan, remaining butter, add salt, pepper: Turn off the heat. Gently stir in the Parmesan cheese and the remaining 1 tablespoon butter. Add salt and pepper to taste. Serve immediately.']",8
95,Ham and Asparagus Quiche Recipe,90,30,120,"['1 recipe pie dough, enough for one bottom crust (see P\\xc3\\xa2te Bris\\xc3\\xa9e recipe)', '2 tablespoons extra virgin olive oil', '2 medium shallots, thinly sliced', '10 ounces asparagus spears, cut on the diagonal into 1-inch long pieces', '1/2 pound ham, cut into 1/4-inch cubes', 'Freshly ground pepper', '1/2 cup milk', '1/2 cup heavy cream', '3 large eggs', '6 ounces Gruy\\xc3\\xa8re cheese, grated (1 1/2 cups)', 'Special equipment:', '10-inch tart pan']",12,"['1 Roll out dough and fit into tart pan, then freeze: On a lightly floured surface, roll out dough into a 12-inch circle. Fit into a 10-by-1 1/2-inch round tart pan (with or without a removable bottom), pressing dough into corners. Transfer to freezer to chill for 30 minutes.', '2 Pre-bake tart crust: Preheat oven to 350\\xc2\\xb0F. Line pastry with aluminum foil, pressing into the corners and edges. Fill to the top with baking weights \\xe2\\x80\\x94 sugar, dried beans, or rice.', 'Bake for 45 minutes. Lift sides of aluminum foil to remove pie weights from tart pan. Move pre-baked crust to a wire rack to cool while making filling. (See How to Blind Bake a Pie Crust for more details on this step.)', '3 Cook shallots and asparagus: Heat oil in a large nonstick skillet over medium high heat. Add shallots, and cook, stirring, until translucent but not brown, about 1 minute.', 'Add asparagus. Cook, stirring frequently, until asparagus are just cooked (al dente), slightly browned, firm, not mushy, 8 to 10 minutes.', '4 Assemble quiche: Increase oven temperature to 375\\xc2\\xb0F. Place tart pan on a baking sheet to catch any run-off there might be (especially if you are using a pan with a removable bottom.)', 'Sprinkle half the cheese evenly over the bottom of the crust. Spread asparagus and ham over the cheese and then top with remaining cheese.', 'In a medium bowl, whisk together milk, cream, and eggs. Season with fresh ground pepper. Pour over cheese.', '5 Bake: Transfer to oven, and bake at 375\\xc2\\xb0F until just set in the center, 30 to 35 minutes. Cool on a wire rack for about 10 minutes before slicing.']",9
96,How to Cook Asparagus Sous Vide Recipe,5,10,15,"['1 bunch asparagus, about 1 pound', '1/2 teaspoon black pepper', '2 tablespoons olive oil or unsalted butter', 'Zest and juice of one lemon', 'Sea salt for garnish', 'Special equipment:', 'Sous vide immersion circulator', 'Gallon-sized zip-top freezer bags']",8,"['You can do this in the pot of water as it heats\\xe2\\x80\\x94just be careful if the water is already steaming!', '4 Cook the asparagus: Once the water has come up to temperature, submerge the bag of asparagus in the pot of water. Make sure the bag is completely submerged (if it floats, remove it from the water and add a few more spoons to weigh it down).', '* Check the asparagus after 6 to 7 minutes if it\\xe2\\x80\\x99s pencil thin.', '* Check average or thick asparagus after 8 to 10 minutes.', 'If you\\xe2\\x80\\x99re at all in doubt, pull them out after 8 minutes, open the bag carefully, and use a fork to determine how tender the spears are. If the fork is getting stuck in the asparagus, it\\xe2\\x80\\x99s not ready; reseal the bag and return it to the water for another minute or two.', '5 Serve: Remove from the water, turn off the circulator and serve immediately. Sprinkle some lemon juice and zest over the top of the asparagus, along with some of the cooking oil or butter (if desired) and some flaky sea salt, such as Maldon.', 'Leftover asparagus will keep refrigerated for about 5 days.']",7
97,Steamed Asparagus with Hollandaise Sauce Recipe,5,15,20,"['1 bunch of asparagus (about 1 lb)', '10 Tbsp unsalted butter (1 stick plus 2 Tbsp)', '3 egg yolks', '1 Tbsp lemon juice', '1/2 teaspoon salt (skip if using salted butter)', 'Pinch of cayenne']",6,"['1 Prep the asparagus: Break off the tough ends with your fingers. Bend the asparagus spears near the end and they will break naturally where the spear is no longer tough.', 'For an elegant presentation of the spears, use a vegetable peeler to peel off a very thin layer of the outer skin of the lower two to three inches of the asparagus spears.', 'Prepare a large, shallow pan (with a cover) with a half inch of water and a steamer rack.', '2 Prepare the Hollandaise sauce: Melt the butter in a small pot. Put the egg yolks, lemon juice, salt and cayenne into a blender.', 'Blend the eggs for 20-30 seconds at medium to medium high speed until lighter in color.', 'Turn blender down to lowest setting and slowly drizzle in the hot melted butter while the blender is going. Continue to blend for a few seconds after all of the butter is incorporated.', 'Taste the sauce and add more salt or lemon juice if needed. Keep warm while you are steaming the asparagus.', '3 Steam the asparagus: Bring the water in your steaming pan to a boil. Place the asparagus on the steaming rack. Cover.', 'Steam for 3 to 5 minutes, until tender, but still a little crisp, definitely not mushy. The timing depends on how thick the asparagus spears are.', '4 Serve: To serve, plate the asparagus. Pour Hollandaise sauce over them.']",10
98,Breakfast Casserole with Leeks and Asparagus Recipe,15,90,105,"['3 slices thick-sliced bacon (about 3 ounces), cut into 1/2-inch pieces', '1 pound of asparagus, trimmed of woody ends, cut into 1/2-inch diagonal pieces', '6 slices of bread, cut into 1 1/2 inch wide square pieces, including crusts', '2 leeks, cleaned, cut in half lengthwise, sliced crosswise into 1/2-inch pieces, white and light green parts only, about 2 cups total', '2 Tbsp butter, divided 1 Tbsp and 1 Tbsp', '1/2 cup of crumbled feta cheese', '8 eggs', '2 cups milk', '1/2 teaspoon of dried herbes de provence (can sub dried tarragon or thyme)', '1 teaspoon kosher salt', '1/8 teaspoon freshly ground black pepper', '1/4 cup of freshly grated Parmesan cheese']",12,"['1 Place bacon in a medium skillet on medium heat. Gently cook, turning occasionally, until the bacon pieces are lightly browned and much of the bacon fat has been rendered, about 10-12 minutes. Remove cooked bacon from the pan with a slotted spoon, leaving the rendered bacon fat in the pan.', '2 While the bacon is cooking, cut up the bread. If the bread is a little stale, great. If it is fresh, then spread it out on a baking sheet and heat it in a 200\\xc2\\xb0F oven for about 10-15 minutes to help it dry out a bit. This will help the keep the bread from disintegrating when mixed with the eggs later.', '3 Bring a small pot of water to a boil. Add the cut asparagus and blanch for 1 minute. Remove the asparagus from the pot to a bowl of ice water. Let cool in the ice water and then drain.', '4 Once the bacon is done and removed from the pan add a tablespoon of butter to the pan with the remaining bacon fat. Add the leeks and gently cook on medium to medium low heat for 10-12 minutes until the leeks are softened, but not browned. Do not let brown.', '5 In a large bowl, whisk together the eggs, milk, crumbled feta cheese, herbes de provence, salt, and pepper.', '6 Place the bread pieces into the egg milk mixture and press down so that the bread becomes completely saturated with the mixture. Add the asparagus and leeks and gently mix to combine, taking care to not break up the bread.', '7 Preheat oven to 350\\xc2\\xb0F. With the remaining tablespoon of butter, butter the insides of a 9x13-inch casserole dish. Sprinkle the bacon over the bottom of the dish. Gently pour the filling mixture into the casserole. Top with Parmesan cheese. Push the grated Parmesan down a bit into to the top of the casserole so that it gets moistened. (At this point you can make the night before, refrigerate and bake the next morning.)', '8 Bake, uncovered, for 45 minutes or until the top is lightly browned and the custard is cooked through. If the top is getting too brown before the custard is done, you can tent it with foil. Remove from oven and let cool for 5 minutes before cutting to serve.']",8
99,Asparagus with Lime and Mint Recipe,5,10,15,"['1 pound of asparagus, trimmed', '1 1/2 tablespoons of extra virgin olive oil', 'Kosher salt', 'Fresh ground pepper', '1-2 fresh limes (yielding a total of 1 1/2 Tablespoons of juice)', '1 teaspoon of fresh mint, chopped or cut in a chiffonade*', '*To chiffonade mint, stack a few leaves, roll leaves up like a cigar, starting at one end, make your way down the roll, making thin slices.']",7,"['1 Saut\\xc3\\xa9 asparagus: Heat the oil in a wide saut\\xc3\\xa9 or frying pan on medium-high. When the oil is hot, add the asparagus and sprinkle with salt and pepper to taste, cooking for about 5-6 minutes until just cooked through, but still with some firmness.', '2 Sprinkle with lime juice and mint: Put on a plate and squeeze lime juice over the asparagus and sprinkle on the mint.']",2
100,Asparagus Quiche with Fontina Cheese Recipe,30,100,130,"['1 9-inch pie crust, chilled for 30 minutes and ready to roll out', 'Flour (for sprinkling)', '1 pound (445 g) fresh asparagus', '1/4 pound Fontina cheese, cut into 1/4-inch cubes', '4 large eggs, lightly beaten in a large bowl', '1 cup heavy cream', '1/2 teaspoon salt', '1/4 teaspoon black pepper', 'Special equipment:', '9 1/2- or 10-inch porcelain or metal tart pan', 'Pie weights or dried beans for baking']",11,"['1 Roll out the pie crust: Roll out the pie crust on a lightly floured counter to an 11-inch round, moving it often to prevent it from sticking.', 'Lift it onto the rolling pin and gently ease it into a 9 1/2 or 10-inch porcelain tart pan. Press the dough all around the bottom edge so it sticks to the pan. With scissors, cut the pastry around the top edge so it has an even 1-inch overhang.', '2 Crimp the dough: Tuck the overhang inside the pan all around, like a hem. Crimp the top edge with your fingers.', '3 Chill the pie crust: Set the pie crust on a rimmed baking sheet. Cover loosely with plastic wrap and freeze for 1 hour. (At this point, you can freeze it overnight, loosely covered; if you want to freeze for up to 1 month, wrap tightly after the crust is frozen).', '4 Blind bake the pie crust: Heat the oven to 375F. Prick the dough all over with a fork. Line the dough with parchment paper or crumpled foil, and fill with pie weights or dried beans.', 'Bake for 12 to 15 minutes, or until the top edge of the pastry is beginning to take on some color. Lift off the paper or foil and beans, and set aside. Return the pie crust to the oven and continue baking for 5 to 10 minutes, or until the bottom of the dough is beginning to cook through. If the dough forms puffs, prick them with the tip of a knife.', 'Set on a wire rack to cool. Leave the oven on.', '5 Prepare the asparagus: Snap off the dry and woody part of the spears near the base, where they break without much effort. Cut the spears into 1-inch pieces.', 'Bring a saucepan of water to a boil. Add the asparagus and cook for 1 minute. Drain and transfer the asparagus to ice water to cool.', 'Dry the asparagus with paper towels. Set aside 3 asparagus tips to garnish the quiche. Halve the remaining pieces lengthwise.', '6 Finish the filling: Scatter the blanched asparagus (not the tips) and Fontina over the bottom of the cooled pie crust. Thoroughly stir the cream into the eggs, add salt and pepper, and pour the egg mixture over the asparagus and cheese.', '7 Bake the quiche: Return the pan to the oven and bake for 35 to 40 minutes, or until the filling is set all over and the top is starting to brown. Set on a wire rack to cool completely.', '8 Serve: Garnish the top of the quiche with the reserved asparagus tips before serving.', 'The quiche can be served immediately, or once cool, cover and refrigerate for up to 5 days. Quiche can be served cold, room temperature, or warm. (If serving warm, heat in a 300F oven until just warm to the touch.)']",14
101,Pesto Pasta with Spinach and Avocado Recipe,10,15,25,"['12 ounces of fusilli pasta', 'Salt', '2 cups packed (about 2 1/2 ounces) chopped fresh baby spinach leaves', '6 to 8 Tbsp prepared basil pesto', '1 to 2 Tbsp red wine vinegar', '1/2 teaspoon freshly ground black pepper (more or less to taste)', '1/2 cup peas (defrosted if frozen)', '1 whole ripe (but not overly ripe) avocado, peeled and chopped']",8,"['1 Cook the pasta: Bring a large pot of salted water (3 quarts water, a tablespoon of salt) to a rolling boil. Add the dry pasta to the boiling water, stirring occasionally  to keep it from sticking to the bottom of the pot.', 'Cook in rapidly boiling water until al dente, cooked through, but still a bit firm to the bite. The amount of time will depend on your package of pasta, anywhere from 8 to 12 minutes.', '2 Add hot pasta to chopped fresh spinach: Place the chopped spinach at the bottom of a large bowl. When the pasta is done, scoop out about a half cup of the pasta cooking water and set aside. Drain the pasta and put the hot drained pasta on top of the chopped spinach in the bowl. Toss to mix. The heat of the pasta will help wilt the spinach leaves.', '3 Stir in the pesto, add some pasta cooking water, vinegar, salt, and pepper: Stir in the pesto, so that the pasta is well coated. Add in a little of the pasta cooking water you set aside to loosen the pasta a bit. Sprinkle in 1 tablespoon of the red wine vinegar, a half teaspoon of salt, and a half teaspoon of black pepper.', '4 Add peas and avocado: Stir in the peas, and gently fold in the chopped avocado. Taste and add more salt, vinegar, and or pepper if needed.', 'Serve slightly warm or at room temperature.']",6
102,Pan Seared Salmon with Avocado Remoulade Recipe,10,15,25,"['2 large avocados, cut and peeled', '3 tablespoons freshly squeezed lime juice (can substitute lemon)', '3-4 tablespoons extra virgin olive oil', '1 tablespoon minced shallots or green onion', '1 tablespoon minced parsley', '1 teaspoon Dijon mustard or to taste', 'Salt and pepper to taste', '1 to 1 1/2 pounds of salmon fillets']",8,"['1 Make avocado remoulade sauce: Put avocado pieces and lime juice into a food processor or blender and pulse until blended.', 'Slowly add olive oil, pulsing, until you reach desired consistency of sauce.', 'Add minced shallots (or green onions) and parsley, pulse just until combined.', 'Remove to a bowl, add mustard, salt and pepper to taste.', '2 Saut\\xc3\\xa9 salmon fillets: Heat a tablespoon of oil in a saut\\xc3\\xa9 pan on medium high heat.', 'Season both sides of the salmon fillets with salt and pepper. Place the fillets in the hot pan and lower the heat to medium.', 'If your fillets are skin-on, you can either place the fillets in the pan skin-side up or skin-side down. If you first place the fillets skin-side up, the fillets will be easier to turn over without falling apart, because the raw skin will help hold the fillet together. If you place the fillets in the pan skin-side down to start, this will help crisp up the skin, which can be a tasty treat on its own.', 'Cook the salmon until about medium doneness, about 3-4 minutes per side.', '3 Serve: Serve salmon with avocado remoulade sauce.']",9
103,Avocado Beet Salad with Citrus Vinaigrette Recipe,20,40,60,"['4 medium-sized beets (any color), green tops removed, beets scrubbed clean', '1 just ripe avocado', '4 ounces mixed green lettuces', '2 tablespoons pistachios, chopped', 'Citrus Vinaigrette:', '1 tablespoon minced shallot', '2 tablespoons rice vinegar (unseasoned)', '1 tablespoon fresh lemon juice', '1 tablespoon fresh orange juice', '2 teaspoons lemon zest', '1 teaspoon orange zest', 'A Pinch of salt', '1/3 cup good quality extra virgin olive oil']",13,"['1 Cook the beets: Place beets in a medium saucepan and cover with an inch of water. Bring to a boil and reduce heat to maintain a low simmer for 30 to 40 minutes, depending on the size of the beets, until easily pierced with the tines of a fork.', '2 Make the vinaigrette: Whisk together the citrus vinaigrette ingredients in a small bowl.', '3 Toss the beets in vinaigrette: When the beets are done, drain them, and peel off the outer skin. Cut the beets in half, and the halves into wedges.(Tip: use a plastic cutting board when cutting red beets. Red beets will stain wooden cutting boards.)', 'Place the beet wedges in a bowl and toss with a tablespoon of the vinaigrette.', '4 Cut and peel the avocado, cut the avocado into wedges (see how to peel and cut an avocado).', '5 Arrange the salad: Toss the salad greens with a half of the citrus vinaigrette. Arrange the dressed greens on serving plates.', 'Arrange the beet wedges and avocado wedges on top of the salad greens. Sprinkle with chopped pistachios. Drizzle remaining vinaigrette over the salads.']",7
104,Baked Salmon with Avocado Mango Salsa Recipe,20,10,30,"['Extra virgin olive oil', '4 6-ounce salmon fillets', 'Salt', 'Freshly ground black pepper', '2 small or 1 large mango, not overly ripe (1 to 1 1/2 pounds of mango)', '2 just ripe avocados', '1/4 cup minced red onion', '1 serrano chile, minced (with seeds for more heat, without for less)', '2 limes, juiced (about 4 Tbsp lime juice)']",9,"['1 Preheat oven to 400\\xc2\\xb0F.', '2 Prep the mangos: While the oven is preheating, prep the mangos.  Either peel and then cut away the mango flesh from the core seed, and then cut the mango into 1/3-inch cubes, or follow the instructions here on How to Cut a Mango. Set the cut mango aside in a medium bowl.', '3 Bake the salmon fillets: Line a roasting pan with aluminum foil. Spread some olive oil on top of the foil. Coat the salmon fillets with olive oil and lay, skin side down, on the foil lined roasting pan.  Sprinkle with salt. Place in the 400\\xc2\\xb0F oven and cook for 10 minutes.', '4 Make the avocado mango salsa: While the salmon is cooking, prep the avocados. Cut the avocados in half. Remove the seeds. Score the inside of the avocados with a small knife in a cross hatch pattern. Scoop out the avocado pieces and add them to the bowl with the cut mango pieces. (See How to Cut and Peel and Avocado.)', 'Add the minced red onion, serrano chile, and lime juice to the bowl. Sprinkle with a little salt. Gently fold the ingredients together.', 'Serve the salmon fillets with a generous portion of avocado mango salsa.']",6
105,Spaghetti Pasta Carbonara Recipe,10,20,30,"['1 tablespoon extra virgin olive oil or unsalted butter', '1/2 pound pancetta or thick cut bacon, diced', '1-2 garlic cloves, minced, about 1 teaspoon (optional)', '3-4 whole eggs', '1 cup grated parmesan or pecorino cheese', '1 pound spaghetti pasta (or bucatini or fettuccine)', 'Salt and black pepper to taste']",7,"['1 Heat pasta water: Put a large pot of salted water on to boil (1 Tbsp salt for every 2 quarts of water.)', '2 Saut\\xc3\\xa9 pancetta/bacon and garlic: While the water is coming to a boil, heat the olive oil in a large saut\\xc3\\xa9 pan over medium heat. Add the bacon or pancetta and cook slowly until crispy.', 'Add the garlic (if using) and cook another minute, then turn off the heat and put the pancetta and garlic into a large bowl.', '3 Beat eggs and half of the cheese: In a small bowl, beat the eggs and mix in about half of the cheese.', '4 Cook pasta: Once the water has reached a rolling boil, add the dry pasta, and cook, uncovered, at a rolling boil.', '5 Toss pasta with pancetta/bacon: When the pasta is al dente (still a little firm, not mushy), use tongs to move it to the bowl with the bacon and garlic. Let it be dripping wet. Reserve some of the pasta water.', ""Move the pasta from the pot to the bowl quickly, as you want the pasta to be hot. It\\'s the heat of the pasta that will heat the eggs sufficiently to create a creamy sauce."", ""Toss everything to combine, allowing the pasta to cool just enough so that it doesn\\'t make the eggs curdle when you mix them in. (That\\'s the tricky part.)"", '6 Add the beaten egg mixture: Add the beaten eggs with cheese and toss quickly to combine once more. Add salt to taste. Add some pasta water back to the pasta to keep it from drying out.', 'Serve at once with the rest of the parmesan and freshly ground black pepper.', 'If you want, sprinkle with a little fresh chopped parsley.']",11
106,Baked Potato Soup Recipe,10,90,100,"['4 pounds russet potatoes (about 7 medium potatoes)', '1/4 pound thick sliced bacon, cut crosswise into 1/8-inch slices (lardons)', '1 large onion, finely chopped (about 2 cups)', '2 ribs celery, finely chopped', '6 cups chicken stock', '1 teaspoon kosher salt (more to taste)', '1/8 teaspoon of ground white or black pepper', '2 to 4 tablespoons heavy cream (optional)', 'Garnishes:', 'Grated sharp cheddar cheese', 'Sour cream', 'Minced chives', 'Crumbled bacon (from step 2 in method)']",13,"[""1 Bake the potatoes: Scrub the potatoes clean and poke them all over with the tines of a fork or paring knife (this is so they don't explode from internal pressure building up as they cook). Place on a foil lined baking sheet and bake at 400\\xc2\\xb0F for 1 hour, or until easily cut through with a knife."", 'Remove and let cool enough to handle. (To speed up cooling, slice them in half lengthwise.)', '2 Cook the bacon: Place bacon lardons in a large, thick bottomed Dutch oven (about 5 to 6 quart pot). Heat on medium high until the bacon starts to brown then lower the heat to medium.', 'Cook until the bacon has rendered most of its fat and the lardons are browned and crispy. Remove the cooked bacon and set aside.', 'Remove all but 1 tablespoon of bacon fat from the pan. (Do not discard bacon fat in your sink, it will clog the drain. Pour the fat into a jar and let it cool and solidify. Then either scoop it out and discard it or use it for another purpose.)', '3 Cook onion and celery in the bacon fat: Add the chopped onion and celery to the remaining bacon fat in the pot. Cook for 2 minutes on medium high, then lower the heat to low, and cover the pot. Let cook slowly on low heat for 15 to 20 minutes.', '4 Scoop out baked potatoes, add it and chicken stock to pot: When potatoes are cool enough to handle, scoop out the insides to a bowl. Then add it to the cooked onion and celery mixture along with 6 cups chicken stock. Add a teaspoon of kosher salt.', 'Bring the soup to a simmer and reduce the heat to low.', 'Use a potato masher to mash the potatoes into the stock.', '5 Pur\\xc3\\xa9e some or all of the soup: Cook the potato soup for about 5 minutes, then use an immersion blender to pur\\xc3\\xa9e about half of the soup if you want a slightly chunky soup, or pur\\xc3\\xa9e all of it if you want a smoother soup.', '6 Add cream: Stir 2 to 4 tablespoons of heavy cream into the soup if you want a creamier soup. Add more salt and pepper to taste.', '7 Top with grated cheddar, sour cream, chives, bacon: Pour into bowls and top with grated cheddar, sour cream, chives, and crumbled crispy bacon.']",12
107,Brussels Sprouts with Bacon and Chestnuts Recipe,15,15,30,"['1 pound Brussels sprouts', '1/3 pound thick-sliced bacon or slab bacon, cut into 1/4-inch pieces or batons', '1 red onion, chopped', '20-25 canned roasted chestnuts, quartered or roughly chopped', '1/4 cup chicken stock', 'Salt and pepper to taste', 'Lemon wedges to serve']",7,"['1 Prep the Brussels sprouts: Cut the Brussels sprouts in half and slice thinly, starting at the top of the sprout and working back toward the stem. Discard the hard tip of the stem side.', '2 Cook the bacon: Cut the bacon into pieces about 1/4 inch wide and put them in a large saut\\xc3\\xa9 pan over medium heat.', 'When the bacon is browned, remove with a slotted spoon and set aside.', '3 Cook the onions in bacon fat, add back the bacon:  Remove all but 1 tablespoon of the bacon fat (do not put down the drain, see how to render bacon fat). Turn up the heat to high, add the red onions. Cook until the onions begin to brown, add back the bacon.', '5 Add chestnuts, Brussels sprouts, stock: Add the chestnuts and Brussels sprouts to the saut\\xc3\\xa9 pan with the bacon and onions. Add the chicken stock and toss to combine. Stir in about 1 teaspoon of salt, more or less to taste. Cook over high heat for 3-4 minutes. Add pepper to taste.', 'Serve hot with lemon wedges. Squeeze a little lemon juice over the sprouts right before you eat them.']",6
108,Braised Red Cabbage with Chestnuts Recipe,10,60,70,"['2 strips thick-cut bacon (about 3 ounces) cut crosswise into 1/4-inch strips', '1 medium onion, thinly sliced', '1 red cabbage head, about 2 pounds, quartered, tough core removed, quarters sliced into 1/4-inch thick slices', '1 large green tart apple', '1/2 cup apple cider vinegar', '2 tablespoons balsamic vinegar', '6 tablespoons sugar', '1/2 teaspoon salt, more to taste', 'Freshly ground pepper', '8 ounces canned or jarred roasted chestnuts (NOT water chestnuts), roughly chopped']",10,"['1 Cook the bacon: Cook the bacon batons slowly in a large saut\\xc3\\xa9 pan (with cover) on medium low heat until most of the fat has rendered out, and the bacon is lightly browned, not crisp.', '2 Add onions: Add the sliced onions, increase the heat of the pan to medium high and cook, stirring often, until the onions have softened and lightly browned.', '3 Add cabbage, apples, vinegars, sugar: While the onions are cooking, peel the apple and cut it into 1/2-inch thick pieces. Once the onions are ready, add the sliced cabbage, chopped apple, cider vinegar, balsamic vinegar, and sugar. Carefully toss to combine. Bring to a simmer, cover the pan, lower the heat, and simmer until the cabbage is cooked through and soft, about 40 minutes.', '4 Add chestnuts: Uncover the pan. Add the chopped roasted chestnuts. Add salt and pepper to taste. Increase the heat to boil off excess moisture for a few minutes.', 'Serve hot.']",5
109,Sauerkraut with Bacon and Apples Recipe,10,30,40,"['1/4 pound sliced apple-wood smoked bacon', '2 tart apples, such as Granny Smith, peeled, cored, and grated', '1 yellow onion, finely chopped', '2 cloves garlic, minced', '1 teaspoon caraway seeds, ground', '3 cups unfiltered apple juice', '1/4 cup white wine vinegar', '2 pounds of refrigerated (in a jar, not can), prepared sauerkraut, drained (about 1 24-fluid-ounce jar, drained)']",8,"['1 Cook and chop the bacon: Lay the slices of bacon down at the bottom of a large, thick-bottomed pot and heat on medium heat. Cook until the bacon has browned and most of the bacon fat has been rendered, 5 to 10 minutes.', 'Remove the bacon from the pot and set on paper towels to drain. Remove all but 1 Tbsp of the fat in the pot. (Do not pour down the sink, bacon fat will clog your drain!) Chop the bacon and set aside.', '2 Cook onions, apples, then add garlic, caraway: Add the chopped onions and apples to the pot and cook until the onions are translucent, about 6-7 minutes. Add the garlic and caraway and cook for a minute more.', '3 Add apple juice and vinegar, then boil: Add the apple juice and the white vinegar to the pot. Increase the heat to high. Bring to a boil and boil vigorously until the liquid is reduced to a syrup, about 5 minutes.', '4 Add the sauerkraut and bacon to the pot and stir to coat with the sauce. Reduce the heat to low and cook until the sauerkraut has been heated through and is tender, about 10 minutes. Season to taste with salt and pepper.']",5
110,"Pasta Salad with Corn, Bacon, and Buttermilk Ranch Dressing Recipe",15,15,30,"['8 ounces orecchiette pasta', 'Salt for pasta water', '4 ounces bacon (about 4 strips)', '1 3/4 cup fresh or frozen corn kernels', '3/4 cup green onions, thinly sliced (from about 6 green onions)', '3/4 cup diced red bell pepper', '1/4 cup coarsely chopped fresh basil', '1/3 cup of buttermilk ranch dressing', 'Salt and pepper to taste']",9,"['1 Cook the pasta and corn: Heat 2 quarts of water in a large pot until boiling. Add 1 tablespoon of salt. Add the pasta and boil uncovered at a rolling boil until al dente.', 'About 1 minute before the pasta is ready, add the corn to the boiling pasta water with the pasta.', 'Drain the pasta and corn, and set aside.', '2 Cook the bacon: Cut the bacon into 1/2 inch pieces. Put in a frying pan and heat on medium. Cook until the fat has rendered and the bacon is well browned. Remove bacon to a paper towel lined plate.', 'Note: Do not pour rendered fat down your kitchen sink unless you really like your plumber. Pour it into a jar to use for another cooking purpose or discard.', '3 Combine the ingredients to make the salad: In a large bowl add the drained, cooled pasta and corn, the bacon, and the remaining ingredients. Toss with with dressing. Add more salt and pepper to taste.', 'Great served with grilled chicken or steak.']",7
111,"Saut\xc3\xa9ed Chestnuts, Onions, and Bacon Recipe",5,25,30,"['1/2 pound thick-sliced slab bacon or pancetta, cut crosswise into 1/4-inch strips', '1 pound pearl onions, scant 1 inch in diameter', '1 pound peeled, roasted chestnuts (vacuum-packed*, jarred without sugar*, or freshly roasted)', '2 tablespoons honey', 'Kosher salt and freshly ground black pepper', '1 tablespoon chopped fresh flat-leaf parsley leaves, for garnish', '*Vacuum-packed or jarred are preferred over freshly roasted.']",7,"['1 Cook the bacon: In a large skillet, cook the bacon over medium-low heat, stirring often, until the fat has rendered and the meaty bits start to crisp, about 12 minutes. Transfer to paper towels to drain.', '2 Blanch and peel the onions: Meanwhile, fill a bowl with ice and water and set aside. Bring a medium saucepan of water to a boil. Drop in the onions and blanch for 30 seconds. Scoop them out with a slotted spoon and plop them into the ice water. To peel the onions, snip off the tip and remove the papery outer layers. Set aside the onions.', '3 Saut\\xc3\\xa9 onions in bacon fat: Raise the heat under the skillet to medium, plonk in the onions, and saut\\xc3\\xa9 in the bacon fat, stirring occasionally, until spotted with brown and cooked through, 8 to 10 minutes.', ""4 Add chestnuts, bacon, honey: Add the chestnuts, cooked bacon, and honey and toss to warm through, being careful not to break the nuts--they're fragile."", 'Season with salt and plenty of pepper and then scoop into a decorate bowl. Sprinkle with the parsley.']",5
112,Roasted Cabbage with Bacon Gremolata Recipe,15,60,75,"['For the cabbage:', '1 medium-sized head of cabbage (about 1 1/2 pounds)', '2 tablespoons olive oil', '1/2 teaspoon salt', 'Freshly ground black pepper', 'For the bacon gremolata:', '3/4 cup roasted unsalted almonds', '4 strips (about 1/4 pound) good-quality thick-cut bacon', '3 tablespoons minced fresh parsley', '1 teaspoon freshly grated lemon zest', 'Pinch of kosher salt', 'To serve:', 'Freshly grated Parmesan cheese']",13,"['1 Heat the oven to 400F. Arrange two oven racks in the upper and lower third of the oven.', ""2 Slice the cabbage: Peel off one or two of the thin, limp outer layers of the cabbage. Trim the stem so that it is flush with the bottom of the cabbage (if it isn\\'t already)."", ""Set the cabbage upright and slice into 1-inch thick slices. Don\\'t worry if a few of the outer layers unfurl or fall away."", '3 Brush the cabbage slices with olive oil: Use a pastry brush to cover both sides of the cabbage slices with olive oil, or use your fingers to rub the oil in. Season both sides with a little salt and pepper.', '4 Roast the cabbage: Arrange the cabbage slices in a single layer on a baking sheet. Roast on the lower oven rack for 35 to 45 minutes, flipping the slices halfway through cooking.', 'When done, both sides should be seared an even golden-brown with crispy edges and the center of the slices should be tender.', ""5 While the cabbage is roasting, prepare the bacon gremolata. If using unroasted almonds, arrange them on another sheet pan and roast in the upper part of the oven for about 10 minutes, until toasted and fragrant. Remove from the oven, cool briefly, then finely chop using a chef\\'s knife (or pulse a few times in a food processor, but be careful not to over process or you\\'ll make almond butter!)"", 'Cook the bacon in a skillet over medium heat until very crispy. Transfer to a plate lined with paper towels to drain. When cool, roughly chop.', 'Combine the chopped almonds, chopped bacon, minced parsley, lemon zest, and a pinch of kosher salt in a small mixing bowl. Toss to combine and set aside. (This bacon gremolata can be prepared ahead and kept refrigerated in an airtight container for about a week.)', '6 To serve: As soon as the cabbage slices are done roasting, transfer to a serving platter or individual plates. Sprinkle with a few spoonfuls of bacon gremolata and grated Parmesan cheese. Serve warm.']",10
113,BLT with Arugula Recipe,0,15,15,"['2-3 slices thick smoked bacon', '1-2 thin slices of a fresh, large tomato', '1-2 ounces (a couple handfuls) fresh baby arugula (can substitute watercress)', '2 slices of bread', 'Mayonnaise']",5,"['1 Cook the bacon: Heat a large saut\\xc3\\xa9 pan or cast iron pan on medium low heat. Lay the strips of bacon in a single layer on the pan. Slowly cook the bacon, rendering out the fat, until lightly browned on one side. Using a fork or tongs, turn the strips of bacon over to cook the other side.', 'When the bacon strips are sufficiently cooked remove from pan and place on a plate lined with a paper towel to absorb the excess fat.', 'Pour out excess fat from the pan (leaving about half a teaspoon in the pan) into a jar or a container to either dispose of or to store. (Never pour bacon grease down the sink, it will clog your pipes.)', '2 Wilt the arugula: In the same pan, add handfuls of fresh baby arugula or watercress. Toss in the remaining remaining fat. As soon as the greens start to wilt, remove from heat and remove from the pan to stop the cooking.', '3 Toast bread, build sandwich: Toast bread slices in a toaster. Spread mayonnaise (or your favorite spread, butter will do too) over the slices. Layer the sandwich with bacon, sliced tomato, and lightly wilted arugula. Cut on the diagonal.', 'Eat immediately.']",6
114,Hot Dogs with Pineapple Bacon Relish Recipe,15,15,30,"['1/4 pound thick cut bacon', '1/2 large red onion, chopped, about 1 cup', '2 cups finely chopped fresh pineapple (about 10 oz)', '1/4 cup chopped sweet pickles', '1 Tbsp sweet pickle juice', '8 hot dogs', '8 hot dog buns']",7,"['1 Pre-cook the bacon: Place the strips of bacon in a skillet on medium heat. Slowly cook the bacon, turning the strips over occasionally until much of the fat is rendered and the bacon is lightly browned. Remove the bacon strips to a paper towel lined plate.', '2 Saut\\xc3\\xa9 the onions: Pour off all but a teaspoon of the bacon fat (do this into a jar, do not pour down the drain or you will clog your pipes). Increase the heat to medium high and add the chopped onion. Cook, stirring occasionally until the onions are translucent, about 5 minutes. Remove from heat.', 'While the onions are cooking, finely chop the cooled bacon strips.', '3 Make pineapple bacon relish: In a large bowl stir to combine the bacon, onion, pineapple, and sweet pickles. Mix in a tablespoon of sweet pickle juice. You can make ahead at this point, chill until ready to serve with the hot dogs.', '4 Cook the hot dogs: Heat the hot dogs your favorite way. The hot dogs are already cooked when you buy them, so all you really need to do is heat them through.', 'Over a grill, grill for about 5 minutes on a medium flame, until lightly browned, and toast the buns for a minute if you wish.', 'Or, put the dogs in a saucepan and cover with water. Bring to a simmer and simmer for 5 minutes.', 'Or, pierce the hot dogs all over with a fork and put on a plate in the microwave for 20 to 30 seconds per hot dog.', '5 Assemble: Place a hot dog in a bun and top with a couple spoonfuls of relish.']",9
115,Cauliflower with Pine Nuts and Bacon Recipe,0,25,25,"['1 cauliflower head, cut into florets (see How to Cut and Core Cauliflower)', '1/4 cup pine nuts', '1/4 pound bacon or pancetta, cut into batons', '4-5 garlic cloves, sliced thin', '1-2 teaspoons dried oregano', '1-2 teaspoons red pepper flakes', 'Salt and black pepper to taste', 'Lemon juice to taste']",8,"['1 Boil cauliflower in salted water: Bring a large pot of salted water to a boil and cook the cauliflower for 5 minutes. Drain and set aside.', '2 Toast pine nuts: While the water is heating, toast the pine nuts in a dry saut\\xc3\\xa9 pan until lightly browned. Keep an eye on them, as pine nuts go from toasted to burnt quickly. Set the pine nuts aside when they are toasted.', '3 Fry bacon: Add the bacon to the pan and fry gently over medium heat until crispy. Remove the bacon and set aside with the pine nuts.', '4 Saut\\xc3\\xa9 the garlic for 1 minute on medium-high heat, then add the cauliflower, pine nuts, bacon, oregano and red pepper flakes. Toss to combine and saut\\xc3\\xa9 for 3-4 minutes, stirring often. Do not let the garlic burn.', '5 Turn off the heat and add salt and lemon juice to taste.']",5
116,How to Make Candied Bacon,5,25,30,"['12 strips bacon (not thick-cut, about one pound)', '1/4 cup light brown sugar', '1/2 teaspoon freshly ground black pepper (optional)', 'Special equipment:', '2 baking sheets', '2 oven-safe wire racks']",6,"['1 Prep the bacon: Preheat oven to 375\\xc2\\xb0 F with one rack in the top third and another rack in the bottom third of the oven. Line two baking sheets with foil, and place an oven-safe wire rack on each. Lay out the bacon strips perpendicular to the lines on the wire rack, divided between the two pans and making sure they don\\xe2\\x80\\x99t overlap. (If you lay them out parallel to the rack, the bacon may fall through the cracks while cooking!)', 'Sprinkle the bacon strips with brown sugar and (optionally) add some freshly ground black pepper. I like to use about 1 teaspoon of brown sugar per bacon strip, spreading it out along the length of the strip.', '2 Bake the candied bacon: Bake the bacon in the oven for 20 to 25 minutes. I recommend rotating the pans once during baking to ensure the bacon is cooking evenly. Start checking the bacon around 18 minutes, as some slices will cook faster, depending on the fat content and thickness of the slices.', 'The bacon is done when the brown sugar is melted and the bacon is a deep brown color. Remember that the bacon will continue to crisp up as it cools, so don\\xe2\\x80\\x99t worry if it\\xe2\\x80\\x99s not completely crispy now.', ""3 Cool the bacon: Let the bacon cool right on the wire rack for a few minutes. (If you eat it right away, you'll burn your mouth on the molten sugar.) The bacon will crisp up as it cools and as the melted sugar hardens. Then serve!"", '4 Store the bacon: Candied bacon can be kept in the fridge for a few days and reheats well in a skillet over low heat.', 'I don\\xe2\\x80\\x99t think candied bacon is worth freezing, although if you made a huge batch you absolutely could. You could just want to make sure to freeze the strips individually so they didn\\xe2\\x80\\x99t stick together.']",7
117,Gouda and Bacon Stuffed Mushrooms Recipe,10,30,40,"['1 pound white button mushrooms, thoroughly cleaned', '8 strips bacon (not thick cut)', '1/2 yellow onion, diced', '8 ounces gouda cheese, grated', '1/2 cup bread crumbs', '1/2 teaspoon dried thyme']",6,"['1 Preheat your oven to 400\\xcb\\x9aF.', '2 Cut the stems out of the mushrooms: Use a small paring knife to cut the stems out of each mushroom. Make a good-sized divot in the mushrooms, but make sure to leave enough mushroom around the edges to hold the filling. Finely dice the stems and cored bits.', '3 Cook the bacon: Meanwhile, add bacon to a medium or large skillet over medium heat. Cook until bacon is browned and crispy, about 6 to 7 minutes. Remove the cooked bacon, leaving the grease, and chop into tiny bits.', '4 Cook the filling ingredients: Add the chopped mushroom cores, diced onions, and thyme to the skillet with the reserved bacon grease. Saut\\xc3\\xa9 the filling ingredients over medium heat until the onions are soft, about 5 minutes. Remove from heat and stir in breadcrumbs and chopped bacon. Let cool.', '5 Add the gouda: After mixture has cooled slightly, stir in the grated gouda cheese.', '6 Stuff the mushrooms: Line up the cored mushrooms in a baking dish that has been lightly oiled to prevent sticking. Spoon about 2 heaping tablespoons of the filling into each mushroom, piling it high and packing it in. It\\xe2\\x80\\x99s okay if the mushrooms are almost overflowing. You should use all the filling!', '7 Bake the mushrooms: Bake the stuffed mushrooms for 20 minutes at 400\\xcb\\x9aF. Let cool slightly before serving.', 'Stuffed mushrooms can be made completely in advance and reheated in a 350\\xcb\\x9aF oven until warmed through. They keep fine in the fridge for up to 3 days.']",8
118,Easy Potato Soup with Bacon Recipe,20,30,50,"['6 strips bacon, chopped', '1 small yellow onion, diced', '2 stalks celery, diced', '2 medium carrots, peeled and diced', '1 parsnip, peeled and diced', '1/2 teaspoon salt', '1/4 teaspoon black pepper', '1/4 cup all-purpose flour', '2 cups whole milk', '2 cups vegetable or chicken broth', '1 1/2 pounds (3 cups) peeled and chopped Yukon Gold potatoes', 'Fresh chives, garnish', 'For the Crispy Skillet Croutons (Dad Add) ', '2 cups chopped bread, cut into 1/4-inch cubes', '2 tablespoons olive oil', '1/4 teaspoon dried thyme', 'Pinch of salt and pepper']",17,"['1 Make the skillet croutons: In a small bowl, toss chopped bread with olive oil, dried thyme, and a pinch of salt and pepper. Toast croutons in a nonstick skillet over medium heat for 4 to 5 minutes, stirring occasionally. It\\xe2\\x80\\x99s okay if the char on them becomes uneven. Some sides should be crunchy and some soft still. Remove and set aside.', '2 Cook the bacon: Add chopped bacon to a large pot over medium heat. Cook until fat renders out and bacon is crispy. Transfer the bacon to a plate lined with a paper towel and set aside as a topping for the soup. Reserve the bacon grease in the pot.', '3 Make the soup: Add onions, celery, carrots, and parsnips to pot. Season with salt and pepper and cook until vegetables soften, 3 to 4 minutes.', 'Stir in flour, cook for another minute, then add broth and milk. Slowly stir. Bring to a slight simmer, then add potatoes and simmer for about 15 minutes, or until potatoes are very tender.', '4 Blend half of the soup: When potatoes are very tender, remove half of the soup from the pot and let cool briefly. Blend until smooth and return to the pot, stirring it into the non-blended soup base.', 'Alternatively, blend half the soup directly in the pot with an immersion blender; be careful not to over-blend! Some chunks are good. Taste the soup and adjust seasoning to your liking. Keep warm until serving.', '5 Serve: Serve the soup topped with fresh chives, crispy reserved bacon, and skillet croutons.', 'Leftover soup keeps well in the fridge for up to a week, or you can freeze it for 3 months. Reheat gently on the stove with a splash of water.']",8
119,Grilled Cheese BLT Recipe,10,10,20,"['8 slices sourdough bread', '4 tablespoon unsalted butter, at room temperature', '8 ounces (2 cups) shredded cheddar cheese', '2 slicing tomatoes (such as beefsteak, Brandywine, or Cherokee purple), sliced 1/4-inch thick', '8 to 12 slices cooked bacon', '12 leaves butterhead or other crispy lettuce', 'Kosher salt and black pepper']",7,"['1 Melt the cheese: For each sandwich, spread 1 tablespoon butter on one side of two pieces of bread. Place the bread buttered-side down in a large skillet or on a griddle over medium-low heat. Sprinkle 2 ounces (1/2 cup) shredded cheese evenly over both slices. Cook until the cheese has melted and the bread is crisp, about 2 minutes.', '2 Assemble the sandwich: Remove from the skillet. Layer one side with 2 to 3 pieces of bacon, the slices from half a tomato seasoned with some salt and pepper, and 3 leaves of lettuce. Close the sandwich. Repeat for remaining sandwiches. Slice in half and eat warm.']",2
120,Baked Beans in Tomato Sauce Recipe,60,165,225,"['1 pound dry cannellini, borlotti or Great Northern beans', '1 tablespoon extra virgin olive oil', '1/4 pound bacon or pancetta, roughly chopped', '1/2 medium onion, chopped', '4 garlic cloves, chopped', '1 tablespoon fresh sage, minced (can sub fresh rosemary)', '1/2 to 1 teaspoon chile flakes (depending on how spicy you want it)', '2 tablespoons honey', '1/4 cup tomato paste', '1 15-ounce can crushed tomatoes or tomato sauce', '2 cups beef or chicken stock (use gluten-free stock for gluten-free version)', 'Salt', '1/2 cup chopped fresh parsley', '2 tablespoons balsamic vinegar']",14,"['1 Soak the beans in water: Pre-soak the beans, either by covering with two inches of water and soaking overnight, or by pouring boiling water over them and soaking them for an hour.', '2 Drain beans, cover with water, cook until tender: Drain the beans and put them in a medium-sized pot and cover with 2 inches of water. Bring to a simmer, cover, reduce the heat to a low simmer and cook until the beans are just soft enough to eat, about 1 hour, give or take 15 minutes or so, depending on how old the beans are (older beans will take longer to cook).', '3 Cook bacon or pancetta: Preheat the oven to 325\\xc2\\xb0F. In a 3 or 4 quart heavy-bottomed, oven-proof, lidded pot such as a Dutch oven, heat the olive oil over medium heat. Add the bacon or pancetta and cook slowly until lightly browned and crispy.', '4 Saut\\xc3\\xa9 onions: Add the chopped onions and increase the heat to medium-high. Cook, stirring often, until the onions begin to brown. Use a wooden spoon to scrape any browned bits off the bottom of the pot.', '5 Add garlic, chili flakes, sage, then add tomatoes and stock: Add the garlic, chile flakes and sage and cook for 1-2 minutes, then add the honey and tomato paste. Stir well to combine.', 'Add the tomatoes or tomato sauce and the stock. Bring to a simmer. Taste for salt and add some if needed.', '6 Add the beans, cover, cook in oven: Drain the beans and add them to the pot. Stir well.', 'Cover the pot and cook in a 325\\xc2\\xb0F oven for 1 hour and 15 minutes.', 'If still a bit wet, remove the cover and cook for 15 minutes more.', 'Note that the cooking time will depend on several things, the most important being how thoroughly the beans were cooked to begin with when they were simmered.', 'If the beans are still a bit hard when they go in the oven, it may take several hours to soften them, once the tomato and honey have been added.', '7 Stir in parsley and balsamic vinegar: Right before serving, gently stir in the chopped parsley and balsamic vinegar. Taste for salt, add more if needed to taste.', 'Serve either hot or at room temperature.']",13
121,Three Bean Baked Beans Recipe,7,75,82,"['1/4 pound sliced bacon', '2 cups chopped onion', '1 Tbsp dry mustard', '1 teaspoon minced fresh thyme (or 1/2 teaspoons dry thyme)', '3/4 cup ketchup', '3 tablespoons apple cider vinegar', '1/4 cup dark molasses', '1/3 cup water', '1 bay leaf', '1 15-ounce can red kidney beans, rinsed, drained', '1 15-ounce can black beans, rinsed, drained', '1 15-ounce can cannellini (white kidney beans), rinsed, drained', '1 teaspoon Tabasco', 'Salt', 'Freshly ground black pepper']",15,"['1 Preheat oven to 350\\xc2\\xb0F.', '2 Cook and crumble the bacon: Cook the bacon in a large Dutch oven over medium heat until browned and crisp. Remove bacon and place on paper towels to soak up excess fat. Crumble up the bacon and set aside.', '3 Saut\\xc3\\xa9 the onions: Remove all but a tablespoon of the bacon drippings from the pot. Add the chopped onions and cook on medium high heat until translucent, about 5 minutes.', '4 Add the rest of the ingredients: Sprinkle the onions with dry mustard and thyme. Stir in the ketchup, vinegar, molasses, bay leaf, beans, Tabasco, and water. Add salt and pepper to taste.', '5 Cover and bake: Cover the pot and put into a 350\\xc2\\xb0F oven. Bake for 1 hour, checking every 15 minutes to stir and add more water if needed. Stir in the bacon the last 15 minutes of cooking.', 'Alternatively, cook in a slow cooker 4 hours on high, or 8 on low.', 'Discard bay leaf before serving.']",7
122,Easy Stovetop Baked Beans Recipe,10,30,40,"['1/2 pound thick-cut bacon, cut crosswise into 1/4-inch wide strips', '1/2 peeled onion, stem intact', '4 (15-ounce) cans navy beans, rinsed and drained', '1 (8-ounce) can tomato sauce', '3 tablespoons molasses', '2 tablespoons brown sugar', '2 teaspoons dry mustard powder', '1 bay leaf', '1 teaspoon salt', '1 cup water']",10,"['1 Cook the bacon: In a large soup pot over medium heat, cook the bacon, turning often, for 5 minutes, or until browned. Pour off and discard about half the excess fat. Set aside about 1/4 cup bacon for garnish.', '2 Cook the beans: Add the onion half, drained beans, tomato sauce, molasses, brown sugar, mustard powder, bay leaf, salt, and water to the pot. Bring to a simmer over medium heat.', 'Cover the pot and simmer for 25 to 30 minutes, or until the sauce is thick. If your sauce doesn\\xe2\\x80\\x99t seem to be thickening to your liking, remove the lid for the final 5 minutes of cooking. Remove the onion half and bay leaf.', '  3 To serve: Serve the beans from the pot, or transfer them to a bowl, and sprinkle the reserved bacon on top.']",4
123,Roasted Beets with Balsamic Glaze Recipe,0,75,75,"['2 pounds red beets, medium sized, scrubbed clean, green tops removed (see beet greens recipe for what to do with beet greens)', '2 teaspoons extra virgin olive oil', 'Salt', '1/2 cup balsamic vinegar', '2 teaspoons sugar', '1 teaspoon grated orange zest', 'Freshly ground black pepper']",7,"['1 Preheat oven to 400\\xc2\\xb0F and line pan with aluminum foil.', '2 Prepare the beets: Place the beets in the pan. Rub olive oil over the beets, and sprinkle with salt. Cover the beets with another sheet of aluminum foil.', '3 Roast the beets: Roast for 1 to 2 hours, depending on the size of the beets and how old they are. After 1 hour, test every fifteen minutes by poking a beet with the tines of a fork. Once the fork tines go in easily, the beets are tender and cooked. Remove from the oven.', '4 Prepare balsamic glaze: While the beets are cooling, prepare the balsamic glaze. In a small, shallow saut\\xc3\\xa9 pan, add the balsamic vinegar and sugar. Heat on high until the vinegar has reduced to a syrup consistency. Remove from heat.', '5 Peel and cut cooked beets: After the beets have cooled for several minutes, but are still warm to the touch, peel off the outer skins and discard. Cut the beets into quarters or more bite-sized pieces.', '6 Pour glaze over beets: Place beets in a serving bowl. Pour balsamic glaze over the beets. Stir in grated orange zest, and add salt and pepper to taste.', 'Garnish with a little orange zest to serve.']",7
124,Hummingbird Cake Recipe,15,50,65,"['For the cake:', '3 cups all-purpose flour', '2 teaspoons baking powder (make sure your baking powder is still fresh!)', '1/2 teaspoon baking soda', '1 teaspoon salt', '1 teaspoon ground cinnamon', '1/2 teaspoon ground nutmeg (optional)', '3 large eggs', '2 cups granulated white sugar', '1 cup canola oil', '2 teaspoons vanilla extract', '1 (8 ounce) can crushed pineapple, with juice', '2 cups mashed bananas (from 3 to 5 bananas)', '1 cup finely chopped pecans', 'For the cream cheese frosting:', '1 pound cream cheese, softened', '1 cup (2 sticks) unsalted butter, softened', '2 pounds (32-ounces) powdered sugar', '1 teaspoon vanilla extract', '1 tablespoon Cointreau or other liquor (see Recipe Note)', '1 cup roughly chopped pecans, for topping (optional, toasted)', 'Edible flowers for garnish (optional)', 'Special equipment:', '3 9-inch cake pans']",24,"['1 Preheat the oven to 350\\xc2\\xb0 F. Butter and flour three 9-inch round cake pans.', '2 Whisk together dry ingredients: In a large bowl, vigorously whisk together the dry ingredients: flour, baking soda, baking powder, salt, cinnamon, and nutmeg (optional).', '3 Whisk together oil, sugar, eggs, then stir in pineapple, bananas, vanilla, 1 cup of pecans: In a separate bowl, whisk the canola oil, sugar, and eggs together until combined. Stir the pineapple, bananas, vanilla and one cup of the chopped pecans into the egg mixture and mix (do not beat).', '4 Fold wet ingredients into dry: Using a wooden spoon or spatula, fold the wet ingredients into the dry ingredients until just combined (do not over-mix).', '5 Pour into cake pans and bake: Pour the batter into the three prepared cake pans, taking care to divide evenly. Bake at 350\\xc2\\xb0F on center racks of oven for 20 to 25 minutes, or until a toothpick or knife inserted in the center comes out clean.', '6 Cool: Allow the cakes to cool in the pan on wire racks for 10 minutes.  After 10 minutes, run a knife around the edges and remove the cakes from the pans.  Cool completely on wire racks before frosting.', '7 Make the frosting: Beat the softened butter and cream cheese in a large bowl with an electric mixer. With the mixer on low speed, add the powdered sugar in small amounts until all is incorporated, then add the Cointreau and vanilla and beat until the frosting is light and fluffy.', 'Note: Do not add the powdered sugar while the mixer is set on a high speed, or you will create a snowy mess of sugar all over your kitchen. (Please do not ask me how I know this.)', '8 Frost the cake: Place one layer, top down, on a large plate or cake stand (this creates a smooth surface on the top and results in a more level cake). Spread frosting evenly over the first layer, then repeat with the second and third layers, then frost the sides.', '3 Sprinkle with chopped pecans: Sprinkle the top completely with the remaining cup of chopped pecans (toasted or un-toasted). Alternatively, press the chopped pecans onto the sides of the cake and leave the top simply frosted.', ""This cake is best served the day it's made and can be kept, assembled and frosted, for a few hours before servings. If you need to serve it the next day or if you have leftovers, cover the cake as well as possible and refrigerate it. Remove it from the fridge and let it come up to room temperature for an hour or two before serving.""]",11
125,Crunchy Banana Nut Granola Recipe,15,45,60,"['1/4 cup unsalted butter (If using salted butter, taste your mixture before adding salt)', '1/3 cup lightly packed light brown sugar', '1 tablespoon vanilla extract', '1 tablespoon water', '3 cups old-fashioned rolled oats (Certified gluten-free, if needed)', '3/4 cup chopped raw walnuts (See recipe notes)', '1/4 cup chia seeds', '1 tablespoon cinnamon', '1/2 teaspoon salt', '2 medium ripe bananas, diced']",10,"['1 Preheat the oven to 275F with two racks placed in the upper and lower halves. Line two baking sheets with parchment paper.', '2 Brown the butter: Slice the butter into small pats. In a small saucepan, melt the butter over medium heat. Once melted, the butter will start foam a bit, then it will begin to turn amber-colored and smell fragrant and nutty.', 'Watch closely, as the butter can go from browned to blackened fairly quickly. This whole process should only take about 3 minutes.', 'Remove the pan from heat immediately, and pour the melted butter into a small heatproof bowl.', '3 Melt the brown sugar: In the same saucepan used to brown the butter, add the brown sugar, vanilla, and water.', 'Stir over medium-low heat until combined, then cook until the brown sugar is thoroughly melted, 2 to 3 minutes. Remove from heat.', '4 Mix the granola: In a large bowl, mix the oats, walnuts, chia seeds, cinnamon, and salt until they are combined and the ingredients look well-distributed.', 'Add the melted brown butter and brown sugar mix and stir to combine. Then add the diced bananas and stir very gently.', '5 Bake the granola: Divide the granola between two baking sheets and spread into an even layer. Place into the warm oven and bake the granola for 45 minutes.', 'Half way through baking, stir the granola, then swap the top and bottom baking sheets and rotate the pans to avoid any hotspots. (If you want big clusters of granola, do not stir the granola.)', '6 Cool the granola: Remove the granola from oven and allow to cool for 20 to 30 minutes before stirring and serving. Store in airtight containers for up to a week.']",11
126,Vegan French Toast with Caramelized Bananas Recipe,10,30,40,"['For the French toast:', '1 cup (240ml) unsweetened almond or macadamia milk (strained if homemade)', '1 ripe medium banana', '2 tablespoons pure maple syrup, plus more to serve', '1 teaspoon natural vanilla extract', '1 tablespoon white (or black) chia seeds', '1 teaspoon ground cinnamon', '1\\xe2\\x81\\x844 teaspoon natural salt', '8 slices gluten-free sandwich bread', '1\\xe2\\x81\\x844 cup (60ml) coconut oil (in liquid form), plus more as needed', 'For the caramelized bananas:', '2 medium bananas, thickly sliced on the diagonal', '1\\xe2\\x81\\x844 cup (37g) coconut sugar', '1 to 2 tablespoons coconut oil (in liquid form)', 'Pure maple syrup, to serve', 'Optional boosters:', '1\\xe2\\x81\\x844 cup (60ml) bourbon or rum', '2 tablespoons crushed raw pecans or walnuts', '1 tablespoon unsweetened dried shredded coconut', 'Special equipment:', 'Blender']",21,"['1 Set the oven to its lowest temperature or the \\xe2\\x80\\x9cwarm\\xe2\\x80\\x9d setting.', '2 Make the French toast batter: Combine the milk, banana, maple syrup, vanilla, chia seeds, cinnamon, and salt into your blender and blast on high for about 30 seconds, until well combined. Pour the mixture into a large shallow baking dish and let rest for about 5 minutes to thicken slightly.', '3 Soak the bread in the batter: In batches, place slices of the bread in the baking dish and let soak on one side for 8 to 10 seconds. Flip the slices and let soak for another 8 to 10 seconds, until evenly moistened.', '4 Cook the French toast: In a medium skillet (that fits two slices of bread) or on a large griddle (that holds all of the slices) over medium heat, warm 1 to 2 tablespoons of coconut oil per two slices of bread. (Resist the urge to use less coconut oil, or the bread won\\xe2\\x80\\x99t get crispy.)', 'Add the bread and fry for 4 to 6 minutes on each side, until golden brown and crispy on the edges; you may need to add more coconut oil after you flip the bread. If cooking in batches, transfer the French toast to a lined baking sheet and place in the oven to keep warm, and repeat to fry the remaining bread, adding more coconut oil to cook each batch.', '5 While the last pieces of toast are cooking, make the caramelized bananas. Combine the banana slices and the coconut sugar in a zipper-lock bag, seal, and shake to coat evenly. In a skillet over medium-high heat, warm the coconut oil, add the coated bananas and the bourbon booster (if using), and fry for about 2 minutes on each side until nicely caramelized.', '6 To serve: Serve two slices of French toast on each plate, topped with one-quarter of the caramelized bananas, one-quarter of the crushed nut boosters, and one-quarter of the coconut booster. Pass maple syrup at the table.']",7
127,Guinness Chocolate Brownies Recipe,5,55,60,"['1 cup (240 ml) Guinness Extra Stout', '10 Tbsp (1 1/4 sticks, 140 g) unsalted butter', '1 1/4 cup (250 g) sugar', '3/4 cup plus 2 Tbsp (85 g) unsweetened natural cocoa', '1/4 teaspoon salt', '1/4 teaspoon cinnamon', '2 teaspoons vanilla', '2 large eggs, lightly beaten', '3/4 cup (96 g) flour', '2/3 cup  (90 g) chopped pecans, optional']",10,"['1 Preheat oven to 350\\xc2\\xb0F. Line an 8x8 square baking pan with parchment paper or foil in a way that there is overhang over two sides of the dish making it easy to remove the brownies once they are baked. Brush with a little butter or baking spray.', '2 Boil Guinness, reduce by half: Place the Guinness stout in a medium saucepan (2-quart) and bring to a boil. Watch out for the stout bubbling up too much. Boil until the liquid reduces by half.', '3 Progressively add butter, sugar, cocoa, salt, cinnamon to the Guinness, then let cool: Stir the butter into the reduced Guinness until melted. Add the sugar and whisk until dissolved. Whisk in the cocoa, salt, and cinnamon.', 'Whisk until smooth. Remove from heat and let cool until just lightly warm to the touch.', '4 Stir in the vanilla, eggs, flour, nuts: When the mixture has cooled until just lightly warm to the touch, stir in the vanilla extract and eggs. Stir in the flour until smooth. Stir in the nuts.', '5 Bake: Pour into the prepared lined baking pan. Bake at 350\\xc2\\xb0F for 30 minutes. Cool on a rack. When completely cool lift the brownies out of the pan. Cut into 16 to 25 squares or rectangles.']",6
128,Gingered Lemon Bars Recipe,15,45,60,"['The Crust:', '1 1/2 sticks (3/4 cup) unsalted butter, softened', '1/3 cup powdered sugar', '1/2 teaspoon freshly grated lemon zest', '1/2 cup minced crystallized ginger', '3/4 teaspoon ground ginger', 'Pinch of salt', '1 1/2 cups all-purpose flour', 'The filling:', '3 large eggs', '1 1/3 cups granulated sugar', '6 Tbsp fresh lemon juice', '1/2 teaspoon lemon zest', '3 Tbsp all-purpose flour', '1/2 teaspoon baking powder', '1/4 teaspoon salt']",16,"['1 Make the crust batter: Preheat the oven to 350\\xc2\\xb0F. Using an electric mixer, beat the butter. Add 1/3 cup of sifted powdered sugar, and beat until light and fluffy.', 'Beat in half a teaspoon of the lemon zest, the ground ginger, the crystallized ginger, and a pinch of salt.', 'Add 1 1/2 cups of flour in batches, a 1/4 cup at a time, beating after each addition. Continue to beat the crust batter until it is well combined.', '2 Bake the crust: Spread the crust batter evenly over the bottom of a 13x9-inch baking dish. Bake at 350\\xc2\\xb0F for 12 to 15 minutes, or until browned lightly around the edges.', '3 Make the lemon batter: While the crust is baking, whisk together the eggs, granulated sugar, lemon juice, 1/2 teaspoon of lemon zest, 3 Tbsp of flour, the baking powder, and 1/4 teaspoon of salt in a medium sized bowl. Whisk until well blended.', '4 Pour batter into pre-baked crust and bake: Pour the lemon batter over the pre-baked crust.', 'Bake at 350\\xc2\\xb0F for 15 to 20 minutes or until the top is golden.', 'If you want, sift a little additional powdered sugar over the top.', 'Let the lemon bars cool in the pan on a rack. Cut it into 36 pieces.']",9
129,Blueberry Crumb Bars Recipe,15,60,75,"['For the crust:', '2 1/2 cups (312 grams) all-purpose flour', '1 cup (198 grams) sugar', '2 teaspoons lemon zest', '1/2 teaspoon kosher salt', '1 cup (227 grams) cold unsalted butter, cubed', '1 large egg yolk', 'For the blueberry filling', '3 cups fresh or frozen blueberries', '3 tablespoon granulated sugar', '1 1/2 teaspoons cornstarch', '1 tablespoon lemon juice', '1 teaspoon lemon zest']",13,"['1 Preheat the oven and prep the pan: Preheat oven to 375\\xc2\\xb0F. Butter and line an 9x9 inch pan with parchment paper leaving an overhang on two sides.', '2 Make the dough: In a food processor, pulse the flour, sugar, lemon zest, and salt together a few times to combine. Add the butter and pulse until you get a fine, sandy texture\\xe2\\x80\\x94all of the butter should be incorporated.', 'Add the egg yolk and pulse until it\\xe2\\x80\\x99s combined, 10 to 15 times. The crumbs should hold together when squeezed in the palm of your hand. If they do not, sprinkle a tablespoon of water over top and pulse a few more times.', 'If you don\\xe2\\x80\\x99t have a food processor, you can cut the butter into the flour with a pastry blender or a fork. It will take longer, but work just fine.', '  3 Refrigerate the crumb topping: Scoop out about 1/3 of the crumb mixture and press it into a bowl, which helps to make larger clumps of crumbs for the topping. Cover and refrigerate for at least 15 minutes or until needed for the topping.', '4 Press the bottom crust into the pan: Firmly press the remaining 2/3 of the crumbs into the bottom of the prepared pan to create the base for the bars. I like to use a measuring cup to press the crumbs into the pan and really compact the crust.', '5 Make the blueberry filling and top with crumbs: In a mixing bowl, toss the blueberries with the sugar, cornstarch, lemon juice, and zest together to coat. Spread the berries over the crust.', 'Remove the remaining crumb mixture from the fridge and crumble. Crumble it with your fingers and sprinkled over the blueberry filling.', '6 Bake the crumb bars: Bake for 1 hour and 5 minutes, or until the blueberries are bubbling and the crumb topping is golden. Remove the bars from the oven and transfer to a cooling rack. Cool completely in the pan, at least 2 hours, before lifting from the pan using the parchment and cutting into squares.', 'Once cooled and sliced, the bars can be transferred to an airtight container and kept at room temperature for about a week.']",10
130,Pumpkin Cheesecake Bars with Streusel Topping Recipe,20,105,125,"['Graham cracker crust:', '1 1/2 cup graham cracker crumbs (See recipe note)', '1/4 cup white sugar', '6 tablespoons regular salted butter, melted and cooled slightly so no longer hot', '1/4 teaspoon cinnamon or pumpkin pie spice', 'Streusel topping:', '1/2 cup brown sugar', '1/2 cup all-purpose flour', '1/4 cup old-fashioned rolled oats', '4 tablespoons regular salted butter, room temperature', '1/4 teaspoon pumpkin pie spice', 'Pumpkin filling:', '2 8-ounce packages cream cheese, softened to room temperature', '2/3 cup sugar', '1 teaspoon vanilla extract', '2 large eggs, room temperature', '2/3 cup pumpkin puree (not pumpkin pie filling)', '2 teaspoons pumpkin pie spice', 'To serve:', 'Caramel sauce, homemade or store-bought, optional', 'Whipped cream, optional']",21,"['1 Heat the oven to 350F. Spray a 9x13 baking pan with non-stick spray and line with parchment paper, allowing the edges to hang over the sides of the pan. This will help remove the bars for slicing and keep the crust intact.', '2 Make the graham cracker crust: Combine all the ingredients for the graham cracker crust in a bowl. Stir the mixture together until it looks like wet sand. If it still looks dry, add an another tablespoon of melted butter. Transfer to the lined baking pan and press with your hand or the bottom of a drinking glass to form an even crust.', '3 Make the streusel topping: In the same bowl used to make the graham cracker mixture, combine the ingredients for the streusel topping. Mix the ingredients together, using your hands if needed, to ensure the mixture comes together evenly. The mixture should resemble large crumbles. Set aside.', '4 Make the pumpkin filling: In a stand mixer fitted with a paddle attachment, beat the cream cheese, sugar and vanilla until smooth. Stop the mixer and scrape down the sides of the bowl. Add the eggs, one at a time, mixing for 30 seconds in between. Scrape the bowl down again. Add in the pumpkin puree and pumpkin pie spice, and mix until completely combined.', '5 Assemble the bars: Pour the pumpkin filling into the pan on top of the graham cracker crust. Smooth out evenly. Sprinkle the streusel topping over the pumpkin filling.', '6 Bake the bars for 45 to 50 minutes: Check the bars at 40 minutes to see how quickly they are baking. When done, a toothpick inserted in the middle should come out cleanly.', '7 Cool the bars completely and refrigerate: Let the bars cool to room temperature on a wire rack. Once cool, place in the fridge to chill completely.', 'Slice and serve with caramel sauce drizzled over the top and whipped cream, if desired. Bars will keep, refrigerated, for about a week.']",8
131,Shauna Sever\xe2\x80\x99s Frosted Snickerdoodle Bars Recipe,10,30,40,"['For the bars:', '2 3/4 cups (352 g) all-purpose flour, spooned and leveled', '2 teaspoons cream of tartar, sifted', '1 1/4 teaspoons fine sea salt', '1 teaspoon baking soda', '1 teaspoon ground cinnamon (Shauna Sever recommends Vietnamese cinnamon)', '1 cup (225 g) unsalted butter, at room temperature', '3/4 cup (170 g) light brown sugar', '3/4 cup (150 g) granulated sugar', '1 1/2 teaspoons vanilla extract', '2 large eggs, room temperature', '1/4 cup (57 g) whole milk', 'For the frosting:', '3/4 cup (170 g) unsalted butter, room temperature', '1 1/2 cups (180 g) powdered sugar', '1 teaspoon ground cinnamon, plus more for dusting (optional)', '1 tablespoon plus 1 teaspoon whole milk', '1 teaspoon pure vanilla extract', '1/4 teaspoon fine sea salt']",19,"['1 Prep the pan and the oven: Position a rack in the center of the oven and preheat it to 325\\xc2\\xb0F.  Line a 9x13 light-colored metal baking pan with aluminum foil and spray it with nonstick cooking spray.', '2 Whisk together the dry ingredients: In a medium bowl, whisk together the flour, cream of tartar, salt, baking soda, and cinnamon.', '3 Make the batter: In the bowl of an electric mixer fitted with the paddle attachment, beat the butter on medium speed until creamy. Add the brown and granulated sugar and vanilla and beat until light and fluffy, about 3 minutes. Beat in the eggs, one at a time, giving each about 30 seconds of beating to fully incorporate. Beat in the milk.', 'Reduce the speed to low and gradually beat in the flour mixture. Finish stirring the batter by hand to make sure every bit is incorporated.', '4 Bake the bars: Spread the batter in the prepared pan and smooth the top. Bake for 25 to 30 minutes, or until the top looks puffy and begins to turn golden. Rotate the pan 180 degrees, and while doing so, rap the pan on the oven rack until the bars deflate.', 'Bake for 5 minutes more, or until the bars have pulled away from the sides of the pan and a toothpick inserted into the center comes out clean. The bars will still look quite soft.', 'If they\\xe2\\x80\\x99ve puffed back up during the last minutes of baking, rap the pan on the countertop once again.', '5 Let cool completely in the pan set on a wire rack.', '6 Make the frosting: In the bowl of an electric mixer fitted with the paddle attachment, beat the butter on medium speed until creamy. Add the powdered sugar, cinnamon, milk, vanilla, and salt, and beat until smooth. Raise the mixer speed to high and beat until very light and fluffy, about 2 minutes.', '7 Frost the bars: Spread the frosting over the cooled bars. Lightly dust cinnamon over the entire pan, if you wish. Store leftovers covered in the refrigerator for up to 5 days.']",10
132,Barbecued Chicken on the Grill Recipe,5,105,110,"['4 pounds of your favorite chicken parts (legs, thighs, wings, breasts), skin-on', 'Salt', 'Extra virgin olive oil or vegetable oil', '1 cup barbecue sauce, store-bought or homemade']",4,"['1 Oil and salt chicken pieces: Coat the chicken pieces with olive oil and sprinkle salt over them on all sides.', '2 Prepare grill: Prepare one side of your grill for high, direct heat. If you are using charcoal or wood, make sure there is a cool side to the grill where there are few to no coals.', '3 Sear chicken on hot side of grill, move to cool side: Lay the chicken pieces skin side down on the hottest side of the grill in order to sear the skin side well. Grill uncovered for 5-10 minutes, depending on how hot the grill is (you do not want the chicken to burn).', 'Once you have a good sear on one side, turn the chicken pieces over and move them to the cooler side of the grill.', 'If you are using a gas grill, maintain the flame on only one side of the grill, and move the chicken pieces to the cooler side, not directly over the flame. Reduce the temp to low or medium low (between 250\\xc2\\xb0F and 275\\xc2\\xb0F, no more than 300\\xc2\\xb0F).', 'Cover the grill and cook undisturbed for 20-30 minutes.', '4 Turn over and baste with barbecue sauce: Turn the chicken pieces over and baste them with with your favorite barbecue sauce. Cover the grill again and allow to cook for another 15-20 minutes.', 'Repeat, turning the chicken pieces over, basting them with sauce, covering, and cooking for another 10-30 minutes.', 'NOTE that timing will depend on your grill set-up, the size of your chicken pieces, and how cold your chicken pieces are to start with! If you are grilling smaller pieces of chicken on a charcoal grill, they may be done much earlier. The goal is to maintain a low enough grill temp so that the chicken cooks ""low and slow"".', '5 Finish with a sear or remove from heat when done: The chicken is done when the internal temperature of the chicken pieces are 160\\xc2\\xb0F for breasts and 170\\xc2\\xb0F for thighs, when tested with a meat thermometer.', 'Or if you insert the tip of a knife into the middle of the thickest piece and the juices should run clear, the chicken is done.', ""If the chicken isn\\'t done, turn the pieces over and continue to cook at a low temperature."", 'If you want, you can finish with a sear on the hot side of the grill. To do this, put the pieces, skin side down, on the hot side of the grill. Allow them to sear and blacken slightly for a minute or two.', '6 Paint with more barbecue sauce to serve.']",14
133,Memphis-Style Pork Ribs Recipe,10,300,310,"['1/4 cup sweet paprika', '1/2 cup brown sugar', '1 Tbsp black pepper', '1 Tbsp garlic powder', '2 teaspoons cumin', '2 teaspoons salt', '2 teaspoons cayenne', '1 teaspoon dry mustard', '1/2 teaspoon celery seed', '1/2 teaspoon dried oregano', '2 St. Louis-cut or spare rib racks']",11,"['1 Make the dry rub, rub all over ribs: Mix all the dry ingredients together. Rub them all over the ribs and, if you have time, set them in the fridge overnight.', '2 Grill over low, indirect heat initially for one hour: Get your grill or smoker going. You want pretty low heat, about 200-220\\xc2\\xb0F if you can measure it. Make sure you have a spot to put the ribs that is not directly over the heat source. Lay the ribs down. They should not sizzle. If they do, cool the grill down until the ribs no longer sizzle when placed down. Cover the grill or smoker and walk away for an hour.', '3 Every hour or so after that, turn and rotate the ribs so they cook evenly. You should not have to baste them if you do this: The fat in the ribs will do the basting for you. Depending on how hot your set-up is and at what stage of doneness you like your ribs, they will be done in 4-8 hours.']",3
134,Kansas City Barbecue Sauce Recipe,5,35,40,"['2 cups tomato sauce or ketchup', '1/2 cup apple juice', '1/2 cup apple cider vinegar', '1/2 cup brown sugar', '5 Tbsp butter', '3 Tbsp paprika', '2 Tbsp chili powder', '1 Tbsp chipotle powder (optional)', '4 finely chopped garlic cloves', '1/2 medium onion, finely chopped', 'Salt to taste', 'Cayenne to taste']",12,"['1 Heat the butter in a pot over medium heat for 2-3 minutes. Add the onion and saut\\xc3\\xa9 until it begins to brown. Add the garlic and saut\\xc3\\xa9 for another 2 minutes.', '2 Pour in the remaining ingredients and stir well to combine. Simmer slowly for at least 30 minutes, and up to 2 hours.', 'Adjust the heat and salt levels with the cayenne and salt right before you plan to use this sauce, which is great on ribs, chicken and pork shoulder.']",3
135,Grilled Chicken with South Carolina-Style BBQ Sauce Recipe,30,25,55,"['For the BBQ sauce:', '1 cup prepared yellow mustard', '1/4 cup packed dark brown sugar', '2 tablespoons apple cider vinegar', '1 tablespoon ketchup', '1 teaspoon Worcestershire sauce', '1/2 teaspoon garlic powder', '1/2 teaspoon bottled hot sauce, plus more to taste', 'For the chicken:', '4 chicken thighs, bone-in with skin', '4 drumsticks, bone-in with skin', '1 tablespoon sea salt']",12,"['1 Make barbecue sauce at least 30 minutes ahead of grilling: Combine all the ingredients for the sauce in a 2-quart saucepan and set over medium-high heat on a back burner. Cook, stirring constantly for 2 minutes or until mixture is very steamy. (The sauce can bubble and spit, so use caution. To avoid burns, stir the sauce constantly to distribute heat.)', 'Turn the heat to medium-low, and cook until sauce has thickened, 5 to 7 minutes more. When done, the sauce should be thick enough that a spoon will leave trails through the sauce when you stir. Set aside to cool.', 'Once cool, measure 3/4 cup into a small bowl for the chicken. Set aside remaining sauce for serving. (Prepared sauce can also be made ahead and kept refrigerated for up to 2 weeks.)', '2 Twenty minutes before cooking, rub the chicken pieces on both sides with sea salt. Set in fridge while you prep grill.', '3 Prepare a charcoal grill. When coals are gray and very hot, carefully move them to one side of the grill so that one side has hot, direct heat and the other side has indirect heat. (Alternatively, prepare a gas grill with two temperature zones for cooking.)', '4 Brush chicken generously on both sides with 3/4 cups of prepare barbecue sauce.', '5 Grill the chicken over high heat to sear: Place the chicken on the hot side of grill directly over coals, placing thighs skin-side down. After 2 to 3 minutes, flip chicken and grill another 2 to 3 minutes, or until chicken is nicely browned or even slightly blackened on both sides.', '6 Finish cooking the chicken over indirect heat: Move the chicken over to side without coals to finish cooking over indirect heat. Brush once more with barbecue sauce. Cover the grill.', 'After 5 to 7 minutes, flip chicken. Cook another 12 to 15 minutes until chicken is a rich golden brown, cooked through, and reaches an internal temperature of at least 175\\xc2\\xb0F when tested with a meat thermometer.', '(I usually cook these thighs and drumsticks to a slightly higher internal temperature to be sure the meat is thoroughly cooked; the sauce and indirect heat keep the chicken from drying out.)', '7 Serve immediately with extra barbecue sauce.']",11
136,Bourbon Barbecue Sauce Recipe,5,30,35,"['1/4 cup vegetable oil, such as canola or peanut', '1/4 cup butter', '1 chopped chile pepper, such as a serrano', '1 medium yellow or white onion, grated', '1 cup bourbon or Tennessee whiskey', '1/2 cup ketchup or tomato sauce', '1/2 cup lemon juice', '1/2 cup apple cider vinegar', '1/3 cup dark molasses', '1/3 cup Worcestershire sauce', '2-3 tablespoons brown sugar', 'Salt to taste']",12,"['1 Heat the butter and oil in a sauce pan over medium-high heat.', ""2 Grate the onion through the coarse grate of a box grater, or finely mince the onion if you don't have a grater."", '3 Add grated onion and chile to the oil/butter combination and cook over medium heat for 3-4 minutes, or until onions turn translucent. You do not want the onions to turn color.', '4 Add the bourbon: Take the pan off the heat and add the bourbon. Return to the stove, turn up the heat to medium-high again and boil down the bourbon for 5 minutes.', '5 Add the ketchup, lemon juice, vinegar, Worcestershire sauce, molasses, and the sugar. Mix well and return to a simmer.', '6 Cook the sauce for a few minutes to combine the flavors and then taste test it. Is it salty enough? (It should be from the Worcestershire sauce). If not, add salt. Is it spicy hot enough? If not, add a little cayenne powder. Is it sweet enough? If not, add some molasses.', ""7 Let the sauce cook down slowly until it thickens, about 20 minutes. Keep it on low heat while your ribs cook. Alternatively, you can make this sauce ahead of time and reheat it when you cook the meat. It will stay good in the fridge at least a week; I've held mine for two weeks with no problem.""]",7
137,Smoky Barbecue Sauce Recipe,10,70,80,"['4 Tbsp butter (can substitute vegetable oil)', '1/2 grated onion', '1 15-ounce can crushed tomatoes', '1/2 cup cider vinegar', '2 Tbsp brown sugar', '1/4 cup molasses', '1-4 chipotle chiles in adobo (depending on how hot you want your bbq sauce)', '1 teaspoon liquid smoke', '1 Tbsp finely chopped fresh sage', 'Salt to taste']",10,"['1 Saut\\xc3\\xa9 the grated onion in butter: Heat the butter in a heavy pot over medium-high heat until it froths (or heat vegetable oil until hot), then add the grated onion. Sprinkle a little salt over the onion. Saut\\xc3\\xa9 until the onion just begins to color, about 4-5 minutes.', '2 Mince the chipotle chile: While the onions are cooking, finely chop the chipotle chiles in adobo. They are hot, so start with one chile. You can add as many more as you want later.', '3 Add chipotle and remaining ingredients to the onions: Add the chipotle to with the onions, then add the tomatoes, vinegar, molasses, sugar, liquid smoke, and chopped sage. Stir to combine and let this simmer for 5 minutes. Taste it and add salt and more chipotle if you want.', '4 Simmer 1 hour: Simmer the sauce gently, uncovered, for 1 hour. Before serving, taste one more time for salt and chile.']",4
138,Bourbon BBQ Meatloaf Recipe,20,60,80,"['2 tablespoons olive oil', '1 medium red or yellow onion, roughly chopped', '1 medium carrot, roughly chopped', '1 stalk celery, roughly chopped', '1/4 red bell pepper, roughly chopped', '3 cloves garlic', '2 pounds ground beef (90/10 blend)', '1 tablespoon Worcestershire sauce', '2 large eggs', '1 cup breadcrumbs', '1/4 cup fresh parsley, minced', '2 teaspoons salt', 'For the Bourbon BBQ Glaze:', '1 cup BBQ sauce, homemade or store-bought (I like Stubb\\xe2\\x80\\x99s)', '1/4 cup bourbon', '1 tablespoon brown sugar', '1 tablespoon honey', 'Special equipment:', '9x5 loaf pan']",19,"['1 Preheat oven to 350\\xc2\\xb0F.', '2 Cook the vegetables: Add chopped onion, carrot, celery, red pepper, and garlic to a food processor and pulse until minced. Transfer the veggies to a large skillet with olive oil.', 'Cook over medium heat for 5 to 6 minutes until veggies are soft and most of the liquid has cooked out of them.', ""Let veggies cool briefly before combining with meatloaf ingredients. The cooler the mixture, the easier it will be to handle; plus, if it's too hot, you might accidentally end up with scrambled eggs when you add the eggs in!"", '3 Mix and shape the meatloaf: Add the cooked vegetables to a large bowl with all the other meatloaf ingredients and mix well with your hands. Then press the mixture in a 9x5 loaf pan.', '4 Bake the meatloaf: Bake the meatloaf at 350\\xc2\\xb0F for 60 minutes, or until the internal temperature of the meatloaf reaches 160\\xc2\\xb0F.', '5 Make the glaze while the meatloaf bakes: Add glaze ingredients to a small saucepan and bring to a simmer over low heat. Simmer for 4 to 5 minutes until mixture forms big bubbles and is thick enough to coat the back of a spatula or spoon. It will continue to thicken as it cools.', '6 Glaze the meatloaf: When the meatloaf has about five minutes left of baking, add 1/4 cup of glaze to the top of the meatloaf and let it finish cooking.', '7 Serve: Let the loaf cool in the pan for 5 minutes, then unmold and serve (or serve from the pan). Serve the rest of the glaze on the side for people to drizzle onto their slices.', 'Leftovers can be kept in the fridge for a few days. If you want to freeze this meatloaf, I recommend slicing it and freezing individually wrapped slices, rather than freezing the entire loaf, which will be difficult to defrost later. Reheat slices in a medium-heat skillet with a drizzle of oil until warmed through, 4 to 5 minutes.']",10
139,Instant Pot BBQ Baby Back Ribs Recipe,15,65,80,"['2 full racks baby back ribs (3-4 pounds)', 'about 1/3 cup dry rub for pork, store-bought or homemade', '3/4 cup water', '3/4 cup apple cider vinegar', '1/2 teaspoon liquid smoke (optional)', '2 cups barbecue sauce, favorite store-bought or homemade']",6,"['1 Prep the ribs: Working with one rack at a time, use a paring knife to separate the thin transparent membrane on the inside of the ribs. Peel it away from the ribs. It should come off in one big piece. This will make it easier to slice and serve the ribs.', '2 Apply the rub: Rub the ribs well on all sides with dry rub. If possible, cover and let rest in the fridge overnight.', '3 Cook the ribs: In the bottom of your Instant Pot, add some foil balls or a rack to raise the ribs above the liquid. Pour water, vinegar, and liquid smoke (optional) into the Instant Pot. Add ribs, bending them to fit. You should be able to fit two racks of baby back ribs in a 6-quart Instant Pot or pressure cooker.', 'Lock the pressure cooker and cook on high pressure for 30 minutes. Release the pressure naturally for 10 minutes, then vent off remaining pressure.', '4 Broil the ribs: Remove ribs from the Instant Pot and spread them out on a baking sheet. Brush liberally with barbecue sauce and broil on high heat for 5 minutes. Slice ribs and serve with sides and extra sauce.', 'To reheat leftover ribs, wrap them tightly in foil and heat them in a 350\\xcb\\x9aF oven until heated through, about 15 minutes. You can also grill them for 10-15 minutes over medium heat. Serve with extra sauce!']",6
140,BBQ Meatloaf Bites Recipe,15,30,45,"['For the meatloaf bites:', '2 pounds lean ground beef (no more than 10% fat)', '1 large egg', '3/4 cup breadcrumbs', '1 small white onion, 1/2 cup diced', '1 stalk celery, 1/3 cup diced', '1 medium carrot, 1/3 cup diced', '1/2 green pepper, 1/3 cup diced', '3 cloves garlic, minced', '1 teaspoon chili powder', '1/2 teaspoon salt', '1/2 teaspoon black pepper', '1 tablespoon Worcestershire sauce', 'For the BBQ Glaze:', '1 cup barbecue sauce (I like Stubbs)', '1/4 cup brown sugar', '1 tablespoon hot sauce (optional)', 'DAD ADD: ""Meatball"" Sub (makes 1 sub)', '1 soft French roll', '2 to 3 cooked meatloaf bites', '2 tablespoons marinara sauce, store-bought or homemade', '2 ounces provolone cheese', 'Banana peppers']",23,"['1 Preheat the oven to 350\\xc2\\xb0F.', '2 Make the meatloaf mixture: In a large bowl, combine ground beef, egg, breadcrumbs, onion, carrot, celery, green pepper, garlic, chili powder, salt, pepper, and Worcestershire sauce. Mix well\\xe2\\x80\\x94I think using your hands works best.', '3 Fill the muffin tin with meatloaf: Line a muffin tin with foil for easier cleanup, and then divide the meatloaf mixture between the muffin tins. I like to use about 1/4 cup of meatloaf mixture for each muffin tin, which ends up being about 3/4 full on each muffin tin. You should get about 18 meatloaf bites out of the recipe.', '4 Bake the bites: Place the meatloaf-packed muffin tins in the oven and bake for about 20 minutes.', '5 Make the glaze: Stir together the barbecue sauce, brown sugar and, if using, hot sauce in a small bowl. After the bites have baked for 20 minutes, remove and brush the glaze right on the meatloaf tops.', '6 Finish baking: Return to the oven and bake for another 10 minutes until meatloaf bites are cooked through. If you have a meat thermometer handy, the meatloaf bites should reach an internal temperature of 160\\xc2\\xb0F.', '7 Serve! Remove meatloaf bites once they have cooled slightly and serve with steamed veggies and potatoes. The meatloaf bites should hold together easily and not crumble.', '8 Make the Dad Add Sub with the leftovers: Heat the oven to 400\\xc2\\xb0F. Cut open a soft French sub roll and slather on a few tablespoons of marinara sauce. Top with provolone cheese, a few meatloaf bites cut in half, and a few banana peppers.', 'Bake the sub for 6 to 7 minutes until it\\xe2\\x80\\x99s the edges are crispy and the cheese is melted and bubbling. Serve while warm.']",9
141,Vegan Mushroom Barley Soup Recipe,30,75,105,"['1 ounce dried porcini or other dried mushrooms', '2 cups hot tap water', '1 1/2 pounds fresh mushrooms (button, shiitake, large or baby portobello, or a mix)', '3 tablespoons olive oil', '1 clove garlic, minced', '1 large onion, diced', '2 stalks celery, diced', '2 carrots, diced', '1 teaspoon salt', '1/2 teaspoon black pepper', '3/4 cup pearl barley', '1 medium Yukon Gold potato, cut into 1/2-inch chunks', '8 cups water, plus more if needed', '2 tablespoons soy sauce, plus more to taste', '2 tablespoons balsamic vinegar, plus more to taste', '1 bay leaf', '1/4 cup chopped fresh parsley', '1/4 cup chopped fresh dill', '3 ounces baby spinach (2 cups packed), tough stems removed']",19,"['1 Soak the dried mushrooms: In a bowl, combine the porcini or other dried mushrooms and the 2 cups hot water. Set aside for 30 minutes to soak.', 'With a slotted spoon, lift the mushrooms out of the bowl and transfer to a cutting board. Coarsely chop them. Strain the soaking liquid through a sieve lined with a paper towel to catch any grit and reserve.', '2 Prep the fresh mushrooms: Whip any dirt from the mushrooms with a damp paper towel. Remove the stems from all except the button mushrooms. Coarsely chop the large mushrooms and thinly slice the small mushrooms. Set aside.', '3 Cook the vegetables: In a large stock pot over medium heat, heat the oil. Add the garlic, onion, celery, carrots, salt, and pepper. Cook, stirring occasionally, for 10 minutes until the vegetables have softened.', 'Add the mushrooms, stir well, and continue cooking, stirring occasionally, for another 10 minutes. Add the potato and barley and cook, stirring, for 1 minute more.', '4 Add the liquids: Stir in the reserved mushroom soaking liquid, water, soy sauce, vinegar, bay leaf, half the parsley, and half the dill.', 'Bring to a boil, then lower the heat. Partially cover and simmer for 45 to 50 minutes, or until the barley and potatoes are both tender. If the mixture seems too thick at any point, add more water, 1/2 cup at a time.', '5 Finish the soup: Add the spinach and stir well. Cover the pot and let the spinach wilt for 2 minutes. Stir the soup and taste for seasoning. Add more salt, soy sauce, or balsamic vinegar, if you like. Sprinkle with the remaining parsley and dill. Ladle into bowls.', 'Leftovers will keep refrigerated for up to a week, or frozen for up to 3 months.']",9
142,Turkey Soup with Lemon and Barley Recipe,15,40,55,"['3 tablespoons extra virgin olive oil', '1 large onion, grated or minced', '3 garlic cloves, minced', '1 teaspoon ground turmeric', '1/2 teaspoon ground cumin', '1/2 teaspoon ground ginger', 'Salt', 'Pepper', '6 cups turkey stock or chicken stock', 'Strips of lemon zest, from one lemon*', '1/2 cup to 1 cup barley (more barley will yield a thicker soup)', '2 cups chopped cooked turkey', '2 tablespoons lemon juice', '1/4 cup chopped parsley', '1/4 cup chopped cilantro (can sub with more parsley)', '*Use a vegetable peeler to peel strips of zest from a lemon. Use a sharp knife to scrape out and discard any of the white pith that still remains on the inside of the zest strips.']",16,"['1 Saut\\xc3\\xa9 the onion, garlic, spices: Heat the olive oil over medium-high heat in a heavy pot or Dutch oven. Add the grated onion and cook until the onion is translucent, about 3 minutes. Stir in the minced garlic and cook another minute, then mix in the turmeric, cumin, ground ginger and a generous pinch of salt.', '2 Add stock, zest, bring to simmer then add barley: Pour in the turkey stock and add the strips of lemon zest. Bring to a simmer, then add the barley. Simmer gently until the barley is cooked, about 20-30 minutes.', '3 Add cooked turkey, lemon juice, parsley, cilantro, salt, pepper: When the barley is cooked through, add the chopped cooked turkey, lemon juice, parsley and cilantro, and salt and pepper to taste. Cook gently just until the turkey is warmed through, about 3-5 minutes. Remove the lemon zest strips before serving.']",3
143,Moroccan Chickpea Barley Salad Recipe,15,30,45,"['1 1/2 cups barley', '1 1/2 cups chicken or veggie broth (use veg broth for vegan version)', '1 1/2 cups water', '1 teaspoon salt', 'Extra virgin olive oil', '1 15-ounce can of chickpeas (garbanzo beans), rinsed and strained, or 1 1/2 cups cooked', '1 cup shelled pistachio nuts', '1 cup diced dried apricots', '2-3 chopped green onions or scallions', '1 cup chopped parsley', 'Zest and juice of a lemon', '1 tablespoon of ras el hanout spice mix*', 'Salt to taste', '*Ras El Hanout Spice Mix:', '1 teaspoon black pepper', '1 teaspoon cardamom', '1/4 teaspoon cayenne', '1/4 teaspoon ginger', '1/4 teaspoon nutmeg', '1/4 teaspoon cinnamon', '1/2 teaspoon turmeric']",21,"['1 Cook the barley: Heat 2 tablespoons of olive oil in a large pot on medium high heat. Add the barley and saut\\xc3\\xa9 for 3-4 minutes, stirring often.', 'Add the broth, water, and a teaspoon of salt. Bring to a simmer and simmer until the barley is tender, anywhere from 30 minutes to an hour, depending on how old the barley is.', '2 Strain the barley, toss with olive oil: Strain the cooked barley through a colander or sieve and run cold water over to cool it quickly. Toss and mix in the colander to strain as much water as you can.', 'Lay out the barley on a sheet pan and drizzle olive oil over it. Mix to coat well and set aside.', '3 Combine salad ingredients: In a large bowl, add the chickpeas, pistachios, apricots, green onions and parsley and mix well.', 'Add the zest and juice of the lemon and mix again.', 'Add the barley and mix.', 'Sprinkle the ras el hanout spice mixture over the barley and mix well. Taste, and add salt if needed.', '4 Marinate before serving: Let the salad marinate for an hour or so before serving. If the barley has absorbed all the olive oil, drizzle a little more on right before serving.']",9
144,Instant Pot Barley Lunch Jars Recipe,10,40,50,"['1 cup pearl barley', '1/2 teaspoon salt', '4 cups water', '2 1/2 cups salad greens', '10 to 12 cherry tomatoes, halved', '5 small sweet peppers, sliced', '2 small cucumbers, sliced', '5 radishes, sliced', 'Vinaigrette, for serving', 'Special equipment:', '6-quart Instant Pot or other pressure cooker', '5 pint jars, for assembly']",12,"['1 Cook the barley: Add dried barley to your Instant Pot or other multi cooker/pressure cooker. Stir in salt and water. Replace lid and cook on high pressure for 15 minutes.', 'Once finished, let pressure naturally release for five minutes. Vent steam, remove lid, drain off any extra water, and let barley cool to room temperature.', '2 Assemble the jars: There\\xe2\\x80\\x99s no single way to assemble these lunch jars. I like to add 1/2 cup of cooked barley to the bottom (make sure it is room temperature). Top that with a mix of salad greens and lots of sliced vegetables.', '3 Store the jars: The jars will keep in the fridge for 4-5 days. After that the greens start to wilt. You cannot freeze these jars. They are intended to be made and eaten within the week.', '4 Enjoy! When it\\xe2\\x80\\x99s time for lunch, drizzle vinaigrette into the jar, season with a pinch of salt and pepper, then eat the barley salad right out of the jar. Alternatively, pour onto a plate. (Don\\xe2\\x80\\x99t add the vinaigrette to the salad until right before serving, as it will make the vegetables soggy.)']",5
145,Pesto Pasta Salad Recipe,10,15,25,"['4 cups uncooked fusili pasta (use rice pasta for wheat-free version)', '1 cup fresh basil pesto', '2 tablespoons chopped green olives, or olive tapenade', '1/3 cup pine nuts', '1 cup frozen peas, defrosted (or fresh if you can get them)', '12 ounces cherry tomatoes, halved', 'Several fresh basil leaves, coarsely chopped', '1 tablespoon extra virgin olive oil', 'Salt and pepper']",9,"['1 Cook the pasta: Cook pasta according to instructions on the package. Make sure the water is salted (one and a half teaspoons per quart). Remove pasta from heat and strain when pasta is cooked, but still firm (al dente).', '2 Toast pine nuts: While the pasta is cooking, toast the pine nuts in a small pan over medium-high heat. Keep an eye on them because pine nuts can go from lovely and toasty to acrid and burnt in seconds.', 'When most of the nuts have a blush of golden brown on them, move them to a cool bowl to rest. They will burn if you leave them in the pan.', '3 Mix pasta with pesto, pine nuts, olives, tomatoes, basil, olive oil: Put pasta in a big bowl. Mix in fresh basil pesto, green olives, and pine nuts. Gently mix in cherry tomatoes, peas, fresh basil leaves and olive oil. Salt and pepper to taste.', 'Serve at room temperature.']",5
146,Mozzarella Stuffed Sweet Mini Peppers Recipe,15,15,30,"['1 pound of sweet mini peppers (about a dozen)', '1/4 pound (115 g) smoked mozzarella cheese, cut into 1/4-inch thick and 2 inch long batons', '12 basil leaves (as many basil leaves as peppers)', '2 teaspoons extra virgin olive oil', '2 teaspoons balsamic vinegar', 'Salt to taste']",6,"['1 Stuff mini peppers with smoked mozzarella and basil: Working one pepper at a time, place flat side down in a way that is most stable for the pepper.', 'With a small sharp knife, cut a 2 1/2 inch slit down the middle on the top of the pepper.', 'If there is a seed pod, scoop it out with a spoon.', 'Stuff the pepper with a basil leaf wrapped mozzarella stick.', 'When you have stuffed all the peppers, brush them on all sides with olive oil. Drizzle balsamic vinegar in the cut openings.', '2 Cook on grill, in oven, or under broiler: Preheat grill, oven, or broiler for high direct heat (if oven, set to 400\\xc2\\xb0F).', 'If grilling, grill covered, cut side up on high direct heat until you have grill marks, then lower the heat to medium until the cheese is melted and the peppers have begun to soften, about 5 to 10 minutes.', 'If broiling or baking, place on a roasting pan and cook until the cheese is melted and peppers have browned and softened, about 5 to 10 minutes.', 'Sprinkle with salt to taste.', 'Let rest for a few minutes before serving.']",10
147,Rotini with Kale and Walnut Pesto Recipe,10,20,30,"['1 bunch kale, stems removed', '1 cup loosely packed basil', '2 cloves garlic', '1/2 cup toasted walnuts', '1/3 cup water', '1/4 cup extra virgin olive oil', '1/2 teaspoon salt', '12 ounces rotini pasta', 'Parmesan cheese, for serving', 'For the Lemon Pepper Chicken (Dad Add)', '2 chicken cutlets', '2 teaspoons lemon pepper', '1/2 teaspoon kosher salt', '2 tablespoons olive oil']",14,"['1 Blanch the kale and basil: Set a pair of tongs or a slotted spoon next to the stove. Bring a large pot of water to a boil seasoned with salt. (I usually add 1 tablespoon kosher salt per 2 quarts of water)', 'Once boiling, add the kale and basil to the pot for only 10 seconds. Use the tongs to lift the kale and basil out of the water and let cool on a baking sheet. If it looks like an excessive amount of water remains on the greens, feel free to press them with a paper towel.', 'Use this same pot of water to cook your pasta.', '2 Make the pesto: Add the blanched kale and basil to a blender or food processor with garlic, walnuts, 1/3 cup water, olive oil, and salt. Blend until pureed into a paste. Taste and adjust seasoning to your liking. If the pesto needs more liquid, add water, 1-2 tablespoons at a time, until it reaches your desired consistency.', '2 Boil the pasta: Add rotini pasta to the water you used to blanch the vegetables. Cook until al dente according to package. Reserve 1 cup pasta water and drain the pasta.', 'Return the pasta to the pot and add all the pesto. Stir to combine. If the pesto seems really dry, add reserved pasta water a little at a time. Stir between each addition until it coats the pasta well.', '3 Serve: Serve pesto rotini with grated parmesan cheese on top.', '4 For the Lemon Pepper Chicken: Season the chicken cutlets liberally with lemon pepper and salt.', 'In a medium skillet over medium heat, add olive oil and cook cutlets for 5 to 6 minutes per side until they reach an internal temperature of 165\\xcb\\x9aF. After they come out of the skillet, let them rest briefly and then slice and serve on top of the rotini.', 'LEFTOVERS!', 'Leftovers keep in the fridge for 2 to 3 days. Reheat gently in a pot with a splash of water over low heat or in the microwave.']",11
148,Basque Lamb Stew Recipe,20,360,380,"['3 1/2 pounds lamb shoulder, cut into 2 inch pieces', '6 cloves garlic, crushed and peeled', '1 sprig fresh rosemary, about 1 tablespoon chopped', '1/2 cup dry white wine', '2 tablespoons extra-virgin olive oil', '1 large onion, peeled and chopped', 'Salt', '2 teaspoons sweet paprika', '1 10-ounce can roasted red bell peppers, cut into 1/2 inch strips', '1 large ripe tomato, peeled, seeded, and chopped', '2 tablespoons chopped fresh parsley', '1 bay leaf', '1 cup dry, full-bodied red wine', '1 cup chicken stock', 'Freshly ground black pepper']",15,"['1 Marinate lamb with garlic, rosemary, white wine: Combine the lamb, half of the garlic cloves, rosemary, and white wine in a medium bowl. Let marinate for 2 to 3 hours.', 'Drain the meat, discard the marinade, and pat dry with paper towels. Mince the remaining garlic cloves and set aside.', '2 Brown the lamb: Heat olive oil in a large, heavy-bottomed pan with lid, over medium-high heat. Working in batches, brown the meat on all sides, about 10 minutes per batch. Salt the meat as it browns.', '3 Saut\\xc3\\xa9 onions and garlic: Remove the meat from the pan and add the chopped onion to the pan. Cook, scraping browned bits stuck to the bottom of the pot with a wooden spoon, until the onions are soft, about 5 minutes. Add the garlic and cook another minute.', '4 Return meat to pan, add paprika, roasted peppers, tomatoes, parsley, bay leaf, red wine, bring to simmer: Return the meat to the pan with the onions and garlic. Stir in paprika, roasted peppers, tomatoes, parsley, bay leaf, and red wine. Bring to a boil, reduce heat to medium, and simmer uncovered for 15 minutes, allowing the liquids to reduce a bit.', '5 Add chicken stock, simmer: Add the chicken stock, bring to a boil, reduce heat to low and simmer, covered, stirring occasionally, until meat is very tender, 2 to 2 1/2 hours. Add freshly ground black pepper and more salt to taste.', 'Serve with rustic bread. If you want, try garnishing with fresh mint leaves (though I have no idea how ""Basque"" that is, it just tastes good.)']",7
149,Basque-Style Chicken with Peppers and Olives Recipe,20,50,70,"['3 mild chili peppers (Anaheim, poblanos, Fresno, or another variety)', 'Olive oil, for sprinkling', '3 tablespoons olive oil', '1/2 teaspoon salt', '1/4 teaspoon ground black pepper', '8 skin-on, bone-in chicken thighs (about 3 pounds)', '1 medium red onion, thinly sliced', '1/4 pound (one thick piece) baked ham, cut into matchsticks', '1 clove garlic, thinly sliced', '1 jalape\\xc3\\xb1o or other small hot chili pepper, seeded and chopped', '1 (15-ounce) can chopped tomatoes', '1 cup chicken stock', '1/2 cup pitted green olives, coarsely chopped', '2 tablespoons chopped fresh parsley']",14,"['1 Roast the chiles: Turn on the broiler and set a rack about 5 inches from the broiler element. Brush the chiles with enough oil to lightly coat. Broil for 5 minutes, turning several times, or until they are charred. (Alternatively, roast the chiles on the open flame of a gas stovetop.)', 'Transfer to a bowl, cover with a plate to help steam and soften the skins, and set aside for 5 minutes.', '2 Peel the chiles: Carefully pull the charred skin of the chili by hand. Cut the chile open, remove and discard the seeds, and chop coarsely.', '3 Brown the chicken: Trim away the excess fat from the thighs. Sprinkle all over with salt and pepper.', 'In a large deep skillet or Dutch oven, heat the oil over medium-high heat. Working in batches, add half of thighs, skin side down. Cook for 4 minutes, or until golden on the undersides. Turn and brown the other sides for 3 minutes.', 'Transfer the chicken to a bowl. Brown the remaining thighs in the same way. Transfer the thighs to the bowl.', '4 Make the sauce: Discard all but 2 tablespoons fat from the pan. Add the onion, ham, and garlic. Cook, stirring often, for 5 minutes until the onions have started to soften. Add the roasted chiles and jalape\\xc3\\xb1o. Continue cooking, stirring often, for 2 minutes.', 'Add the tomatoes and stock. Use a wooden spatula to scrape up the dark glaze from the bottom of the pan. Bring to a boil, lower the heat, and partially cover. Simmer 5 minutes.', '5 Cook the chicken: Return all the chicken to the pan, skin side up, along with any juices in the bowl. It\\xe2\\x80\\x99s ok if the thighs are a tight fit. Spoon some of the sauce over the chicken. Return to a boil, lower the heat, and partially cover.', 'Simmer for 20 to 25 minutes, or until the chicken is cooked through, opaque, and registers 165\\xc2\\xb0F with a digital thermometer.', '6 Finish and serve: Taste the sauce for seasoning and add more salt and black pepper, if you like. Sprinkle the dish with the chopped olives and parsley. Serve hot.']",11
150,Barbecued Pork Shoulder on a Gas Grill Recipe,60,480,540,"['One 4 pound pork shoulder roast, preferably Boston butt, boneless or bone-in (you can easily make two 4 pound roasts in about the same amount of time if your grill is big enough to accommodate them both)', '5 to 6 cups of wood chips, hickory, oak, apple, or other fruit wood', 'BBQ Rub (enough for a 4 pound roast)', '2 Tbsp brown sugar, packed', '2 Tbsp white sugar', '2 Tbsp paprika', '1 Tbsp kosher salt', '1 1/2 teaspoons ground cumin', '1 1/2 teaspoons garlic powder', '1 1/2 teaspoons chipotle chile powder', '1 1/2 teaspoons black pepper', 'Santa Maria Rub (enough for a 4 pound roast)', '1 Tbsp salt', '1 Tbsp finely ground black pepper', '1 Tbsp garlic powder', '1 Tbsp onion powder', '1 teaspoon cayenne', '1 Tbsp dried oregano', '1 teaspoon dry rosemary (or fresh, finely minced)', '1/2 teaspoon dry sage', '1/4 teaspoon sugar']",21,"['The day before:', '1. Prepare the rub. Mix all the ingredients for the rub together, breaking up any clumps. Taste the rub as you make it and see if you like the taste, adjust accordingly.', '2. Rub the roast with the rub. Unwrap the pork roast and place it on its butcher paper or in a roasting pan, something that can catch the rub. With your (clean) hands work the rub mixture into the pork shoulder all over, including inside any crevasses you may find in a boneless roast where the bone had been. Be generous with the amount of rub.', 'Rewrap it in the butcher paper or wrap it in plastic and place it in a pan (to catch any liquid that may drip out), and refrigerate it overnight.', 'The night before:', '3. Soak the wood chips. Take 3 or 4 large handfuls of wood chips (hickory, oak, apple or other fruit wood) and place them in a bowl and cover them with water to soak them overnight (can also do for an hour before using).', 'I think it helps to have a mix of sizes, from small chips to larger (1-inch x 2-inch) chunks. The smaller chips will get smoking more quickly, but will burn out more quickly too. The larger chunks will take longer to catch, but last well past when the smaller chips have burned themselves out.', 'The Day Of:', '4. Bring the chilled roast to room temp. 1 to 2 hours before you start the barbecue, take the pork out of the refrigerator to come to room temperature.', ""Now, if you forget to do this, which I have done, you can still go ahead and BBQ it. You\\'ll likely be finishing it in the oven anyway. It will just take a bit longer to cook."", '5. Prepare your grill. Remove one of the grill grates. This will be your ""hot"" side, where the wood chips will go. The other side of the grill will be the ""cool"" side, and where the meat will be, away from direct heat.', 'Depending on the structure of your grill, you may want to remove the ""flavor bar"", the thin metal piece with lots of holes in it that sits over the burner. The wood chips will smoke more easily if they lay in a (fireproof metal or foil) container directly on the burner.', '6. Place a tray of water on the grill: If there is room on your grill, place a small aluminum tray of water on the grill to help moderate the heat and help keep the roast from getting too dry. A good place to place this is on an upper rack if you grill has one.', '7. Get the grill smoking. Create a double layered aluminum foil boat with a handful or two of damp wood chips in it.', 'Place the boat directly on the burner on the ""hot"" side of the grill if you can (otherwise place on the flavor bar). Turn the grill on to medium flame, cover the grill and let it heat up until the the wood chips start smoking.', ""You\\'ll either see smoke coming out of the grill, or if you raise the lid, you\\'ll see smoke coming out of the wood chip boat. You should see and smell the smoke."", ""You\\'ll be replenishing the wood chips periodically for the next several hours so put more dry chips into water to soak if needed."", '8. Cook roast on cool side of grill, fat side up: Once the grill is smoking, place the roast on the grill grates on the cool side of the grill, away from direct heat. If your grill has a hot spot, position the roast away from it. If there is a fatty side to the meat, put that side facing up; the fat will render over time and baste the pork.', ""Cover the grill, lower the flame, and let the cooking begin. The temperature you want to maintain ideally is 225\\xc2\\xb0F. Try to keep it close to that temperature, within a range of 210\\xc2\\xb0F to 240\\xc2\\xb0F. If the temperature goes too high, the roast may dry out. If it\\'s too low, it will take forever to cook."", '9. Maintain the smoke and the 225\\xc2\\xb0F temperature. This is the tricky part. You will want to maintain smoke in the grill for at least 4 hours (6 hours for a bigger roast). You will also want to maintain a cooking temperature of around 225\\xc2\\xb0. So, you have to check the grill!', 'Check if the temperature is being maintained between 210\\xc2\\xb0F and 240\\xc2\\xb0F, and check to make sure the chips are still producing smoke, every half hour. About once an hour you will likely need to replenish the chip boat with more wood chips.', 'Resist the temptation to open the grill more than once an hour. Every time you open the grill the inside temperature drops and you increase your overall cooking time.', ""I found the best way to check the temperature, since I don\\'t have a gauge in the grill itself, is to put an instant read meat thermometer into an opening in the hood on the meat side (cool side) of the grill, and just keep checking it. Make sure sensor tip of the probe is not touching the meat itself."", 'You want to avoid opening up the hood too often, because every time you do that, you lose heat. Of course, if your gas grill gets too hot, opening the hood can cool it down quickly.', 'Expect a minimum cooking time, if you have been diligent at maintaining a 225\\xc2\\xb0F, of 90 minutes per pound. So if you are cooking a 4 pound roast, total cooking time will be at least 6 hours (and easily more). An 8 pound roast will take at least 12 hours of cooking time.', 'If you want to cook 8 pounds of pork shoulder more quickly, I recommend starting with two 4 pound roasts, spaced on the grill a few inches apart, which will cook in just a little more time than an 8 pound roast.', '10 Reposition the roast: After 2 or 3 hours, during one of your hourly opening of the grill to refresh the wood chips, reposition the roast so that the side that was closest to the heat is now furthest from the heat.', ""11. Test internal temperature of meat. After about 5 hours, start taking the pork\\'s internal temperature: You can eat it at 165\\xc2\\xb0F, but if you are making pulled pork the meat needs to be ideally 195\\xc2\\xb0F."", '12 Remove from heat, let rest: When the meat reaches 195\\xc2\\xb0F, remove it from the heat, tent it loosely with foil over a cutting board (to catch the juices) and let it rest for at least 30 minutes, and preferably 1 hour.', ""If after 6 hours of cooking, if the meat hasn\\'t reached 195\\xc2\\xb0 internal temp (usually after 6 hours, the internal temp on my roasts is about 155\\xc2\\xb0F), my recommendation is to remove it from the grill and finish in the oven."", 'To finish in the oven, wrap the roast in aluminum foil to help prevent it from drying out in the oven, and place it in a roasting pan, in a 300\\xc2\\xb0F oven.', 'Cook until the internal temperature of the roast reaches 195\\xc2\\xb0F. If your starting internal meat temperature is 150\\xc2\\xb0F or so, this can take anywhere from an hour to two hours.', 'When it reaches temperature, remove the roast from the oven and let rest for at least 30 minutes, up to an hour.', '13. Pull the pork. Pull the pork with 2 forks. Only now do you add any barbecue sauce (and any accumulated juices) to the meat. Taste it first! It might not need sauce at all, and if it does, add only a little at a time. One of the biggest sins of barbecue is to over-sauce perfectly good meat.', 'Serve on a bun with or without sauce, and with or without coleslaw. Also great with grilled or raw pineapple.']",35
151,White Bean and Ham Soup Recipe,10,210,220,"['1 lb or 2 1/2 cups dry white beans\\xe2\\x80\\x94Cannellini or Great Northern', '2 quarts of water', '2-3 lbs of smoked ham shanks or ham hocks', '2 teaspoons Herbes de Provence, or Italian seasoning', '1 Tbsp extra virgin olive oil', '1 cup of diced onions (about 1 small onion)', '1 cup chopped celery (about 2-3 ribs)', '2/3 cup chopped carrots (about 1 medium carrot)', '2-3 cloves garlic, minced', 'Tabasco sauce', 'Salt and pepper', 'Fresh parsley']",12,"['1 Soak the dry beans in hot water: Fill a pot large enough to hold the beans with water and bring to a boil. Turn off the heat, add the beans and soak the beans for about 2 hours. Drain the water.', '2 Make the ham broth: While the beans are soaking in step 1, put the ham shanks or ham hocks in a separate large pot and cover them with 2 quarts of water. Add the herbes de Provence or Italian seasoning. Heat on high heat until the water comes to a simmer, then lower the heat, partially cover and maintain the simmer for about an hour.', '3 Saut\\xc3\\xa9 the onions: Heat olive oil in a small saut\\xc3\\xa9 pan on medium high heat. Add the chopped onions and cook until translucent, about 5 to 6 minutes. Add the minced garlic and cook a minute more.', '4 Add vegetables and beans to the ham broth: Once the ham hocks or shanks have been simmering for an hour, add the drained soaked beans from step 1, the onions, garlic, and the chopped celery and carrots. Cook for another 40 minutes or so, uncovered, until the vegetables are soft and the ham meat easily pulls away from the bone. Remove the ham bones from the soup and pull off any meat and return it to the soup. Discard the bones.', '5 Season to taste: Add several drops of Tabasco to taste. Add salt and pepper to taste.', 'Serve with a pinch of chopped fresh parsley.']",6
152,Turkey Chili (with Leftover Turkey) Recipe,10,80,90,"['2 tablespoons extra virgin olive oil', '2 cups chopped onion', '1 cup chopped green bell pepper', '4 garlic cloves, chopped fine', '2 tablespoons chili powder (or up to 4 Tbsp if you like it spicier)', '1 tablespoon ground cumin', '3 15-ounce cans crushed tomatoes (fire roasted if you can get it)', '1 tablespoon tomato paste', '1 cup of turkey stock or chicken stock', 'Two 15 oz cans kidney beans, drained', '1 teaspoon dried oregano', '1 tablespoon sea salt, plus more if desired to taste', '1/2 teaspoon black pepper', '3 to 4 cups of shredded, cooked turkey meat', '1 to 3 teaspoons sugar (optional)', 'Shredded cheddar cheese, chopped green or red onion, sour cream for optional garnish.']",16,"['1 Saut\\xc3\\xa9 the onions, peppers, garlic, and spices: In a large, 8-quart, thick-bottom pot, heat the olive oil on medium high heat. Add the onions and green peppers and cook, stirring, until golden, about 5 minutes.', 'Add the garlic, chili powder, and cumin, and cook, stirring, for a minute or two more. Add a bit more olive oil if needed.', '2 Add tomatoes, beans, stock, cooked turkey: Add tomatoes, tomato paste, stock, kidney beans, oregano, salt, pepper, and cooked turkey meat. Bring mixture to a simmer and reduce heat to low. Simmer, partially covered, for an hour.', '3 Add salt: Salt to taste. Add sugar to taste if needed to balance the acidity of the tomatoes.', 'The chili may be made in advance and chilled for 2 days, or frozen for 2 months.', '4 Serve with toppings: Serve with shredded cheddar cheese, chopped red onion, and or sour cream. Serve alone, over rice, or with cornbread.']",6
153,"How To Make Fast, No-Soak Beans in the Instant Pot",0,30,30,"['1 pound dried beans (see below for cooking times for specific beans)', '8 cups water', '1 tablespoon olive oil', '1 to 2 teaspoons salt', '2 o 3 cloves peeled garlic, optional', '1 bay leaf, optional', 'Special equipment:', '6- to 8-quart pressure cooker (I use a 6-quart Instant Pot)']",8,"['1 Combine all ingredients in the pressure cooker. Do not fill the pressure cooker more than half full.', '2 Secure the lid. Make sure the pressure regulator valve is closed. (On an Instant Pot, this means it will be set to the the ""sealing"" position.)', '3 Cook the beans: Here are the cooking times for unsoaked beans in the Instant Pot. Cooking times will be similar for other electric pressure cookers; cooking time will be slightly less for stovetop pressure cookers. Double-check the manual that came with your pressure cooker for more exact cooking times:', 'Black beans: 20 to 25 minutes', 'Black-eyed peas : 20 to 25 minutes', 'Great Northern beans: 25 to 30 minutes', 'Navy beans: 25 to 30 minutes', 'Pinto beans: 25 to 30 minutes', 'Cannellini beans: 35 to 40 minutes', 'Chickpeas (garbanzo beans): 35 to 40 minutes', 'Red kidney beans: 25-30 minutes (boil for 10 minutes before pressure cooking)', 'Cook beans at high pressure for the time recommended above. The pressure cooker will take 15 to 20 minutes to come to full pressure before cooking begins.', '4 Let the pressure release: Once cooking is complete, you can let the pressure release naturally on its own, which takes about 20 to 30 minutes, or you can do a ""quick release"" by opening the pressure valve on the top of the pressure cooker. If doing a rapid release, be careful because the bean liquid sometimes foams into the valve.', ""I recommend letting the pressure release naturally for as long as you\\'re able before the beans are needed. This helps the beans retain their shape and avoids the bean liquid foaming."", 'What to do if your beans aren\\\'t quite done: Put the lid back on the pressure cooker and make sure the release valve is set back to ""sealing."" Cook at high pressure for another 5 to 10 minutes (depending on if you think your beans need just a little more time or a little more time to finish). The pot will quickly come back up to pressure because the contents are already hot. Check your beans after the extra cooking time and continue cooking for longer if needed.', '5 Using and storing your beans: The beans can be strained and used right away, or cooled and stored in their cooking liquid. They will keep for up to a week refrigerated or up to 3 months in the freezer.']",16
154,"Quinoa Bowls with Sweet Potatoes, Black Beans, and Spinach Recipe",10,45,55,"['For the sauce:', '1/4 cup sour cream', '1 teaspoon Frank\\xe2\\x80\\x99s Red Hot Sauce or more to taste', '1 teaspoon fresh lime juice', '1 1/2 teaspoon water', 'For the quinoa:', '2 cups water', '1 cup dry quinoa', '1 teaspoon olive oil', '1/2 teaspoon kosher salt', 'For the pepitas:', '1/2 teaspoon olive oil', '1/4 cup pepitas', '1/4 teaspoon kosher salt', 'For the sweet potatoes:', '1 pound sweet potatoes, peeled, and cut into \\xc2\\xbd inch cubes.', '2 teaspoons olive oil', '1/4 cup water', '2 tablespoons brown sugar', '1/4 teaspoon smoked paprika', '1/4 teaspoon cayenne pepper', '1/4 teaspoon kosher salt', 'For the black beans:', '1 teaspoon olive oil', '1/2 medium yellow onion, diced small', '2 cloves minced garlic', '2 teaspoons dried oregano', '1 teaspoon cumin', '1 bay leaf', '1 (15-ounce) can black beans, rinsed and drained', '1/4 cup water', '1 teaspoon apple cider vinegar or lime juice', 'For the spinach:', '8 ounces baby spinach, two large handfuls per person', '3 tablespoons water', '2 teaspoons olive oil', '1/2 teaspoon kosher salt', 'For the garnish:', '2 ounces cotija cheese, crumbled', 'Lime wedges', 'Chopped fresh cilantro']",41,"['1 Make the sauce: In a small bowl, combine sour cream, Frank\\xe2\\x80\\x99s Red Hot, lime juice, and water. Cover and place in the refrigerator.', '2 Cook the quinoa: Put the quinoa in a fine mesh strainer and rinse it under cold water for about a minute. In a medium-sized pot, combine water, quinoa, 1 teaspoon oil, and 1/2 teaspoon salt.', 'Cover and cook over medium heat until the water is absorbed, about 15 minutes. Remove from the heat, fluff with fork, and keep it covered.', '3 Toast the pepitas: Set a large skillet over medium heat. Add 1/2 teaspoon of olive oil. When the oil shimmers, add the pepitas and the salt. Stir frequently and toast for about 5 minutes until the seeds start popping and some parts turn a toasty brown.', 'Transfer to a large plate. Scoot pepitas to one side. You\\xe2\\x80\\x99ll put the sweet potatoes on the other side.', '4 Cook the sweet potatoes in sugar and spices: Using the same skillet you used to toast the pepitas, keep the heat at medium and add 2 teaspoons oil. Once the oil starts to shimmer, add the cubed potatoes. Stir to coat. Cook for about 1 minute. Stir again. Add the water. Cover and leave untouched for 5 minutes.', 'Combine sugar, paprika, cayenne, and salt in a small bowl. Add the spice mixture to the potatoes. Stir to coat.', 'Cook uncovered for 7 additional minutes. Don\\xe2\\x80\\x99t stir. The sugar should be caramelized, one side of the potatoes should be brown, and the potatoes should be tender but still hold together.', 'Remove the potatoes from the skillet and place them on the plate alongside the pepitas. Tent with foil to keep them warm.', '5 Make the beans: Return the skillet to the burner over medium heat and add 1 teaspoon of olive oil. Once the oil shimmers, after about a minute, add the diced onion, garlic, oregano, cumin and bay leaf. Cook until the onions are softened, about 2 minutes.', 'Add the beans, 1/4 cup of water, and 1 teaspoon apple cider vinegar. Turn to medium-high, stirring occasionally until the liquid is reduced, about 5 minutes.', 'Divide the beans evenly among four bowls. Wipe out the pan with a paper towel and set it over medium heat.', '6 Wilt the spinach: Add 3 tablespoons of water to the pan followed by all of the spinach. Drizzle with 2 teaspoons of olive oil and 1/2 teaspoon kosher salt. Toss gently until the spinach is wilted\\xe2\\x80\\x94this should take about 2 minutes.', '7 Serve the bowls: To the bowls with the black beans, add a 1/2 cup of sweet potatoes, 1/2 cup quinoa, and the spinach. Top with toasted pepitas, crumbled cotija, a squeeze of lime, and a drizzle of creamy lime hot sauce.']",14
155,"Spicy, Citrusy Black Beans Recipe",0,120,120,"['4 cups dried black beans', '2 1/2 quarts (10 cups) water', '2-3 fresh sprigs oregano, or 1 tablespoon dried', '3 bay leaves', '6 small or 3 large sage leaves', '2 teaspoons salt', '4 tablespoons extra virgin olive oil', '2 yellow onions, chopped', '2 chopped peppers \\xe2\\x80\\x93 bell pepper, Anaheim, or jalape\\xc3\\xb1o (your choice, depending on taste for heat), seeds, stems and ribs discarded', '6 cloves crushed garlic', '2 tablespoons Ancho red chili sauce, or chili powder or Tabasco to taste*', '1-2 teaspoons of pur\\xc3\\xa9ed chipotle in adobo, chipotle Tabasco, or chipotle powder (to taste)', '1 tablespoon cumin, (crushed whole toasted cumin seed is best, if possible)', '3 tablespoons frozen orange juice concentrate or 1/2 cup fresh orange juice', 'Juice of 1 lime', '2 tablespoons rice wine vinegar', 'Chopped fresh cilantro for garnish']",17,"['1 Soak the beans (optional): Rinse and sort the beans, discarding any stones or shriveled beans. You can soak the beans overnight in cold water (cover with several inches of water) OR pour enough boiling water over them to cover by a few inches and soak them for an hour OR skip the pre-soaking step.', 'Soaking will speed up the cooking process. If you soak, discard the soaking liquid after soaking.', '2 Cook the beans: Add beans to a large pot with 2 1/2 quarts (10 cups) of water. Add oregano, bay leaves, and sage. Bring the beans to a boil and reduce heat to a simmer.', 'Cook until the beans are soft, but not quite done. The time will vary depending on how large, dry, or old your beans are, and if you have pre-soaked them, from anywhere from 30 minutes to an hour and a half.', '3 Saut\\xc3\\xa9 onions and peppers, add spices: While the beans are cooking, saut\\xc3\\xa9 onions and peppers in olive oil until soft. Add chili sauce, chili powder, and/or chili pur\\xc3\\xa9e, cumin, and garlic. Saut\\xc3\\xa9 until spices are fragrant.', '4 Fish out and discard the bay leaves, stems of oregano, and sage leaves from the pot of beans. Remove, but reserve, extra cooking liquid until there is about 1/2-inch of liquid above beans.', '5 Add the onion mixture and salt to the pot of beans. Cook another hour or so until thickened. Add reserved liquid if needed.', '6 Add half of the orange juice, and simmer. Adjust chili heat at this point \\xe2\\x80\\x93 you may or may not want to add more of your chili paste.', 'Just before serving, add remaining orange juice, lime juice, and vinegar. Salt to taste. Garnish with chopped fresh cilantro.', 'Serve with corn tortillas, and/or rice, sour cream, and salsa.']",10
156,"Mexican Quinoa Salad with Black Beans, Corn, and Tomatoes Recipe",15,25,40,"['1 cup uncooked quinoa, well rinsed', '1/2 teaspoon salt', '2 cups water', '1/3 cup diced red onion', '2 Tbsp lime juice', '1 15-ounce can black beans, drained and rinsed', '1 cup frozen corn, defrosted, OR 1 cup of fresh corn, parboiled, drained and cooled (approximately the amount of kernels from one ear of corn)', '3 medium tomatoes, seeded and cut into chunks', ""5 ounces Queso fresco, Queso Panela, fresh Mozzarella or other mild farmer's cheese, cut into 1/4-inch to 1/2-inch cubes"", '1 jalape\\xc3\\xb1o, seeded and finely chopped', '1/4 cup chopped cilantro, including tender stems, packed', '3 Tbsp extra virgin olive oil']",12,"['1 Cook the quinoa: Put the rinsed quinoa, salt and water into a pot and bring it to a boil. Cover and simmer gently until the quinoa absorbs all the water, about 10-15 minutes.', 'Remove from heat and let sit for 5 minutes. Place into a large bowl and fluff up with a fork to help it cool more quickly.', '2 Soak onions in lime juice: While the quinoa is cooking, prepare the rest of the salad. Soak the red onions in the lime juice and set aside. Soaking the onions in lime juice (or lemon juice or water) helps take the edge off of them.', '3 Mix the prepped black beans, corn kernels, tomatoes, cheese, jalape\\xc3\\xb1os, cilantro, and oil into a large bowl.', '4 Add quinoa and onions to bean mixture: When the quinoa has cooled, mix it into the bean mixture. Add the red onion and the lime juice and add salt, more oil or lime juice to taste.', 'Serve at room temperature.']",6
157,Turkey Black Bean Enchiladas Recipe,10,50,60,"['Enchilada sauce:', '7 Tbsp chili powder (note that chili powders vary in strength, you may want to start with less and add more to taste)', '2 teaspoons ground cumin', '1 teaspoon crushed oregano', '1 teaspoon garlic powder', '1 teaspoon cinnamon', '1/8 teaspoon ground cloves', '1 teaspoon sugar', '2 teaspoons salt (less if using salted stock)', '1/4 cup flour', '2 Tbsp extra virgin olive oil', '2 cups of turkey or chicken stock', 'Enchilada filling:', '1 Tbsp extra virgin olive oil', '1 medium onion, chopped', '3 garlic cloves, minced', '1 to 2 jalape\\xc3\\xb1o chili peppers (1 for mild, 2 or more for spicy), seeded, minced', '3 cups cooked turkey meat, chopped', '1 15-ounce can black beans, rinsed and drained, or homemade', '8 ounces Monterey Jack cheese, grated (makes 2 cups grated cheese)', '1/4 cup chopped fresh cilantro', '2 Tbsp lime juice (can sub lemon juice)', '1 to 2 teaspoons salt or more to taste', '8-16 flour tortillas, depending on size and thickness', 'Garnishes:', 'Chopped red onion', 'Chopped avocado', 'Chopped fresh cilantro', 'Sour cream or crema fresca', 'Ice berg lettuce, sliced thin and sprinkled with salt and vinegar']",30,"['1 Make enchilada sauce: In a medium bowl, whisk together the chili powder, cumin, oregano, garlic powder, cinnamon, ground cloves, sugar, salt, and flour.', 'Heat olive oil on medium heat in a cast iron pan (or other thick-bottomed saut\\xc3\\xa9 pan). Add the spices and cook for a minute or two, until fragrant.', 'Slowly whisk in the stock, until smooth. Let come to a simmer, cook for a minute, then remove from heat, cover and set aside.', '2 Prepare the filling: Heat olive oil in a saut\\xc3\\xa9 pan on medium heat. Add the chopped onion and jalape\\xc3\\xb1os and cook until the onions are translucent, about 3-4 minutes. Add the garlic and cook a minute more. Remove from heat.', 'Place onion mixture in a medium mixing bowl. Mix in the cooked turkey meat, the beans, 1 cup of the grated cheese, 1/4 cup of chopped cilantro, 2 Tbsp lime juice, and 1/2 a cup of the enchilada sauce. Add 1 to 2 teaspoons of salt, or more to taste. Set aside.', '3 Assemble the enchiladas: Preheat the oven to 350\\xc2\\xb0F. Heat the pan with the enchilada sauce on medium heat. Spread 1/2 cup of the sauce over the bottom of a 9x13 casserole dish (pyrex works well).', 'Working one at a time, dip the flour tortillas in the sauce to coat them on both sides. If the sauce is too thick, thin it with a little water.', 'Place the tortilla in the casserole dish and place anywhere from 1/4 of a cup to 1/2 cup of the filling in the middle of the tortilla.', 'Roll up the tortilla around the filling and place it in the casserole dish. Continue to roll up the rest of your tortillas until they fill the casserole dish. Cover the enchiladas with the remaining sauce, and sprinkle with the remaining cheese.', '4 Bake: Place in the oven and bake, uncovered, for 15 to 20 minutes, until the enchiladas are heated through and the cheese has melted.', '5 Sprinkle with lime juice, serve with garnishes: Sprinkle with a little more lime juice before serving. Serve with chopped red onion, chopped avocado, fresh cilantro, sour cream or crema fresca, and thinly sliced iceberg lettuce that has been dressed with vinegar and salt (no oil).']",11
158,White Beans and Sausage Recipe,5,380,385,"['1 pound dried cannellini beans', '2 tablespoons extra virgin olive oil', '4-5 fresh sage leaves', '2 cloves garlic, crushed', '3 teaspoons kosher salt', '4 black peppercorns', 'OR', '4 15-ounce cans cannellini beans', '  5 tablespoons extra olive oil', '1 1/2 pounds sweet Italian sausage', '4 cloves garlic, peeled and crushed', '3-4 canned plum tomatoes, chopped', 'Pinch red pepper flakes', '1 cup tomato pur\\xc3\\xa9e', 'Salt (about 2 teaspoons) and freshly ground black pepper']",15,"['Preparing dry beans if using:', '1 Rinse and soak the beans: Rinse the dry beans under cold running water, removing any stones you may find. Place the beans in a large pot and cover with at least a couple of inches with cold water. Soak for at least 4 hours. (To do a quick soak, you can pour boiling water over the beans and cover by a couple of inches, and just soak for one hour instead of four.)', '2 Cook beans with aromatics: Drain the beans. Return the beans to the pot and add 3 quarts of water to the pot. Add 2 Tbsp olive oil, the sage leaves, 2 cloves crushed garlic, 3 teaspoons kosher salt, and the peppercorns. Cover, bring to a simmer on medium heat, and simmer beans for one hour. Lower the heat so that the beans are barely simmering. Cook for an additional 1-2 hours, or until beans are just tender. Note that the fresher the beans the shorter the cooking time, the older the beans the longer the cooking time. Remove from heat and let cool in cooking liquid. Set aside 1/2 cup of the cooking liquid, drain the rest from the beans.', 'Preparing canned beans if using:', ""Taste the liquid in the cans of beans. If it tastes good (and it should), drain the beans and reserve 1/2 a cup of the bean liquid. If the liquid doesn't taste good (which may happen if the can has been sitting around too long), discard the liquid and use 1/2 cup of water instead of the bean liquid in the next step."", 'Preparing the beans and sausage:', '3 Cook the sausage: Heat one tablespoon of olive oil in a large, heavy-bottomed skillet over medium heat. Remove sausages from their casings (if the sausage has come in casings), and cook in the skillet until lightly browned, about 3-4 minutes.', '4 Add the reserved bean cooking (or can) liquid, 4 Tbsp olive oil, garlic, chopped tomatoes, and red pepper flakes, stirring occasionally until slightly thickened, about 5 minutes.', '5 Add the reserved beans and tomato pur\\xc3\\xa9e. Season to taste with salt and pepper. Simmer a few minutes longer, stirring gently, until sausage is cooked through and the sauce has thickened. Be careful not to break up the beans.']",9
159,Mexican Three Bean Salad Recipe,10,80,90,"['1 15-ounce can black beans, drained and rinsed', '1 15-ounce can pinto beans, drained and rinsed', '1/2 pound green beans', 'Salt', '3 tablespoons extra virgin olive oil', '3 green onions, sliced', '1-2 jalapenos, seeded, chopped', '1 large garlic clove, sliced thin', '1 cup Cotija queso seco cheese, crumbled (can sub feta)', '1/4 cup chopped cilantro', '1/3 cup lime juice', '1/4 cup sugar']",12,"['1 Boil the green beans: Cut the ends off the green beans and slice into pieces about an inch long. Fill a medium sized pot halfway with well salted water. Bring to a boil.', 'Add the beans to the pot and boil for 5 minutes, or as long as it takes for the beans to get tender. Green beans can be highly variable in how long it takes to cook them to tenderness. More mature beans can take longer, up to 20 minutes.', '2 Combine with pinto beans, green onions, jalape\\xc3\\xb1os, garlic, Cotija, olive oil: Drain the green beans and put in the bowl with the pinto and black beans. Drizzle the olive oil over everything and toss to combine. Mix in the green onions, jalape\\xc3\\xb1o, garlic, and Cotija cheese.', '3 Make dressing, add to salad to marinate: In a separate bowl, mix the lime juice and sugar until the sugar dissolves, then add it to the salad. Coat the beans well and let marinate for at least 1 hour, preferably several hours.', '4 Right before you serve, toss in the cilantro. Add more salt to taste if needed.']",5
160,Lemony Broccoli Rabe with White Beans Recipe,10,12,22,"['1 bunch broccoli rabe, ends trimmed (about 2 1/2 pounds)', '1/2 teaspoon salt, or more to taste', '4 tablespoons olive oil', '1 lemon, very thinly sliced', '1 clove garlic, chopped', '2 (15-ounce) cans cannellini beans, drained and rinsed', '1/2 teaspoon crushed red pepper', '1/2 cup water, or more if needed', '1 lemon, cut into wedges, for serving', 'Extra crushed red pepper, for serving']",10,"['1 Prepare the broccoli rabe: Cut any thick stems (with leaves still attached) in half lengthwise. Then cut all the stems into 4-inch pieces.', '2 Blanch the broccoli rabe: Bring a saucepan of water to a boil and add 1/4 teaspoon of the salt. Add the broccoli rabe and cook for 1 minute, turning them in the water occasionally so they cook evenly.', 'Drain and rinse with very cold water until the broccoli is no longer warm. Pat dry with paper towels.', '2 Cook the lemon slices: In a large heavy skillet over medium-high heat, heat 2 tablespoons of the olive oil. Add the lemon slices, overlapping if necessary, and cook without disturbing for 2 minutes. Turn and cook the other sides for 2 minutes more. The slices should be browned in spots. Transfer to a clean plate.', '3 Warm the white beans: In the same skillet over medium heat (no need to clean), heat the remaining 2 tablespoons olive oil. Add the garlic, white beans, red pepper, and remaining 1/4 teaspoon salt. Cook, stirring occasionally, for 2 minutes. Add the water and bring to a boil, lower the heat, and simmer for 1 minute more.', '4 Add the broccoli rabe to the pan and cook: Add the broccoli rabe and cook, stirring often, for 3 minutes, or until it is tender when the stems are pierced with the tip of a knife. During cooking, add more water if the pan seems dry. Stir in the lemon slices and turn them in the mixture until the slices are just heated through.', 'Taste for seasoning and add more salt, if you like. Serve with lemon and red pepper.']",7
161,"White Bean Soup with Ham, Pumpkin, and Chard Recipe",20,150,170,"['2 tablespoons extra virgin olive oil', '2 cups chopped yellow onion', '3 bay leaves', '2 stalks of celery, chopped', '4 cloves garlic, peeled and minced', 'One 2 pound whole sugar pumpkin, halved, seeds scooped out, flesh peeled, and cut into 1-inch chunks (resulting in 3 1/2 cups or 1 pound of chunks)', '1/2  pound ham hock', '8 cups chicken stock', '1 15-ounce can of whole peeled tomatoes, drained OR 1 large fresh, ripe tomato, peeled and chopped', '6 sprigs of thyme, tied with string (or 1/2 teaspoon dried thyme)', '2 15-ounce cans of cannellini white beans, rinsed and drained, or homemade', '4 large Swiss chard leaves (can substitute kale), center rib removed, leaves roughly chopped', 'Freshly ground black pepper to taste']",13,"['1 Saut\\xc3\\xa9 onions, bay leaves, celery, garlic: Heat the olive oil on medium heat in a large, thick-bottomed pot (5 to 6 quart). Add the onion and the bay leaves and cook for 2 to 3 minutes, until slightly softened. Add the chopped celery, cook for 2 to 3 more minutes. Add the minced garlic and cook for a minute more.', '2 Add pumpkin, ham hock, stock, tomatoes, thyme: Add the chopped pumpkin and the ham hock to the pot. Add the chicken stock, tomatoes, and thyme. Increase heat to bring to a simmer. Reduce heat to maintain a simmer, uncovered. Let simmer for an hour and a half.', '3 Remove ham hock, add white beans, chard: Remove the ham hock from the soup pot, to a plate to let cool enough to handle.  Add the white beans and cook for 15 minutes. Add the chopped chard, simmer until chard is wilted, a few minutes more.', '4 Strip ham from bone, chop, return to soup: Strip the meat from the ham hock, chop it, and return to the pot. Add 1 to 2 cups of water to the soup to thin it to your preference. Remove the bay leaves before serving.', 'Add freshly ground black pepper and adjust seasonings to taste.']",5
162,Sweet Potato White Bean Dip Recipe,10,30,40,"['1 pound sweet potatoes', '2 shallots (about 1/4 pound), cut into 4 pieces each', '4 tablespoons olive oil, divided', '1 teaspoon sea salt', '1 15-ounce can (or 1 1/2 cups cooked) white beans, drained (reserve the liquid) and rinsed', '1 to 2 chipotles in adobo sauce', '2 tablespoons lime juice', '1/4 cup cilantro, plus more for serving', 'For serving:', 'Chips', 'Chopped cilantro', 'Special equipment:', 'Food processor']",13,"['1 Roast the sweet potatoes: Preheat your oven to 450\\xcb\\x9aF. Peel the sweet potatoes and cut into 1 1/2-inch cubes.', 'Place both the sweet potatoes and shallots on a rimmed baking sheet and toss with 2 tablespoons of olive oil and sea salt. Roast until the sweet potatoes are tender, about 25 to 30 minutes.', '2 Make the dip: Place the roasted sweet potatoes and shallots in a food processor or blender along with the white beans, 2 tablespoons olive oil, chipotles, lime juice, and cilantro. Puree, adding reserved bean liquid as needed, until the dip is smooth and thick, like a hummus would be.', '3 Serve the dip: Serve immediately or refrigerate until needed; serve room temperature or cold. Sprinkle the top of the dip with cilantro, and serve with your favorite tortilla chips or an assortment of fresh vegetables.']",4
163,Pinto Beans with Bacon and Jalape\xc3\xb1os Recipe,5,25,30,"['1 tablespoon extra virgin olive oil', '2 to 3 whole jalape\\xc3\\xb1o chile peppers', '2 to 3 thick-cut slices of bacon', '2 cups of chopped onion', '2 medium clove of garlic, minced', '4 cups of cooked pinto beans (2 15-ounce cans, rinsed and drained)', 'Salt', '1/2 cup, loosely packed, chopped fresh cilantro']",8,"['1 Cook and prep jalape\\xc3\\xb1os: Heat oil in a medium skillet on high heat. Put the jalape\\xc3\\xb1os in the pan and stir to coat with the oil. Let cook, turning occasionally, on all sides, until all sides are nicely browned (about 10-15 minutes, depending on how hot your burner is).', 'Remove from pan. Cut away and discard the stem, core, seeds, and veins. Coarsely chop the remaining jalape\\xc3\\xb1o flesh.', '2 Cook bacon: While the jalape\\xc3\\xb1os are cooking, cook the bacon slices on medium low heat in a large skillet, until crispy. Remove bacon from the pan to a paper towel-lined plate. Pour off (do not discard down the drain!) all but 2 tablespoons of bacon fat.', '3 Cook onion in bacon fat: Add the chopped onion to the pan with the bacon fat. Increase the heat to medium high and cook until translucent and lightly browned. Add the minced garlic and cook a minute more. While the onion is cooking, chop the cooked bacon.', '4 Add the cooked beans, chopped bacon, and the chopped jalape\\xc3\\xb1os to the pan and stir to mix. Sprinkle with salt.', 'Serve with chopped fresh cilantro, and steak and salsa.']",6
164,White Bean and Cherry Tomato Salad Recipe,10,25,35,"['1 15-ounce cans of white beans, such as Great Northern or cannellini beans, drained and rinsed', '1 pint cherry or plum tomatoes, halved', '1/3 cup coarsely chopped parsley', 'Dressing ingredients:', '1/4 cup extra virgin olive oil', '3 cloves garlic, peeled and smashed', '1 3-inch sprig of fresh rosemary', '3 anchovy fillets, coarsely chopped (omit for vegetarian option)', '1/4 cup freshly grated Parmesan cheese', '3/4 teaspoon Kosher salt', '1/4 teaspoon freshly ground pepper', '1 teaspoon lemon zest', '1/4 cup of lemon juice']",13,"['1 Infuse rosemary in olive oil: Place the garlic and sprig of rosemary in the olive oil in a small saucepan. Heat the oil on medium until the rosemary begins to sizzle.', 'Remove the pan from the heat and let sit for 20 minutes, allowing the rosemary and garlic to infuse in the oil.', '2 Make the dressing: Remove rosemary sprig from the oil, discard. Remove the garlic from the oil, reserving the oil.', 'Add the garlic, anchovies (omit for vegetarian option), Parmesan cheese, salt, pepper, lemon zest, and lemon juice to a food processor or mini chopper. Pulse until smooth.', '3 Mix dressing with beans: In a medium bowl, gently mix the garlic Parmesan lemon mixture in with the beans until the beans are well coated.', 'Let the beans sit for a few minutes so they absorb some of the dressing.', '4 Gently mix in the reserved olive oil, tomatoes, and parsley.']",7
165,Black-Eyed Pea Salad Recipe,10,35,45,"['2 cups dry black-eyed peas', 'Salt', '1 package of feta cheese, about 7 ounces', '1 jar of sun-dried tomatoes in oil, about 8 ounces', '1 cup black olives, preferably Kalamata or oil-cured', '1 finely chopped green onion', '1 finely chopped garlic clove', '1 large bunch of spinach, about 1 pound, washed, chopped', 'Zest and juice of a lemon']",9,"['1 Bring a medium pot of water to a boil. Add enough salt to make the water taste like the sea. Turn the heat down to low and add the black-eyed peas. Let them cook slowly, uncovered, until they are done, anywhere from 30 minutes to an hour, depending on how old the peas are. Don\\xe2\\x80\\x99t let the water simmer.', '2 Add the spinach to a large bowl. Crumble the feta cheese into the bowl and add all the other ingredients except the lemon juice. Mix well.', '3 When the black-eyed peas are done, pour them into a colander and spray them with cold water to stop the cooking. Pick through and discard any loose skins or mashed peas; you\\xe2\\x80\\x99ll find a few, but hopefully not many.', '4 Add the black-eyed peas to the salad, mix well and serve. Squirt some lemon juice over each serving before you take them to the table.']",4
166,Creamy Polenta with White Beans and Roasted Broccoli Recipe,15,30,45,"['For the polenta:', '2 cups water', '3/4 teaspoon salt', '1/2 cup yellow polenta', 'For the roasted broccoli:', '4 cups chopped broccoli', '2 tablespoons olive oil', '1/2 teaspoon sea salt', 'For the white beans:', '1 cup white beans, homemade or canned, drained and rinsed', '3 tablespoons olive oil', '1 tablespoon nutritional yeast', '1 teaspoon garlic powder', '1/4 teaspoon onion powder', 'Pinch of salt', 'For the chili oil:', '1/4 cup olive oil', '2 teaspoons chili flakes']",18,"[""1 Make the polenta: Bring the water and salt for the polenta to a boil over medium heat in a 2-quart saucepan. Once it's boiling, add the polenta and whisk until the polenta is fully incorporated."", 'Lower the heat (as low as it can go) and cook the polenta for 20 to 25 minutes, stirring every 5 to 10 minutes with a whisk to break up any clumps.', '2 Roast the broccoli: Heat your oven to 425\\xcb\\x9aF. Arrange the chopped broccoli on a rimmed baking sheet and toss with the 2 tablespoons of olive oil and salt. Roast until the broccoli is tender and beginning to char, about 15 to 20 minutes.', '3  Make the bean puree: While the polenta and broccoli are cooking, combine the drained beans with the olive oil, nutritional yeast, garlic powder, onion powder, and salt in the bowl of a food processor or in a high speed blender. Puree until smooth, adding a few tablespoons of water as needed to help smooth it out.', 'When the polenta is done cooking, stir the bean puree into the polenta.', '4 Make the chili oil: Heat the oil in a small skillet. Add the chili flakes, remove from the heat, and let it rest until ready to serve. (You can make this ahead of time!)', '5 Assemble the bowls: Divide the polenta among four bowls. Top with the broccoli and a drizzle of the chili oil.']",7
167,Pasta and Bean Picnic Salad Recipe,30,10,40,"['3 teaspoons salt', '1 pound small-shaped pasta (curly, twisted, corkscrew, shells, or bow-ties)', '7 tablespoons olive oil, divided', '2 cans (15-to 16-ounces each) white beans, like Great Northern, navy, or cannellini, drained and rinsed', 'Zest of 1 lemon', '2 tablespoons apple cider vinegar', '1 heaping teaspoon Dijon mustard', '1/4 teaspoon ground black pepper', '1 pint mixed cherry or grape tomatoes, sliced or cut into quarters', '2 stalks celery, halved lengthwise and very thinly sliced', '1/2 red onion, very thinly sliced', '1/4 cup chopped fresh parsley']",12,"['1 Cook the pasta: Bring a large pot of water with 2 teaspoons of the salt to a boil. Add the pasta and cook, stirring occasionally, for 8 minutes or until the pasta is tender.', 'Drain but do not rinse; shake the colander to remove excess water.', '2 Combine the pasta and beans: Transfer the pasta to a large bowl and sprinkle with 3 tablespoons of the olive oil. Shake the bowl to distribute the oil.', 'Add the rinsed beans and lemon zest to the hot pasta. Stir the salad gently. Leave to cool.', '3 Make the dressing: In a bowl, whisk the vinegar, mustard, remaining 1 teaspoon salt, and pepper. Slowly whisk in the remaining 4 tablespoons oil until it is all added.', 'Taste for seasoning and add more salt and pepper, if you like.', '4 Finish mixing the salad: Pour the dressing over the pasta and beans and stir. Add the tomatoes, celery, onion, and parsley to the pasta mixture and stir gently but thoroughly.', 'Taste for seasoning and add more salt and pepper, if you like. You can also squeeze some lemon juice over the top if it needs a touch more brightness.']",8
168,"Green Bean Salad with Basil, Balsamic, and Parmesan Recipe",10,15,25,"['1 1/2 pounds trimmed green beans, cut to 2 to 3 inch long pieces', 'Salt', '1/2 cup finely chopped red onion (or shallots)', '2 tablespoons balsamic vinegar', '4 tablespoons extra virgin olive oil', '3/4 cup chopped fresh basil leaves', '3/4 cup freshly grated Parmesan cheese (about 1 1/2 ounces)', 'Freshly ground black pepper']",8,"['1 Soak chopped onions in water: Place the chopped onions in a small bowl of water. This will help take the edge off the onions. Let sit while you prepare the rest of the salad.', '2 Blanch the green beans: Bring a large pot of salted water to a boil (2 Tbsp salt for 2 quarts of water). Add the green beans to the water and blanch only for about 2 minutes or so, until the beans are just barely cooked through, but still crisp.', 'Fresh young beans should cook quickly. Older, tougher beans may take longer.', '3 Shock in ice water: While the beans are cooking, prepare a large bowl of ice water. When the beans are ready, use a slotted spoon to remove them from the boiling water to the ice water to stop the cooking.', 'Drain the green beans and the red onions.', '4 Toss with red onion, balsamic, Parmesan: Place the green beans, red onion, and chopped basil in a large bowl. Sprinkle in the olive oil, toss to coat. Sprinkle in the balsamic and Parmesan cheese. Toss to combine. Season to taste with salt and freshly ground black pepper.', 'Chill until ready to serve.']",7
169,Chinese Chicken Salad Recipe,15,25,40,"['3 cups loosely packed, shredded, cooked white chicken meat (about 3/4 pound), (see How to Poach Chicken)', '1/4 cup soy sauce (use gluten-free soy sauce for gluten-free version)', '1 Tbsp sherry', '1 Tbsp sugar', 'About 1 cup canola oil or peanut oil', '2 ounces (1 bunch) bean threads', '4 green onions, shredded lengthwise', '1 large head of romaine lettuce (or 2 small heads), cut into 1/2 to 3/4 inch slices', '2 Tbsp chopped toasted almonds', '2 Tbsp toasted sesame seeds', 'Dressing:', '2 Tbsp sugar', '1 teaspoon salt', '1/2 teaspoon ground pepper', '3 Tbsp vegetable oil', '1 Tbsp dark sesame oil', '3 Tbsp rice vinegar (can sub cider vinegar)']",17,"['1 Shred, season, and marinate the cooked chicken: Using two forks, shred the cooked chicken. (If starting with raw chicken, see How to Poach Chicken).', 'Mix soy sauce, sherry and sugar in a bowl and add the chicken. Let soak for 10 minutes. Remove chicken and pat dry with paper towels.', '2 Fry the bean threads in hot oil: Put 3/4 inch of high smoke point cooking oil (such as canola oil or peanut oil) into a small saucepan. Heat on high heat until shimmering.', 'Take one bunch of the dried bean threads and gently break them up a bit. Test the oil by putting one bean thread into the oil.', ""If the oil is hot enough, the bean thread will almost immediately sizzle and puff up. That's when you know the oil is hot enough."", 'When the oil is ready, working with a few bean threads at a time, put them in the hot oil.', 'As soon as they puff up, remove them carefully with tongs and place them on a paper towel to cool. The paper towel helps remove any excess oil. Set aside.', '3 Fry the shredded chicken: In a large skillet over medium high heat, heat 2 tablespoons of oil from the bean threads until hot.', 'Add the chicken and cook for 2 to 3 minutes to bake in the seasoning. Set aside.', '4 Slice green onions lengthwise: Cut the green onions in 3 to 4 inch long pieces, and shred them lengthwise.', ""5 Toast the chopped almonds and sesame seeds: Toast the chopped almonds, or chop your toasted almonds; toast your sesame seeds. (Heat a thin skillet to medium high heat, add the seeds - or nuts, don't do them both together - stir frequently until they begin to brown, remove from heat, they will continue to cook. Let cool to room temp.)"", '6 Make the dressing: Put all of the dressing ingredients together in a jar\\xe2\\x80\\x94sugar, salt, pepper, vegetable oil, dark sesame oil, rice vinegar\\xe2\\x80\\x94cover with a lid and shake until emulsified.', '7 Serve: Just before serving the salad, mix all of the salad ingredients together - lettuce, chicken, bean threads, almonds, sesame seeds, and dressing.']",13
170,Asian Beef Lettuce Wraps Recipe,30,1480,1510,"['For the marinade/dipping sauce:', '1/2 cup low sodium soy sauce', '3 tablespoons lime juice', '2 teaspoons fish sauce', '2 teaspoons Sriracha or other hot sauce (or to taste)', '1 teaspoon sesame oil', '3 tablespoons dark brown sugar', '2 tablespoons finely chopped peeled ginger root', '1 teaspoon finely chopped garlic', '2 scallions, finely sliced', '1 1/2 pounds flank steak', 'For the wraps:', '6 ounces rice noodles (any kind)', 'Leaves from 1 head Boston or red leaf lettuce', '4 scallions, thinly sliced', '4 radishes, thinly sliced', '2 Persian cucumbers, thinly sliced', '1/2 cup roasted peanuts', 'Handful of fresh cilantro leaves', 'Handful of fresh mint leaves']",20,"['1 Make the marinade/dipping sauce: In a small bowl, combine the soy sauce, lime juice, fish sauce, sriracha, sesame oil, brown sugar, ginger, garlic, and scallions. You will use some of it for the marinade and some for the dipping sauce.', '2 Marinate the steak: Place the steak in a shallow dish. Pour 1/3 cup of the marinade over the steak and set the remaining marinade aside to use later as the dipping sauce.', 'Turn the steak to coat it in the marinade. Let the steak marinate at room temperature for 30 minutes, turning the steak once or twice, or cover it and let the steak marinate for up to 24 hours in the refrigerator.', 'If you refrigerate the meat, let it come to room temperature before grilling.', '3 Cook the rice noodles: Follow the cooking directions on the package of noodles. (Individual manufacturers\\xe2\\x80\\x99 instructions vary.) Drain the noodles in a colander and rinse under cold running water, tossing with your hands, to remove the excess starch and prevent the noodles from sticking together.', '4 Grill the steak: Light a charcoal grill or turn a gas grill to high (about 450\\xc2\\xbaF). Grill the steak for 3 to 5 minutes per side for medium-rare (135\\xc2\\xbaF). The exact timing will depend upon the heat of the individual grill and the thickness of your steak.', 'For best results, use an instant read thermometer inserted into the center of the steak: 125\\xc2\\xbaF for rare, 135\\xc2\\xbaF for medium rare, 145\\xc2\\xbaF for medium.', '5 Rest and slice the steak: Transfer the steak to a cutting board, cover with foil, and let rest for 10 minutes. Thinly slice it across the grain.', '6 Arrange the ingredients on a platter: Tear the lettuce leaves into large pieces, removing the stiff stem ends.', 'Arrange the lettuce leaves, scallions, radish, cucumbers, peanuts, mint, and cilantro on a large platter around the sliced steak, rice noodles, and dipping sauce. This allows each person to build his or her own wrap.', '7 To make one wrap: Set a lettuce leaf on a plate. Place some rice noodles and steak slices over the leaf, and top with scallions, cilantro, mint, radishes, cucumbers, and peanuts. Roll or fold and serve with dipping sauce.']",11
171,Rosemary Olive Steak Kabobs Recipe,15,45,60,"['1 pound sirloin steak, cut into thin 2-inch strips (or use beef labeled ""stir-fry beef"")', '1 1/2 cups mixed black and green pitted olives', '1/3 large red onion, cut into pieces', '3 tablespoons olive oil', '2 tablespoons lemon juice', '2 tablespoons minced fresh rosemary', '1/2 teaspoon salt', '1/2 teaspoon black pepper', 'Flat-leaf parsley, for serving']",9,"['1 Marinate the meat: Combine the steak strips, olives, onion pieces, olive oil, lemon juice, rosemary, salt, and pepper into a bowl. Stir to combine everything. Place in the refrigerator to marinate for 30 minutes. If using wood skewers, place in water at this time.', '2 Assemble the skewers: When ready to grill, thread pieces of beef, onion, and olives onto the skewers. For longer pieces of beef, make an ""S"" shape as you thread onto the skewers.', '3 Heat the grill: Heat a gas or charcoal grill to high heat, about 500\\xc2\\xb0F or until you can hold your hand above the grate for 1 to 2 seconds.', '4 Grill the steak skewers: When your gas or charcoal grill is hot, use tongs to oil the grill grates with a small folded piece of paper towel dipped in oil.', 'Place the skewers on the hot grill and cook, turning once or twice, until charred and the steak is cooked to your preferred level of doneness, about 6 minutes total for medium-rare or up to 10 minutes for well-done.', '5 Serve: Remove from the grill and place on a clean serving platter. Sprinkle with fresh parsley and serve.']",6
172,Home Cured Corned Beef,0,0,0,"['Pickling spices:', '1 tablespoon whole allspice berries', '1 tablespoon whole mustard seeds (brown or yellow)', '1 tablespoon coriander seeds', '1 tablespoon red pepper flakes', '1 tablespoon whole black peppercorns', '2 teaspoons whole cloves', '9 whole cardamom pods', '6 large bay leaves, crumbled', '2 teaspoons ground ginger', '1/2 stick cinnamon', 'Brine:', '1 gallon (3.8 liters) water', ""300 g Kosher salt (2 cups of Diamond Crystal brand Kosher Salt OR 1 cup 3 1/2 tablespoons of Morton\\'s Kosher Salt)"", '5 teaspoons pink curing salt (optional, see Recipe Note)', '3 tablespoons pickling spices', '1/2 cup (90 g) brown sugar', 'Brisket:', '1 5-pound beef brisket', '1 tablespoon pickling spices']",20,"['1 Toast and crush spices: You can either used store-bought pickling spices or you can make your own. To make your own, toast the allspice berries, mustard seeds, coriander seeds, red pepper flakes, peppercorns, cloves, and cardamom pods in a small frying pan on medium heat until fragrant. Note that it is pretty easy to burn spices; you want enough heat to release their flavors, not so much that they get burned.', 'Remove from heat and place in a small bowl. Use a mortar and pestle to crush the spices a little (or the back of a spoon or the side of a knife on a flat surface). Add to a small bowl and stir in the crumbled bay leaves and ground ginger.', '2 Make curing brine: Add about 3 Tbsp of the spice mix (reserve the rest for cooking the corned beef after it has cured), plus the half stick of cinnamon, to a gallon of water in a large pot, along with the Kosher salt, pink salt (if using), and brown sugar. Bring to a boil, then remove from heat and let cool to room temperature. Then refrigerate until well chilled.', '3 Brine the brisket for 5-7 days: Place the brisket in a large, flat container or pan, and cover with the brine. The brine should cover the meat. The meat may float in which case you may want to weigh it down with a plate.', ""Alternatively you can use a 2-gallon freezer bag (placed in a container so if it leaks it doesn\\'t leak all over your refrigerator), place the brisket in the freezer bag and about 2 quarts of brine, squeezing out the air from the bag before sealing."", 'Place in the refrigerator and chill from 5-7 days. Every day flip the brisket over, so that all sides get brined equally.', '4 Cook the corned beef: At the end of the cure, remove the brisket from the brine and rinse off the brine with cold water. Place the brisket in a large pot that just fits around the brisket and cover with at least one inch of water. If you want your brisket less salty, add another inch of water to the pot.', 'Add a tablespoon of the pickling spices to the pot. Bring to a boil, reduce to a very low simmer (barely bubbling), and cook 3-4 hours, until the corned beef is fork tender. (At this point you can store in the fridge for up to a week.)', '5 Cut across the grain: Remove the meat to a cutting board. (You can use the spiced cooking liquid to cook vegetables for boiled dinner or corned beef and cabbage.) Notice the visible lines on the meat; this is the ""grain"" of the meat, or the direction of the muscle fibers.', 'To make the meat easier to cut, cut it first in half, along the grain of the meat. Then make thin crosswise cuts, across the grain to cut the meat to serve.']",10
173,New England Boiled Dinner Recipe,0,270,270,"['3 1/2 pounds corned beef brisket or plain beef brisket', '15 peppercorns', '8 whole cloves', '1 bay leaf', 'Salt, if using plain brisket', '2 medium sized turnips, peeled and quartered', '4 red new potatoes, peeled and quartered', '3 large carrots, cut into thirds and the thickest pieces quartered lengthwise', '1 small head cabbage, cut into fourths']",9,"['1 Put corned beef in a pot, cover with water, add seasonings, simmer: Put the brisket in a 5 or 6 quart Dutch oven and cover with an inch of water.', 'If you are using corned beef brisket and it does not come already packed in seasoning, add peppercorns, cloves, and a bay leaf to the pot.', 'If using plain brisket, add a teaspoon of salt for every quart of water.', 'Bring to a simmer and then cover, lower the heat until it is barely simmering. Keep at a low simmer for four hours or until the meat is tender (a fork goes through easily).', '2 Remove meat, add vegetables, simmer: Remove the meat and set aside, keeping the meat warm. Add the vegetables to the pot. Check the broth for taste. If it is too salty, add a little more water to taste.', 'Raise the temperature and bring the soup to a high simmer. Cook at a high simmer until done, about 15-30 minutes longer, depending on the size of the cut of your vegetables.', '', '3 Slice meat across the grain: Slice the meat in thin slices across the grain. You may find it easier to slice if you first cut the roast in half along the same direction as the grain of the meat. Then slice smaller lengths across the grain.', '', 'Serve in bowls, a few pieces of meat in each, add some of the vegetables and some broth. Serve with horseradish or mustard or both.']",10
174,Slow Cooker Guinness Beef Stew Recipe,20,270,290,"['2 Tbsp butter', '2 pounds (900 g) well marbled chuck beef roast, cut into 2-inch pieces', 'Salt', '2 cups chopped onion (about 1 large onion)', '2 celery stalks, chopped', '2 Tbsp tomato paste', '1 pint (16 ounces, 475 ml) Guinness extra stout (make sure you use extra stout and not draught)', '3 cups (700 ml) beef broth', '2 large carrots, peeled and cut into chunks', '3 to 4 parsnips, peeled and cut into chunks', '1/2 pound (280 g) celery root, potatoes, or very young turnips, peeled and cut into chunks', '2 teaspoons dried thyme', '4 Tbsp chopped fresh parsley (optional)', 'Special equipment:', '6-quart or larger slow cooker']",15,"['1 Brown the beef, transfer to slow cooker: Heat the butter in a large saut\\xc3\\xa9 pan over medium-high heat. Brown the beef in the butter, starting with the fattiest pieces of meat, fat side down in the pan. This will allow some beef fat to render out. Work in batches as to not crowd the pan.', 'Sprinkle salt over the beef as it browns. Once browned on all sides, transfer the beef pieces into a 6-quart or larger slow cooker.', '2 Saut\\xc3\\xa9 onions and celery, transfer to slow cooker: Add the onions and celery to the pan in which you just browned the beef. Saut\\xc3\\xa9 the onions and celery until they begin to brown at the edges, about 5 minutes.', 'Add the tomato paste and mix well. Cook for a minute or two, then add a little of the Guinness, enough to make it easier for you to scrape up any browned bits at the bottom of the pan.', 'Transfer the celery and onions into the slow cooker.', '3 Add Guinness, broth, root vegetables, thyme, salt: Add the rest of the Guinness, the beef broth, carrots, parsnips, celery root, and thyme to the slow cooker. Add two teaspoons of salt.', '4 Cook in slow cooker: Cover and cook on ""high"" for 4 hours, or ""low"" for 8 hours. When done, add more salt to taste. If you want, sprinkle with fresh parsley to serve.']",7
175,Instant Pot Guinness Beef Stew Recipe,20,80,100,"['2 pounds beef stew meat', '1 teaspoon salt', '1/2 teaspoon ground black pepper', '2 tablespoons butter or neutral flavored oil', '1 large (8 ounce) onion, chopped', '2 celery stalks, chopped', '2 tablespoons tomato paste', '1 cup Guinness extra stout, or other stout', '1 1/2 cups beef broth', '1 teaspoon dried thyme or 2 teaspoons fresh thyme leaves', '2 large carrots, peeled and cut into chunks', '3 to 4 parsnips (about 1 pound), peeled and cut into chunks', '1/2 pound potatoes, rutabaga, or celery root, peeled and cut into chunks', '2 teaspoons cornstarch', '2 teaspoons water', '1/4 cup chopped fresh parsley', 'Special equipment:', '6-quart Instant Pot, or other electric pressure cooker']",18,"['1 Sear the meat: Pat the pieces of beef dry with a paper towel, then season them on all sides with the salt and pepper.', 'Select the high \\xe2\\x80\\x9cSaut\\xc3\\xa9\\xe2\\x80\\x9d setting on the electric pressure cooker and heat the butter or oil. Brown the beef in the butter in two batches, searing the pieces for 4 minutes per batch and flipping them halfway through cooking.', 'Don\\xe2\\x80\\x99t worry about trying to sear every side of the beef\\xe2\\x80\\x94you\\xe2\\x80\\x99re just trying to get some browning on the beef and some flavor developing in the pot. Use a pair of tongs to transfer the meat to a dish.', '2 Cook the onions and celery: Add the onions and celery to the now-empty pressure cooker. Cook until the onions begin to soften and turn translucent, about 4 minutes. Stir in the tomato paste and cook for another minute.', '3 Add the liquids to the pot: Pour in the Guinness. Use a stiff spatula to scrape up any browned bits from the bottom of the pot. Let it simmer for five minutes to reduce the beer a bit, then stir in the reserved beef, beef broth, and thyme.', '4 Pressure cook the meat: Secure the lid on the pressure cooker and make sure it\\xe2\\x80\\x99s set to its \\xe2\\x80\\x9csealing\\xe2\\x80\\x9d position. Cancel the cooking program, then select the Meat/Stew,\\xe2\\x80\\x9d \\xe2\\x80\\x9cPressure Cook,\\xe2\\x80\\x9d or \\xe2\\x80\\x9cManual\\xe2\\x80\\x9d setting, and set the cooking time to 30 minutes at high pressure. (The pot will take about 10 minutes to come up to pressure before the actual cooking time begins.)', 'When the cooking program finishes, let the pressure release naturally for 10 minutes, then release the remaining pressure by moving the pressure vent to its \\xe2\\x80\\x9cventing\\xe2\\x80\\x9d position.', 'At this point, you may also leave the stew on the \\xe2\\x80\\x9cKeep Warm\\xe2\\x80\\x9d setting for up to 10 hours, before continuing with the rest of the recipe. The beef will become more tender the longer it sits.', '5 Add the root vegetables and pressure cook: When the pressure has released, open the pot. (Optional: for a leaner stew, you can use a ladle or spoon to skim off some of the fat.) Stir in the carrots, parsnips, and root vegetables.', 'Put the lid back on the pressure cooker and make sure it\\xe2\\x80\\x99s set to its \\xe2\\x80\\x9csealing\\xe2\\x80\\x9d position. Cancel the cooking program, then select the \\xe2\\x80\\x9cPressure Cook\\xe2\\x80\\x9d or \\xe2\\x80\\x9cManual\\xe2\\x80\\x9d setting and set the cooking time to 3 minutes at high pressure.  (The pot will take about 10 minutes to come up to pressure before the actual cooking time begins.)', '6 While the stew is finishing, mix the cornstarch and water together in a small bowl to make a slurry.', '7 Finish the stew: When the cooking program ends, perform a quick pressure release by moving the pressure vent to its \\xe2\\x80\\x9cventing\\xe2\\x80\\x9d position. (It\\\'s also ok if you need to leave the stew on the ""Warm"" setting for a little while before venting the pressure and serving, though the vegetables will eventually start to get mushy if left too long.)', 'Stir in the cornstarch slurry right away while stew is still bubbling. The residual heat will thicken the stew within a couple minutes.', '8 Serve: Ladle the stew into bowls and serve it hot, with fresh parsley sprinkled on top.']",14
176,Beef and Broccoli Ramen Stir Fry Recipe,10,15,25,"['For the stir fry sauce:', '2 cloves garlic, minced', '1 tablespoon grated fresh ginger', '1/3 cup soy sauce', '1/4 cup honey', '1/4 cup hoisin sauce', '3/4 cup beef broth', '2 tablespoons rice vinegar', '2 tablespoons sesame oil', '2 tablespoons cornstarch', 'For the stir fry:', '2 (3-ounce) packages dried ramen noodles, seasoning packets discarded', '2 tablespoons olive oil, divided', '1 pound sirloin steak, trimmed of fat and sliced into 1/4-inch thick strips', '1/2 teaspoon kosher salt', '1/2 teaspoon ground black pepper', '3 cups fresh broccoli florets', 'Sesame seeds, garnish', 'Sriracha, garnish (optional)', 'Special equipment:', '12-inch anodized wok']",21,"['1 Make the stir fry sauce: Add garlic and ginger to a bowl and whisk in soy sauce through sesame oil. Whisk in cornstarch last, and try to whisk out as many lumps as possible. It\\xe2\\x80\\x99s okay if there are a few lumps, as they will cook out when you add the sauce to the skillet.', 'This makes a lot, because I like this dish to be very saucy. You could halve the recipe if you like a drier stir fry. If you have leftover sauce, it stores well in the fridge for a week in an airtight container or jar.', '2 Prepare the noodles: Cook dry ramen noodles in boiling water until they are tender, 2 to 3 minutes. Drain the noodles and rinse with cold water to stop them from cooking.', '3 Cook the stir fry: In a large skillet or wok over medium-high heat, add 1 tablespoon olive oil. Season the steak with 1/2 teaspoon salt and pepper.', 'Once the skillet is glistening hot, add the steak strips. Cook for about 3 minutes, undisturbed, to allow them to sear well on one side. Then stir and continue to cook for 2 to 3 more minutes, until the steak is cooked through.', 'Remove the steak from skillet, and add another tablespoon of olive oil and the broccoli florets. Add 1/2 cup of water to the skillet and cover. Steam broccoli for 2 minutes. Broccoli should be bright green and tender, and not mushy at all.', 'Add the steak back to the skillet, along with cooked and rinsed noodles. Pour in all of the sauce. (If you prefer a drier stir fry, you can start with half the sauce.) Use tongs or a large rubber spatula to stir together ingredients as sauce cooks. Cook for another 2 to 3 minutes until sauce thickens.', '5 Serve: Serve stir fry immediately, garnished with sesame seeds and, optionally, sriracha.']",8
177,Sous Vide Beef Tenderloin with Port Wine and Garlic Recipe,30,150,180,"['1 1/2 to 2 pounds center-cut beef tenderloin (See Recipe Note)', '1 teaspoon salt', 'Freshly ground black pepper', '2 tablespoons vegetable oil, divided', '2 tablespoons butter', '1/2 cup tawny port wine', '4 to 5 medium cloves garlic', '5 to 6 sprigs fresh thyme, plus extra to serve', 'Special equipment:', '10-inch stainless steel or cast iron skillet', 'Joule, or other sous vide immersion circulator', '1-gallon zip-top freezer bag']",12,"['4 Heat the water for sous vide cooking: Place your Joule or other sous vide immersion circulator in the stockpot of water. Set the sous vide immersion circulator to heat the water to 133\\xc2\\xb0F for rare beef, 140F for medium-rare (my preference), 149\\xc2\\xb0F for medium-well, or 167\\xc2\\xb0F for well-done.', ""5 Cook the tenderloin sous vide for 2 1/2 to 3 hours: When the water has heated to its required temperature, lower the tenderloin into the water so that it is entirely submerged. It\\'s ok if the top of the bag pokes out of the water as long as the tenderloin itself is submerged."", 'Cook for 2 1/2 to 3 hours, but avoid cooking for much longer or the beef will start to get a little soft and mushy.', '6 Sear the tenderloin a second time: When the tenderloin is done, lift it from the water and place the bag on a kitchen towel. Heat the remaining tablespoon of oil in the skillet over medium-high heat until a drop of water sizzles and evaporates on contact.', 'Use tongs to lift the roast from the bag and transfer it to the skillet. Be careful\\xe2\\x80\\x94it will sputter! Sear for 30 to 60 seconds on all sides, until the outside is even more deeply browned and a crust has formed.', 'Transfer the tenderloin to a cutting board and rest for 5 to 10 minutes.', '7 Deglaze the pan: With the pan still over medium-high heat, pour in the sauce directly from the bag into the pan (discard the sprigs of thyme). Simmer for about a minute and scrape up any browned bits stuck to the bottom of the pan. Carefully transfer the sauce to a serving cup.', '8 Slice and serve the tenderloin: Cut through the twine and discard. Slice the tenderloin either into thick ""filet mignon"" steaks (one steak per person), or into thinner ""roast beef"" slices (3 or 4 slices per person). Serve immediately with the sauce.']",8
178,Italian Pot Roast Recipe,10,240,250,"['3 1/2 to 4 pound rump or chuck beef roast', '1 teaspoon salt plus more to taste', '1/2 teaspoon freshly ground black pepper', '1/4 cup extra virgin olive oil', '1 large carrot, diced (about 1 cup)', '1 large celery stalk, diced (about 1 cup)', '1 medium red onion, diced (1 to 1 1/2 cups)', '2 garlic cloves, finely minced', '2 tablespoons chopped fresh flat-leaf parsley', '1 bay leaf', '1 tablespoon finely chopped fresh sage', '3 cups medium-bodied Italian red wine (we used a Barbera)', '1 28-ounce can Italian plum tomatoes, put through a food mill to remove the seeds']",13,"['1 Sear the roast: Trim some of the fat from the meat. Pat dry with paper towels. Season generously with the salt and pepper. Heat the oil in a large, heavy pot or Dutch oven over medium-high heat.', 'When the oil is hot, shimmering but not smoking, add the roast and cook, turning it a few times, until it is nicely browned on all sides, 10-12 minutes.', 'Transfer the meat to a platter.', '2 Add vegetables: Reduce the heat to medium. Add the carrot, celery, and onion. Cook, stirring occasionally until the vegetables are golden brown and begin to stick to the bottom of the pan, 10-12 minutes.', 'Add the garlic, parsley, and sage, and stir until the herbs are lightly colored and fragrant, about 1 minute.', '3 Deglaze the pan with wine, return meat to the pan: Add 1 cup of the wine and stir quickly, lifting up the richly browned caramelized vegetables that stick to the bottom of the pan.', 'When the wine is almost all evaporated and thickly coats the vegetables, return the meat to the pan and turn it over a few times to coat it with the savory base.', '4 Add remaining ingredients, simmer until tender: Raise the heat to high, adding the remaining wine, the bay leaf, and the tomatoes, and bring to a boil. Cover the pot, reduce the heat to low, and simmer, turning and basting the meat every half hour or so, until the meat is very tender and flakes away when pierced with a fork, 3-4 hours.', '5 Turn off the heat and let the roast sit in its juices for an hour. (You can also put the pot into a 300\\xc2\\xb0F oven and turn the roast every hour.)', '6 Remove meat, reduce sauce: Remove the meat from the pot and place it on a cutting board, covered loosely with aluminum foil. If the sauce is too thin, bring it to a fast boil and reduce it until it has a medium-thick consistency. Taste and adjust seasoning.', '7 Cut the meat into thick slices (it will probably fall apart), and place on warm serving dishes. Spoon the sauce over the meat and serve hot. Serve with rice, mashed potatoes, or polenta.']",11
179,Grilled Tri-Tip Steak with Bell Pepper Salsa Recipe,5,30,35,"['Marinade', '2 tablespoons soy sauce', '2 tablespoons sherry vinegar or apple cider vinegar', '2 tablespoons extra virgin olive oil', '4 garlic cloves, minced', '1/4 teaspoon freshly ground black pepper', 'Steak', 'One 2-pound tri-tip steak or roast', 'Salt', 'Freshly ground black pepper', 'Salsa', '1 large bell pepper (any color), stem and seeds removed, finely chopped', '4 green onions, thinly sliced, white and green parts', '1 garlic cloves, finely chopped (1 teaspoon)', '2 tablespoons chopped parsley, basil, or arugula', '1/4 teaspoon red chile flakes', '2 tablespoons apple cider or red wine vinegar', '2 tablespoons extra virgin olive oil', 'Salt and freshly ground black pepper to taste']",19,"['1 Marinate the steak: Prepare the marinade in a large bowl, stirring together all of the marinade ingredients. Place steak in the bowl and coat on all sides with the marinade. Marinate for 20 minutes while you are preheating the grill.', '2 Prepare the grill: Prepare the grill for direct high heat. If you are using charcoal, use approximately 5 pounds of coals. Bank the coals so that more of them are on one side than the other, so that you have a high heat zone and a lower heat zone.', '3 Pat dry steak, sprinkle with salt and pepper: When the grill is ready and hot, remove the meat from the marinade and pat it dry with paper towels. Sprinkle generously all over with salt and freshly ground black pepper.', '4 Sear tri-tip on hot side of grill: Place the tri-tip on the hot side of the grill. Leave the cover off and watch carefully for flare-ups.', ""As the meat browns, any fat will melt and drip on to the coals causing flare-ups. These are okay, as long as they don't get out of control."", 'Keep moving the tri-tip around the grill away from the flames if they get too high. Brown well on both sides.', '5 Move steak to lower heat side of grill: When the tri-tip steak is browned all over, move it to the lower heat side of the grill.', 'Cover the grill and close the vents enough so that you maintain about 300-325\\xc2\\xb0F temperature in the grill. (If you are using a charcoal grill, you can place a meat thermometer through the vents to measure the heat.)', 'If you are using a gas grill, turn off one of the burners and move the meat over that burner for indirect heating.', '6 Check temperature: Cook the tri-tip until a meat thermometer reads 130\\xc2\\xb0F when inserted into the thickest part of the meat (15-30 minutes, depending on the thickness of the meat).', '7 Let rest: Remove from grill, cover with foil and let rest for 15 minutes.', '8 Make salsa: Make the bell pepper salsa by stirring together all of the salsa ingredients in a small bowl.', '9 Slice: Cut the tri-tip in 1/4-inch slices across the grain of the meat. Serve with the bell pepper salsa.']",13
180,Slow Cooker Pot Roast Recipe,25,480,505,"['2 teaspoons kosher salt', '2 teaspoons fresh cracked pepper', '2 teaspoons garlic powder', '3 pounds beef chuck arm or rump roast', '1 tablespoon canola oil', '5 sprigs fresh thyme', '1 large onion, quartered, peeled', '1 bay leaf', '3/4 cup red wine', '3 tablespoons Worcestershire sauce', '2 cups beef stock', '3 large cloves garlic, smashed', '8 ounces cremini mushrooms, halved', '6 carrots, peeled and halved', '1 1/2 pounds baby potatoes, halved', '2 tablespoons cornstarch', 'Special equipment:', '6- to 8-quart slow cooker']",18,"['1 Season and sear the roast: Combine salt, pepper, and garlic powder. Rub onto all sides of the roast.', 'Set a medium skillet over medium-high heat. Add the oil to the skillet. Once the oil shimmers, add the roast and sear the roast on all sides. This should take about 5 minutes. Transfer the roast to the slow cooker, and nestle thyme, quartered onion and bay leaf around the roast.', '2 Deglaze the skillet: Reduce the heat for the skillet to medium. Add the wine, Worcestershire sauce, and garlic cloves to the skillet to deglaze the pan. Cook for about 1 to 2 minutes, just until some of the alcohol cooks off the wine, and you scrape the brown bits off the bottom of the pan. Turn off the burner.', '3 Add the vegetables and liquid to the slow cooker: Nestle the mushrooms, carrots, and potatoes around the roast. Pour the wine from the skillet and the beef stock over everything.', '4 Cover and cook: Secure the lid, cover and cook on high for 4 to 5 hours or low for 8 to 10 hours.', '5 Make the gravy and serve: Ladle 2 cups of the slow cooker liquid into a medium saucepan. Set it over medium-high heat and bring to a boil.', 'Make a slurry by combining 2 tablespoons of cornstarch with 3 tablespoons of water. Whisk the slurry into the boiling liquid. You should see it thicken to the consistency of honey within a minute or so.', 'Once thickened, remove it from heat. Serve up some pot roast and veggies, then top with gravy. Add more salt and pepper to taste.']",8
181,Carbonnade Beef and Beer Stew Recipe,15,210,225,"['3 1/2 lbs chuck roast, cut into 1-inch pieces', 'Salt and freshly ground black pepper', '4 Tbsp butter, divided 2 Tbsp and 2 Tbsp', '3 medium yellow onions sliced about 1/4 inch thick (about 8 cups)', '3 Tbsp all-purpose flour', '1 1/2 cups chicken or beef broth', '1 1/2 cups (12 oz bottle) Belgian beer', '4 sprigs fresh thyme', '2 bay leaves', '1 Tbsp whole grain mustard', '1 Tbsp brown sugar']",11,"['1 Brown the beef: Pat beef dry with paper towels, then season well with salt and pepper. On the stove top, heat 2 tablespoons of butter in a large heavy bottomed dutch oven over medium-high heat until hot, almost smoking.', 'Working in batches, brown the meat, without stirring, about 3 minutes on each side (do not stir, give the meat an opportunity to brown well).', 'Transfer browned beef to a separate bowl.', '2 Cook the onions: Add 2 tablespoons butter to dutch oven; reduce heat to medium. Add the onions and 1/2 teaspoon of salt; cook until onions are browned, about 15 minutes.', '3 Add flour and stir until onions are evenly coated and flour is lightly browned, about 2 minutes.', '4 Stir in broth, scraping pan bottom to loosen browned bits; stir in beer, thyme, bay, browned beef with any of the accumulated juices, and salt and pepper to taste. Increase heat to medium-high and bring to a full simmer. Reduce heat to low, partially cover, let cook for 2-3 hours until beef is fork tender. (Alternatively can cook in the oven at 300\\xc2\\xb0F.)', 'Stir occasionally, scraping up anything that is sticking to the bottom of the pan.', 'About half an hour before it finishes cooking, add the mustard and brown sugar. Adjust seasonings to taste.', '5 Serve: Discard thyme and bay leaf. Adjust seasonings with salt and pepper to taste and serve. Can serve plain, with potatoes, over noodles, or over French fries.', 'Whatever ale you have used in the cooking makes for a great drink accompaniment to the stew.']",10
182,Short-Rib Beef Stew with Ale Recipe,15,210,225,"['1/2 cup flour', '2 Tbsp hot paprika', '2 teaspoons smoked paprika', 'Salt', 'Freshly ground black pepper', '4 pounds bone-in beef short ribs, trimmed of excess fat', '4 strips thick-cut bacon', '1 medium onion, chopped (about 1 1/2 cups)', '4 cloves garlic, finely chopped', '1 bottle (12 oz.) a malty brown ale (we used Newcastle Brown ale)', '1 can (14.5 oz.) whole peeled tomatoes, chopped and juices reserved', '2 pounds Yukon Gold or russet potatoes', '2 large carrots', '1 pound turnips (optional)']",14,"['1 Cook the bacon: Place bacon strips in a large (5 to 6 quart), thick-bottomed Dutch oven. Set the heat to medium and cook the bacon until much of the fat has been rendered. Remove bacon to a paper-towel lined plate.', 'Pour off all but 1 Tbsp of the bacon fat from pot. (Do not pour down the drain or you will clog your drain when the fat hardens as it cools.)', '2 Dredge the short ribs: Preheat oven to 300\\xc2\\xb0F. While the bacon is cooking, in a large bowl, whisk together the flour, hot paprika, smoked paprika, 1 teaspoon of salt and 1 teaspoon of black pepper. Dredge the short ribs in the flour mixture.', '3 Brown the short ribs in the bacon fat: Add the short ribs to the pot with the bacon fat, taking care to not crowd the pot (work in batches if necessary). Brown on all sides, about 3 to 5 minutes per side.', 'If you want to get good browning, do not stir the short ribs unless to turn.', 'While the short ribs are browning, chop the bacon and set aside.', '4 Cook the onions and garlic: Use tongs or a slotted spoon to remove the short ribs from the pot to a bowl. Add the chopped onions to the pot. Sprinkle with 1/2 teaspoon of salt. Cook until translucent, about 4 minutes.', 'Add the garlic and cook for an additional minute.', '5 Add ale and tomatoes: Add the ale and, using a wooden spoon or spatula, scrape up any browned bits on the bottom of the pan.', 'Add tomatoes and their juices and reserved bacon. Increase heat to high and bring mixture to a boil.', '6 Cover and cook in oven: Return the short ribs to the pot, cover, put in the 300\\xc2\\xb0F oven, and cook for two hours. (Alternatively, you can do the cooking on the stovetop, just lower the heat to the lowest setting and cover.)', '7 Add the root vegetables: Peel potatoes, turnips (optional), and carrots, and cut into 1-in. pieces. Add to short ribs, cover, and cook until the vegetables are tender and meat pulls away easily from the bone, about 30-45 minutes. Add salt and pepper to taste.', '8 Remove bones, excess fat: Spoon off excess fat (it helps if you have a fat separator). If you want, remove the bones before serving and cut any big pieces of meat into smaller chunks.']",13
183,Quick Beef Stew with Mushrooms and White Beans Recipe,10,40,50,"['4-5 ounces of cremini or button mushrooms, quartered', '4-5 ounces some other fresh mushroom, shiitake, oyster, chanterelle, etc.', '1 1/2 pounds boneless beef top sirloin steak, cut into 1-inch cubes', '2 tablespoons extra virgin olive oil', 'Salt', '2 medium carrots, cut into 1/4 inch thick slices', '1 medium onion, cut lengthwise into thin wedges', '2 garlic cloves, sliced thin', '1/2 cup dry white or red wine (can sub beef or chicken broth)', '16-ounce can small white beans (such as Great Northern, navy, or cannellini), rinsed, drained', '14 1/2-ounce can diced tomatoes with garlic and onion, undrained', 'Chopped parsley for garnish']",12,"['1 Dry saut\\xc3\\xa9 the mushrooms: Put a large skillet over high heat and add all the mushrooms. Shaking the pan from time to time to prevent the mushrooms from sticking, dry saut\\xc3\\xa9 them until they being to release their water. Keep cooking until the mushrooms begin to brown. Remove to a bowl and set aside.', '2 Brown the beef: Add 2 tablespoons olive oil to the skillet and lower the heat to medium-high. Brown the beef cubes in batches, turning to brown at least two sides of the meat. Remove from skillet, add to the bowl with the mushrooms and sprinkle salt over them.', '', '3 Cook the carrots, onions, and garlic: Add the carrots and saut\\xc3\\xa9 3-4 minutes. Add the onions and cook another 5 minutes, then add the garlic and cook another minute.', '4 Add wine, bring to a boil and return the cooked beef and mushrooms to the pan. Continue cooking 3 more minutes.', '5 Stir in the beans and tomatoes. Cook 5 minutes more. Add salt to taste. Serve, garnished with chopped parsley.', '']",7
184,Veal Goulash with Sauerkraut Recipe,10,90,100,"['4 tablespoons unsalted butter or rendered beef fat', '2 pounds of veal, cut into 1 1/2-inch cubes', '1 1/2 cups sliced onions, sliced root to tip, 1/4-inch thick slices', '1 teaspoon minced garlic', '1 teaspoon salt, plus more to taste', '1/2 teaspoon black pepper', '1 cup canned crushed tomatoes, or chopped fresh ripe tomatoes', '1 cup full-fat sour cream', '2 teaspoons paprika', '2 teaspoons caraway seeds, chopped or crushed in a mortar with pestle', '2 28-30 ounce jars sauerkraut (we recommend Bubbies, in the refrigerated section of the grocery store)', '3 tablespoons chopped fresh parsley']",12,"['1 Lightly brown the veal: Heat butter or beef fat in a large saut\\xc3\\xa9 pan on medium high heat. Pat dry the cubed veal. Sprinkle with salt and add to pan. Working in batches, saut\\xc3\\xa9 the meat until the meat is just beginning to brown.', '2 Add onions, then garlic: Add the onions to the pan with the veal, cook for another 5 minutes. Add the garlic and cook for another minute.', '3 Add a teaspoon of salt, a half teaspoon of black pepper, and the tomatoes. Add enough water to just barely cover the meat, about 2 cups or so, depending on the size and shape of your pan.', '4 Simmer about 30 minutes: Increase the heat to bring the mixture to a simmer, then lower the heat to maintain a low simmer, uncovered. Cook until the meat is almost cooked through, about 30 minutes.', '5 Remove veal, reduce the sauce: Use a slotted spoon to remove the veal from the pan to a bowl to temporarily set aside. Increase the heat to high and let the liquid boil until it is reduced by half. Lower the heat to medium.', 'Add the meat back to the pan.', '6 Add the sour cream, paprika, and crushed caraway seeds, and simmer uncovered for another 20 minutes.', '7 Heat the sauerkraut in a medium pot on medium heat until hot.', 'To serve, strain the sauerkraut. Place the sauerkraut in a serving dish and top with the goulash.']",9
185,Chocolate Guinness Cake Recipe,10,60,70,"['1 cup Guinness extra stout', '10 tablespoons unsalted butter', '3/4 cup unsweetened natural cocoa', '1 1/2 cups superfine sugar', '1/2 cups dark brown sugar', '3/4 cup sour cream', '2 eggs', '1 tablespoon pure vanilla extract', '2 cups all-purpose flour', '2 1/2 teaspoons baking soda', '1/4 teaspoon salt', '1/2 cream cheese frosting recipe']",12,"['1 Preheat oven, prepare pan: Preheat the oven to 350\\xc2\\xb0F. Grease a 8 or 9-inch springform pan with butter and line the bottom with a round of parchment paper.', '2 Heat Guinness, butter, add cocoa and sugar: In a large saucepan place the stout and butter. Cook over medium-high heat until the butter has melted. Add the cocoa powder and sugars and whisk together. Take off heat and allow to come to room temperature.', '3 Beat sour cream, eggs, vanilla, then add to stout butter mixture: In another bowl beat together the sour cream, eggs, and vanilla extract until very, very well combined. Add to the butter-stout mixture and whisk together.', '4 Whisk flour, baking soda, salt, add to stout-butter mixture: In another bowl whisk together the flour, baking soda, and salt. Add to the stout-butter mixture and whisk together until it just comes together.', '5 Bake: Pour into the prepared pan and give the pan a few short drops onto the countertop to shake the air pockets in the batter to the surface and out of the cake. Bake at 350\\xc2\\xb0F for 50-60 minutes.', '6 Cool: Allow to cool on a wire rack. Run a knife around the edge to separate the cake from the pan and pop the ring off the springform.', '7 Frost: Spread frosting on the cooled cake and serve.']",7
186,Grilled Polish Sausage and Sauerkraut Recipe,5,60,65,"['2-3 pounds kielbasa, Polish sausage or bratwurst', '1 to 2 light-colored (not dark) beers', '1 to 1 1/2 pints of sauerkraut', '2 medium yellow onions, thickly sliced', '2 Tbsp vegetable oil', '1 teaspoon salt', '1/2 teaspoon celery seed', '1 Tbsp. caraway seed', 'Mustard']",9,"[""1 Grill the sausages slowly over medium heat, allowing them to get well browned. Be patient; do not be tempted to grill the links over high heat, or they will break open and the juices and fat will drain into the grill (they may break open anyway, but they'll break less if you cook them slowly)."", '2 Heat the beer with celery seed and caraway seeds: While the sausages are cooking, put an aluminum grilling pan on a cooler part of the grill and pour in the beer. Stir in the celery and caraway seeds and salt. Bring to a simmer. (This may require covering the grill.)', '3 Add sausages and sauerkraut: Once the sausages are browned add the sausages, the sauerkraut and sauerkraut juices to the pan.', '4 Grill the onions: Paint the sliced onion with the vegetable oil and grill on high direct heat. If your grates are too wide and you think you will lose too much onion through the grates, you can either skip the grilling part and put the onions directly into the beer bath, or you can cut the onions in halves or quarters and grill them that way.', 'Then slice them and add them to the beer.', '5 Cover the grill and simmer (a low simmer, not a boil) for 30 minutes to 2 hours before serving. Cut the sausages into serving sized pieces before serving.', 'Serve as is in a bowl or on a plate, or in a sandwich roll. Serve with mustard on the side.']",7
187,Rabbit Braised in Belgian Ale Recipe,20,75,95,"['One 2 1/2 to 3 pound rabbit, cut into 6 to 7 serving pieces (2 front legs, 2 back legs, the loin cut into 2 to 3 pieces), plus ribs and flap meat', 'Salt', '1/2 cup all purpose flour for dredging', '2 tablespoons extra virgin olive oil', '2 tablespoons butter', '2 medium onions, sliced stem to root (about 2 1/2 cups sliced)', '4-6 whole cloves of garlic, peeled', '6 sprigs of fresh thyme, tied together with kitchen string (or 1/2 teaspoon dried thyme)', '1 1/2 cups of Belgian ale, such as Chimay or Ommengang', '1/2 cup of chicken stock', '1/2 teaspoon salt', '1/2 teaspoon freshly ground black pepper', '1 celery root, peeled and diced', '2 teaspoons whole grained mustard', '2 teaspoons brown sugar', '1 tablespoon chopped fresh parsley']",16,"['1 Sprinkle rabbit pieces with salt: Place rabbit pieces on a platter, sprinkle both sides with kosher salt. Let sit for 30 minutes to an hour.', '2 Dredge rabbit with flour, brown in butter: Place flour on plate. Dredge rabbit pieces in flour.', 'Heat oil and butter in a large  Dutch oven on medium heat (large enough to fit rabbit pieces in a single layer). Once the butter is melted and foamy, add the rabbit pieces in a single layer to the pot.', 'Brown on one side without stirring for 5 to 6 minutes. Then turn the pieces over and brown on the other side. Remove to a plate.', '3 Brown the onions, add garlic and thyme: Add the sliced onions to the pot, and cook, stirring occasionally, until lightly brown, scraping up and browned rabbit bits from the bottom of the pot. Add garlic cloves and thyme, cook until onions are soft and the garlic quite fragrant.', '4 Add ale, then stock, salt, pepper: Increase the heat to high and add the Belgian ale. Let it simmer for a minute or two, then add the stock. Add a half teaspoon of salt and the freshly ground black pepper.', '5 Add celery root, rabbit, then simmer: Place the diced celery root over the onions in a single layer. Place the browned rabbit pieces over the  celery root. Bring to a simmer. Cover and reduce heat to maintain a very low simmer. Cook for 45 minutes, or until the rabbit is just cooked through and tender.', '6 Reduce sauce: Remove rabbit pieces from the pot and keep warm on a platter. Increase the heat to high and reduce the liquid by one third. Then, reduce the heat to low, stir in the mustard and sugar. Taste and add more salt and pepper in needed.', '7 Return meat to sauce in pot: Slice the flap meat pieces of the rabbit into strips and return to the pot. Strip away any available meat from the back and chest parts and return meat to the pot. Add the serving pieces to the pot. Cover and let rewarm for a minute.', '8 Serve: Sprinkle with chopped parsley to serve. Serve with crusty bread, egg noodles, or rice pilaf, along with some Belgian ale.']",10
188,Beer Braised Chicken and Onions Recipe,15,120,135,"['1 Tbsp unsalted butter', '6 chicken thighs, about 2 to 2 1/2 pounds', 'Salt', '3 pounds yellow onions, sliced 1/4-inch thick, root to stem, about 6-8 cups sliced', '1 Tbsp brown sugar, packed', '2 bay leaves', '2 teaspoons dried thyme', '2 Tbsp smooth Dijon mustard', '1 1/2 cups dark beer', '1 cup chicken stock', 'Freshly ground black pepper']",11,"['1 Brown the chicken thighs on all sides: Melt the butter in a large, heavy pot with a lid, such as a Dutch oven, over medium-high heat. Pat the chicken thighs dry with paper towels and set them skin side down in the butter. Salt the meat side lightly.', 'Brown the chicken on both sides well. Remove the browned thighs from the pan and set aside in a bowl.', '2 Drain off some of the fat: The chicken skin has likely rendered quite a bit of fat. Drain off all but 2 tablespoons of fat from the pan, taking care to not discard any of the tasty browned bits. (Note, do not discard the fat down the drain, you may clog your plumbing. Pour off into a jar.)', '3 Cook the onions: Lower the heat to medium and add the sliced onions to the pan. If you want, sprinkle brown sugar over the onions. This is optional. The added sugar will intensify the natural sweetness of the onions.', 'Cook the onions slowly, stirring occasionally, until they begin to brown, about 15 minutes.', '4 Add herbs mustard, salt, beer, stock, chicken, bring to simmer: Add the bay leaves, thyme, mustard, 2 teaspoons of salt, and beer to the onions. Scrape up any browned bits from the bottom of the pot with a wooden spoon. Add the chicken thighs and the chicken stock and bring to a simmer.', '5 Cook until chicken is falling off the bone tender: Cook covered for 45 minutes, then uncover the pot and simmer well until the liquid is greatly reduced and the meat wants to fall off the bone, between 45 minutes and 1 hour.', 'If you are using unsalted or low sodium stock, you will likely need to add more salt. Add freshly ground black pepper and more salt to taste.', 'Serve over egg noodles or with rice or potatoes.']",9
189,Cider Vinaigrette Roasted Root Vegetables Recipe,25,40,65,"['1/2 cup cider vinegar', '1/2 cup extra virgin olive oil', '3 tablespoons dark brown sugar', '1/4 teaspoon kosher salt', 'Freshly grated black pepper to taste', '4 medium golden beets, peeled, thickly sliced', '4 medium carrots, peeled, sliced lengthwise into 1 to 2 inch long pieces', '3 medium garnet yams, sliced lengthwise into 1 to 2 inch long pieces', '4 medium parsnips, peeled, sliced lengthwise into 1 to 2 inch long pieces, any tough woody core removed', '1 large red onion, thickly sliced', '3/4 teaspoon thyme, dry or fresh']",11,"['1 Toss vegetables with vinegar, oil, sugar, salt, pepper: Preheat the oven to 450\\xc2\\xb0F. In a large bowl (enough room for all the vegetables) mix together the cider vinegar, olive oil, brown sugar, salt and pepper. Add the vegetables\\xe2\\x80\\x94the beets, carrots, yams, parsnips, onion\\xe2\\x80\\x94to the bowl and toss to combine.', ""2 Spread vegetables out into two lined sheet pans: Line two large roasting pans or sturdy rimmed baking sheets with aluminum foil. Spread the root vegetables out over the pans in a single layer, with some space in between so that the vegetables don't crowd each other too much and the hot oven air can circulate around the vegetables. (You'll get better browning that way.) Pour the remaining vinaigrette over the root vegetables in the pans."", '3 Roast the vegetables: Place vegetables in the oven and roast at 450\\xc2\\xb0F for 35 to 40 minutes, turning the pans (and swapping bottom and top rack positions), half-way through the cooking. Cook until the vegetables are well browned and caramelized around the edges.', '4 Sprinkle with thyme: Remove from oven and gently loosen the root vegetables from the foil with a wooden spoon. Sprinkle with thyme. Add more salt and pepper to taste.']",4
190,Roasted Root Vegetables with Tomatoes and Kale Recipe,20,55,75,"['3 to 4 pounds of root vegetables such as parsnips, rutabagas, carrots, potatoes, golden beets, turnips, and celery root, peeled and cut into chunks', '1 head of garlic, the cloves separated and peeled', '6 tablespoons extra virgin olive oil, divided 3 Tbsp and 3 Tbsp', '1 teaspoon Kosher salt', '1/2 cup chopped onion', '1 heaping tablespoon tomato paste', '1 28-ounce can of whole peeled tomatoes', '2 cups (packed) of chopped leafy greens such as kale or chard', '1 teaspoon Italian seasoning or dried oregano', 'Black pepper to taste', 'Tabasco sauce (optional, to taste)']",11,"['1 Roast the root vegetables: Preheat oven to 450\\xc2\\xb0F. Into a large roasting pan, mix together the vegetables, garlic, 3 Tbsp olive oil. Sprinkle with salt.  Roast for 45 minutes, turning the vegetables over in the pan halfway through cooking.', '2 Make the tomato base: While the root vegetables are roasting, in a 4 to 5 quart Dutch oven, heat 3 Tbsp of olive oil over medium high heat. When the oil is hot, add the onions and saut\\xc3\\xa9 until the edges of the onions just begin to brown. Stir in the tomato paste, and cook a minute longer.', 'Using your hands, tear the canned tomatoes into large pieces as you add them to the pot. Add the remaining liquid from the can into the pot. Stir well. Add the Italian seasoning. Bring to a simmer, then lower the heat to the lowest possible setting. Cover the pot and let cook gently while the root vegetables are roasting.', '3 Combine and simmer the roasted root vegetables, tomatoes, and greens: When the root vegetables are ready (they should be browned on the edges and easily pierced with a fork), remove from the oven. Add chopped leafy greens to the pot of tomatoes. Simmer until the greens are wilted, about 5 minutes. Stir in the root vegetables. Season with salt and pepper to taste. Season with Tabasco to taste if using.']",4
191,Orange and Beet Salad Recipe,10,45,55,"['1 bunch of beets, leaves removed (save them for beet greens!) - about 4 or 5 medium sized, scrubbed clean', '2 large navel oranges, peels cut off with a small small knife and sliced', '1 bunch of arugula leaves, cleaned, and any thick stems removed', 'Several thin slices of red onion', 'optional 1/4 cup chopped walnuts', 'Vinaigrette Dressing:', '3 Tbsp white wine vinegar', '1/4 cup extra virgin olive oil', '1/4 teaspoon dried mustard', 'Salt and pepper to taste']",10,"['1 Cook the beets: You can either boil or roast the beets. To boil the beets, cover the unpeeled beets with water, bring to a boil, and simmer for 30 minutes or until beets can easily be pierced through with a fork.', 'If you prefer to roast the beets instead of boiling them, wrap the unpeeled beets in aluminum foil and bake them in the oven at 400\\xc2\\xb0F for an hour or until done. (See our Roasted Beets recipe.)', 'After cooking, allow the beets to come to room temperature and remove their peels. Slice or quarter them.', 'If you have time, place them in a small bowl and marinate them in half of the oil and vinegar dressing.', '2 Make the dressing: While the beets are cooking, make the dressing by putting all of the dressing ingredients into a jar. Seal and shake until the dressing is well blended.', '3 Compose the salad: Compose individual salad plates with arugula, a few slices of orange, a few beets, a few slices of red onion and a few chopped walnuts.', 'If you want some added color, gently add a few slices of the orange to the beet juice from your bowl of beets. Let the oranges absorb the beet color and use in your salad.', 'Sprinkle dressing over the individual salads.']",8
192,Golden Beets and Brussels Sprouts Recipe,10,55,65,"['2 medium sized golden beets', '10 Brussels sprouts, trimmed of rough outer leaves and cut in half', '2 teaspoons salt', '1 shallot, peeled and sliced', '2 tablespoons extra virgin olive oil', '2 teaspoons fresh thyme, chopped', '2 tablespoons almond slivers, toasted', 'Salt and freshly ground pepper']",8,"['1 Boil or roast the beets: The beets take the longest to cook so start them first. Either boil them in water in a small saucepan for 45 minutes (or how ever long it takes to get them tender), or wrap them in foil and roast them in the oven at 350\\xc2\\xb0F for an hour fifteen minutes or until done.', 'Roasting will give you better flavor, but takes longer and uses a lot more energy (unless you are already cooking something in the oven).', 'When done, set the beets aside to cool for 10 minutes, then peel and chop them into 1 x 1/2 inch chunks.', '2 Toast the slivered almonds: While beets are cooking toast your almond slivers if you are starting with raw almonds. Just heat a skillet to medium high heat and put in the almonds. Stir frequently with a spatula. When the almonds begin to brown, remove from pan into a small bowl. Let cool, set aside.', '3 Blanch the Brussels sprouts: Also while the beets are cooking, prepare the Brussels sprouts. Bring 1 1/2 quarts of salted water (2 teaspoons salt) in a medium saucepan to a boil. Add the Brussels sprouts to the water and blanch them for 2-3 minutes. They should be almost all the way cooked through.', 'Drain and rinse with cold water to stop the cooking. Set aside.', '4 Cook the shallots, add beets and Brussels sprouts: In a medium sized skillet heat 1 Tbsp olive oil on medium heat. Add the shallot slices and cook until translucent, a few minutes.', 'Add another tablespoon of olive oil and raise the heat to medium high. Add the sprouts and beets to the pan, along with the thyme and mix well. Salt and pepper to taste.', 'Cook for 1 minute more, stirring. Remove from heat and serve. Can serve warm or at room temperature.']",9
193,Festive Beet Citrus Salad with Kale and Pistachios Recipe,20,135,155,"['6 - 10 large beets (about 4 to 5 pounds), a mix of red, pink, and golden', '2 - 3 blood oranges (or cara cara or navel oranges or a mixture)', '1 bunch of kale (lacinato or dinosaur kale if available), center ribs removed, leaves thinly sliced', '1 cup roasted pistachios, roughly chopped', '1/4 cup chopped fresh mint leaves', '3 Tbsp chopped Italian parsley', 'Dressing:', '2 Tbsp lemon juice', '1/2 cup good quality extra virgin olive oil', '6 Tbsp seasoned rice vinegar (or unseasoned rice vinegar plus 2 teaspoons of sugar)', 'Zest of one orange', 'Zest of one lemon', '2 Tbsp capers, coarsely chopped', '1/2 teaspoon salt', 'Freshly ground black pepper to taste']",15,"['1 Cook the beets: Scrub the beets clean, leaving the skin on. You can boil or roast the beets to cook them.', 'If boiling, boil the beets separately by color (otherwise the red beets will run into the the orange, turning the orange beets red). Place each batch of beets in a pot and cover with water by about an inch. Add a couple teaspoons of salt. Bring to a boil and reduce to a simmer. Simmer until you can just pierce easily with a fork, 30 to 60 minutes, depending on the size of the beets. Drain. Let cool. Rub the skins off.', 'To roast the beets, wrap them in foil and roast them in a 400\\xc2\\xb0F oven for 1 to 1 1/2 hours, until fork tender. Then cool and peel. See our roasted beets recipe.', '2  While the beets are cooking, prepare the dressing and prep the rest of the ingredients. Place all of the dressing ingredients into a jar, cover and shake until well blended.', '3 Marinate beets in dressing: Cut the beets into 1/2-inch to 1-inch pieces. Separate by color and place in separate bowls and toss with a little of the dressing (use about a third of the dressing). Chill for an hour or up to two days.', '4 Sprinkle sliced kale with some dressing: 15 minutes to an hour or two before serving, place the thinly sliced kale in a serving bowl. Sprinkle half of the remaining dressing over the sliced kale and toss to lightly coat the leaves.', '5 Serve: Either create a composed salad by placing the beets, citrus, mint, parsley, over the kale, sprinkling with the chopped roasted pistachios, and drizzling with the remaining dressing, OR toss everything together, sprinkling with with pistachios at the end.']",7
194,Mom\xe2\x80\x99s Ground Turkey and Peppers Recipe,15,15,30,"['3 to 4 tablespoons extra virgin olive oil', '1 cup chopped yellow onion, including some chopped greens from scallions or green onions', '1 bell pepper (red or yellow preferred), chopped', '2 cloves garlic, minced', 'Kosher salt', '1 pound ground turkey, preferably ground turkey thighs', '1 teaspoon chipotle powder or chili powder (or to taste)', '2 tablespoons chopped fresh parsley or cilantro']",8,"['1 Saut\\xc3\\xa9 the onions, bell pepper, garlic: Heat 2 tablespoons olive oil in a large skillet on medium high heat. Add the chopped onions and bell pepper and cook until onions and peppers are softened, a couple minutes.', 'Add the garlic and cook 30 seconds more.', '2 Add the ground turkey, salt, chipotle chili powder: Push the vegetables to the edge of one side of the pan and position that side of the pan so that it is off the burner, away from the heat. The empty part of the pan should be right over the burner.', 'Add one or two more tablespoons of oil to coat the empty part of the pan. Put crumpled chunks of ground turkey in the pan, sprinkle with salt and chipotle or chili powder.', '3 Brown the turkey, stir in the peppers and onions: Cook the turkey without stirring until it is browned on one side, then turn the pieces over to brown the other side.', 'Once the turkey is just cooked through, stir in the onions and peppers, and sprinkle with more salt and chili powder to taste. Remove from heat.', 'Stir in fresh chopped parsley or cilantro.', 'Serve alone, or with steamed rice or noodles.']",8
195,Dad\xe2\x80\x99s Stuffed Bell Peppers Recipe,10,50,60,"['1 1/2 cup of cooked white rice (from about 3/4 cup raw rice)', '4 to 6 bell peppers, any color', '5 tablespoons extra-virgin olive oil', '1 medium yellow onion, peeled and chopped', '1 clove garlic, peeled and chopped', '1 pound lean ground beef', '1 cup chopped tomatoes, fresh or canned (if using can, drain of excess liquid first)', '1 tablespoon chopped fresh oregano, or 1 teaspoon of dried oregano', '1 teaspoon salt', '1/2 teaspoon ground black pepper', '1/2 cup ketchup', '1/2 teaspoon of Worcestershire Sauce', 'Dash of Tabasco sauce']",13,"[""1 Cook the rice (if needed): If you are starting with raw rice, you'll need to cook it first. Cook the rice following the directions on the rice package."", '2 Steam the bell peppers: Cut the tops off of the bell peppers about 1/2 inch to 1 inch from the stem end and remove the seeds. (Save the extra bits of bell pepper for another dish such as Ground Turkey and Peppers.)', 'Place a steaming rack in a large pot and add enough water to cover the bottom of the pan by an inch. Place the bell peppers on the rack, cut side up, and bring the water to a boil. Cover the pot and let the peppers steam for 5 to 10 minutes until they start to soften.', 'Note that you can skip the steaming if you want, but this step will help ensure that the peppers cook through thoroughly when they are stuffed and baked.', '3 Saut\\xc3\\xa9 onions and garlic: Preheat oven to 350\\xc2\\xb0F. Heat 4 tablespoons of the oil in a large skillet over medium heat. Add onions and cook, stirring often, until soft and translucent, about 5 minutes. Add the garlic and cook a minute more.', '4 Make filling: Add the meat, cooked rice, cooked onions, tomatoes, oregano, salt, and pepper to a large bowl. Mix everything together with your hands or a wooden spoon, just enough so that the ingredients are all well distributed. Do not over-mix.', '5 Stuff the peppers: Drizzle remaining 1 tablespoon of olive oil inside the peppers. Arrange the cut side of the peppers up in a baking dish, then stuff peppers with filling.', 'Combine ketchup, Worcestershire sauce, Tabasco sauce, and 1/4 cup of water in a small bowl, then spoon over filling.', '6 Bake: Add 1/4 cup of water to the baking dish. Place in 350\\xc2\\xb0F oven and bake for 40-50 minutes (or longer, depending on how big the peppers are that you are stuffing), until the internal temperature of the stuffed peppers is 150-160\\xc2\\xb0F.']",9
196,"Sausage, Pepper, and Potato Bake Recipe",25,60,85,"['3 tablespoons olive oil, separated', '1 1/2 pounds Yukon gold potatoes (about 4 medium), washed and unpeeled', '1 teaspoon kosher salt, separated', '1/4 teaspoon ground black pepper, separated', '5 tablespoons balsamic vinegar', '2 teaspoons Dijon mustard', '1 tablespoon fresh rosemary, chopped', '1 teaspoon whole grain mustard', '1 clove garlic, peeled and crushed', '1/2 red bell pepper, thinly sliced', '1/2 yellow bell pepper, thinly sliced', '1/2 orange bell pepper, thinly sliced', '1/2 white onion, thinly sliced', '1 (14-ounce) package kielbasa (or Polish sausage), sliced into thin rounds about 1/4-inch thick']",14,"['1 Preheat your oven to 400\\xc2\\xb0F and prep the pan. Pour 1 tablespoon of the olive oil into an 9x13 baking dish and use your hand, or a brush, to grease the bottom and sides of the dish. This oil will help create a crisp crust on the bottom of the baked potatoes.', '2 Prep and start baking the potatoes: Thinly slice the potatoes to about 1/8-inch thick; use a mandoline if needed. Try to keep the potato slices together as you cut as this makes it easier to assemble them in the dish.', 'Fan the potatoes slightly in the dish, overlapping them like a fallen set of dominoes in the pan and creating four rows of potatoes. Sprinkle with 1/2 teaspoon of kosher salt and an 1/8 teaspoon of the black pepper.', 'Bake the potatoes for 30 minutes.', '3 Make the vinaigrette: Combine the vinegar, 2 tablespoons olive oil, both mustards, rosemary, garlic, and the remaining salt and pepper in a glass jar with a tight-fitting lid (or in a bowl).', 'Shake the ingredients together vigorously until combined. If you\\xe2\\x80\\x99re making the dressing in a bowl, use a whisk or an immersion blender to combine. Set this aside.', '4 Add the peppers, onions, and sausage to the dish: Carefully remove the dish of potatoes from the oven and evenly arrange the peppers, then the onions, and lastly, the sausage, on top of the potatoes.', 'Give the dressing another vigorous shake and pour evenly over the top of the casserole.', '5 Bake the dish: Return the dish to the oven and bake for an additional 30 minutes, or until a knife inserted into the middle of a potato offers no resistance.', '6 Cool and serve: Remove the dish from the oven and cool for 5 minutes before serving. Leftovers will keep in a covered container for up to two days in the fridge.']",10
197,Cheesy Hamburger Pasta Skillet Recipe,10,30,40,"['1 pound lean ground beef', '1 medium green bell pepper, diced', '1/2 large sweet onion, diced', '2 medium cloves garlic, minced', '1/2 teaspoon salt', '1/2 teaspoon ground pepper', '2 1/2 cups chicken broth', '1 1/2 cups half-and-half', '2 tablespoons all-purpose flour', '8 ounces wide egg noodles', '2 cups shredded cheddar or mozzarella', 'Special equipment:', '12-inch skillet']",13,"['1 Brown the ground beef: Heat a large 12-inch skillet over medium heat. Add the ground beef and brown, breaking into smaller pieces with a spatula or spoon. When browned, place onto a paper towel lined plate, and drain the beef. Set aside.', '2 Cook the pepper and onion: In the same pan, add in the bell pepper and onion. Cook until golden brown and softened. Add the garlic and cook until fragrant, about 30 seconds. Season with salt and pepper. Transfer this mixture to another plate and set aside.', '3 Make the sauce: Still in the same the pan, whisk together the chicken broth and half-and-half. Bring this mixture to a simmer. Whisk in flour and continue to simmer, about three minutes until the mixture begins to thicken slightly.', '4 Cook the noodles: Add the egg noodles to the milk mixture. Cover pan and cook for about 8 minutes, or until the noodles are cooked through. Stir occasionally to ensure all noodles are submerged and cooking.', '5 Add the ground beef, green peppers, and onions back to the pan. Stir to combine. Lastly, stir in the shredded cheese and combine until the cheese has melted. Serve immediately.']",5
198,Peperonata (Saut\xc3\xa9ed Peppers and Onions) Recipe,15,15,30,"['1/4 cup extra virgin olive oil', '2 red bell peppers, seeded, sliced into 2 1/2 to 3-inch long strips', '2 yellow bell peppers, seeded, sliced into 2 1/2 to 3-inch long strips', '2 orange or green bell peppers, seeded, sliced into 2 1/2 to 3-inch long strips', '1 large onion, sliced into half-moons', '4 garlic cloves, sliced thin', '1 tablespoon dried oregano', '1 tablespoon sugar', '4-5 Roma or other plum tomatoes, seeded and diced', 'Salt and pepper to taste', '1/2 cup fresh basil, leaves torn roughly', 'Lemon juice']",12,"['1 Saut\\xc3\\xa9 the onions: Heat olive oil in a large saut\\xc3\\xa9 pan on medium high heat. When the oil is shimmering, add the onions. Sprinkle with a little salt and saut\\xc3\\xa9 for 2-3 minutes, until the onions just begin to color.', '2 Add the peppers: Add the peppers and stir well to combine with the onions. Saut\\xc3\\xa9 for 4-5 minutes, stirring often. The peppers should be al dente\\xe2\\x80\\x94cooked, but with a little crunch left in them.', '3 Add the garlic: Add the garlic, and saut\\xc3\\xa9 another 1-2 minutes.', '4 Add salt, sugar, oregano: Sprinkle a little more salt over everything and add the sugar and dried oregano. Cook 1 minute.', '5 Add the diced tomatoes, and cook just one minute further.', '6 Add basil, black pepper, lemon juice: Turn off the heat and mix in the torn basil. Grind some black pepper over everything. Right before serving squeeze a little lemon juice over the dish.']",6
199,Quick Beef Stir-Fry with Bell Peppers Recipe,15,10,25,"['1 pound top sirloin or chuck steaks (about 1/2 inch thick), trimmed', 'Salt and freshly ground black pepper', '1 large garlic clove, minced', '3 tablespoons extra virgin olive oil, divided', '2 medium bell peppers, one red, one green, sliced into 1/4-inch strips', '1/2 yellow onion, thinly sliced lengthwise (root to top)', 'A dozen cherry tomatoes, cut in half, or one large tomato, roughly chopped', '2 tablespoons chopped cilantro (optional)', '1 tablespoon soy sauce', '2 teaspoon toasted sesame oil']",10,"['1 Season steaks with salt, pepper, garlic, then pound thin: Season the steaks with salt and pepper and rub minced garlic over one side. Place the steaks between two sheets of plastic wrap. With a meat pounder, pound the steaks to a 1/4 inch thickness.', 'Let the steaks sit for 10 minutes to absorb the flavor of the garlic.', '2 Cut the steaks across the grain into 1/2-inch wide strips.', '3 Saut\\xc3\\xa9 onions and peppers: Heat 2 Tbsp oil in a large skillet on high heat. Add the sliced onions and bell peppers, cook, stirring, until just barely tender, about 1-2 minutes. Remove the vegetables from the pan to a bowl and keep warm.', '4 Saut\\xc3\\xa9 beef strips: Heat an additional Tbsp of oil in the skillet on high heat, until the oil is shimmering, but not smoking. Add the strips of beef let the beef brown initially, without stirring, but as soon as it is brown on one side, then stir. Cook for no more than a minute (for medium-rare).', '5 Add the peppers and onions, tomatoes, cilantro, soy sauce and sesame oil and cook for a half minute longer, stirring. Remove from heat.', 'Serve alone (paleo, low carb), or with steamed rice. Salt and pepper to taste.']",7
200,Roasted Red Pepper Pasta Sauce Recipe,15,40,55,"['3 tablespoons extra virgin olive oil', '1 onion, chopped', 'Salt', '4 garlic cloves, chopped', '1 tablespoon fresh sage, chopped', '3-5 anchovies, or 2 teaspoons anchovy paste', '2 tablespoons tomato paste', '1 1/2 cups red wine', '4 cups roasted red peppers (jarred or freshly roasted)', '1/4 teaspoon smoked paprika (optional)', '1/2 teaspoon cayenne or hot paprika', 'Grated cheese (parmesan, pecorino, manchego, etc.)', 'Some minced fresh sage for garnish']",13,"['1 Soak jarred peppers in water: If you are using jarred peppers, drain away the marinade and soak them in a large bowl of cold water. If you skip this step, the sauce will become too acidic. Soak for 10-15 minutes before proceeding.', '2 Saut\\xc3\\xa9 onions: Heat the olive oil in a pot over medium-high heat. Add the chopped onion and saut\\xc3\\xa9, stirring from time to time, until it is wilted and translucent, about 3 minutes. Sprinkle some salt over the onions as they cook.', '3 Add garlic and sage, then anchovies, then tomato paste: Add the garlic and sage, mix well, and saut\\xc3\\xa9 another minute. Mix in the anchovies, smashing them up, and cook for 1 more minute.', 'Stir in the tomato paste and cook for 2-3 minutes, stirring often, until the paste begins to turn a brick red.', '4 Add wine, roasted peppers, then simmer: Add the red wine and stir well. Turn the heat up to high and let this boil down by half. Stir in the roasted red peppers and turn the heat back down to medium.', 'Let this simmer for 10-20 minutes \\xe2\\x80\\x93 it\\xe2\\x80\\x99s pretty forgiving at this point. You just want the peppers to be cooked through and soft.', '5 Pur\\xc3\\xa9e: Pur\\xc3\\xa9e the sauce in a blender. You might need to do this in batches, because you don\\xe2\\x80\\x99t want to fill your blender more than 2/3 up at one time.', 'Pur\\xc3\\xa9e the sauce, starting with the machine on low for 1-2 minutes to break up the big pieces. Turn off the blender and scrape the sides down. Turn it on again, and starting at the low setting, bring it up to its highest setting. Pur\\xc3\\xa9e for at least a minute, until smooth.', '6 Add spices: Return the sauce to the pan and heat to medium-low. Taste for salt and add some if needed. Add the cayenne or hot paprika, along with smoked paprika if you have some. If you want, a teaspoon of sugar helps, too, if your peppers are not already sweet enough. Keep the sauce warm while you make the pasta.', '7 Make the pasta according to the package instructions, depending on the type of pasta you are using.', '8 Serve pasta with sauce: To serve, drain the cooked pasta and put it into a large bowl. Ladle some sauce over the pasta and mix with tongs to combine. You want to coat all the noodles evenly. Divide into servings. Garnish with some grated cheese and minced fresh sage. Serve with a medium-bodied red wine, or a dry rose.']",11
201,Marinated Roasted Red Bell Peppers Recipe,20,55,75,"['4 pounds firm, fresh, clean red bell peppers', '1 cup bottled lemon juice*', '2 cups white vinegar (5%)', '1 cup extra virgin olive oil + additional for roasting the peppers', '2 cloves garlic, quartered', '1 1/2 teaspoons salt', '3 pint canning jars', '*Bottle lemon juice has a consistent level of acidity which you need for this canning recipe.']",8,"['If you have an electric stove, heat a cast iron pan on high and place the peppers in the pan, allowing the peel to blister and blacken, turning so that all sides get blackened.', '3 Remove blackened peel: When the peppers are all well blistered and blackened, place in a non-reactive bowl and cover. (The steam from the hot peppers will help dislodge the skins.)', 'Once the peppers have cooled enough to handle, work with them one by one over a plate, gently peel off the blackened skins.', 'Cut the peppers in half and remove and discard the seed pods, stems and all seeds.', '4 Heat lemon juice, white vinegar, olive oil, garlic, and salt, in a saucepan until boiling.', '5 Sterilize the lids: If canning for shelf storage, remove some boiling water from the pot of boiling water in step one and place into a bowl. Put the lids in that bowl.', '6 Distribute peppers and vinegar mixture in jars: Use tongs or a jar lifter to remove mason jars from the boiling water in step 1 (if canning). Distribute the peppers evenly among the jars. Pour the hot vinegar mixture over the peppers to cover (try to make sure some garlic gets in each jar).', 'Leave 1/2-inch head space on the jars. Wipe the rims with a clean, dampened paper towel. Place on lids and rings (do not tighten rings too tight).', 'At this point you can store in the refrigerator for several weeks. If you want longer storage, or shelf storage, proceed.', '7 Water bath for canning: Place filled jars in boiling water on a rack (from step 1). (Helps to use tongs and wear thick rubber gloves). Water should cover jars by at least an inch. Boil for 15 minutes.', 'Let cool in pot for several minutes, remove. Let cool completely. You should hear the jars ""pop"" as the lids seal.', 'If a jar does not seal, store it in the refrigerator and use up within a few weeks. Otherwise the jars should last a year.']",12
202,"Grilled Italian Sausage with Peppers, Onions and Arugula Recipe",10,20,30,"['1 large red onion, cut into wedges*', '2 large red bell peppers, seeded and cut into thirds', '1 pound sweet Italian sausage links', 'Extra virgin olive oil', 'Salt', '3 Tbsp honey', '3 Tbsp balsamic vinegar', '2 to 3 handfuls of baby arugula', '*Cut the onion wedges so that the root end is still intact on each wedge. It will make the onion wedges easier to grill and help keep them from falling apart on the grill.']",9,"['1 Preheat the grill.', '2 Mix together the balsamic vinegar and honey in a small bowl and set aside.', '3 Grill the onions: Coat the onions with a little olive oil, and sprinkle with salt. Coat the grill grates with a little olive oil. Put the onion wedges on the grill and cover the grill.', 'Let the onions roast for 5 minutes, or until they are a little charred. Turn the onions and move them to a cooler part of the grill to finish.', '4 Grill the sausages and peppers: Coat the sausages and peppers with olive oil. Sprinkle salt on the peppers. If your grill has two levels, place the sausages on the top part of the grill and the peppers directly below them.', 'Done this way, as the sausages drip juice and fat, it will fall on the peppers, flavoring them while simultaneously preventing flare-ups.', 'If your grill does not have two levels, put the peppers on the hottest part of the grill and the sausages on the coolest.', 'Cover and grill everything for 15 to 20 minutes or so, periodically checking and turning the sausages and peppers as needed.', '5 Baste with honey balsamic mixture: Towards the end of cooking, baste the sausages, peppers and onions with the honey and balsamic mixture.', '6 Remove from grill, cut sausages, cut peppers and onions: When the sausages are cooked through and the peppers and onions cooked, remove them from the grill to a sheet pan or large bowl.', 'If you want, pick off some or all of the charred skin on the peppers. Cut the peppers into long strips, and slice the root end off the onions to separate the pieces.', 'Cut the sausages into thirds. Mix everything well in the pan or bowl.', '7 Serve: To serve, place a bed of baby arugula on the serving plates and top with the sausage, peppers and onion.']",13
203,Foil Baked Salmon with Leeks and Bell Peppers Recipe,10,35,45,"['1 1/2 to 2 pounds (680 to 900 g) of salmon fillets, cut into 4 portions', '1 Tbsp butter', '2 Tbsp extra virgin olive oil', '2 large red, yellow, or orange bell peppers, cored and sliced (about 3 cups)', '3 medium leeks, cleaned and sliced, white and light green parts only (see How to Clean Leeks)', '1/2 teaspoon salt', '1 teaspoon dried tarragon (can sub thyme)', '4 teaspoons dry vermouth or dry white wine (optional)', '4 lemon wedges']",9,"['1 Saut\\xc3\\xa9 leeks and bell peppers: In a large saut\\xc3\\xa9 pan, heat the butter and olive oil on medium heat until the butter is melted and foamy.  Stir in the sliced leeks and bell peppers, sprinkle with salt and dried tarragon, and gently cook until completely soft, 10 to 15 minutes.', '2 Prepare foil packets: Preheat oven to 375\\xc2\\xb0F (190\\xc2\\xb0C). Prepare 12x12-inch foil pieces for each of the salmon fillets. Portion out the leek and bell pepper mixture evenly onto the centers of each of the foil pieces. Top with a salmon fillet. Sprinkle lightly with salt. Sprinkle each fillet with a teaspoon of dry vermouth or white wine if using.', 'Fold up the foil packets to allow some room over the salmon, but seal so that steam is not allowed to escape. (There are many ways to fold the foil, do which ever way works best for you!)', '3 Bake: Place the salmon filled foil packets on a baking sheet and  place in the oven in the middle rack. Bake at 375\\xc2\\xb0F (190\\xc2\\xb0C) about 12 to 15 minutes, or until just barely cooked through.', 'Sprinkle with lemon juice to serve or serve with lemon wedges.']",5
204,Slow Cooker Cajun-Spiced Stuffed Peppers Recipe,15,240,255,"['1 pound (450g) lean ground beef', '1 1/2 (225g) cups cooked brown rice', '1 1/4 cups (150g) diced yellow onions', '1 1/4 (115g) cups shredded mozzarella cheese', '3/4 cup (80g) corn kernels (fresh or frozen)', '1 1/2 teaspoons Cajun seasoning', '1 teaspoon dried oregano', '1 teaspoon sea salt', '1/2 teaspoon paprika', '5 to 6 large bell peppers', 'Special Equipment:', '4- to 6-quart slow cooker, though any size will work as long as the peppers will stand upright']",12,"['1 Mix the filling: In a large bowl, mix the ground beef, cooked rice, onions, 3/4 cup of the mozzarella cheese, corn, Cajun seasoning, oregano, sea salt and paprika together. The beef can be a bit difficult to break apart in the beginning. Using a fork can help. Set filling aside (or cover and refrigerate for up to 24 hours).', '2 Prepare the peppers: Slice off the tops of the bell peppers. You don\\xe2\\x80\\x99t need to cut off a lot; just enough to get the stem off. Remove the seeds and membrane from the insides of the peppers. The peppers should look like little cups that are ready for stuffing.', '3 Stuff each pepper with beef and rice filling. Carefully place each stuffed pepper into the slow cooker. Cover the pot.', '(The stuffed peppers can also be covered and refrigerated for up to 24 hours before cooking.)', '4 Set the slow cooker on low and cook for 4 to 5 hours. The peppers are done when the meat is cooked through. About 10 minutes before the peppers are done, sprinkle the remaining cheese on top of the peppers and close the lid.', '5 Drain excess liquid and serve: Carefully remove peppers from the slow cooker. Some of your peppers may have filled with some liquid. That\\xe2\\x80\\x99s perfectly normal. I like to gently tip the peppers over to drain the excess liquid before serving. Be careful when doing this, as the peppers may still be quite hot.']",6
205,Sheet Pan Hawaiian Chicken Recipe,5,25,30,"['1 pound thin-cut chicken breasts, sliced into strips', '1 (20-ounce) can pineapple chunks in juice, drained and juice reserved', '1 red bell pepper, seeded and cut into strips', '1 tablespoon extra-virgin olive oil', '1/2 teapsoon Kosher salt', '1/2 teaspoon freshly ground black pepper', '1/4 cup soy sauce or tamari (gluten free, if needed)', '1 tablespoon freshly grated ginger', 'Cooked rice, to serve']",9,"['1 Bake the chicken: Preheat the oven to 400\\xc2\\xb0F. Arrange the chicken on a nonstick rimmed baking sheet (or line a rimmed sheet with aluminum foil).', 'Place the pineapple chunks and red pepper strips on and around the chicken. Drizzle with olive oil, season with salt and pepper, and bake for 20 minutes.', '2 Make the sauce: In a measuring cup, whisk together the soy sauce, 5 to 6 tablespoons of reserved pineapple juice, and the grated ginger. Set aside.', '3 Brush the chicken, pineapple, and peppers with the sauce: At the 20 minute-mark, remove the pan from the oven and generously brush the sauce all over the chicken, pineapple, and peppers.', 'Bake for an additional 5 to 7 minutes until the peppers start to look lightly browned around the edges and the pineapples have lightly caramelized.', '4 Remove and serve. Remove from the oven and serve immediately with rice and the extra sauce. Leftovers can be stored in covered containers in the fridge for up to 3 days.']",6
206,"Halibut with Fennel, Peppers, and Tomatoes Recipe",15,30,45,"['4 halibut fillets (6 ounces each)', '4 teaspoons lemon juice', 'Leaves from 1 sprig rosemary', 'Leaves from 2 stems thyme', 'Leaves from 2 stems basil', 'Leaves from 2 stems oregano', '1/2 cup Panko breadcrumbs', '2 teaspoons plus 2 tablespoons plus olive oil', '1/2 medium red onion, sliced', '1 bulb fennel, cored and sliced', '1 yellow bell pepper, seeded and sliced into strips', '1 orange bell pepper, seeded and sliced into strips', '4 Roma (plum) tomatoes, halved lengthwise and cut into strips', '1/2 cup pitted Kalamata olives', '3 tablespoons chopped parsley (to garnish)', '1 lemon, quartered (to garnish)', 'Special equipment:', 'Large, oven-proof skillet']",18,"['1 Prep the fish: Preheat the oven to 425\\xc2\\xb0 F. Place the halibut fillets on a large plate and season both sides with salt and pepper. Sprinkle each fillet with 1 teaspoon lemon juice.', '2 Prep the herbs and Panko: Combine the herbs on a cutting board and coarsely chop. In a small bowl, combine the Panko, 2 teaspoons of the oil, and a pinch each of salt and pepper.', '3 Cook the vegetables: In a large, oven-proof skillet, heat the remaining 2 tablespoons of oil over medium heat. Add the onion and cook for 3 to 4 minutes, or until it begins to soften. Add the fennel and bell pepper slices, and cook for 5 minutes. Add the tomatoes, olives, and the chopped herbs. Cook for 3 minutes. Salt and pepper to taste.', '4 Bake the fish: Place the fish fillets on top of the vegetables in the skillet. Sprinkle each fillet with 2 tablespoons of the Panko mixture.', 'Place the skillet in the oven and bake for 6 minutes. Check the fish: if the panko is browning too quickly, place a piece of aluminum foil loosely on top of the fish.', 'Bake another 6 to 9 minutes (12 to 15 minutes total), until the center of the fish is opaque when probed with a small knife. If you have an instant read thermometer, the temperature of the center of the fish should register a 135\\xc2\\xb0F.', '5 Serve: Divide the vegetables between four plates and top each plate with a fish fillet. Sprinkle with parsley and serve with lemon wedges.']",7
207,Hawaiian SPAM Tacos with Pineapple Recipe,10,30,40,"['DAD ADD: Haba\\xc3\\xb1ero Guacamole', '1 haba\\xc3\\xb1ero pepper, seeded and minced', '1/4 cup minced red onion', '2 tablespoons minced cilantro', '1 lime, juice only', '1/2 teaspoon salt', '2 large ripe avocados', 'For the tacos:', '1/2 tablespoon olive oil', '1 (12-ounce) container SPAM, sliced into matchsticks', '2 cups fresh pineapple, chopped', '1 red pepper, sliced into matchsticks', '1/2 head of green cabbage, shredded (about 2 cups)', '4 ounces queso fresco, crumbled', '1 cup sour cream', 'Fresh cilantro, garnish', '12 small flour tortillas']",17,"['1 Make the Dad Add: Haba\\xc3\\xb1ero Guacamole: In a medium bowl, combine minced haba\\xc3\\xb1ero, red onion, cilantro, lime juice, and salt. Mash together with a fork.', 'Add in ripe avocados and mash until the guacamole comes together. Some chunks are good, but it should be creamy and dippable.', 'Guacamole can be made a day in advance. To store it, place plastic wrap directly on the surface of the guacamole to slow oxidation and refrigerate.', '2 Make the taco filling: In a large skillet over medium-high heat, add the olive oil and SPAM strips. Cook until strips start to get crispy and browned, about 10 minutes, stirring occasionally.', 'Remove strips from the skillet and add the pineapple and red peppers. Continue to cook until red peppers soften slightly and pineapple starts to turn tan in spots, another 6 to 8 minutes.', 'Add strips back to skillet and toss to combine. Keep warm until serving.', '3 Assemble the tacos: Warm tortillas by wrapping them in damp paper towels and microwaving them for 10 seconds. Then add a smear of sour cream (and/or guacamole) to each tortilla. Top with a handful of shredded cabbage, 2 to 3 strips of crispy SPAM, and seared pineapple and red pepper. Garnish the taco with queso fresco and cilantro. Serve while warm!']",7
208,Blackberry Cobbler Recipe,35,30,65,"['For the berry mixture:', '4 cups blackberries, rinsed clean', '1/2 cup white granulated sugar (less or more to taste, depends on how sweet the berries are and how sweet you would like your cobbler to be)', '1 teaspoon lemon zest', '1 tablespoon lemon juice', '1/4 teaspoon cinnamon', '1 1/2 tablespoons cornstarch (or instant tapioca)', 'For the cobbler topping:', '1 cup all purpose flour', '3 tablespoons sugar', '1 1/2 teaspoon baking powder', '1/4 teaspoon salt', '4 tablespoons unsalted butter', '1/4 cup milk', '1 large egg, lightly beaten']",15,"['1 Make the berry mixture: Put the blackberries, sugar, lemon zest and juice, cinnamon and cornstarch in a 9x9 baking dish. Stir to combine everything and make sure that the berries are all evenly coated with sugar.', 'Let sit for 30 minutes for the berries to macerate so that the sugar dissolves and the berries release their juices.', '2 Preheat your oven to 350\\xc2\\xb0F.', '3 Make biscuit dough topping: Vigorously whisk together the flour, 3 tablespoons of the sugar, baking powder, and salt in a medium bowl. Cut the butter into the flour mixture with your fingers or a fork until the topping mixture resembles coarse crumbs.', 'Make a well in the center and stir in the milk and beaten egg until the dough is just moistened.', '4 Top the cobbler: Scoop up the dough in large spoonfuls, and drop over the berries in the baking dish like cobblestones.', '5 Bake: Bake for 30 minutes at 350\\xc2\\xb0F, or until the berry mixture is bubbly and the topping is nicely browned.', '', '', 'Great served with whipped cream or vanilla ice cream.']",10
209,Blueberry Buckle Recipe,5,70,75,"['Cake ingredients:', '2 cups (260 g) all purpose flour (plus 1-2 Tbsp of flour for dusting the blueberries)', '2 teaspoons baking powder', '1/2 teaspoon salt', '1/4 cup (1/2 stick, 57 g) unsalted butter, softened', '3/4 cup (150 g) sugar', '1 large egg', '1/2 cup (120 ml) milk', '1 pint (550 ml) blueberries', 'Topping ingredients:', '1/4 cup (57 g) unsalted butter, softened', '1/2 cup (100 g) sugar', '1/3 cup (45 g) all purpose flour', '1/2 teaspoon cinnamon']",14,"['1 Preheat the oven to 375\\xc2\\xb0F (190\\xc2\\xb0C). Butter the inside of an 8-inch springform pan. Set aside.', '2 Whisk together the 2 cups of flour, the baking powder and the salt in a medium bowl.', '3 Using a stand mixer (or by hand with a wooden spoon) beat together the butter and sugar until fluffy, about 3 minutes. Beat in the egg.', '4 Add the flour mixture in 3 parts, alternating with the milk. Toss the berries with the remaining 1 to 2 tablespoons of flour (to separate and scatter evenly throughout the batter) and fold in. Pour batter into the prepared pan. Set aside.', '5 Combine ingredients (butter, sugar, flour, cinnamon) for topping with a fork (or by hand) to make crumbly mixture. Sprinkle this over the batter.', '6 Bake for one hour, then test for doneness by gently inserting a fork. If it does not come out clean, give the cake another 5 to 10 minutes to bake.', '7 When the cake has cooled, run a knife around the edges and lift the cake out of the pan.']",7
210,Blueberry Maple Breakfast Bake Recipe,15,60,75,"['1 loaf of rustic white bread, crusts removed, bread cut into 1-inch cubes (about 10 cups)', '4 oz cream cheese, cut into small cubes (about 1 cup)', '2 cups fresh or frozen blueberries, divided (if using frozen berries, defrost and drain them first)', '8 eggs, beaten', '1 1/2 cups milk', '1/4 cup melted butter', '1/4 cup maple syrup plus more for serving']",7,"['1 Preheat oven, prep baking dish: Preheat oven to 350\\xc2\\xb0F. Grease an 8 or 9-inch square baking dish.', '2 Layer cubed bread, cream cheese, and blueberries in baking dish: Place half of the bread cubes in the dish. Sprinkle cream cheese cubes and half of the blueberries over the bread. Top with remaining bread cubes and blueberries.', '3 Combine eggs, milk, maple syrup, and melted butter in a large bowl and pour over bread mixture.', 'To make ahead, cover and chill overnight, and proceed the next morning to bake.', '3 Bake: Bake at 350\\xc2\\xb0F until a knife inserted in the center comes out clean, about 1 hour to 1 hr 20 min. Cover with aluminum foil if you notice the edges browning too much during baking.', '4 Serve: Let stand for 10 minutes before serving. Cut into squares to serve. Serve with additional maple syrup.']",6
211,Blackberry Slump Recipe,10,30,40,"['Dumplings:', '1 cup all purpose flour', '1 1/2 teaspoons baking powder', '1/2 teaspoon salt', '2 Tbsp sugar', '2 Tbsp butter', '1/3 cup whole milk', 'Berries:', '4 cups fresh or frozen (defrosted and drained) blackberries', '1/2 to 3/4 cup sugar (depending on how sweet your berries and how sweet you would like your slump to be)', '1/4 teaspoon cinnamon', '1 teaspoon lemon juice', '1 teaspoon lemon zest', '1/3 cup water', 'Whipping cream or vanilla ice cream for topping']",15,"['1 Make the dumplings: In a medium sized bowl, whisk together the flour, baking powder, salt, and sugar.', 'Cut the butter into small cubes and add to the flour. Using a pastry cutter, two knives, or your clean hands, cut the butter into the flour until the flour resembles a coarse meal.', 'Add the milk all at once and stir until the flour is just moistened. Handling the dough as little as possible, form into a ball. Set aside.', '2 Heat berries with sugar, cinnamon, lemon, water until boiling: In a 2-qt saucepan, add the berries, sugar, cinnamon, lemon juice, lemon zest, and water. Heat until boiling, stirring a few times so that the berries are well coated with the sauce.', '3 Add chunks of dumpling dough: Once the berry mixture is boiling, tear off spoonful chunks from the dough ball and drop onto the fruit around the edges of the pot. You should have enough dough for 6 dumplings.', '4 Cover and simmer: Cover the pot and reduce the heat to a simmer. Cook for 25 minutes, without peeking at the dumplings.', 'Place dumplings in serving bowls and top with berries. Serve with cream or ice cream. Serve hot or chilled.']",7
212,Lemon Blueberry Scones Recipe,15,138,153,"['For the scones:', '2 1/3 cup (300g) unbleached all-purpose flour', '1/4 cup (56g) granulated sugar', '2 teaspoons baking powder', '1/2 teaspoon baking soda', '1/4 teaspoon kosher salt', '8 tablespoons (1 stick, 4 ounces) unsalted butter, cut into 1/2-inch cubes', '3/4 cup (170g) whole milk Greek yogurt', '1 large egg', '1 (6 ounce) container fresh blueberries, picked over for stems, rinsed, and dried', 'For the glaze:', '1 tablespoon lemon zest, from 1 medium lemon', '2 tablespoons lemon juice, from 1 medium lemon', '1 cup (120g) powdered sugar', 'Special equipment:', 'Food processor']",16,"['1 Make the dough in a food processor: Measure the flour, sugar, baking powder, baking soda, and salt into a food processor. Process the ingredients to combine them evenly.', 'Sprinkle the cubed butter over the flour mixture, and process the mixture in 1-second pulses until the butter is no longer visible and the mixture looks somewhat sandy.', 'In another mixing bowl, whisk together the yogurt and egg until no streaks of egg yolk remain. Pour this mixture into the food processor with the flour and the butter.', 'Run the food processor for about three seconds, just until all of the flour is absorbed and the dough begins to come away from the sides of the bowl.', '2 Fold in the blueberries: Turn out the dough onto a lightly floured surface. Scatter the blueberries over top and fold the dough a few times with a spatula to incorporate. (You can also do this in a separate mixing bowl instead of on the counter, if you prefer.)', '3 Shape the dough into disks and chill: With a bench scraper or knife, divide the dough in half and pat into two disks, about 1/2-inch thick and six inches across (you can use the length of your hand as a guide).', 'Wrap the disks of dough in plastic wrap and refrigerate for at least two hours, or up to 24 hours.', '4 Preheat the oven to 350F: Line a baking sheet with a silicon baking mat or parchment paper.', '5 Cut and bake the scones: Unwrap the disks of chilled dough and cut each one into eight wedges (16 wedges total).', 'Place the wedges an inch apart on the lined baking sheet. Try not to touch the sides or handle the scones too much as you transfer them since this can inhibit how much they rise in the oven.', 'Bake the scones for 15 to 18 minutes, until they are lightly browned.', '6 Make the glaze: While the scones are baking, whisk together the lemon zest, lemon juice, and powdered sugar in a small bowl. The glaze should be a pourable consistency; add additional lemon juice (or milk, or water) 1 teaspoon at a time if needed.', '7 Glaze and cool the scones: Transfer the scones to a cooling rack with something underneath to catch any dripping glaze (I use wax paper). While the scones are still warm, drizzle each one with a teaspoon of the glaze. Let the scones cool until the glaze has fully set, about 30 minutes.']",13
213,Blueberry Slump Recipe,10,35,45,"['Dumplings:', '1 cup all purpose flour', '1 1/2 teaspoons baking powder', '1/2 teaspoon salt', '2 Tbsp sugar', '2 Tbsp butter', '1/3 cup milk', 'Blueberries:', '4 cups of fresh or frozen blueberries', '1/2 cup sugar', '1 teaspoon ground cinnamon', '1/4 teaspoon ground nutmeg', '1 1/2 teaspoons lemon juice', '1 teaspoon lemon zest', '1/3 cup water', 'Vanilla ice cream or whipping cream for serving']",16,"['1 Make the dumplings: In a medium bowl whisk together the flour, baking powder, sugar, and salt.', 'Cut the butter into small cubes and use your clean hands to work the pieces of butter into the flour until the mixture resembles a coarse meal.', 'Make a well in the center and add the milk. Mix together with a fork or wooden spoon just until the dough comes together. Form it into a ball. It should be rather shaggy. Do not knead or over work it or the dumplings will be tough.', '2 Heat the blueberries: Place the blueberries, sugar, cinnamon, nutmeg, lemon juice, lemon zest, and water into a medium (2 quart) saucepan. Stir so that the berries are well coated with everything. Heat on high heat until the berries start to boil.', '3 Add the dumplings: When the blueberry mixture is boiling, pull off clumps of dumpling dough from the ball of dough and place on top of the berries. You should have enough dough for 6 dumplings, so portion accordingly.', '4 Cover and cook: Cover the pan, and lower the heat to maintain a low simmer. Cook for 25 minutes.', 'Do not uncover to peek at the dumplings while cooking! The dumplings need the steady steam and pressure from being covered to cook properly so they are light and fluffy.', '5 Serve: Portion into individual serving bowls and top with vanilla ice cream or whipping cream.']",8
214,Blackberry Shortcake Recipe,30,20,50,"['Blackberries:', '2 to 2 1/2 pounds of blackberries (6 to 8 cups), gently rinsed if fresh, defrosted if frozen (save any juices that come from defrosting!)', '1/4 cup to 1/2 cup of sugar (to taste, depending on the tartness of the berries)', '1 teaspoon lemon juice', '1/2 teaspoon lemon zest', 'Biscuits:', '3 cups flour', '3 Tbsp sugar', '4 teaspoons baking powder', '3/4 teaspoon salt', '8 Tbsp cold butter, cut into small cubes', '1 1/2 cups heavy cream', '1 teaspoon vanilla extract', 'Whipped Cream:', '1 cup heavy whipping cream', '2 teaspoons powdered sugar', 'A few drops of vanilla extract']",17,"['1 Macerate the berries with sugar: Put the blackberries into a large bowl, sprinkle with sugar, and toss to coat all the berries with sugar. Use a potato masher to gently mash about half of the berries, releasing their juices.', 'Stir in lemon juice and zest.', 'Let sit for 20 minutes to an hour to macerate, allowing the sugar to help release more of the juices from the blackberries.', '2 Whisk flour, sugar, baking powder salt. Cut in butter: In a large bowl vigorously whisk together the flour, sugar, baking powder and salt. Add the chilled butter cubes and use your fingers (or a fork, pastry cutter, or food processor) to break up the butter and mix with the flour until the largest pieces of butter are the size of peas.', '3 Add cream and vanilla: Make a well in the center of the flour mixture and pour in the cream and vanilla. Use a fork to mix the flour and the cream until the dough just comes together.', 'It should have a rather shaggy appearance. Empty on to a clean surface and knead a few times to form a loose ball. Do not over mix or over-knead!', '4 Form into square shape and chill: Place ball on a small tray or baking sheet and form into an 8-inch by 8-inch square. Cover with plastic wrap and place in the refrigerator to chill for 15 to 20 minutes.', '5 Cut into squares, arrange on baking sheet: Preheat oven to 425\\xc2\\xb0F. Once the dough has chilled sufficiently, remove it from the refrigerator and cut it into 9 even squares. Arrange them on a baking sheet with an inch or two between each square.', '6 Bake: Bake at 425\\xc2\\xb0F until the biscuits are nicely browned, about 18 minutes.', ""7 Make whipped cream: While the biscuits are baking place the heavy whipping cream into a large chilled bowl (I usually put a metal mixing bowl into the freezer for a few minutes if I know I'm going to be making whipped cream.)"", 'Sprinkle with powdered sugar and a few drops of vanilla extract. Use a hand mixer to beat until you have peaks that somewhat hold their shape. Chill until ready to serve.', '8 Assemble shortcakes: When the biscuits are ready, remove them from the oven and let them cool for a few minutes. To serve, place one in a bowl or dessert plate, pull it apart in half.', 'Place a large scoop of berries and the juices from the berries over the bottom half. Top with the other half of the biscuit and a generous dollop of whipped cream.']",13
215,Berry Almond Crumble Recipe,20,50,70,"['Filling:', '8 cups mixed fresh berries: blueberries, raspberries, blackberries, strawberries', '1 Tbsp quick-cooking tapioca', '2 to 3 tablespoons granulated sugar, depending upon sweetness of berries', '1/2 teaspoon finely grated lemon zest', 'Crumble Topping:', '1 3/4 cups all-purpose flour', '1/3 cup dark brown sugar', '1/3 cup granulated sugar', '1 teaspoon ground cinnamon', '1/2 teaspoon ground ginger', 'A pinch of salt', '1/2 cup melted butter', '1/2 cup finely chopped almonds.']",14,"['1 Preheat oven to 350\\xc2\\xb0F.', '2 Mix berries with tapioca, sugar, zest: In a large bowl put berries and mix with tapioca, sugar and lemon zest. (Without tapioca, crumble will be very runny.) Set aside.', '3 Make the topping: Whisk together the flour, sugars, spices and salt in a large bowl. Stir in the melted butter and almonds until coarse crumbs form.', '4 Assemble: Pour the filling into a 9-inch square or round pan (do not grease first). Using your fingers, form topping mixture into 1/4-inch to 1/2-inch crumbs and spread over cake.', '5 Bake: Bake at 350\\xc2\\xb0F until filling bubbles and topping is light golden, about 45-55 minutes.', 'Let cool at least half an hour. Serve warm.']",6
216,Provencal Seafood Bisque Recipe,5,40,45,"['3 slices of bacon, roughly chopped (can substitute extra virgin olive oil or butter, 3 Tbsp)', '1 medium white or yellow onion, chopped', '1 large celery stalk, chopped', '1 large carrot, chopped', '2 garlic cloves, chopped', '2 plum tomatoes, chopped', '1 pound white fish fillets, roughly chopped', '1 teaspoon of orange zest', 'A pinch of cayenne', 'A large pinch of saffron', '1 quart of shellfish stock, OR 16 ounces of clam juice plus 16 ounces of fish stock or water', '1/4 cup heavy cream', 'Salt to taste']",13,"['1 Cook the bacon: Cook the bacon on medium heat in a 6 to 8 quart pot until it is crispy. Remove the bacon from the pot with a slotted spoon. Set aside on a paper towel to use for garnish later.', '2 Cook the onions, celery, carrot: Increase the heat to medium high and add the onions, celery and carrot. Cook for 3-4 minutes, stirring often, until the onions are translucent. Do not brown. Sprinkle some salt over everything as it cooks.', '3 Add the fish, tomatoes and the garlic and cook for another 2-3 minutes, stirring often.', '4 Add the orange zest, cayenne and saffron, then add the shellfish stock or whatever stock you are using. In a pinch you could even use chicken or vegetable stock, but the flavor of the soup will be different. Simmer this gently \\xe2\\x80\\x93 do not let it get to a rolling boil \\xe2\\x80\\x93 for 20 minutes, stirring occasionally.', '5 Pur\\xc3\\xa9e the soup: Get another pot ready. Fill a blender a third of the way with the soup and blend it on high (starting on low then increasing to high) for 1 minute, or until it is well pur\\xc3\\xa9ed. Work in batches to pur\\xc3\\xa9e the rest of the soup. Pour the pur\\xc3\\xa9ed soup into the clean pot.', '6 Add cream: Put the soup on medium-low heat and add the cream. Stir well and taste for salt, adding if needed. Do not let this boil! Or it might break.', 'Serve garnished with bacon bits or dill fronds, and alongside some crusty bread. A dry rose or light red wine would go well with this; I\\xe2\\x80\\x99d suggest a Beaujolais or a Pinot Noir.']",7
217,Smoked Salmon Bisque Recipe,10,20,30,"['1/4 cup butter (1/2 stick)', '1 cups thinly sliced leeks', '1/2 chopped yellow onion', '1 cup thinly sliced mushrooms', '1 Tbsp minced garlic', '1 quart (32 oz) clam juice', '3/4 pounds salmon fillet, chopped 1/2 inch cubes', '2 to 4 ounces hot smoked salmon (depending on how strong a smoked flavor you want, and how strongly smoked the salmon is), chopped', '2 cups canned whole or stewed tomatoes', '2 Tbsp chopped fresh parsley', '1/4 cup chopped fresh cilantro', '2 Tbsp chopped fresh dill', 'Pinch black pepper', 'Pinch crushed red pepper', '1/2 teaspoon Old Bay seasoning (optional)', '3 Tbsp all-purpose flour', '1 cup cream', '1 cup milk', 'Salt to taste']",19,"['1 Cook onions, leeks, mushrooms garlic in butter: Melt butter in a medium stockpot over medium heat. Add onion, leeks, mushrooms, garlic and cook until onions are translucent and mushrooms have given up their moisture (7 to 10 minutes).', '2 Add the clam juice, smoked salmon, tomatoes (break up tomatoes while putting them in the soup), parsley, cilantro, dill, black pepper, red pepper flakes, and Old Bay seasoning. Cook until heated through.', '3 Make a slurry with flour, milk, cream: Put flour into a separate bowl. Slowly add the milk, beating with a wire whisk until smooth. Mix in the cream. Stir cream flour slurry into the soup.', '4  Stir in fresh salmon and simmer for 5 more minutes.', '5 Pur\\xc3\\xa9e (optional): If you want, use an immersion blender to pur\\xc3\\xa9e the soup, or pour some or all of the soup into a standing blender and pur\\xc3\\xa9e. Salt to taste.', 'Garnish with fresh dill.']",6
218,Easy Black Beans and Rice Recipe,10,20,30,"['1 cup uncooked white rice', '1 tablespoon extra virgin olive oil', '1 small onion, chopped', '1/2 green bell pepper, thinly sliced', '1/2 red bell pepper, thinly sliced (for added flavor you can substitute roasted red bell peppers or some chopped pimentos)', '3 cloves minced garlic', '2 16-ounce cans of black beans, rinsed and drained', '2 tablespoons white vinegar', 'A few dashes of Tabasco or 1/4 teaspoon cayenne powder', '1 teaspoon dried oregano OR 1 heaping tablespoon chopped fresh oregano', 'Salt and pepper to taste', 'Optional Lime wedges and cilantro for garnish']",12,"['1 Cook the rice: Cook rice according to package instructions. White rice usually takes 15 minutes to cook once the water is simmering, and 10 minutes to sit.', '2 Saut\\xc3\\xa9 onions, bell peppers, garlic: Heat oil in a large skillet on medium high. Saut\\xc3\\xa9 onions and bell peppers for 3-4 minutes, until just beginning to soften, then add garlic and saut\\xc3\\xa9 a minute more.', '3 Add beans, vinegar, Tabasco, then simmer: Add the black beans, vinegar and Tabasco or cayenne. Bring vinegar to a simmer, reduce heat, cover and simmer for 5 minutes.', '4 Stir in rice and oregano. Add salt and pepper to taste.']",4
219,Texas Stacked Enchiladas with Corn and Black Beans Recipe,25,10,35,"['For the sauce', '2 garlic cloves, sliced', '1/2 yellow onion, coarsely chopped', '1 (28-ounce) can whole, peeled tomatoes', '2 tablespoons all-purpose flour', '2 teaspoons ancho chile powder, or to taste', '1/2 teaspoon dried oregano', '1/2 teaspoon salt', '1/2 cup water', '1 tablespoon olive oil', 'For the tortillas', '12 corn tortillas (6 to 7-inch size)', '2 tablespoons olive oil', 'For the filling', '2 tablespoons finely chopped red or yellow onion', '1 cup frozen corn', '1/4 teaspoon salt', 'Pinch black pepper', '1 can black beans, rinsed and drained', 'For the garnishes', '4 ounces queso fresco, crumbled (or feta or Monterey jack)', '1 ripe avocado, cut into slices', '4 to 6 radishes, thinly sliced', 'Leaves from 1/4 bunch cilantro', 'Special equipment:', '2 baking sheets']",26,"['1 Preheat the oven to 350\\xc2\\xbaF.', '2 Make the sauce: In a blender, puree the garlic, onion, tomatoes, flour, chili powder, oregano, salt and water until smooth.', 'In a deep skillet over medium heat, heat the oil. Add the sauce and cook, stirring often, until it comes to a boil.', 'Lower the heat and cook the sauce at a steady simmer for 10 minutes. It may sputter like mad, so either stir often or top with a spatter guard. The sauce should have the consistency of heavy cream. Add more water to thin it if necessary.', 'Note: you may have a bit more sauce than you need. It can be stored in the refrigerator for up to 5 days and used for leftovers.', '3 Bake the tortillas: Using a pastry brush, brush both sides of one tortilla with oil and place it on a plate. Set a second tortilla on top and brush the top with oil. Continue to brush and stack the tortillas in the same manner.', 'When done, press down on the stack gently so that that both sides of each tortilla are lightly coated with oil. This way, all the sides get covered with oil as you create the stack.', 'Spread them out on two baking sheets. Bake for 10 minutes, or until slightly crisp at the edges.', 'Note: You can prepare the tortillas up to a day ahead. Cool completely, then transfer to a plastic zip-top bag and store at room temperature.', '4 Prepare the filling: In a microwave-safe bowl, combine the onion, corn, salt and pepper. Microwave for 2 minutes. Add the beans and microwave for one minute longer, or until the filling is hot all the way through. Cover and keep warm.', 'Note: The filling can be prepared up to a day ahead and refrigerated. ', '5 Assemble the enchiladas: Set 4 plates next to the stove.', 'Dip one tortilla in the sauce and set it on one of the plates. Spread 2 tablespoons of the filling over the tortilla. Dip a second tortilla in the sauce and place it on top. Spread with 2 more tablespoons of the filling. Dip a third tortilla in the sauce and place on top of the stack. Spoon a little more sauce over the top.', 'Sprinkle the stack with one-fourth of the cheese, one-fourth of the avocado slices, one-fourth of the radishes and top with one-fourth of the cilantro leaves.', 'Repeat with remaining tortillas, sauce, and garnishes.', 'If desired, transfer each stack to a baking sheet in a 350\\xc2\\xb0F oven to keep warm as you finish assembling the rest. Serve all the stacks together at once.']",16
220,Chicken and Black Bean Tostadas Recipe,15,25,40,"['For the chicken:', '2 boneless skinless chicken breasts (3/4 to 1 pound total)', '1 teaspoon Kosher salt', '1/2 teaspoon freshly ground pepper', 'Optional for flavoring the poaching liquid: whole peppercorns, sprigs of fresh thyme or oregano, bay leaves, whole garlic cloves or halved shallots, and lemon slices', 'For the chipotle dressing:', '3 tablespoons extra virgin olive oil', '1 tablespoon lime juice (from about 1 lime)', '1 teaspoon pureed chipotles in adobo sauce (optional)', '1 tablespoon minced shallots', 'For the cilantro crema:', '1 teaspoon lime juice', '1/2 cup sour cream', '2 tablespoons minced cilantro leaves', 'For the tostadas:', 'Vegetable or canola oil for pan frying', '4 6-inch corn tortillas (or tortillas with a blend of flour and corn such as La Tortilla Factory 50/50)', '1 teaspoon minced garlic', '1 (15-ounce) can black beans, drained and rinsed', '1/2 teaspoon cumin', '1 heart of romaine, thinly sliced crosswise into slivers (about 4 cups)', '1/2 cup diced plum tomato', '1 ripe avocado, peeled and cubed', '1/2 cup shredded cheddar or Mexican blend cheese, or crumbled cotija cheese']",24,"['1 Cook the chicken. Place the chicken breasts, salt, pepper, and any optional flavoring extras in a small pot. Add water to cover by 1 inch and place over medium-high heat.', 'Cover the pot and bring the chicken to simmer for 8 to 12 minutes until it is cooked through and registers at least 165\\xc2\\xb0F with a digital thermometer. Exact cooking time will depend on the thickness of the chicken breasts.', '2 Shred the chicken: Remove the chicken from the heat and remove the chicken from the liquid. Scoop out 1/2 cup of the cooking liquid and set to the side (the remainder can be strained and saved for another recipe).', 'When cool enough to handle, shred the chicken into bite-sized pieces.', '3 Make the chipotle dressing: In a small bowl or container with a lid, combine the olive oil, 1 tablespoon lime juice, the pureed chipotle in adobo (if using), and shallot. Taste and season with salt and pepper to taste.', '4 Make the lime crema: In another small bowl or container, combine the sour cream, 1 teaspoon lime juice, and the cilantro.', '5 Pan fry the tortillas: Heat a thin layer of canola oil in a skillet over medium-high heat until a tiny flick of water into the pan sizzles on contact. Pan fry the tortillas one at a time, for about 2 minutes on each side until lightly browned and fairly crisp.', 'Add a bit more oil if needed during the frying process.  Transfer the tortillas to paper towels as they finish cooking.', '6 Cook the garlic and beans: Pour off any excess oil from the skillet, leaving a thin film on the bottom of the pan. Return to medium heat. Stir in the garlic and cumin and saut\\xc3\\xa9 for 30 seconds until you can smell the seasonings and the garlic starts to turn golden.', 'Add the beans and stir well, then add 1/4 cup of the reserved cooking liquid and bring to a simmer. Simmer for about 5 minutes until the beans are hot and the liquid reduces to a glaze on the beans\\xe2\\x80\\x94if it starts to look dry you can add a bit more of the reserved liquid.', '7 Serve the tostadas: Place each of the tortillas on a plate and pile 1 cup of lettuce onto each.', 'Divide the warm beans equally over the lettuce, then repeat the same process with the chicken, tomatoes, and avocados. Finally, top the tostadas with the cheese and cilantro. Drizzle the dressing evenly over the tostadas and finish with a dollop of crema. Serve immediately.']",12
221,Turkey Taco Salad Recipe,15,20,35,"['For the bean and turkey topping:', '2 tablespoons olive oil', '1 medium onion, finely chopped', '1 clove garlic, finely chopped', '2 1/2 teaspoons ancho chili powder (or substitute regular chili powder)', '2 teaspoons ground cumin', '1 teaspoon oregano', '1/4 teaspoon salt', 'Fresh ground black pepper', '1/2 pound ground turkey', '1 can (15 ounces) diced fire-roasted tomatoes', '1 can (15 ounces) black beans, rinsed and drained', '1 cup fresh or frozen corn kernels', 'For the salad:', '2 tablespoons sherry vinegar', '1/4 teaspoon salt', 'Fresh ground black pepper', '5 tablespoons olive oil', '2 hearts of romaine, chopped or sliced', '1/2 pint cherry tomatoes, halved', '1/2 red onion, sliced', '6 radishes, thinly sliced', '2 ripe avocados, sliced', '1 cup (4 ounces) shredded Monterey jack cheese, or more, to taste', 'Handful of cilantro leaves, stems removed', '1/2 cup sour cream', '1 lime, cut into wedges']",27,"['1 Cook the onion, garlic and spices: In a large, deep skillet over medium heat, heat the olive oil. Add the onion, garlic, chili powder, cumin, oregano, salt and a few grinds of fresh black pepper.', 'Cook, stirring occasionally for 5 minutes, or until the onions soften.', '2 Add the ground turkey and continue cooking. Break up the meat into small bits as it cooks using a stiff spatula. Cook for about 4 minutes, or until the turkey is no longer pink.', '3 Stir in the diced tomatoes, black beans and corn. Reduce the heat to medium-low and cook for about 10 more minutes to allow the flavors to mingle and the mixture to thicken. If the mixture seems dry, add water 2 tablespoons at a time.', 'Remove the skillet from the heat. Taste for seasoning and add more salt, if you like. Cool briefly.', 'This topping can be made ahead and kept refrigerated for up to 5 days. Serve cold, or warm briefly in the microwave or a warm skillet before serving.', '4 Dress the greens: In a bowl large enough to hold the lettuce, whisk together the vinegar, 1/4 teaspoon salt and a few grinds of fresh black pepper. Gradually whisk in the olive oil until the dressing looks combined.', 'Add the lettuce to the bowl. Toss to coat it with the dressing. Taste for seasoning and add more salt and pepper, if you like.', '5 Assemble the salad: Divide the lettuce among 4 to 6 plates. Divide the filling between the plates, and garnish with the tomatoes, onions, avocado, radishes, shredded cheese and cilantro. Top each salad with spoonful of sour cream and a lime wedge, and serve.']",9
222,Butternut Squash and Black Bean Skillet Dinner Recipe,15,25,40,"['1 pound peeled and seeded butternut squash, cut into 1/2-inch cubes', '3 tablespoons olive oil', '3/4 teaspoon salt', '1/8 teaspoon ground black pepper', '1 cup red quinoa', '1 medium onion, finely chopped', '2 cloves garlic, finely chopped', '1 teaspoon ancho chili powder, or chili powder of your choice', '1/2 teaspoon ground cumin', '1 teaspoon dried oregano', '1 1/4 cups water or low-salt vegetable stock', '1 (15-ounce) can fire-roasted diced tomatoes', '1 (15-ounce) can black beans, rinsed and drained', '2 large handfuls baby spinach leaves', '1/3 cup pepitas (green pumpkin seeds)', '3 ounces (1/2 cup) crumbled cotija cheese (optional)', 'To garnish:', '1/2 cup cilantro leaves']",18,"['1 Preheat the oven to 450\\xc2\\xbaF.', '2 Roast the squash: On a rimmed baking sheet, mound the squash in the center. Sprinkle it with 1 tablespoon of the oil, 1/4 teaspoon salt, and 1/8 teaspoon pepper. Toss to coat the squash, massaging the oil into the cubes to coat them.', 'Spread into a single layer and roast for about 20 minutes, turning it once after 15 minutes, until tender and browned in places. Remove from oven and let cool.', '3 Rinse the quinoa: Place the quinoa in a fine-mesh strainer and rinse it with cold running water for 1-2 minutes, shaking the strainer and stirring with your hands to remove the bitter coating (saponin) from the seeds.', '4 Cook the onion and spices: In a large skillet over medium-high heat, add 2 tablespoons of oil. Once the oil shimmers, add the onion, and cook, stirring occasionally, for 4 minutes or until lightly browned. Add the garlic, oregano, chili powder, and cumin, and stir for 1 minute.', '4 Cook the quinoa: Add the quinoa, water or broth, diced tomatoes (including the juices), drained beans, and 1/2 teaspoon salt and bring to a boil.', 'Reduce the heat to medium, cover the pan, and simmer for 18 to 20 minutes, or until the liquid is absorbed. Stir in the spinach and cook for another minute, or until the spinach wilts.', '5 Toast the pumpkin seeds while the quinoa cooks: In a small skillet over medium heat, add the pumpkin seeds and stir for 4 to 5 minutes, or until they begin to crackle and turn golden brown. Transfer to a plate to cool. (If you leave them in the hot pan, they may burn.)', '6 Finish and serve the quinoa: Fold the squash into the skillet. Sprinkle with the toasted pumpkin seeds, cheese, and cilantro, and serve.']",9
223,Butternut Squash Enchiladas Recipe,45,25,70,"['For the vegetables:', '1 (2-pound) butternut squash, seeds removed and cut into 3/4-inch pieces', '1 large onion, cut into 8 wedges', '2 cloves garlic', '2 tablespoons olive oil', '1/2 teaspoon salt', '1/8 teaspoon black pepper', 'For the sauce:', '1 (28-ounce) can whole tomatoes with juice', '1 tablespoon ancho chili powder, or regular chili powder', '1/2 teaspoon oregano', '1/2 teaspoon cumin', '1/2 teaspoon salt', '1 tablespoon olive oil', 'For the filling and assembly:', 'About 1/4 cup olive oil, to brush on the tortillas', '1 (15-ounce) can black beans, rinsed and drained', '12 (7-inch) corn tortillas', '2 cups grated Monterey Jack cheese', 'For the garnishes (optional):', '1 handful cilantro leaves', '1 avocado, sliced', '6 radishes, thinly sliced', '1/4 red onion, sliced', '1/2 cup sour cream, thinned with milk to the consistency of thick cream']",25,"['1 Preheat the oven to 450\\xc2\\xbaF.', '2 Roast the squash, onion, and garlic: On a large, rimmed baking sheet, mound the squash cubes in the center and place the onion wedges and garlic on the side.', 'Sprinkle everything with the olive oil, salt, and pepper. Toss to coat the vegetables and spread them evenly over the baking sheet, segregating the onion and garlic alongside the squash. Bake for 25 minutes, or until tender.', 'Remove the pan from the oven, and reduce the oven temperature to 375\\xc2\\xbaF. Let the squash and onion cool slightly on the baking sheet.', '3 Make the sauce: In a blender, combine the tomatoes, chili powder, oregano, cumin, and salt. Add the garlic and half of the roasted onion slices. Puree until smooth.', 'In a medium skillet set over medium heat, add 1 tablespoon olive oil. Once the oil shimmers, add the pureed sauce to the pan and bring to a simmer. Cook, stirring often, for 5 minutes. Set aside.', '4 Make the filling: Transfer the squash and the remaining onion slices to a bowl. Separate the onion slices. Stir in the drained beans. Taste and add more salt, if you like.', '5 Warm the tortillas: Using a pastry brush, brush both sides of each tortilla with oil. Place up to 6 tortillas in a stack on a microwave-safe plate.', 'Loosely cover and microwave in 30-second intervals until the tortillas are warm and pliable; this takes about 1 minute.', 'Wait to repeat the process with the remaining 6 tortillas until you\\xe2\\x80\\x99ve filled the first batch.', '6 Assemble the enchiladas: Spread a thin layer of sauce over the bottom of a 9x13-inch baking dish.', 'Dip one tortilla in the sauce and set it on a plate. Place about 1/3 cup of the filling in a line down the center of the tortilla. Sprinkle with about 1 tablespoon of cheese.', 'Roll up the tortilla to enclose the filling and set it in the baking dish with the seam side down.', 'Repeat until all 12 of the tortillas are filled. Pour the remaining sauce over the enchiladas and sprinkle the remaining cheese on top.', '7 Bake the enchiladas: Bake for 25 minutes at 375\\xc2\\xbaF, or until the cheese melts and the enchiladas are hot all the way through. Serve with the garnishes of your choice.']",15
224,Tex-Mex Shepherd\xe2\x80\x99s Pie Recipe,25,30,55,"['2 1/2 pounds (5 to 6 medium) Yukon Gold potatoes', '1 tablespoon salt, divided', '4 tablespoons unsalted butter, cut into slices', '1/2 cup milk, or more as needed', '1 1/2 cups grated sharp cheddar cheese', '1/8 teaspoon pepper', '2 tablespoons olive oil', '1 medium onion, finely chopped', '1 large garlic clove, finely chopped', '1 teaspoon dried oregano', '1/2 teaspoon ground cumin', '1 (15-ounce) can black beans, rinsed and drained', '1 cup frozen corn', '2 cups shredded, cooked chicken', '2 cups of your favorite salsa']",15,"['1 Preheat the oven: to 425\\xc2\\xbaF. Have on hand a 9- x 13-inch or 2-quart, shallow baking dish.', '2 Cook the potatoes: Wash and cut the potatoes into 1-inch chunks (peeling optional). Place them in a large pot. Fill the pot with cold water until there is about an inch of water above the potatoes.', 'Add 2 teaspoons salt and taste; the water should taste as briny as the sea. If it doesn\\xe2\\x80\\x99t, add a few more pinches of salt.', 'Bring to a boil over high heat. Reduce the heat to a simmer and cook the potatoes, uncovered, for 15 to 20 minutes, or until tender when pierced with the tip of a paring knife.', 'Drain in a colander and return to the potatoes to the pot. Set the pot over low heat and stir the potato chunks for 1 to 2 minutes to dry them.', '3 Mash and season the potatoes: Add the butter to the pot of hot, drained potatoes (still over low heat) and mash well with a potato masher until the butter melts. There may be a few \\xe2\\x80\\x98rustic\\xe2\\x80\\x99 lumps. Push the potatoes to one side of the pot to make a space for the milk. Add the milk and heat it until hot (this only takes a few seconds.)', 'Use a sturdy whisk to stir in the milk, whisking until the potatoes are fluffy and adding more milk, 1 tablespoon at a time, if the potatoes seem dry. Stir in 1/2 cup of the cheese, 1/2 teaspoon salt and 1/8 teaspoon pepper. Taste, and add more salt, if you like.', '4 Meanwhile, make the filling: In a large skillet over medium heat, heat the oil. Add the onions and garlic and cook for 5 minutes, or until softened. If the onions are cooking to fast reduce the heat to medium-low.', 'Add the oregano and cumin, and cook for 30 seconds. Add the beans, corn, chicken, and salsa to the skillet. Stir in 1/2 teaspoon salt. Taste and add more salt, if you like.', '5 Assemble the casserole: Transfer the filling to the baking dish. Spread the mashed potatoes over the top and sprinkle with the remaining 1 cup cheese.', '6 Bake the casserole: Bake for 25 to 30 minutes, or until the filling bubbles and the cheese is golden. Leftovers will keep in the fridge for up to 3 days.']",11
225,Instant Pot Chicken Tortilla Soup Recipe,5,45,50,"['2 tablespoons olive oil', '2 cloves garlic, chopped', '1 medium yellow onion, diced', '1/2 teaspoon kosher salt', '4 cups chicken broth', '1 (4-ounce) can fire-roasted diced green chilies', '1 (15-ounce) can black beans, rinsed and drained', '1 1/2 cups corn kernels (fresh or frozen)', '1 (14.5-ounce) can fire-roasted crushed tomatoes', '1 pound chicken tenders or thighs, boneless and skinless', 'For the corn tortilla strips:', '6 street taco-sized corn tortillas', '1 tablespoon avocado oil or olive oil', '1/2 teaspoon kosher salt', 'To garnish:', '3/4 cup shredded Monterey Jack or Mexican blend cheese', '1 large avocado, sliced', '1/2 cup fresh chopped cilantro', '1 lime, cut into 6 wedges', 'Special equipment:', 'Instant Pot']",21,"['1 Saut\\xc3\\xa9 the onions and garlic: Select the \\xe2\\x80\\x9cSaut\\xc3\\xa9\\xe2\\x80\\x9d setting on your pressure cooker and heat the olive oil. Add the garlic, onion, and salt and saut\\xc3\\xa9 for about 3 minutes until the onion begins to soften.', '2 Add the remaining soup ingredients: Add the chicken broth, using a wooden spoon or spatula to scrape up any browned bits from the bottom of the pot. Stir in the green chilies, black beans, corn, tomatoes, and chicken.', '3 Cook the soup: Cancel the \\xe2\\x80\\x9cSaut\\xc3\\xa9\\xe2\\x80\\x9d program to reset your pressure cooker. Place the lid on the pressure cooker. Make sure the pressure regulator is set to the \\xe2\\x80\\x9cSealing\\xe2\\x80\\x9d position. Select the \\xe2\\x80\\x9cPressure Cook\\xe2\\x80\\x9d or \\xe2\\x80\\x9cManual\\xe2\\x80\\x9d setting and set the cooking time for 10 minutes at high pressure. (The pot will take about 15 minutes to come up to pressure before the cooking program begins.)', '4 While the soup cooks, make the tortilla strips: Preheat a toaster oven, air fryer, or oven to 350\\xc2\\xb0F. Pour the oil into a bowl large enough to toss the tortilla strips. Cut the tortillas into 1/4-inch strips, then toss them in the bowl with the oil.', 'Bake or air fry the tortillas until they are golden and slightly browned around the edges, about 7-9 minutes. Right when you take the strips out of the toaster oven or air fryer, sprinkle them with the salt. Set aside to cool.', '5 Release and serve or keep warm: When the cooking program ends on the Instant Pot, let the pressure release naturally for at least 15 minutes. The pot will default to its \\xe2\\x80\\x9cKeep Warm\\xe2\\x80\\x9d setting. You can serve the soup right away or leave it for up to 10 hours.', '6 Shred the chicken: Once the pressure has released, open the pot. Use tongs to transfer the cooked chicken to a cutting board. Use a pair of forks to shred the chicken, then add it back to the soup and stir to combine. Taste for seasoning, adding more salt if you like.', '7 Serve the soup: Ladle the soup into bowls. Top each bowl with shredded cheese, sliced avocado, and cilantro. Serve with wedges of lime and tortillas alongside.']",8
226,Black Eyed Pea Salsa with Cheese Quesadillas Recipe,25,20,45,"['Black-eyed Pea Salsa', 'About 3 1/4 to 4 cups cooked black-eyed peas (2 15.5-ounce cans, rinsed, drained)', '1/2 to 2/3 cups of chopped, cooked, mild green chiles (2 large poblanos or 3 Anaheims, roasted, seeded, and chopped) AND/OR 1/4 cup chopped pickled jalape\\xc3\\xb1os (to taste)', '1/2 to 2/3 cups of chopped roasted red bell pepper (can use jarred marinated or roast fresh red bell peppers by charring over a gas flame or under a broiler, placing in a covered bowl for a few minutes, wiping off the char, seeding, and chopping)', '6 to 8 green onions, thinly sliced including at least half of the greens, about 1/2 to 2/3 cup total', '1 bunch of cilantro, chopped, tender stems included (about a cup)', '2 tablespoons extra virgin olive oil', '2 tablespoons red wine vinegar', '1 teaspoon dried oregano, crumbled', 'Large pinch of ground cumin', '1/2 teaspoon salt', 'Freshly ground black pepper', 'Quesadillas', '1 dozen flour tortillas', '8 ounces Monterey jack cheese, sliced or grated']",15,"[""If you haven't already done so, prep your ingredients. Char and peel your chiles and/or red bell peppers if using fresh not jarred or canned. Cook your black-eyed peas if not using canned."", '1 Assemble the salsa: Place the drained cooked black eyed peas in a large bowl. Add the chiles, red bell peppers, and most of the chopped onions and cilantro (reserving some for garnish).', 'Drizzle with olive oil and red wine vinegar. Sprinkle with crumbled, dried oregano, cumin, salt, and pepper.', 'Toss and let marinate while you prepare the quesadillas.', '2 Make the quesadillas: Heat a large cast iron pan on medium high heat. If you are using something other than a well-seasoned cast iron pan, add a small amount of oil or butter to lightly coat the bottom of the pan. Add a flour tortilla to the pan. Let it heat up on one side for half a minute.', 'Flip it over and place a light layer of cheese over the tortilla. If you are using grated cheese, you can just sprinkle it all over. If using sliced cheese, lay the slices down on only one side of the tortilla.', 'When tortilla begins to form air pockets or the cheese begins to melt, use a spatula to lift up one edge of the tortilla and turn it over to the other edge, as if you were making an omelette.', 'Let cook until lightly browned, and then flip the whole quesadilla over to the other side and let cook until lightly browned on that side. Remove from the pan and prepare the other quesadillas in the same manner.', '3 Cut the quesadillas into pie-shaped wedges and serve with the black-eyed pea salsa.']",9
227,Blackberry Muffins Recipe,20,20,40,"['2 1/2 cups (320g) all purpose flour', '1 tablespoon baking powder', '1/2 teaspoon baking soda', '1/2 teaspoon salt', '1/2 teaspoon cinnamon', '2 large eggs', '1 cup (236ml) sour cream', '1 teaspoon milk or water', '1 cup (200 g) sugar', '8 tablespoons warm melted butter (1 stick, 112 g)', '1 teaspoon vanilla', '1 1/2 cups (about 5-6 oz, about 150g) of blackberries, fresh or frozen (if using fresh berries, cut them in half, if using frozen berries, defrost first, drain excess liquid, then coat them lightly in flour)']",12,"[""1 Preheat oven, prepare muffin pan: Position rack in center of oven. Preheat oven to 400\\xc2\\xb0F (200\\xc2\\xb0C). Grease a standard 12 muffin pan or line with paper muffin cups. (Actually, with the berries you'll have more batter than just for 12 muffins. This batch made 18 muffins.)"", '2 Combine dry ingredients: Whisk together the flour, baking powder, baking soda, cinnamon and salt in a large bowl.', '3 Combine wet ingredients and sugar: In a separate bowl, whisk together eggs, sour cream, milk, sugar, butter and vanilla.', '4 Add wet ingredients to dry, then add berries: Add the wet mixture to the dry mixture, and mix together with a few light strokes, just until the dry ingredients are moistened.', 'Add the berries. (If you are using frozen berries, defrost them first, then drain the excess liquid, then coat them lightly in flour.)', 'Do not over-mix! Over-mixing will cause the muffins to be dense, not fluffy. The batter should not be smooth, but rather lumpy.', '5 Put into muffin cups and bake: Divide the batter evenly among the muffin cups. Bake at 400\\xc2\\xb0F (200\\xc2\\xb0C) until a toothpick inserted into the middle of 1 or 2 of the muffins comes out clean, 17-20 minutes (or longer).', '6: Let cool: Let cool for 2 to 3 minutes before removing from the pan. If not serving hot, let cool on a rack.', 'Serve as soon as possible, preferably within a few hours of baking.']",9
228,Lemon Mascarpone Blondies Recipe,15,25,40,"['1/2 cup (1 stick, 112 g) of butter, melted', '1 cup (220 g) of tightly packed dark brown sugar', '1 egg, lightly beaten', '1/4 teaspoon of vanilla', '8 ounces (225 g) of mascarpone cheese', '2 tablespoons of lemon juice', '2 1/2 teaspoons of lemon zest', '1/2 teaspoon baking powder', '1/8 teaspoon of baking soda', 'Pinch of salt', '1 cup (128 g) of all-purpose flour']",11,"['1 Preheat the oven to 350\\xc2\\xb0F (175\\xc2\\xb0C). Lightly butter and flour an 8X8 pan (20cmX20cm). Whisk together the melted butter and sugar in a bowl.', '2 Add the egg and vanilla extract and whisk.', '3 Add the lemon juice, zest, and mascarpone cheese and mix thoroughly.', '4 Add the flour, baking soda, baking powder, and salt, mix it all together.', '5 Pour into the pan and spread evenly. Bake for 25-30 minutes or until a toothpick comes out clean. Allow to cool on a wire rack. Cut into squares and serve.']",5
229,Chewy Tahini Blondies Recipe,10,30,40,"['1/2 cup (1 stick) unsalted butter, melted and cooled, plus more for buttering the pan', '1 1/4 cups all-purpose flour', '3/4 teaspoon baking powder', '1/2 teaspoon ground cardamom (or more to taste if you really like this flavor)', '1/2 teaspoon fine sea salt', '1/4 teaspoon freshly ground black pepper', '2 tablespoons lightly toasted black sesame seeds', '2 tablespoons lightly toasted white sesame seeds', '1 1/4 cups lightly packed light brown sugar', '2 large eggs', '1 teaspoon pure vanilla extract', '1/2 cup pure tahini paste']",12,"['1 Preheat the oven and prep the pan: Preheat the oven to 350\\xc2\\xb0F.', 'Butter an 8-inch square baking pan, then line the pan with 2 criss-crossing strips of parchment paper, buttering between each layer and leaving a 2-inch overhang on all sides. Butter the top and sides of the parchment.', '2 Make the batter: In a medium bowl, whisk together the flour, baking powder, cardamom, salt, pepper, and the black and white sesame seeds.', 'In another medium bowl, whisk together the brown sugar, 1/2 cup melted butter, eggs, and vanilla until smooth. Fold the dry ingredients into the wet ingredients until just incorporated, then fold in the tahini until smooth.', '3 Bake blondies: Pour the batter into the prepared pan and bake until golden on the outside and the center doesn\\xe2\\x80\\x99t jiggle but is still soft, 25 to 30 minutes.', '4 Serve: Remove from the oven, cool in the pan, and cut into 16 equal squares.']",6
230,Peach Blueberry Cake Recipe,10,120,130,"['For the pastry crust:', '1 1/2 cups all-purpose flour', '1/2 cup sugar', '1 teaspoon baking powder', '1/4 teaspoon salt', '1 stick (1/2 cup) cold unsalted butter, cut into 1/2-inch cubes', '1 large egg', '1 teaspoon vanilla extract', 'For the filling:', '1/2 cup sugar (can reduce to 1/4 cup of sugar)', '2 Tbsp all-purpose flour', '1 Tbsp instant tapioca (can sub with a Tbsp of cornstarch)', '2 lb ripe, firm, large peaches (about 4), halved lengthwise, pitted, and each half cut lengthwise into four wedges', '1 cup blueberries (1/2 pint)', '1 Tbsp lemon juice', 'Special equipment:', 'A 9 to 9 1/2-inch (24-cm) springform pan', 'An electric spice grinder', 'Food processor']",19,"['1 Make the crust dough: Put flour, sugar, baking powder, and salt into a food processor and pulse until combined.', 'Add the butter and pulse just a few times, until the pieces of butter are no bigger than a pea.', 'Add the egg and vanilla extract and pulse several more times, until the dough begins to clump together and form a ball.', '2 Press dough into pan: Generously butter the inside of your springform pan. Place a round of parchment paper at the bottom of the pan and butter the top of the parchment as well.', 'Press the dough evenly onto the bottom of the pan (about 1/4 inch thick), and about 2 inches up the sides of the pan.', 'Put into the refrigerator to chill for at least 10 minutes.', '3 Prepare oven: Put oven rack in middle position and preheat oven to 375\\xc2\\xb0F.', '4 Make the filling: Grind 2 tablespoons sugar with flour and tapioca in a spice grinder until tapioca is powdery. (If using cornstarch instead of instant tapioca, you do not need to grind.)', 'Transfer to a large bowl and stir in remaining sugar. Add peaches, blueberries, and lemon juice and gently toss to coat.', '5 Bake: Fill pastry crust with peach and blueberry filling. Cover loosely with foil. Bake at 375\\xc2\\xb0F until the filling is bubbly in the center and crust is golden, about 1 3/4 hours.', '6 Cool and remove from pan: Remove cake from oven and set on a rack to cool, uncovered for 20 minutes. Run a blunt knife around the inside edge of the pan to help release the crust from the sides of the pan. Then carefully remove the side of pan.', 'Cool cake to barely warm or room temperature Cut into thick wedges before serving.', 'Note that although the cake will come out of the oven somewhat liquidy. The liquid should gel nicely as the cake cools.']",13
231,Blueberry Buttermilk Pancakes Recipe,5,20,25,"['Dry ingredients:', '2 cups all purpose flour', '1/2 teaspoon salt', '1/2 teaspoon baking powder', '1/2 teaspoon baking soda', '2 Tbsp sugar', 'Other ingredients:', '2 large eggs', '1/2 cup buttermilk', '1 cup milk', '3 Tbsp warm melted butter', '1 cup blueberries', 'Butter or vegetable oil']",13,"['1 Make pancake batter: Whisk together the dry ingredients in a large bowl.', 'In a separate bowl, whisk the eggs, then whisk in the milk, and buttermilk.', 'Pour the wet ingredients into the dry ingredients and combine, using a wooden spoon. Mix only until the batter just comes together.', 'Stir in the melted butter. Do not over-mix! The mixture should be a little lumpy. Lumpy is good. A lumpy batter makes fluffy pancakes.', 'At this point you can either gently fold in the blueberries, or wait until you pour the batter onto the griddle, and then place the blueberries into the surface of the pancake batter. Placing the blueberries into the pancakes while they are cooking will help keep them from bleeding.', '2 Ladle batter in hot pan: Heat a griddle or large pan on medium to medium high heat. (A large cast iron pan works great for cooking pancakes.)', 'Oil the pan with either a little butter or vegetable oil.', 'Ladle the pancake batter onto the griddle to the desired size (a quarter-cup measure works well for this), anywhere from 4 to 6 inches wide.', ""If you haven't already added the blueberries to the batter, you can place several in each pancake while it cooks."", '3 When you see air bubbles in the center, flip the pancakes over: When air bubbles start to bubble up to the surface at the center of the pancakes (about 2-3 minutes), use a flat metal spatula to flip them over.', 'After a minute, peek under one for doneness. When golden or darker golden brown, they are done.', ""Note that cooking the second side takes only about half as long as the first side. And the second side doesn't brown as evenly as the first side."", ""Continue to make the batches of pancakes, putting a little oil or butter on the pan before each batch so the pancakes don't stick."", 'Serve immediately. Serve with butter, maple syrup, and extra blueberries.']",14
232,Soba Noodle Soup with Chicken and Bok Choy Recipe,10,20,30,"['8 cups chicken stock, or low-sodium chicken broth', '1 boneless skinless chicken breast (about 12 ounces)', '2-inch piece of fresh ginger, finely chopped (about 2 tablespoons)', '1/4 cup lime juice', '2 tablespoons Thai fish sauce', '3 tablespoons Thai sweet red chili sauce', '1 tablespoon brown sugar', '8 ounces soba (buckwheat) noodles', '4 baby bok choy, cut into 1-inch slices, or halved lengthwise', '6 scallions, thinly sliced', 'A few sprigs Thai basil, mint or cilantro, for garnish', 'Lime wedges, to serve', 'Red pepper flakes, for garnish']",13,"['1 Poach the chicken: Place a boneless skinless chicken breast in a saucepan and add enough stock to barely cover. Cover the pot and bring it to a simmer over medium-low heat.', 'Once simmering, place the lid slightly ajar and continue to simmer for 5 minutes.', 'Remove from the heat, cover completely with the lid again, and let the chicken rest for 10 minutes. Transfer to a plate, and shred into pieces with your fingers when cool enough to handle.', '2 While the chicken cools, season the stock: Add the remaining chicken stock to the pot and bring to a simmer. Add the ginger, lime juice, fish sauce, chili sauce and brown sugar. Stir and taste for seasoning. Add more chili sauce if you wish to make a spicier broth. Simmer for about 10 minutes to allow the flavors to mingle.', ""3 Meanwhile, cook the soba noodles: Bring a large pot of water to a boil. Add the noodles and cook for 6 to 8 minutes, until tender or according to package directions. Drain into a colander. (If the soup isn't quite ready yet, run the under cold water, drain, and toss with a little olive oil to keep the noodles from sticking together while you finish the rest of the soup.)"", '4 Add the bok choy and scallions to the soup broth. Return to a simmer. Remove from the heat after 1 minute. (If you kept the bok choy in halves, cook for a few minutes longer, or until tender.)', '5 Assemble the bowls of soup: Divide the noodles among 4 large soup bowls and top with the chicken. Ladle the broth and vegetables over top and garnish with the basil, mint or cilantro, if desired. Serve with lime wedges and sprinkle with red pepper flakes.']",7
233,Baby Bok Choy with Yellow Bell Peppers Recipe,10,10,20,"['1 tablespoon peanut oil, canola oil, or rice bran oil', '1 tablespoon toasted sesame oil', '2 large yellow bell peppers, stem and seed pod removed and discarded, sliced (about 2 cups sliced)', '4 green onions, chopped, including green parts that are not dried out', '1 lb baby bok choy, bottom root ball cut off and discarded, rinsed thoroughly, torn into smaller pieces']",5,"['1 Saut\\xc3\\xa9 onions and sliced bell peppers: Heat a tablespoon each of peanut oil and sesame oil in a large saut\\xc3\\xa9 pan on high heat.', ""Add the sliced yellow peppers and chopped green onion, and cook, stirring occasionally, until lightly browned. (Keep a watch so that the onions don't burn.)"", '2 Add the bok choy: Lower the heat and add the bok choy. Stir to coat with the oil in the pan. Cook only until the bok choy has wilted. The thicker, whiter ends of the baby bok choy should still be somewhat crunchy.', 'Serve immediately.']",4
234,Baby Bok Choy with Sherry and Prosciutto Recipe,5,20,25,"['1 tablespoon extra virgin olive oil', '4 medium cloves garlic, thinly sliced', '6 heads baby bok choy, cut in half lengthwise', '1/8 teaspoon kosher salt, more as needed', '1/4 cup dry sherry', '1/2 cup chicken broth', '1 Tbsp soy sauce (use gluten-free soy sauce for gluten-free version of recipe)', '1/4 teaspoon sugar', '1 teaspoon cornstarch mixed with a tablespoon of cold water', '1/3 to 1/2 cup of thinly sliced prosciutto cut into 1/4-inch strips, or finely chopped']",10,"['1 Cook the garlic: Put the oil and garlic into a large, heavy-based saut\\xc3\\xa9 pan with a lid. Heat on medium high heat and cook, stirring frequently until the garlic begins to sizzle, about 1 minute.', '2 Add the bok choy, then sherry: Add the baby bok choy halves. Use tongs to turn the pieces in the oil. Season with salt. When the bok choy leaves begin to wilt, add the sherry, turning the pieces again.', '3 Add broth, soy sauce, sugar, cover and simmer: Add the chicken broth, soy sauce, and sugar. Reduce the heat to medium. Cover and simmer until the bok choy tops are wilted and the stalks are crisp-tender, about 5 minutes.', 'Using tongs, transfer the bok choy to a plate, leaving the cooking fluid in the pan.', '4 Add cornstarch slurry: Whisk the cornstarch slurry into the cooking fluid. Simmer until liquid has thickened, about 30 seconds.', 'Remove the pan from the heat.', '5 Add the bok choy and prosciutto: Add the bok choy back to the pan. Add the prosciutto and toss quickly to coat the bok choy with the broth and mix with the prosciutto. Season to taste with salt. Serve immediately.']",7
235,Lasagna Bolognese Recipe,15,270,285,"['Bolognese Sauce:', '2 ounces diced pancetta, finely chopped', '1 medium Spanish onion or yellow onion, finely chopped', '1 stalk celery, finely chopped', '1 carrot, finely chopped', '4 tablespoons unsalted butter', '11 ounces ground beef', '4 ounces ground pork', '4 ounces ground Italian sausage', '1 freshly ground clove', 'Dash of freshly ground cinnamon', '1 teaspoon freshly ground black pepper', '2 pounds peeled and chopped tomatoes (or one 28-oz can whole peeled tomatoes)', '1 cup whole milk', '1/2 teaspoon sea salt', 'B\\xc3\\xa9chamel Sauce:', '2 cups whole milk', '1/4 cup unsalted butter', '1/4 cup all-purpose unbleached flour', 'Lasagna:', 'Enough lasagna noodles to make four layers in a 13x9-inch baking pan with the lasagna pieces overlapping each other a little bit.', 'Recommended 16 sheets of De Cecco brand Italian lasagna noodles.', '1 cup freshly grated Parmesan cheese']",23,"['PREPARE THE BOLOGNESE MEAT SAUCE', '1 Make the soffritto: Combine pancetta, onion, celery, and carrot in saut\\xc3\\xa9 pan with butter and cook over medium heat until onion turns pale gold.', '2 Add the beef, pork, sausage to the soffritto, and increase the heat to high; cook until browned.', 'Sprinkle with the ground clove, cinnamon, and pepper.', '3 Stir in tomatoes, bring to a simmer and reduce the heat to medium. Cook over medium heat for 15 minutes. If you are using whole canned tomatoes, break them up as you add them to the sauce.', '4 Add milk and season with sea salt. Then turn down the heat and let simmer for 2 and 1/2 hours. Stir at least every 20 minutes. Whenever the sauce simmers down to the point that it is sticking to the bottom of the pan, just add 1/4 cup of water and scrape up the browned bits from the bottom and continue to cook.', 'MAKE THE B\\xc3\\x89CHAMEL SAUCE', '5 Make the roux: Heat the milk until almost boiling in a heavy bottomed sauce pan.', 'In a separate pan melt the unsalted butter with the flour over low heat. Stir rapidly with a spoon. Cook this for 1 minute and then remove from the heat. (See Wikipedia on B\\xc3\\xa9chamel Sauce for more information on this sauce.)', '6 Slowly add half the milk to the roux: Slowly add half the hot milk to your butter and flour mixture. During this process stir constantly.', '7 Add remaining milk, thicken the sauce: Return the milk, butter, flour mixture to low heat until the sauce begins to thicken. Add the remaining milk slowly while stirring working it into the thickened sauce. Continue to stir until it comes to a boil.', '8 Season, stir: Season with some sea salt, and continue stirring until the right consistency has developed. If any lumps form, beat them out rapidly with a whisk until they dissolve. Remove from heat.', 'PREPARE THE LASAGNA', '9 Cook the lasagna noodles: Preheat oven to 375\\xc2\\xb0F. Cook the lasagna according to instructions. About 8 minutes in 6 quarts of boiling salted water. Drain, rinse with cold water.', 'Lay the individual lasagna noodles out on kitchen towels, not touching, so they do not stick together while you layer the casserole.', '10 Layer the lasagna: Spread a little olive oil around the inside of a 13x9-inch baking pan. Make sure your baking pan is non-reactive - pyrex or stainless steel. Do not use an aluminum pan as it will react with the acidity of the sauce and ruin the flavor.', 'Put a layer of lasagna noodles down first. Layer on a third of the bolognese sauce, then a third of the bechamel sauce.', 'Sprinkle with grated Parmesan. Repeat two more times. Top with a final layer of noodles and sprinkle with grated Parmesan.', '11 Bake: Tent the casserole with aluminum foil. Put lasagna into the middle rack of a pre-heated 375\\xc2\\xb0F oven. Bake for 20-30 minutes, until the top begins to get lightly browned.', 'Remove from oven and let cool 5-10 minutes before serving.']",20
236,Quick and Easy Bolognese Sauce Recipe,5,35,40,"['1/2 large yellow onion, cut into 2-inch chunks', '1 large carrot, peeled and thickly sliced', '1 large stalk celery, thickly sliced', '2 tablespoons unsalted butter', '1 pound ground beef', '1/2 teaspoon table salt', '1/8 teaspoon freshly ground black pepper', '1/2 cup whole milk', 'Pinch of nutmeg', '3/4 cup dry white wine', '1 (28-ounce) can whole San Marzano or other good quality tomatoes with thick juice', '12 ounces cooked pasta (for serving)']",12,"['1 Chop the vegetables: In a food processor, combine the onion, carrot, and celery. Pulse until finely chopped.', '2 Cook the vegetables: In a deep, wide skillet over medium heat, melt the butter. Add the onions, carrots, and celery. Cook, stirring often, for 5 minutes, or until soft and translucent but not browned.', '3 Cook the beef: Add the ground beef to the skillet with the saut\\xc3\\xa9ed vegetables. Add the salt and pepper. Break the meat up with a fork or a potato masher and cook over medium heat for 3 to 4 minutes, mashing it until it is crumbly and no longer pink. You are not actually browning the meat, just cooking it until it no longer looks raw.', '4 Simmer the meat and milk: Add the milk to the skillet and simmer, stirring often, for about 4 minutes, or until the milk has almost completely evaporated. Stir in the nutmeg.', '5 Add the wine: Add the wine to the skillet and continue to simmer for about 5 minutes, or until it has almost evaporated.', '6 Crush and add the tomatoes: Pour the tomatoes into a bowl and squish them with your hands to break them up so there are no large pieces.', ""Add them to the skillet and bring the sauce to a simmer. Turn the heat to low and simmer the sauce for 15 to 20 minutes, stirring occasionally, until the sauce is thick. If the sauce begins to look dry, stir in 1 to 2 tablespoons hot water. Taste and add more salt and pepper if you feel it's needed."", '7 Serve: Serve the sauce over a bed of cooked pasta.']",8
237,Classic Bolognese Sauce Recipe,15,210,225,"['2 ounces pancetta, finely chopped', '1 medium Spanish onion or yellow onion, finely chopped', '1 celery rib, finely chopped', '1 carrot, finely chopped', '3 tablespoons unsalted butter', '11 ounces ground beef', '4 ounces ground pork', '4 ounces ground Italian sausage', '1 freshly ground clove', 'Dash of freshly ground cinnamon', '1 teaspoon freshly ground black pepper', '2 pounds peeled and chopped tomatoes (or one 28-ounce can whole peeled tomatoes, packed in water)', '1 cup whole milk', '1/2 teaspoon sea salt']",14,"['1 Make the soffritto: Combine pancetta, onion, celery, and carrot in saut\\xc3\\xa9 pan with butter and cook over medium heat until onion turns pale gold, about 10 minutes.', '2 Add the meats: Add the beef, pork, and sausage to the soffritto, and cook until browned, about 5 minutes.', '3 Add the spices: Sprinkle with the clove, cinnamon, and pepper.', '4 Add the tomatoes and simmer: Stir in tomatoes, increase the heat to bring to a simmer and then reduce the heat back to medium. Cook over medium heat for 15 minutes. If you are using whole canned tomatoes, break them up as you add them to the sauce.', '5 Simmer for 2 hours: Add milk and season with sea salt. Then turn down the heat to low, partially cover, and simmer for 2 and 1/2 hours. Stir at least every 20 minutes.', 'Whenever the sauce gets too dry and starts sticking to the pan, just add 1/4 cup of water and scrape up any browned bits from the bottom of the pan.', '6 Serve: Bolognese is traditionally served with fresh tagliatelle pasta, but you can also serve it with fettucine, pappardelle, penne, or other pasta. Sauce freezes well for future use.']",7
238,Beef Bouillon Soup from Oxtails Recipe,10,210,220,"['3-4 lbs oxtails, patted dry', 'Salt and pepper', '2 onions, peeled and quartered', '2 carrots, cut into 1-inch sections', 'Zest of one orange, removed in strips with a vegetable peeler', '1 cup dry white wine', '4 quarts water', '1/3 cup fresh cranberries (if in season, otherwise use a quarter of a lemon)', '10 oz mushrooms, chopped coarse', '3 ribs celery, cut into 1-inch sections', '4 sprigs of thyme or 1/2 teaspoon dried thyme', '1 bay leaf', '4 cloves', '1 teaspoon peppercorns']",14,"['1 Roast the oxtails, carrots, onions: Preheat the oven to 450\\xc2\\xb0F. Pat dry the oxtails with paper towels and put them in a roasting pan. Sprinkle on all sides with salt and pepper.', 'Add the carrots, onions, and zest. Roast in the middle rack, turning the oxtails as the are browned.', 'Once browned, remove from oven and place the oxtails and vegetables into a large stockpot.', '2 Deglaze the roasting pan: Place the roasting pan on the stovetop on medium high heat. Add the wine to the pan to deglaze the pan, scraping up any browned bits.', '3 Simmer the oxtails and other ingredients: Add the deglazing liquid to the stockpot with the oxtails. Add the cranberries, mushrooms, celery, thyme, bay leaf, cloves, and peppercorns.', 'Bring the liquid to a boil, skimming whatever foam rises to the surface. Reduce the heat and simmer gently, uncovered, for 3 hours.', '4 Strain the bouillon from the oxtails: Ladle the mixture through a sieve lined with cheesecloth or paper towels into a large bowl.', 'Reserve the oxtails for another use, such as oxtail pate. Discard the remaining solids.', 'The bouillon can be made 3 days in advance and kept chilled. Discard excess fat (leave enough to cover soup when chilled).']",9
239,Bourbon Maple Glazed Chicken Wings Recipe,5,45,50,"['2 pounds chicken wings', '1 Tbsp butter', '2 Tbsp grated onion (use small hole grater)', '1/2 cup bourbon whisky', '3/4 cup maple syrup (grade A)', '2 Tbsp tomato paste', '2-inch sprig fresh rosemary (or 1 teaspoon dry)', '1 1/2 teaspoon salt', '1/2 teaspoon black pepper', '1/4 teaspoon Tabasco (more or less to taste)']",10,"['1 Make the bourbon maple glaze: Melt butter in a medium saucepan on medium heat. Add the grated onion and cook for 2 to 3 minutes.', 'Add the bourbon whisky, the maple syrup, tomato paste, rosemary, salt, pepper, and Tabasco. Whisk to combine. Bring to a low simmer. Simmer for 5 minutes.', '  2 (Optional) Marinate the wings in the glaze: If you want you can marinate the wings for an hour, or overnight in the glaze. Just let the glaze cool for a few minutes, then toss half of the glaze mixture in a bowl with the wings, cover with plastic wrap and chill. Reserve the remaining half of the glaze mixture to glaze the wings at the end.', ""3 Coat wings with glaze and arrange on roasting pan: Preheat oven to 350\\xc2\\xb0F. If you haven't marinated the wings, place them in a bowl and pour half of the bourbon maple sauce over the wings, returning the remaining sauce to the stovetop."", 'Toss the wings with the sauce to coat.', 'Arrange the wings on an oiled, foil-lined baking pan, with space between each wing.', '4 Roast the wings: Roast the wings at 350\\xc2\\xb0F for 20 minutes, then turn the wings over and roast them an additional 15 to 25 minutes, or until nicely browned. Lower the heat or remove from oven if the wings start getting too dark.', '5 Boil remaining glaze until thickened: While the wings are roasting, boil the remaining sauce until it thickens slightly and can coat the back of a spoon, then remove from heat.', 'If it is taking too long for the sauce to reduce, pour it into a wide shallow pan and bring to a boil. The wider pan will make sauce evaporate more easily.', '6 Coat cooked wings in glaze: When wings are done, remove them to a bowl and toss with the remaining sauce.']",10
240,Bourbon Mashed Sweet Potatoes Recipe,10,30,40,"['3 pounds garnet sweet potatoes, peeled and cut into 1 inch chunks', 'Salt', '3 to 4 Tbsp of bourbon whisky', '4 Tbsp butter (more or less to taste)', '4 Tbsp brown sugar (more or less to taste)', '2 teaspoons vanilla extract']",6,"['1 Boil the sweet potatoes until tender: Place the sweet potato chunks in a large (5 quart) pot, cover with water.  Add a tablespoon of salt to the water. Bring to a boil.  Cook until tender, about 15 to 20 minutes.', '2 Mash the sweet potatoes: Drain the cooked sweet potatoes and return them to the pot on the stove. Lower the heat to low.', 'Add the bourbon and the butter to the pot and stir. Add the brown sugar and vanilla extract and stir.', 'Mash with a potato masher until smooth.  Add more salt, bourbon, butter, and brown sugar to taste.']",4
241,Pork Chops with Mushroom Bourbon Cream Sauce Recipe,15,25,40,"['Mushroom Cream Sauce:', '2 tablespoons extra virgin olive oil', '1 pound sliced button or cremini mushrooms', '1/4 cup chopped onions', '2 large garlic cloves, chopped', '1/2 cup dry white wine (e.g. Sauvignon Blanc)', '1 cup chicken stock', '1/2 cup heavy cream', '1/4 cup bourbon whisky', 'Salt and pepper', 'Pork Chops:', '1 large egg', '2 tablespoons water', '4 6-7 oz center-cut pork chops', 'All purpose flour', '2 cups fresh bread crumbs', '3 tablespoons extra virgin olive oil', '2 tablespoons minced fresh basil']",18,"['1 Make the mushroom bourbon cream sauce: Saut\\xc3\\xa9 onions, garlic, and mushrooms in 2 Tbsp of olive oil in a large wide skillet on medium high heat until the mushrooms are browned - about 10-15 minutes.', 'Add the wine, increase the heat to high, and boil down until the liquid is reduced to almost a glaze, about 4 minutes.', 'Add the chicken stock and bourbon, boil until reduced by two thirds.', 'Add the cream and simmer several minutes until the sauce thickens.', '2 Dredge the chops: Whisk an egg and 2 Tbsp of water in a shallow baking dish. Sprinkle both sides of pork chops with salt and pepper. Dip chops into the flour, then egg mixture, then breadcrumbs, coating completely.', '3 Cook the chops on both sides: Heat olive or canola oil in a large skillet over medium-high heat. Add the pork chops and cook until brown, about 4 minutes per side. If your pork chops are thin cuts, this may be all the cooking they need. If thicker, lower the heat to low and cover the pot. Cook for a few minutes more until the chops are just cooked through, about 145\\xc2\\xb0F.', '4 Finish the sauce: When about to serve the pork, bring the sauce to a simmer and add the chopped basil to it. Season to taste with salt and freshly ground black pepper.']",7
242,Apple Cider Hot Toddy Recipe,0,10,10,"['1 1/2 ounces bourbon (or any other kind of whiskey)', '1 teaspoon honey', '5 whole cloves', '1 cinnamon stick', '1 anise star (optional)', '1/2 cup apple cider']",6,"['1 Combine bourbon and honey in a heat-proof mug or snifter.', '2 Simmer the apple cider with spices: Add the apple cider and spices to a small saucepan. Heat the mixture over medium-low heat and bring it to a simmer, about 10 minutes.', '3 Pour cider into mug: Strain the cider into the mug and stir. Or if you want, leave a few spices in the mug for extra aromatics as you sip!']",3
243,Easy Beef Brisket Recipe,10,180,190,"['3 to 4 pounds of a brisket cut of beef', '3/4 cup barbecue sauce', '1/4 cup soy sauce', '1 cup of water']",4,"['4 Let the brisket rest: Remove from oven and let rest in the foil for 30 minutes before serving.', ""5 Slice across the grain of the meat: The easiest way to serve the roast is to first cut it in half along the grain of the meat (poke the meat with the tip of a knife or tines of a fork to see which way the grain or lines of the muscles are going if you can't see it from the surface)."", 'Then make 1/4-inch to 1/2-inch thick cuts across the grain to serve. (Cutting the meat across the grain will make it much easier to eat, as the cuts break up the muscle tissue.)']",3
244,Braised Beef Short Ribs Recipe,0,720,720,"['12 beef short ribs, bone-in', 'Salt and freshly ground pepper', '1/4 cup extra virgin olive oil', '1 yellow onion, peeled and chopped', '1 stalk celery, chopped', '1 carrot, peeled and chopped', '1 750-ml bottle good dry red wine (we used a zinfandel)', '6 cups veal stock (can substitute beef stock)']",8,"[""1 Brown the ribs: Preheat oven to 350\\xc2\\xb0F. Season ribs to taste with the salt and pepper. Heat oil in a large, heavy bottomed ovenproof pan over high heat. Add ribs and brown on all sides. Work in batches if you need to so that the ribs don't get crowded (this will help with browning)."", '2 Saut\\xc3\\xa9 vegetables: Transfer ribs to a plate. Pour off the excess fat (do not put down the drain or you will clog your sink!). Add the onions, celery, and carrots to the pan and saut\\xc3\\xa9, stirring often, until lightly browned, about 5 minutes. Remove the vegetables from the pan, set aside.', '3 Deglaze pan with wine, then reduce sauce: Add the wine to the pan, deglazing the pan, scraping off any browned bits from the bottom of the pan. Reduce the wine by three-quarters until thick and slightly syrupy, about 15 minutes on high heat.', '4 Braise ribs in oven: Return the ribs to the pan, add the veal stock and enough water to cover the ribs. Bring to a boil, cover with foil, and place in the oven. Braise, cooking in the oven, until the meat is fork-tender, 2 to 2 1/2 hours.', 'During the last 1/2 hour of cooking, add back in the vegetables.', '5 Chill overnight: Allow the ribs to cool in the liquid, then cover and refrigerate overnight.', '6 Remove excess fat: The next day, remove the excess fat that has solidified at the top from the overnight chilling.', '7 Reduce sauce with ribs: Place the pan with the ribs and cooking liquid over medium heat, uncovered. Cook until the liquid has reduced by three-quarters, about 1 hour. Continue to cook, spooning the sauce over the ribs, until the sauce is thick and ribs are glazed. Take care not to burn the glaze; move the ribs around in the pan to keep them from burning.', 'Serve over mashed potatoes, egg noodles, or rice.']",9
245,Beef Roast Braised in Red Wine Recipe,15,210,225,"['1 (3 1/2 pound) chuck roast, boneless', 'Salt and ground black pepper', '4 oz pancetta, cut into 1/4-inch cubes', '2 medium onions, chopped medium (about 2 cups)', '2 medium carrots, chopped medium (about 1 cup)', '2 ribs celery, chopped medium (1 cup)', '1 Tbsp tomato paste', '3 medium cloves garlic, minced or pressed through garlic press (about 1 tablespoon)', '1 (750 ml) bottle Zinfandel wine (can substitute Cabernet Sauvignon, or other full bodied red wine)', '1 can (14 1/2 ounces) diced tomatoes, drained', '1 Tbsp chopped fresh oregano', '1 teaspoon minced fresh rosemary']",12,"['1 Salt the roast and let sit at room temp while you prep the vegetables: If your roast is very fatty, trim some of the fat. But it is important to keep some fat, as this will keep the roast moist while braising. In many supermarkets chuck roasts will already be properly trimmed.', 'Salt the roast well and set aside at room temperature while you prepare all the other vegetables.', '2 Render fat and crisp the pancetta: Pour a little water into a Dutch oven or other heavy, lidded pot. Set the pot over medium heat and add the diced pancetta. As soon as the water begins to simmer, lower the heat to medium-low and slowly crisp up the pancetta; the water allows some of the fat in the pork to render out without charring the pancetta.', 'When the pancetta is crispy and brown, remove it with a slotted spoon and set aside.', '3 Brown the roast on all sides: Preheat the oven to 300\\xc2\\xb0F. Pat the beef roast dry with a paper towel, increase the heat to medium and brown all sides in the pot.', '4 Saut\\xc3\\xa9 the chopped vegetables: Once the meat has browned remove it to a bowl and add the onions, carrot and celery. Sprinkle salt over the vegetables while they cook. Increase the heat to medium-high and saut\\xc3\\xa9 for 2-3 minutes.', 'Add the tomato paste and stir well, saut\\xc3\\xa9 for another 1-2 minutes. Add the garlic and cook a minute more.', '5 Add tomatoes, pancetta, herbs, wine, and the roast. Cover and cook: Increase the heat to high and add the tomatoes, the pancetta, herbs and red wine. Nestle the beef roast into the pot, cover, place in the 300\\xc2\\xb0F oven and cook for 3 hours. At the halfway point, use tongs to turn the beef roast over.', ""6 Strain and reduce the sauce: Remove the pot from oven and transfer beef to a large bowl; tent with foil to keep warm. Allow the liquid to settle in the pot for a few minutes, if you'd like, skim off some of the fat with a wide shallow spoon. If you have an immersion blender, use it to blend the contents of the pot. If you don't, use a whisk to help break down the vegetables."", 'Boil the sauce until it is reduced to about 3 1/2 cups. Strain liquid through large fine-mesh strainer, pressing on solids with spatula to extract as much liquid as possible; you should have a couple cups strained sauce.', 'Add any accumulated juices from the bowl you have the beef in. Boil the sauce again until it has reduced to 1 1/2 cups. Season sauce to taste with salt and pepper.', '7 Slice the meat and serve with the sauce: Cut the meat into roughly 1/2-inch-thick slices and pour the sauce over them. Serve with a bold red wine and crusty bread or mashed potatoes.']",12
246,Braised BBQ Beef Sandwich Recipe,5,210,215,"['One 3-pound chuck roast, rinsed and dried', '2 medium onions, chopped', '1 tablespoon extra virgin olive oil', '1 28-ounce can whole tomatoes (preferably plum tomatoes)', '1 18-ounce bottle of your favorite barbecue sauce (or 2 1/4 cups of your favorite homemade barbecue sauce)', 'Salt and freshly ground black pepper', '12 sandwich or hamburger buns']",7,"['1 Make sauce with onions, tomatoes, BBQ sauce: In a large, heavy pot, heat olive oil on medium heat. Add the onions and cook until translucent, about 5 minutes. Add the tomatoes, roughly chopping them in the pot. Add the barbecue sauce, increase heat to medium high and simmer for 10 minutes.', '2 Add the beef roast, simmer on low for 3 hours: Add the chuck roast. Bring to a low simmer, cover and slow cook until meat is very tender, stirring occasionally, about 3 hours.', '3 Separate meat into small pieces: Remove the meat from the pot. Use a fork and knife to separate the roast into small pieces. Set aside.', '4 Reduce liquid in sauce: Increase the heat on the pot to medium/medium-high, uncover, and reduce the liquid until thick. Stir often to prevent burning.', '5 Return meat to sauce: Return the meat to the liquid in the pan. Warm both thoroughly. Add salt and pepper to taste.', 'Serve on buns.']",6
247,Chicken Normandy Recipe,10,90,100,"['4 tablespoons butter', '2 cooking apples (Fuji or Jonagold are perfect for this dish, do NOT use a red delicious), cored and sliced into wedges (you can peel or not)', 'Flour for dredging', '4 whole chicken legs (with thighs)', 'Salt', '1 large onion, peeled, sliced lengthwise (root to top) into wedges', '1/2 cup (120 ml) brandy (apple brandy or Calvados if you have it)', '2 cups (475 ml) apple cider (the cloudy type)', '1 teaspoon dried thyme', '1/2 cup cream']",10,"['1 Sprinkle chicken with salt: Sprinkle salt over the chicken pieces and let sit for 20 minutes at room temperature while you prep the other ingredients and saut\\xc3\\xa9 the apples in the next step.', '2 Saut\\xc3\\xa9 apple slices: Preheat the oven to 375\\xc2\\xb0F (190\\xc2\\xb0C). Heat 2 Tbsp of the butter in a large, oven-proof saut\\xc3\\xa9 pan over medium heat. Add the apple slices and saut\\xc3\\xa9 until they turn a little brown around the edges, turning occasionally.', 'Sprinkle the apple slices with a little salt. Remove from pan and aside on paper towels to drain.', '3 Dredge chicken in flour, brown in pan: Dredge the chicken in flour and place the pieces in the saut\\xc3\\xa9 pan, skin side down. Add the remaining 2 Tbsp of butter.', 'Fry until golden, about 3-5 minutes on medium to medium-high heat on each side. Remove from pan and set aside.', '4 Saut\\xc3\\xa9 onion slices: Add the onions and increase the heat to medium-high. Spread the onion slices out in an even layer to cover the pan. As the onions cook they will release moisture that will help deglaze the pan of the browned bits from the chicken.', 'Saut\\xc3\\xa9 the onions, stirring occasionally, until they just being to brown, about 5-8 minutes.', '5 Deglaze pan with brandy: Add the brandy to the pan. Using a wooden spoon, scrape any remaining browned bits off the bottom of the pan.', '6 Add apple cider: Let the brandy boil until it has reduced by about half. Add the apple cider and bring it to a boil. Sprinkle in the thyme. Add just a pinch of salt to the cider.', '7 Place chicken on onions, and roast in oven: Arrange the chicken legs in the pan so the skin faces up and is not submerged by the cider-brandy mixture. Place in the oven and cook at 375\\xc2\\xb0F (190\\xc2\\xb0C), uncovered, for 30 minutes.', '', '8 Remove chicken, add apples, reduce sauce: Remove the pan from the oven. (Watch out for the hot handle! I like to run an ice cube over the handle as soon as I remove the pan, to help bring the handle temp down quickly and prevent a bad burn if I forget the handle is hot.) Remove the chicken pieces from the pan and set aside.', 'Place the pan back on a stovetop burner on high heat. Add the apples and boil down the sauce by half.', ""9 Add cream, salt, pepper: When the sauce reduces to the point where it's a little syrupy, add the cream and turn down the heat. Taste for salt and add some if needed."", 'To serve, spoon some apples and onions on the plate, top with sauce and a piece of chicken.']",15
248,Brandied Cranberries Recipe,5,75,80,"['1 (12-ounce) bag of fresh or frozen cranberries', '1 1/2 cups sugar', '1/3 to 1/2 cup brandy', '2 Tbsp finely shredded orange zest (use microplane zester)']",4,"['1 Sort and discard bad cranberries: Preheat oven to 325\\xc2\\xb0F. Sort through cranberries and discard any that are soft or decayed.', '2 Mix cranberries, sugar, brandy, and orange zest in a 2-quart baking dish.', '3 Bake: Bake at 325\\xc2\\xb0F uncovered, until most of the liquid has evaporated, 1 to 1 1/4 hours, stirring occasionally.', 'Chill up to one week.']",4
249,Spiced Mulled Wine Recipe,5,25,30,"['1 orange', '15 whole cloves', '1 bottle red wine (inexpensive Cabernet or Malbec)', '1/4 cup sugar (turbinado is nice)', '3 cinnamon sticks', '2 teaspoons ground ginger', '1/4 cup brandy', 'Special equipment:', 'Large pot or slow cooker']",9,"[""1 Stud the cloves into the orange, then cut the orange: Push the cloves into the orange (see this picture for reference), then cut the orange into half circles. (Studding the cloves into the orange means you won't have to worry about floating cloves in your drink.)"", 'Alternatively, cut the orange into half circles and add it and the cloves to the wine separately.', '2 Add ingredients to the pot: Add all the ingredients to a pot or a slow cooker.', ""3 Heat the wine: On the stovetop, simmer the wine for 20\\xe2\\x80\\x9325 minutes over medium-low heat, stirring occasionally to mix ingredients and dissolve sugar. If you're using a slow cooker, heat the wine on low heat for 1 1/2 hours or on high for 45 minutes, until warm."", ""When the mulled wine smells amazing, tastes spicy, and is hot (but not boiling), it's done. Serve and enjoy!""]",5
250,Grilled Branzino with Rosemary Vinaigrette Recipe,15,12,27,"['2 tablespoons minced onion', '1 teaspoon Dijon mustard', '1 teaspoon salt', '3 tablespoons white wine vinegar', '1 large garlic clove, chopped', '1 heaping tablespoon of minced fresh rosemary', '1/2 cup extra virgin olive oil', '1 whole branzino', 'Olive oil', 'Salt, preferably sea salt']",10,"['1 Make the rosemary vinaigrette: Put the minced onion, mustard, salt, vinegar, garlic and rosemary into a blender and pulse it for about 30 seconds. Use a spatula to scrape down the sides of the blender and pur\\xc3\\xa9e it again for 10-20 seconds. Scrape the sides down again.', 'Turn the blender on low and take the removable cap off the lid. Hold your hand over the hole, as it might spit a little. Pour the olive oil in slowly and put the cap back on.', 'Turn the blender off and scrape the sides down one more time. Turn the blender back on low, then high for 60 seconds.', '2 Prepare the fish: Rinse the fish under cold water. Now make sure its gills and scales are all removed; your fishmonger is not always so diligent about this task, and no one wants a scale on his plate. Gills can impart a bitter taste to the fish, so they need to go, too.', '3 Make cuts on the sides of the fish: Use a very sharp knife and make several slashes on the sides of the fish, maybe every inch or so. Make the cuts at an angle to the side of the fish, and slice down until you feel the spine. Do not sever the spine, however. These cuts will help the fish cook faster. Rub olive oil all over the fish and set it aside.', '4 Prepare the grill for high, direct heat. Scrape down the grates well and close the lid. Salt the fish well. Now grab a paper towel, a set of tongs, and some cheap vegetable oil. Bring all of this out to the grill.', 'Fold the paper towel over several times, moisten it with the vegetable oil, and hold it with tongs to wipe down the grill grates.', '5 Grill the fish: Lay the fish down on the grill and close the lid. Let this cook for 5 minutes without touching it.', 'Open the lid and, using tongs, gently see if you can lift the fish off the grates cleanly. Don\\xe2\\x80\\x99t actually do this, but check for sticky spots. If you have some, get a metal spatula. Use the spatula to dislodge the fish from the sticky spots.', 'Using tongs in one hand, and the spatula in another, gently flip the fish over. If it sticks, no biggie. It happens sometimes.', '    7  Finish grilling the fish: Once the fish has been flipped, let it cook another 3-5 minutes. Again, test for sticky spots with the tongs and spatula. Dislodge them gently and gently lift the fish onto a plate.', 'If the fish is too long or seems like it might break in half, use two metal spatulas instead of the tongs-and-spatula set-up.', '8 Drizzle the vinaigrette over the fish and serve at once. Goes well with crusty bread and a glass of pilsner beer or white wine.']",13
251,Brazilian Salmon Stew (Moqueca) Recipe,25,165,190,"['Marinade:', 'The cloves from 1/2 head of garlic, peeled, crushed, minced', '2 Tablespoons of fresh lime juice', '3/4 teaspoon of coarse salt', '1 Tablespoon of sweet paprika', '2 1/2 teaspoons of ground cumin', '1 1/2 teaspoons of freshly ground black pepper', 'Other:', '1 1/2 to 2 pounds of salmon, cut into 2-inch pieces (largish-bite sized pieces)', 'Extra virgin olive oil', '2 medium onions, sliced', '1 large green bell pepper, seeded, de-stemmed, and sliced', '2 medium tomatoes, sliced', 'Salt and freshly ground pepper', '1 14-ounce can regular (not light) coconut milk', '1 large bunch fresh cilantro, chopped, 1-2 cups']",16,"['1 Marinate salmon: Mix together the marinade ingredients. Let the salmon marinate in this paste for at least 2 hours. The longer, the better.', '2 Layer ingredients in a large pot: In a large pan (large covered skillet or Dutch oven), coat the bottom of the pan with a couple tablespoons of olive oil. Add a layer of sliced onions, and then a layer of sliced bell peppers, and a layer of sliced tomatoes.', 'Place the fish pieces, with the marinade, on top of everything, and start layering again\\xe2\\x80\\x94onions, bell peppers, and tomatoes.', '3 Top with cilantro, coconut milk, olive oil: Sprinkle generously with salt and pepper. Add about half of your fresh cilantro to the top.', 'Pour coconut milk over the top. Drizzle generously with olive oil over the top (several tablespoons).', '4 Simmer: Bring to a boil, reduce heat to low, cover and let simmer for 30 minutes to an hour, until the vegetables are cooked through.', 'Garnish with remaining cilantro.']",7
252,St. Lucia Saffron Buns Recipe,150,12,162,"['3/4 cup milk (175 ml)', '1/2 teaspoon saffron threads', '1 teaspoon plus 1/4 cup (50 g) white, granulated sugar', ""One 1/4-ounce packet active dry yeast (check the expiration date on the package to make sure it\\'s still good!)"", '3 1/2 to 4 cups (490 g to 570 g) all purpose flour', '1/2 teaspoon kosher salt', 'The seeds from 3 cardamom pods, ground (optional)', '1/4 cup (1/2 stick, 4 Tbsp, 56 g) unsalted butter, softened', '1/4 cup of sour cream (or quark if available)', '2 large eggs', 'Raisins', 'Glaze', '1 egg, beaten']",13,"['1 Heat milk, saffron, sugar: In a small pot, heat the milk, saffron, and 1 teaspoon of sugar together until the milk is steamy. Remove from heat and stir to dissolve the sugar. Let cool until about 115\\xc2\\xb0F, or warm to the touch, but not hot.', '2 Sprinkle the yeast over the warm saffron-infused milk and let sit for 5 to 10 minutes until foamy.', '3 Whisk flour, sugar, salt, cardamom: In the bowl of a stand-up mixer* whisk together 3 1/2cups (490 g) of the flour, remaining 1/4 cup of sugar, salt and ground cardamom (if using).', ""*You can make this recipe without a mixer, for me it\\'s just a bit easier with one."", '4 Make a well in the center of the flour and add the yeast milk saffron mixture, the eggs, the butter, and the sour cream. Mix the ingredients until well incorporated.', '5 Knead the dough: Switch to the dough hook of your mixer (if using, otherwise knead by hand). On low speed start to knead the dough. Slowly add additional flour, a tablespoon at a time, kneading to incorporate after each addition. Do this until the dough is still a little sticky to the touch, but does not completely stick to your hands when you handle it.', '6 Let dough rise: Shape the dough into a ball and place in a large bowl. Cover with plastic wrap. (Note at this point you can make ahead and refrigerate overnight if you wish.)', 'Let sit in a warm place for 1 to 2 hours, until the dough has doubled in size. (One way to tell that the dough is ready is that you poke your finger in it and it takes quite a bit of time for the indentation left by your finger to go away.)', '7 Form dough into S shapes: When the dough has doubled in size, gently press it down and knead it a couple of times. Break off a piece and form it into a ball about 2 inches wide (60 to 70 grams if you are weighing). Roll the ball out into a snake, about 14 inches long.', 'Then Curl the ends in opposite directions, forming an ""S"" with spirals at each end. Place on a lined baking sheet and repeat with the rest of the dough.', '8 Let sit for second rise:  Cover with plastic wrap and place in a warm spot until the dough shapes double in size, 30 minutes to an hour.', '9 Brush with egg wash, place raisins on buns: Preheat oven to 400\\xc2\\xb0F (205\\xc2\\xb0C). Using a pastry brush, brush some beaten egg over the tops and sides of the uncooked buns. Place raisins in the centers of the ""S"" spirals.', '10 Bake: Place in the oven and bake at400\\xc2\\xb0F (205\\xc2\\xb0C) for about 10 to 11 minutes (turning halfway through cooking to ensure even browning), until the buns are golden brown.', 'Remove from oven and let cool for 5 minutes before eating.']",14
253,Southern Cornbread Recipe,15,20,35,"['1 tablespoon bacon drippings', '2 cups cornmeal OR 1 1/2 cups cornmeal and 1/2 cup flour', '1 teaspoon baking soda', '1 teaspoon salt', '1 tablespoon sugar (optional)', '1 large egg (optional)', '1 1/4 cups buttermilk', '6 tablespoons unsalted butter, melted']",8,"[""1 Preheat pan with bacon drippings: Put the bacon drippings in a 9 or 10-inch well-seasoned cast iron skillet and put the skillet into the oven. Then preheat the oven to 400\\xc2\\xb0F with the skillet inside. (If you don't have an iron skillet, you can use an uncovered Dutch oven or a metal cake pan.)"", '2 Make the batter: Whisk together all the dry ingredients (cornmeal, baking soda, salt, sugar if using) in a large bowl. In another bowl, beat the egg (if using) and buttermilk until combined, then mix that into the bowl of dry ingredients. Stir in the melted butter.', '3 Pour batter into hot skillet and bake: When the oven is hot, take out the skillet (carefully, as the handle will be hot!). Add the cornbread batter and make sure it is evenly distributed in the skillet.', 'Bake at 400\\xc2\\xb0F for about 20 minutes, or until the edges are beginning to brown and a toothpick inserted in the center of the bread comes out clean.', '4 Rest bread in skillet, then serve: Let the bread rest for 10 to 30 minutes in the skillet before cutting it into wedges and serving.', 'To store, let the cornbread cool, then remove from pan and wrap in plastic wrap or transfer to an airtight container. Store at room temp for 2 to 3 days', ""To avoid burning your hand because you've forgotten the pan is hot, I recommend placing a pot holder on the pan's handle while the cornbread is resting, or cooling the handle down a bit with an ice cube.""]",7
254,Caraway Soda Bread Recipe,10,40,50,"['3 1/2 cups of all-purpose flour (1 pound)', '1 Tbsp sugar', '1 teaspoon salt', '1 teaspoon baking soda', '2 teaspoons caraway seeds', '4 Tbsp butter (1/2 stick) room temp', '1 1/2 cups buttermilk*', '*If necessary, you can substitute buttermilk with a half cup of plain yogurt mixed in with a cup of plain milk and a tablespoon of white vinegar.']",8,"['1 Preheat oven to 450\\xc2\\xb0F. In a large bowl, whisk together the flour, sugar, salt, baking soda, and caraway seeds.', '2 Using your fingers (or a fork) work the butter into the flour until the mixture resembles a coarse meal.', '3 Make a well in the center of the flour. Pour the buttermilk into the center and using either your hands or a wooden spoon, fold the flour over the buttermilk and gently mix until just combined.', 'The dough should be neither too wet or too dry, so if it is a little too dry to work with, add a little more buttermilk. If too wet, add a little more flour. Roughly shape into a ball and place on a floured surface. Knead just a few times to shape it into a round loaf. Do not over-knead or the bread will be tough.', '4 Place dough loaf onto a lightly greased baking sheet (or cast iron pan). Make 1 1/2-inch deep cuts, forming a cross, from side to side on the loaf. The scoring helps the heat get to the center of the loaf while cooking.', ""5 Place in oven, cook for 15 minutes at 450\\xc2\\xb0F, then lower the heat to 400\\xc2\\xb0F and cook for 25 more minutes. One way to test for doneness is to take it out of the oven, turn it over and knock on the bottom. If it sounds hollow, it's done. You can also use a skewer inserted into the center."", ""Let bread sit on the baking sheet for 5-10 minutes to cool. Then remove it to a rack to cool a little bit longer. I think the bread is best when it is still warm and just baked. Quick breads like this, which rely on baking soda for leavening, are generally best eaten soon after they're baked.""]",7
255,Easy Brazilian Cheese Bread Recipe,5,15,20,"['1 large egg*', '1/3 cup extra virgin olive oil', '2/3 cup milk', '1 1/2 cups (170 grams) tapioca flour', ""1/2 cup (packed, about 66 grams) grated cheese, your preference, we get good results with feta cheese (no need to grate), or fresh farmer's cheese (if using fresh farmer's cheese, you may want to add another 1/2 teaspoon of salt)"", '1 teaspoon of salt (or more to taste)', ""*It helps when baking with eggs to start with eggs at room temperature. If you don't plan ahead (that would be me, usually) you can put the egg in a bowl of warm water for a few minutes to gently take off the chill of the fridge."", 'Special equipment:', 'One 24-well or or two 12-well mini muffin tins. Mini muffin tins are about half the size of a regular muffin pan. The muffin openings are about 1-inch deep, and 1 3/4 inch wide at the top.']",9,"['1 Pre-heat oven, prepare mini-muffin tin: Preheat oven to 400\\xc2\\xb0F. Spread a small amount olive oil around the insides of each well of a mini-muffin tin.', '2 Blend ingredients: Put all of the ingredients into a blender and pulse until smooth. You may need to use a spatula to scrape down the sides of the blender so that everything gets blended well. At this point you can store the batter in the refrigerator for up to a week.', '3 Pour into mini-muffin tin: Pour batter into prepared mini-muffin tin, not quite to the top; leave about 1/8 inch from the top.', '4 Bake: Bake at 400\\xc2\\xb0F in the oven for 15-20 minutes, until all puffy and nicely browned. Remove from oven and let cool on a rack for a few minutes.', 'Eat while warm or save to reheat later.', 'Note that Brazilian cheese bread is very chewy, a lot like Japanese mochi.']",6
256,Cranberry Orange Nut Bread Recipe,15,55,70,"['2 cups flour', '1 1/2 teaspoon baking powder', '1/2 teaspoon baking soda', '1/2 teaspoon salt', '1 cup chopped fresh cranberries', '3/4 cup coarsely chopped walnuts', '3/4 cup orange juice', '3/4 cup granulated sugar', '1/4 cup butter, melted', '1 egg, beaten', '1 Tbsp orange zest']",11,"['1 Pre-heat oven to 350\\xc2\\xb0F.', '2 Combine dry ingredients: Whisk together the flour, baking powder, baking soda, and salt in a large bowl. Stir in the chopped cranberries and walnuts to coat with the flour mixture. (Coating with flour will help suspend the nuts and cranberries in the dough and keep them from sinking.)', '3 Combine wet ingredients: In a separate bowl combine the orange juice, sugar, melted butter, egg, and orange zest.', ""4 Add wet ingredients into dry: Pour the orange juice sugar mixture into the flour nut cranberry mixture and fold until just blended. (Don't over-mix!)"", '5 Bake: Transfer dough into a well buttered 8x4 or 9x5 loaf pan. Bake at 350\\xc2\\xb0F for 50 to 55 minutes or until done (a tester inserted into the center comes out clean).', '6 Cool: Cool in pan for 10 minutes. Remove from pan and cool on a wire rack.']",6
257,Chocolate Zucchini Bread Recipe,10,70,80,"['4 cups grated zucchini (from about a pound and a half of zucchini)', '2 1/2 cups all purpose flour', '1/2 cup unsweetened cocoa (use natural unsweetened cocoa, NOT Dutch processed)', '2 teaspoons baking soda', '1/2 teaspoon salt', '1 teaspoon cinnamon', '1 1/2 cups granulated white sugar', '2 eggs', '3/4 cup unsalted butter (12 Tbsp or 1 1/2 sticks), melted', '1/2 teaspoon instant coffee granules', '1/2 teaspoon almond extract']",11,"['1 Drain excess moisture from grated zucchini: Place the freshly grated zucchini in a sieve over a bowl to catch any excess moisture as it drains, while you work on prepping the other ingredients and preparing the recipe.', 'If for some reason your zucchini is on the dry side, hydrate the shredded zucchini by soaking it in water first, and then place in sieve.', '2 Preheat oven, prepare loaf pans: Preheat oven to 350\\xc2\\xb0F, with a rack in the middle. Grease two 9x5-inch loaf pans with baking spray or butter.', '3 Whisk together flour, cocoa, baking soda, salt, cinnamon: Vigorously whisk together the flour, unsweetened cocoa, baking soda, salt, and cinnamon in a large bowl. Whisk until there are no more clumps and the ingredients are well combined.', ""4 Beat sugar and eggs, add melted butter, instant coffee granules, almond extract: In a separate large bowl, beat together the sugar and eggs until smooth, about a minute. You can do this with an electric mixer on medium speed, or by hand with a wooden spoon. (I'm lazy and use a mixer but it's easy enough to do by hand.)"", 'Add the melted butter, instant coffee granules, and almond extract and beat until smooth.', '5 Stir zucchini into sugar egg mixture, add flour mixture: Mix the shredded zucchini into the sugar egg mixture.', 'Add the flour to the zucchini mixture in 3 additions, stirring to combine after each addition.', '6 Divide batter into pans and bake: Work quickly, and divide the batter between the two prepared loaf pans. (Work quickly because once the dry ingredients have mixed with the wet ingredients, the leavening has begun.)', 'Place into the oven. Bake for 50 minutes at 350\\xc2\\xb0F, or until a skewer inserted into the center comes out clean and easily.', '7 Cool: Remove to a rack. Let cool in the pan for 5 minutes, then run a blunt knife around the edges to separate the bread from the pan. Remove from the loaf pans and let cool completely on a rack.', ""Note that if you try to slice the chocolate zucchini bread before it has completely cooled, it will be rather crumbly. It's also easiest to slice with a bread knife.""]",12
258,Boston Brown Bread Recipe,20,135,155,"['Butter for greasing loaf pans or coffee cans', '1/2 cup (heaping) all-purpose flour', '1/2 cup (heaping) rye flour', '1/2 cup (heaping) finely ground corn meal (must be finely ground)', '1/2 teaspoon baking powder', '1/2 teaspoon baking soda', '1/2 teaspoon salt', '1/2 teaspoon allspice', '1/2 cup molasses (any kind)', '1 cup buttermilk', '1 teaspoon vanilla extract (optional)', '1/2 cup raisins (optional)', 'One metal 6-inch tall by 4-inch diameter coffee can, or a 4x8 loaf pan']",13,"['7 Steam the bread: Steam the bread on the stovetop or in the oven for at least 2 hours and 15 minutes.', ""Check to see if the bread is done by inserting a toothpick into it. If the toothpick comes out clean, you're ready. If not, re-cover the pan and cook for up to another 45 minutes."", '8 Allow bread to cool: Remove from the stovetop or oven and let cool for 10 minutes before putting on a rack. Let the bread cool for 1 hour before turning out of the container.', 'Slice and eat plain, or toast in a little butter in a frying pan.']",4
259,Cheesy Skillet Cornbread Recipe,10,40,50,"['1 cup cornmeal', '1/2 cup flour', '1 tablespoon baking powder', '1 tablespoon sugar', '1 teaspoon garlic powder', '1/2 teaspoon salt', '1 cup shredded medium or sharp cheddar cheese', '1/4 cup chopped onion', '1 cup milk', '3 tablespoons bacon drippings (warmed to liquid), plus 1 teaspoon to grease the pan', '1 egg, beaten', '3/4 cup of cooked corn, either fresh, defrosted frozen corn, or drained from a can']",12,"['1 Preheat pan in oven: Place a 9 or 10-inch cast iron pan in the oven and preheat the oven to 350\\xc2\\xb0F.', '2 Make the batter: In a large bowl, whisk together the cornmeal, flour, baking powder, sugar, garlic powder, and salt. Add remaining ingredients, and stir until just combined.', '3 Grease hot pan, add batter: Carefully remove the hot pan from the oven (remember the handle is hot!). Place a teaspoon of bacon fat in the bottom of the hot pan and swirl it around until it is all melted and coating the bottom of the pan. Pour the batter from the mixing bowl into the pan. Remember to put a pot holder over the hot handle of the pan and return it to the oven.', '4 Bake: Bake at 350\\xc2\\xb0F for 40 minutes or until golden brown. Remove from oven and let the cornbread cool in the pan. Remember that the handle is hot and will stay hot for quite some time. I recommend rubbing an ice cube over the handle to cool it down, just to avoid someone burning their hand if they attempt to move the pan before it has cooled down enough.']",4
260,Homemade Rye Bread Recipe,30,40,70,"['2 packages active dry yeast (4 1/2 teaspoons or 16 grams)', '2 1/2 cups warm water (just barely warm to the touch)', '2/3 cup molasses (regular unsulphured; not blackstrap)', '2 tablespoons caraway seeds (optional)', '1 tablespoon salt', '1/4 cup vegetable oil', '1/4 cup cocoa powder (unsweetened)', '2 cups rye flour', '5 cups bread flour']",9,"['1 Dissolve the yeast: Dissolve the yeast in the warm water with the molasses. Put yeast mixture into a large metal bowl.', '2 Make the dough: Add the caraway seeds, salt, vegetable oil, cocoa powder, 2 cups of rye flour and then 2 cups of bread flour, mixing into the yeast mixture after each addition with a wooden spoon.', 'Add more bread flour, a cup at a time, until the dough is not so sticky and it is too hard to mix it with the wooden spoon. At that point, spread a half cupful of flour onto a large, clean, flat surface and put the dough onto the surface.', '3 Knead the dough: Knead the dough by pressing down with the heel of your hand, stretching it, turning the dough a quarter-turn, pulling the dough back toward you and then pressing and stretching again. Knead additional bread flour into the dough until it reaches the right consistency. Knead for 5-7 minutes, or until the dough is smooth and elastic.', '4 Let the dough rise: Spread some vegetable oil around a large bowl and place the dough in it, turning it so it gets coated in the oil.', 'Cover the bowl with plastic wrap or a damp cloth. Let rise at room temperature until it has doubled in size, 1 to 1 1/2 hours.', '5 Divide the dough: Gently press down on the risen dough so some of its air is released. Turn the dough out onto a lightly floured surface, knead the dough a few turns and then divide it by cutting it in half with a sharp knife.', '6 Shape the loaves: Shape each half into loaf. Place dough loafs into either oiled 8x4-inch bread loaf pans, or onto a flat baking sheet or peel that has been sprinkled with corn meal, depending if you want to cook the loaves in pans or directly on a baking stone. Cover with plastic or a damp cloth.', '7 Let the loaves rise: Let the bread rise again, this time not doubling in volume, but rising by about half of its volume, about 30 to 45 minutes, half as long as the first rising. The dough should be peeking over the top of the loaf pan if using a loaf pan.', '8 Heat the oven: If you are using a baking stone, place the stone in the oven. Preheat oven to 350\\xc2\\xb0F for at least half an hour before baking.', '9 Bake the loaves: If baking on a stone and not in the pan, score the loaves a few times on the top of the dough right before putting it in the oven.', 'Put loaves in the oven. If you have a mister, mist the dough with a little water the first 10 minutes of baking. Bake for 40-50 minutes, or until done. The bread should sound hollow when tapped.']",12
261,Yankee Cornbread Recipe,10,35,45,"['Butter (for the pan)', 'Flour (for the pan)', '3 large eggs', '1 cup canola oil', '2 cups plain Greek yogurt', '1/2 cup sugar', '2 cups yellow cornmeal, preferably stoneground', '1 cup all-purpose flour', '1 1/2 teaspoons baking powder', '1/2 teaspoon baking soda', '1/2 teaspoon salt', 'Special equipment:', '9x13-inch baking pan']",13,"['1 Heat the oven to 375F. Butter a 9x13-inch baking pan. Line the bottom with parchment paper and butter the paper. Dust the pan with flour, tapping out the excess.', '2 Prepare the batter: In a bowl large enough to hold all the ingredients, stir together the eggs, canola oil, and yogurt until smooth. Stir in the sugar followed by the cornmeal, flour, baking powder, baking soda, and salt. Keep stirring until no pockets of dry ingredients show.', '3 Bake the cornbread: Pour the batter into the pan and use an offset spatula or regular spatula to smooth the top. Bake the cornbread for 35 minutes, or until it is uniformly golden brown on top and firm in the middle. Set on a rack to cool for 10 minutes.', '4 Slice the cornbread: Make 2 vertical slices and 5 horizontal slices to form 18 squares. Lift them from the pan and serve with butter.']",4
262,Dinner Potato Rolls {Buttery & Fluffy Recipe,20,145,165,"['For the rolls:', '1/2 cup water, room temperature', '2 1/4 teaspoon (1 packet) active-dry or instant yeast', '1 teaspoon plus 1/3 cup sugar, divided', '1 cup mashed potatoes', '1/4 cup milk', '6 tablespoons regular salted butter, melted and cooled', '2 large eggs', '2 1/2 teaspoons minced fresh rosemary leaves', '1 1/2 teaspoon salt', '4 1/2 to 5 cups all-purpose flour', 'For honey butter topping:', '1/4 cup regular salted butter, room temperature', '2 tablespoon honey']",14,"[""1 Proof the yeast: In the bowl of a stand mixer, combine the water, the yeast, and 1 teaspoon of the sugar. Set aside for about 5 minutes, or until the mixture looks bubbly. If the mixture doesn't start to bubble, then your yeast has likely expired and it's best to start over with new yeast."", '2 Mix the dough: Add the remaining sugar, mashed potatoes, milk, butter, eggs, rosemary, and salt to the bowl with the yeast mixture and stir with a spatula until smooth. Add 4 1/2 cups of the flour and mix until you form a shaggy dough.', ""3 Knead the dough: With a dough hook attachment (or on the counter, if kneading by hand) knead on medium-low for 5 to 7 minutes until the dough is smooth, forms a ball around the dough hook, and pulls away from the sides of the bowl (it's fine if the dough sticks to the bottom of the bowl). If the dough is still sticking to the sides after few minutes of kneading, add in a little more flour 2 tablespoons at a time."", '4 Let the dough rise: Place the dough in a lightly greased bowl, cover with plastic wrap, and place somewhere warm for about 1 hour, or until the dough doubles in size.', '5 Shape the dough into rolls: Line a 13x9-inch baking pan with parchment paper and lightly grease. Turn the dough the out onto lightly floured surface and cut into 16 to 20 equal pieces. Roll the dough into small balls, and place seam side down in the baking dish.', '6 Cover and let the rolls rise until puffed and nearly doubled in size, about 1 hour. About 15 minutes before the rolls are ready, heat the oven to 350F.', '7 Bake for the rolls for 20 to 25 minutes, or until the rolls are golden brown on top and register 200F on the inside when tested with an instant-read thermometer.', '8 Brush the rolls with honey butter: In a small dish, mix together 1/4 cup room temperature butter and 2 tablespoons honey until smooth. Brush tops of baked rolls with mixture, then sprinkle with salt. Allow to cool slightly before serving.']",8
263,Zucchini Bread with Pineapple Recipe,20,55,75,"['3 cups all purpose flour', '1 teaspoons baking soda', '1 teaspoon salt', '1 teaspoon baking powder', '2 teaspoons cinnamon', '3/4 teaspoon nutmeg', '3 eggs', '1 3/4 cups sugar', '1 cup olive oil', '2 teaspoons vanilla', '2 to 3 cups coarsely grated zucchini', '1 can (8oz) crushed pineapple, drained', '1 cup chopped walnuts (optional)', '1 cup golden raisins (optional)']",14,"['1 Drain zucchini of excess moisture: Put the shredded zucchini in a colander or sieve placed over a bowl to drain any excess moisture.', '2 Prepare the oven and pans: Preheat oven to 350\\xc2\\xb0F (175\\xc2\\xb0C). Prepare 2 buttered 5 by 9 inch loaf pans.', '3 Whisk together dry ingredients: In a medium sized bowl, vigorously whisk together the flour, baking soda, baking powder, salt, cinnamon, and nutmeg.', '4 Mix wet ingredients and sugar: In a mixer, beat eggs on medium speed for one minute.', 'Add the sugar and beat for one more minute.', 'Add the oil and vanilla; continue beating mixture until thick and foamy.', '5 Stir in grated zucchini and pineapple: Remove the bowl from the mixer and with a spoon, stir in the zucchini and pineapple.', '6 Combine dry ingredients with wet: A third at a time, add dry ingredients into wet and gently stir (by hand) after each addition.', '7 Add the walnuts and raisins, blend gently.', '8 Bake: Divide the batter equally between the two loaf pans. Bake at 350\\xc2\\xb0F for 55 minutes or until a wooden pick inserted in to the center comes out clean.', 'Cool in pans for 10 minutes. Turn out onto wire racks to cool thoroughly.']",11
264,Cinnamon Toast Recipe,0,2,2,"['2 slices of sliced bread', '2 pads of butter, softened or room temp', '1/4 teaspoon cinnamon', '1 Tbsp white granulated sugar']",4,"['In a small bowl or jar, stir together the cinnamon and sugar so they are well mixed. Toast your bread. Slather the toast with butter. Sprinkle the cinnamon sugar over the buttered toast.']",1
265,Whole Wheat Bread,20,130,150,"['2 1/2 cups warm 2% milk', '1 packet Active Dry Yeast (about 3 teaspoons)', '3 1/3 cups (395g) bread flour plus more for dusting', '3 1/3 cups (410g) whole wheat flour', '1 tablespoon Kosher salt', '2 1/2 tablespoons butter, plus more for brushing loaves', '2 1/2 tablespoons honey', 'Special equipment:', 'Two 9x5-inch loaf pans (You can use 8.5x4.5-inch pans, but your loaves will be quite a bit taller.)']",9,"['1 Prep the pans: Butter a large bowl and two 9x5-inch loaf pans and set aside. (You can use 8.5x4.5-inch pans, but your loaves will be quite a bit taller.)', '2 Proof the yeast: Warm the 2 1/2 cups of milk in the microwave in 30 second bursts, stirring in between, just to take the chill off. The milk should feel tepid to the touch, NOT hot. (Hot milk will kill the yeast.)', 'Stir the yeast into to the warm milk and let it hang out for about 5 minutes. The yeast should mostly dissolve and you should see some small bubbles on the surface of the milk.', '3 Meanwhile, whisk together the dry ingredients and melt the butter: In a large bowl, whisk whole wheat flour, bread flour, and salt. Make a well in the center.', 'In a small, microwave-safe bowl, warm the butter in 30 second bursts in the microwave until just melted. Add honey. Let it cool until no longer hot.', '4 Mix the dough: Pour the milk and yeast mixture into well in the flour. Add the butter and honey mixture.', 'Stir with a wooden spoon until a shaggy dough forms. Most of the flour should be incorporated, but it\\xe2\\x80\\x99s ok if you still have some loose flour in the bowl.', '5 Knead the dough: To knead by hand: Turn the dough and any loose flour onto a countertop and knead for 10 minutes. Start by bringing the dough together with your fingers then smooshing it with the heel of your hand. Pull the dough back over itself with your fingers, rotate the dough a quarter turn. Smoosh with the heel of your hand and repeat.', 'As you knead, the dough should feel soft, pliable, and a little tacky. Dust with additional bread flour as needed, 1 tablespoon at a time, if it sticks to the counter or your hands.', 'To knead in a stand mixer: In a stand mixer fit with a dough hook attachment, knead the dough on the lowest speed for 5 to 7 minutes.', 'When finished kneading, the dough should be tacky but not sticky. Form the dough into a ball. It should be smooth on top, and feel elastic.', '6 Let the dough rise: Place the ball of dough into the buttered bowl. Use your fingers to gently spread a thin layer of softened butter on top of the dough ball.', 'Cover with plastic wrap or a clean dish towel and let it sit on the counter until it has just about doubled in size. This should take 45 to 60 minutes.', '7 Shape the loaves: Gently punch the dough down two or three times. Take the dough out of the bowl and form it into a ball. Divide the dough into equal halves.', 'Shape each half into a loaf: Gently flatten the dough with the tips of your fingers to form a puffy oval roughly the width of your baking pan. Starting from a short end, gently roll it up and pinch the seam closed. Roll it over so the seam-side is down and transfer to the prepared baking pan.', 'Repeat with the second loaf.', '8 Let the loaves rise: Cover with plastic wrap or a clean kitchen towel. Let rise for 45 to 60 minutes, or until the bread rises just above the lip of the pan.', 'The dough is ready for the oven once it has puffed up, but it maintains its structure. You should be able to press a fingertip gently onto the top of it, and the dimple should slowly fill back in.', '9 Halfway through this second rise, preheat your oven to 375-degrees. Melt additional butter for brushing over the tops of the loaves.', '10 Bake the loaves: Slash a shallow line down the center of the dough with serrated knife. Brush the tops with the melted butter. (The top layer of dough might bubble a little when you baste it with the warm butter. That\\xe2\\x80\\x99s ok. Just pop the bubbles with your knife.)', 'Place the loaves in the oven and bake for approximately 40 minutes until loaves are golden brown, have risen, and make a hollow sound when the bottoms are tapped.', '11 Cool the loaves: When the loaves have finished baking, remove from oven and baste the tops with butter one more time.', 'Turn the loaves out onto a wire rack and let cool. Do not let the bread cool in the loaf pans. If you do, the bread will get soggy.', '12 Store and enjoy! Once the bread has cooled, store it on the countertop in a plastic bag or a cloth bread bag.', 'The bread will stay fresh for 4 days, which isn\\xe2\\x80\\x99t to say it goes bad by day 5, just that it will start to dry out a bit. Rather than using the bread to make a fresh turkey sandwich on day 5 make grilled sandwiches or toast.']",25
266,Rosemary Focaccia Recipe,30,260,290,"['1 package (2 1/4 teaspoons) dry yeast', '1/3 cup warm water, about 100 degrees', '2 1/4 cups tepid water', '2 tablespoons good quality extra virgin olive oil, plus more for the pan and to paint on top of the bread', '3 cups bread flour', '4 1/2 cups all-purpose flour', '1 tablespoon salt, plus coarse salt (fleur de sel if you have it, otherwise Kosher salt) for sprinkling over the top', '2-3 tablespoons finely chopped fresh rosemary (can use sage or other herbs such as thyme or oregano, but whatever herb you use, do use fresh herbs, do not use dried)']",8,"['1 Proof the yeast: Stir the yeast into the 1/3 cup of slightly warm-to-the-touch water and let it rest for 10 minutes.', '2 Add olive oil to water, then add yeast: In a large bowl, pour in 2 1/4 cups of tepid water and 2 tablespoons olive oil. After the yeast has rested for 10 minutes and has begun to froth, pour it into the water-oil mixture.', ""3 Add flour and rosemary: Whisk in 2 cups of flour (either the bread flour or the all purpose, at this stage it doesn't matter which) and the tablespoon of salt. Add the rosemary."", ""Cup by cup, whisk in the rest of the flour (both the bread flour and all-purpose). As the mixture goes from a batter to a thick dough, you'll want to switch from a whisk to a wooden spoon."", '4 Knead the dough: By the time you get to adding the last cup of flour, you will be able to work the dough with your hands. Begin to knead it in the bowl \\xe2\\x80\\x93 try to incorporate all the flour stuck to the sides and bottom of the bowl as you begin kneading.', 'Once the bowl is pretty clean, turn the dough out onto a board and knead it well for 8 minutes. You might need some extra flour if the dough is sticky.', ""Note that a KitchenAid mixer (or some other brand of upright electric mixer) works well for the mixing and kneading of the bread dough. About the time you add the last cup of flour you'll want to switch from the standard mixer attachment to the dough hook attachment."", 'Just knead the dough using the dough hook on low speed for 8 minutes. If after a few minutes the dough is still a little sticky, add a little sprinkling of flour to it.', '5 First rise: In a large clean bowl, pour in about a tablespoon of oil and put the dough on top of it. Spread the oil all over the dough.', 'Cover the bowl with plastic wrap and set aside to rise (in a relatively warm spot or at room temp) for an hour and a half. It should just about double in size.', '6 Spread dough in baking pan: Spread a little olive oil in your baking pan or baking sheet (will make it easier to remove the bread). Place the dough in your baking pans or form it into free-form rounds on a baking sheet.', 'This recipe will make two nice-sized loaves or one big one and a little one. Cover the breads and set aside for another 30 minutes.', '7 Dimple the bread: Dimple the breads with your thumb. Push in to about the end of your thumbnail, roughly 1/2-inch.', '8 Second rise: Cover the dough again and leave it to rise for its final rise, about 2 hours.', '9 Preheat oven: With 30 minutes to go before the rise finishes, preheat your oven to 400\\xc2\\xb0F. If you have a pizza stone put it in.', '10 Brush with olive oil, sprinkle with salt: Once the dough has done its final rise, gently paint the top with olive oil \\xe2\\x80\\x94 as much as you want.', 'Then sprinkle the coarse salt on top from about a foot over the bread; this lets the salt spread out better on its way down and helps reduce clumps of salt.', '11 Bake: Put the bread in the oven. If you are doing free-form breads, put it right on the pizza stone. Bake at 400\\xc2\\xb0F for a total of 20-25 minutes.', 'If you have a water spritzer bottle, spritz a little water in the oven right before you put the bread in to create steam, and then a couple of times while the bread is baking.', ""12 Cool and serve: When the bread comes out of the oven, turn it out onto a rack within 3-5 minutes; this way you'll keep the bottom of the bread crispy. Let cool on a rack for 10 minutes before eating.""]",20
267,Cheesy Jalape\xc3\xb1o Pull Bread Recipe,15,30,45,"['1 rustic loaf of bread, unsliced, either Italian or French', '12 ounces shredded Monterey Jack cheese', '1/4 cup (less or more to taste) chopped pickled jalape\\xc3\\xb1os', '1/4 cup chopped green onions, including greens', '1/4 cup (4 Tbsp) butter, melted']",5,"['1 Slice bread in cross hatch pattern: Preheat the oven to 350\\xc2\\xb0F. Slice the bread almost all the way through (not all the way) in a cross hatch pattern, spacing an inch between the slices.', '2 Make cheese mixture: Place the shredded cheese in a large bowl. Toss with the green onions and jalape\\xc3\\xb1os. Pour over with melted butter and use your clean hands to toss, to distribute the butter evenly through the cheese.', '3 Stuff bread with cheese mixture: Place the bread on a large sheet of aluminum foil (large enough to wrap the bread) on a baking sheet. Stuff every crevasse with the cheese mixture.', 'Wrap with the aluminum foil. At this point you can make ahead and refrigerate until ready to bake.', '4 Bake: Bake in a 350\\xc2\\xb0F oven for 15 minutes. Then uncover the foil from the bread and cook for 10 minutes more, until all of the cheese has melted.', 'Place on a serving board or plate to serve.']",6
268,Irish Brown Bread Recipe,15,35,50,"['Vegetable oil spray (for the loaf pan)', '1 1/2 cups (350g) warm water (about 100\\xc2\\xb0F)', '2 tablespoons milk', '2 tablespoons molasses', '2 teaspoons active dry yeast (slightly less than one package)', '1/2 cup (25 grams) coarse wheat bran, plus more for sprinkling', '2 teaspoons salt', '2 tablespoons unsalted butter, softened', '3 1/2 cups (450g) stoneground whole wheat flour', '1 teaspoon vegetable oil']",10,"['1 Prepare the pan(s): Generously spray a 9-inch loaf pan (or two 8 by 3 3/4-inch loaf pans\\xe2\\x80\\x94disposable aluminum pans are the perfect size) with non-stick spray.', '2 Mix and knead the dough by hand: In a large bowl, stir the warm water, milk, molasses and yeast together and let stand until the mixture starts to bubble, about 5 minutes. Add the wheat bran, salt, butter and 2 cups of the flour.  Beat vigorously with a wooden spoon in the same direction for 1 minute.', 'Add enough of the remaining flour, 1/2 cup at a time, until the dough is difficult to stir with a wooden spoon and pulls away from the side of the bowl.', 'Using one hand to hold the bowl, use your other hand to knead the dough in the bowl for a minute or two. The dough will stick to your hands but should pull away from the side of the bowl after about a minute. If necessary, add more flour, 1 tablespoon at a time. While the dough will be damp, it should not feel muddy.', 'Alternatively, mix with a stand mixer on medium speed with the paddle attachment, beating for about 1 minute until the dough pulls away from the sides of the bowl.', '3 Shape the loaf: On a lightly floured work surface, pat the dough into an oval shape approximately 9 inches long with the long side of the oval parallel to the edge of the work surface. Starting with the long side closest to you, roll the dough into a tight cylinder. Pinch the seam closed.', ""Flip the loaf over, so it's seam-side down. Tuck the ends under so the loaf is uniform and even. Place the dough in the pan with the seam side down."", '(To make 2 small loaves, divide the dough in half and shape as above, making the oval 7 inches long.)', '4 Let the dough rise: Drizzle the vegetable oil on top of the dough and smooth it over the dough as you pat it into the corners of the pan. Sprinkle with extra bran, if you like. Cover the pan loosely with plastic wrap and let rise for 1 to 1 1/2 hours, or until the dough rises about 1 inch above the top of the pan,', '5 Heat the oven: About 20 minutes before the loaf is ready to be baked, position a rack in the lower third of the oven and preheat it to 400\\xc2\\xb0F.', '6 Bake the loaf: Place the loaf in the oven and immediately reduce the heat to 375\\xc2\\xb0F. Bake for 35 minutes for a large loaf, or 25 to 30 minutes for 2 small loaves, or until the loaf sounds hollow when tapped on the bottom.', '7 Harden the crust: Remove the bread from the oven and immediately turn it out of the pan. Place it directly on the oven rack and continue to bake for 7 to 10 minutes, or until the crust browns.', '8 Cool the loaf: Remove and set on a wire rack to cool. When thoroughly cool, store the loaves in plastic bags.', 'The bread is best eaten on the day it\\xe2\\x80\\x99s made, but after a day or two it is still good toasted for breakfast or tea. Well-wrapped in plastic and then foil, the bread may be stored in the freezer for up to a month.']",14
269,Lemon Rosemary Zucchini Bread Recipe,15,45,60,"['3 cups (390 grams) flour', '2 teaspoons baking soda', '1/2 teaspoon baking powder', '2 Tbsp minced fresh rosemary', '2 eggs', '1/2 cup melted unsalted butter', '1/4 cup olive oil', '1/2 teaspoons salt (omit if using salted butter)', '1 1/4 cup sugar', '1 Tbsp lemon zest', '3 cups grated zucchini (from about 1 pound of zucchini)']",11,"['1 Preheat oven to 350F. Prepare two 4x9-inch loaf pans, either coating with butter or spraying with baking spray.', '2 In a large bowl, whisk together the flour, baking soda, baking powder, salt, and rosemary.', '3 Beat the eggs in a mixer (or by hand) until frothy. Beat in the sugar. Beat in the melted butter and olive oil. Stir in the lemon zest and grated zucchini.', '4 Add the dry ingredients to the wet, a third at a time, stirring after each incorporation.', '5 Divide batter/dough into two loaf pans. Bake in a 350\\xc2\\xb0F oven for 45 to 50 minutes. Test after 40 minutes. If you gently press down on the surface of the loaf, it should bounce back, and a bamboo skewer inserted into the center should come out clean.', '6 Remove from the oven. Let cool for a few minutes and then remove the loaves from their pans to cool on a rack.']",6
270,Parker House Rolls Recipe,20,78,98,"['2 1/4 teaspoons (1 envelope) active dry yeast', '3 tablespoons lukewarm water', '1 1/2 cups (355 ml) whole milk', '3 tablespoons butter, cut into chunks', '3 tablespoons sugar', '2 teaspoons salt', '4 1/2 cups (630 g) flour, plus more if needed', '6 tablespoons melted unsalted butter, for brushing the rolls', 'Special equipment:', '2 1/2-inch plain round cutter', 'Pastry brush']",11,"['1 Dissolve the yeast: In a bowl large enough to hold all the dough, sprinkle the yeast over the water and let it dissolve, about 5 minutes.', '2 Warm the milk: In a saucepan over low heat, combine the milk, 3 tablespoons cut-up butter, sugar, and salt. Heat just until the butter melts and the milk feels warm to the touch of a fingertip. If the milk gets too hot, remove from the heat and let it cool to lukewarm.', '3 Mix the dough: Stir the yeast mixture with a wooden spoon to mix the dissolved yeast and water. Tip in the milk mixture, still stirring, until smooth. Add 2 cups of the flour and stir again until the mixture is almost smooth, with just a few lumps.', 'Continue stirring in flour, 1 cup at a time, until the mixture forms a dough. It will be very soft.', '4 Knead the dough: Turn the dough out onto a floured counter and knead for a few minutes until the dough is smooth, adding more flour as needed if the dough is very sticky.', '5 Let the dough rise: Clean and dry the bowl, then grease lightly with a little vegetable oil. Set the dough in the bowl and turn it all around so it is oiled all over.', 'Cover with a clean, damp kitchen towel or plastic wrap, and set in a warm place to rise for 1 hour, or until it is puffy (it doesn\\xe2\\x80\\x99t need to double in bulk).', '6 Preheat the oven to 425\\xc2\\xb0F. Line 2 baking sheets with parchment paper.', '7 Shape the rolls: Punch the dough down in the bowl, then transfer it to a lightly floured counter or pastry board. Knead until all the air is out.', 'Roll the dough to a 1/4-inch thickness. If it springs back as you try to roll it, let it rest for 5 minutes and then try again.', 'Use a 2 1/2-inch round biscuit or cookie cutter to stamp out rounds. Dip the cutter in flour often to avoid sticking, and stamp the rounds as close to each other as possible.', 'Press the back of a butter knife down the center of each round to form a crease; this is where you will fold the rolls in half. Dip the knife in flour if it starts to stick to the dough.', 'Brush the rounds with melted butter. Fold each round in half to make half-moon shapes and press the edges together lightly to seal them. Gather and reroll the scraps to make more rolls.', 'Transfer the rolls to the baking sheets, leaving 2-inches between rolls. Brush with more melted butter.', ""8 Bake the rolls: Transfer the baking sheets to the oven and bake for 15 to 18 minutes, rotating the sheets halfway through baking, until the rolls are puffed and golden. They're best served warm and fresh, but leftovers will keep for a few days in an airtight container at room temperature.""]",15
271,Tomato and Bread Soup (Pappa al Pomodoro) Recipe,15,60,75,"['2 cups diced yellow onion', '4 tablespoons extra virgin olive oil, divided 2 Tbsp and 2 Tbsp', '5 cloves garlic, minced', '2 28-ounce cans whole peeled tomatoes (or about 4 pounds of fresh, ripe tomatoes, that are blanched, peeled, and chopped*)', '3 bay leaves', '2 cups of chicken stock', '1 1/2 cups of cubed rustic bread, 1 1/2-inch cubes (about 2 to 3 thick slices of Italian loaf), day old is best', '1 teaspoon dried oregano', '1/2 teaspoon salt, less or more to taste', 'Freshly grated Parmesan cheese and chopped fresh basil or parsley for garnish', '*To prepare fresh tomatoes for this recipe, cut out the stem end, score the bottoms with a sharp knife. Put into boiling water and boil for 1 minute. Place in ice water to quickly cool. Peel back the tomato peels and discard. Chop the tomatoes, saving as much of the juice as you can. Add the chopped tomatoes and the juice in place of the canned tomatoes in step 2.']",11,"['1 Saut\\xc3\\xa9 onions, garlic: Heat 2 Tbsp olive oil on medium heat in a 5 to 6-quart thick-bottomed pot. Add the diced onions and cook slowly until softened and beginning to color, about 10-12 minutes.', 'Add minced garlic and cook a minute more.', '2 Add tomatoes, stock, bay leaves, oregano, then simmer: Add tomatoes to the pot with the onions, crushing them by hand as you put them in the pot. Discard any hard stem ends or stray tomato skins. Add chicken stock, bay leaves, and dried oregano.', 'Heat to a simmer and reduce heat to maintain a low simmer. Cook for 20 minutes.', 'As you are cooking the tomato soup base, prepare the bread croutons in the next step.', '3 Toast croutons on stovetop: Heat 2 Tbsp olive oil in a saut\\xc3\\xa9 pan on medium heat. Once the oil is hot, add the cubed bread to the pan. Toss to coat with the oil and spread the cubes out in a single layer.', 'Let sit in pan without moving until one side is golden browned, then use tongs to turn over to another side. Once at least two sides have browned, remove from heat.', '4 Add croutons to soup: Once the tomatoes have cooked for 20 minutes, add the lightly browned croutons to the soup. Cook for 5 minutes. Turn off the heat and cover the pan. Let sit for 10-15 minutes.', '5 Pur\\xc3\\xa9e: Remove the bay leaves. Use an immersion blender or upright blender to roughly pur\\xc3\\xa9e the soup (about half of the soup, leave some chunky bits).', 'Garnish with freshly grated Parmesan and chopped fresh basil or parsley.']",10
272,Guinness Bread with Molasses Recipe,5,50,55,"['3 cups self-rising flour*', '1/2 cup white sugar', '1/3 cup unsulfured molasses', 'A pinch of salt (roughly 1/8 teaspoon)', '12 ounces of Guinness extra stout', 'Butter for greasing the pan and painting the top, about 3 tablespoons', ""* If you don't have self-rising flour, you can substitute using a ratio of 1 cup all-purpose flour, 1 1/4 teaspoon baking powder, plus 1/8 teaspoon of salt, for every cup of self-rising flour. Have made both ways though and got better results from the self-rising flour.""]",7,"['1 Preheat oven and prepare loaf pan: Preheat oven to 350\\xc2\\xb0F. Grease a 9x5-inch loaf pan well with butter.', '2 Whisk together the flour, salt and sugar in a large bowl.', '3 Slowly add Guinness to the flour, add molasses: Slowly pour the Guinness into the flour mixture. (The \\xe2\\x80\\x9cpub cans\\xe2\\x80\\x9d are larger than 12 ounces, but they have better carbonation, so I pour most of it out and leave a swig to drink. This has never failed me, but if you are a stickler, use a 12-ounce bottle of Guinness instead.)', 'Start stirring the beer into the dry ingredients, and when you are about halfway done, add the molasses. Mix well, just to combine.', 'Don\\xe2\\x80\\x99t work the heck out of the batter \\xe2\\x80\\x93 because that\\xe2\\x80\\x99s what it\\xe2\\x80\\x99ll look like \\xe2\\x80\\x93 but you don\\xe2\\x80\\x99t want lumps, either.', '4 Bake: Pour into the loaf pan to no more than 2/3 full. Pop into the oven immediately and bake at 350\\xc2\\xb0F for 50 minutes. Since ovens can vary, check the bread after 40 minutes and see if a tester inserted into the deepest part of the loaf comes out clean. If it does, you\\xe2\\x80\\x99re done.', '5 Cool and paint with butter: Let the loaf cool a bit, maybe 5 minutes, and then turn it out onto a rack. Paint it with lots of soft butter, which will melt as you go.']",7
273,Fattoush Bread Salad Recipe,20,10,30,"['For the pita chips:', '2 rounds pita bread (8- to 12-inches)', 'Olive oil (for toasting the pita)', 'Salt and pepper, to taste', 'For the salad:', '4 Persian, pickling, or other small cucumbers, thinly sliced (or 1 English cucumber, trimmed, halved vertically, and thinly sliced)', '4 radishes, trimmed and thinly sliced', '2 large tomatoes, cored and cut into 1-inch pieces', '1/2 pint cherry tomatoes, halved', '1/4 red onion, very thinly sliced', '1/4 cup sliced scallions, white and light green parts', 'For the dressing:', 'Juice of 1 lemon, or more to taste', '4 tablespoons olive oil', 'Large handful fresh mint leaves, coarsely chopped', 'Large handful fresh parsley leaves, coarsely chopped']",16,"['1 Prepare pita chips: Set the oven to 375\\xc2\\xb0F. With kitchen shears, cut the pita round into 1-inch pieces. In a bowl, sprinkle the pita with just enough olive oil so a drop lands on each piece. Toss well. Sprinkle with salt and toss again.', ""2 Toast the pita chips: Spread the pieces out on a rimmed baking sheet. It's fine if the pieces overlap or cluster together. Bake for 2 minutes, then toss the chips. Bake another 2 minutes and toss again. Remove any pieces that are starting to look crisp and golden. Continue baking another 1 to 2 minutes until all the pieces are crisp and golden. Set aside to cool."", '3 Prepare the vegetables: In a large bowl combine the cucumbers, radishes, large and cherry tomatoes, scallions, and red onion.', '4 Dress the salad just before serving: Sprinkle the lemon juice, olive oil, salt, and pepper over the vegetables and toss gently but thoroughly. Add the mint and parsley and toss again. Taste for seasoning and add more salt and pepper, if you like. Add the pita chips and toss gently to avoid crushing them. Serve immediately.']",4
274,"Bread Soup (Panade) with Onions, Chard, and Mushrooms Recipe",15,90,105,"['12-14 ounces day-old rustic bread, cut into 1-inch cubes', '3 tablespoons extra virgin olive oil', 'Salt', '1 tablespoon butter', '2 cups thinly sliced onions (sliced vertically, from tip to root)', '1 tablespoon minced garlic', '6 to 8 ounces cremini or button mushrooms, sliced 1/4-inch thick', '10 to 12 ounces fresh chard, rinsed', '1/2 teaspoon freshly ground black pepper', '1 1/2 teaspoons minced fresh thyme (or 1/2 teaspoon dried thyme)', '1/2 cup hearty red wine', '1 tablespoon honey', '2 quarts stock (chicken, beef, or vegetable, use vegetable stock for vegetarian option)', '1 cup grated Parmesan cheese']",14,"['1 Brown the cubed bread in the oven: Pre-heat oven to 350\\xc2\\xb0F. Toss the cubed bread with a tablespoon of olive oil, sprinkle with a little salt. Arrange bread on a baking sheet and toast for 20-30 minutes (check timing!) or until nicely browned.', '2 Gently cook the sliced onions, add the garlic: While the cubed bread is in the oven, prepare the onions. Heat 2 tablespoons olive oil and the butter on medium heat in a 5 to 7 quart Dutch oven. Add the onions and stir to coat with the butter and oil. Cook gently, stirring occasionally for 10 to 15 minutes.', 'If the onions begin to dry out at all, lower the heat. They should begin to caramelize and lightly brown.', 'Add the garlic, cook for a minute more, remove from heat.', '3 Dry saut\\xc3\\xa9 the mushrooms: While the onions are browning, heat a large saut\\xc3\\xa9 pan on medium high heat. Add the sliced mushrooms. ""Dry"" saut\\xc3\\xa9 them (saut\\xc3\\xa9 without any added fat) until they release their moisture and are lightly browned.', '4 Prep the chard: Cut away the tough central stems of the the chard leaves. Cut across the leaves into 1-inch wide strips.', '5 Layer Dutch oven with onions, chard, mushrooms, bread, spices: Remove half of the browned onions from the Dutch oven and set aside. Spread the remaining onions evenly over the bottom of the pot.', 'Layer over with half of the chard and half of the browned mushrooms. Sprinkle with pepper, half a teaspoon of salt, and thyme.', 'Put down a layer of toasted bread cubes. Add the remaining onions, chard, and mushrooms. Layer on top the remaining bread cubes.', '6 Add honey wine mixture: Mix together the honey and wine, until the honey is dissolved. Pour over the bread mixture. Pour the broth over everything.', '7 Scatter the top evenly with the grated cheese.', '8 Bake in oven: Cover the pot with foil (not the lid) and seal it around the edges. Cut 4 or 5 vent holes in the top. Put it in a 350\\xc2\\xb0F (175\\xc2\\xb0C) oven. Bake for 1 hour 15 minutes. Serve immediately, digging into the layers to get a bit of everything for each portion, or let cool and refrigerate, covered.', 'To reheat, gently simmer a portion until hot. Plate and garnish with additional cheese and thyme.']",13
275,Peach Melba French Toast Casserole Recipe,30,50,80,"['1 large loaf brioche, challah, or crusty bread (about 21 ounces)', '2 tablespoons butter, softened', '8 ounces fresh or frozen peaches, peeled and sliced 1/2 inch thick', '6 ounces fresh or frozen raspberries', '8 large eggs', '2 1/3 cups heavy whipping cream', '3/4 cup sugar', '3/4 teaspoon salt', '1 tablespoon vanilla extract', 'For the topping:', '2 tablespoons sugar', '1/2 cup sliced almonds (optional)', 'For the raspberry sauce:', '10 ounces fresh or frozen raspberries', '1/4 cup sugar', '1 teaspoon vanilla extract', '1/8 teaspoon salt']",17,"['1 Heat the oven to 350\\xc2\\xb0F.', '2 Prepare the baking dish: Generously spread 2 tablespoons of butter on the bottom and sides of a 9x13 baking dish.', '3 Prepare the bread and fruit: Cut or tear the bread into 2x2-inch pieces. Place an even layer of bread on the bottom of the prepared baking dish. Dot the top of the bread with 2/3 of the raspberries, and layer all of the peach slices around the raspberries. Top with another layer of bread pieces. Tuck the remaining berries into cracks and crevices on the top of the dish.', '4 Make the custard: In a large bowl, aggressively whisk together the eggs so they are one homogeneous color (about 30 seconds). Add the heavy cream, sugar, extract, and salt. Whisk aggressively together for about a minute.', 'Pour the custard over the bread and fruit mixture. Gently smoosh the bread down into the custard so everything is moistened.', '5 Finish the casserole prep: Sprinkle the top evenly with 2 tablespoons sugar and sliced almonds.', 'At this point, the casserole can be baked right away, or covered and refrigerated overnight and baked in the morning. Preheat the oven to 350\\xc2\\xb0F when ready to bake.', '6 Bake: Bake the casserole for 50 minutes. The bread will puff up and the top should be golden with toasty bits.', '7 While the casserole is baking, make the raspberry sauce: Set a fine mesh strainer over a bowl and set aside.', 'Set a small sauce pan over medium heat. Add frozen raspberries, sugar, vanilla, and salt. Stir occasionally while mashing the berries down with the back of a spatula, allowing the berries to release their juices while gently simmering. You don\\xe2\\x80\\x99t want this to boil or aggressively simmer, because it would reduce the sauce too much. This should only take about 5-7 minutes.', 'Once the berries have released their juices, pour the sauce through the fine mesh sieve, pressing down to release as much of the sauce as you can. Discard the solids.', '8 Serve: Remove the French toast casserole from the oven and let rest for 10 minutes. Cut into pieces, and transfer to a plate. Drizzle each piece with raspberry sauce.']",12
276,Slow Cooker Banana Bread Pudding Recipe,40,240,280,"['For the bread pudding:', '16-ounce French brioche loaf, cut into 3/4-inch cubes  (12 cups)', '1 tablespoon unsalted butter (softened)', '8 large eggs', '4 cups half-and-half', '1/2 cup (100g) granulated sugar', '1/2 cup (100g) dark brown sugar, packed', '1 tablespoon pure vanilla extract (bourbon vanilla recommended)', '1 1/2 teaspoons ground cinnamon', '1/4 teaspoon ground nutmeg', '1/4 teaspoon kosher salt', '3 medium ripe bananas, mashed', 'For the caramel sauce (Makes about 1 cup)', '1 cup (200 g) sugar', '1/4 cup water', '1/4 cup heavy cream', '4 tablespoons unsalted butter', '1/4 teaspoon cinnamon', '1/8 teaspoon salt', 'Special equipment:', 'Candy thermometer', '6-Quart Slow Cooker']",22,"['1 Get ready: Set the oven rack to the center position and preheat the oven to 300\\xc2\\xbaF for toasting the bread. Grease the inside of a 6-quart slow cooker with the softened butter.', '2 Toast the bread: Spread the bread cubes in a single layer on a large sheet pan or two smaller pans. Bake for 20 minutes, stirring halfway through toasting. The bread should be lightly golden, dry, and crisp. Remove the bread cubes from the oven and let them cool for 10 minutes.', 'Once cool, transfer toasted bread to the slow cooker and arrange in an even layer.', '3 Make the custard: In a medium bowl, whisk the eggs. Add the half-and-half, granulated sugar, brown sugar, vanilla extract, cinnamon, nutmeg, salt, and mashed bananas to the bowl with the eggs, and whisk to combine.', '4 Add the custard to the bread cubes: Pour the custard mixture over bread. Press the bread into the liquid to submerge. Cover and transfer to the refrigerator for at least 60 minutes, or up to 24 hours.', '5 Bring the casserole to room temperature: Remove the casserole from the refrigerator and let it sit at room temperature for 30 minutes.', '6 Cook casserole: Place the slow cooker insert into the slow cooker base, cover it with a lid, and cook it on the high setting for 2 1/2 to 3 1/2 hours, or on the low setting for 4 to 5 hours.', 'The casserole is ready when the custard is set in the center and puffy; it should not be runny or jiggle. It will shrink slightly once the heat is turned off. The center of the casserole should be above 175\\xc2\\xbaF when tested with a thermometer.', '7 Make the caramel sauce: In a medium high-sided saucepan add the sugar and water. Set the pan over medium-low heat and let the sugar dissolve without stirring. This should take about 3 to 5 minutes.', 'When it\\xe2\\x80\\x99s ready, the granules will be dissolved, and it will look just like gently bubbling clear water. (If you see sugar granules on the sides of the pan. Dip a pastry brush into a cup of tap water, and \\xe2\\x80\\x9cpaint\\xe2\\x80\\x9d the inside of the pan with the wet brush to wash away any undissolved sugar.)', 'Once the sugar has dissolved completely, increase the heat to high and bring sugar to a low boil. Stir with a whisk until a deep amber color is formed and the temperature reads between 320\\xc2\\xbaF to 340\\xc2\\xbaF on a candy thermometer. This should take about 5 to 7 minutes. If your sugar boils rapidly, reduce the heat to medium high.', 'Remove the caramel from the heat.', 'Slowly and carefully whisk in 1/3 of the heavy cream in a thin stream. The caramel will bubble as the cream is added; allow it to subside before adding the rest of the cream. Whisk in the butter, cinnamon, and salt until smooth.', 'Let the sauce cool at room temperature for about 10 minutes before using, it will thicken as it cools, but still be pourable. (You can store the sauce in an airtight container for up to one week in the refrigerator.)', '8 To serve: Allow the casserole to rest for at least 15 minutes before serving. Serve warm with a scoop of vanilla ice cream, caramel sauce, and a sprinkle of cinnamon.']",15
277,How to Make Eggs Benedict Recipe,5,20,25,"['8 pieces of bacon or 4 pieces of Canadian bacon', '2 tablespoons chopped parsley, for garnish', '4 eggs', '2 teaspoons white or rice vinegar', '2 English muffins', 'Butter', 'Blender Hollandaise', '10 tablespoons unsalted butter (if using salted butter, omit the added salt)', '3 egg yolks', '1 tablespoon lemon juice', '1/2 teaspoon salt', 'Dash of cayenne or tabasco']",12,"[""Turn off the heat, cover the pan, and let sit for 4 minutes. (Remember which egg went in first, you'll want to take it out first.) When it comes time to remove the eggs, gently lift out with a slotted spoon."", 'Note that the timing is a little variable on the eggs, depending on the size of your pan, how much water, how many eggs, and how runny you like them. You might have to experiment a little with your set-up to figure out what you need to do to get the eggs exactly the way you like them.', '5 Toast English muffins: As soon as all the eggs are in the poaching water, begin toasting your English muffins. If you can\\xe2\\x80\\x99t get all the muffins toasted by the time the eggs are ready, gently remove the eggs from the poaching water and set in a bowl.', '6 Assemble your Eggs Benedict: To assemble, butter one side of an English muffin. Top with two slices of bacon or 1 slice of Canadian bacon. You can trim the bacon to fit the muffin if you\\xe2\\x80\\x99d like.', 'Put a poached egg on top of the bacon, then pour some hollandaise over. Sprinkle some parsley over it all and serve at once.']",5
278,Easy Poached Eggs,5,4,9,['1 or more fresh eggs'],1,"['Remove from the pot with a slotted spoon.', 'USING AN EGG POACHER', ""If you don\\'t want to futz around with trying to keep the eggs from spreading or bumping into each other, the easiest way to make poached eggs is with an egg poacher."", 'The ""poacher"" is actually coddling the eggs, not truly poaching them, but if what you want is an egg with a cooked white and runny yolk, this is an easy way to do it.', 'To use an egg poaching pan, remove the cups from the pan that you intend to use.', 'Fill the pan with only 1/2-inch of water and bring it to a low boil. Put a drop or so of olive oil in each of the egg cups you are using and spread around. (The cups are stick-free, but the oil helps.)', 'Crack the eggs into the egg cups, one egg per cup. Place the egg filled cup back in the slot for it in the pan.', 'Cover the pan and cook for 4 minutes.', 'Remove from heat and carefully lift the egg cups out of the pan. Slide the cooked eggs out of the cups onto serving plates or bowls.']",9
279,Sausage Breakfast Casserole Recipe,25,60,85,"['1 pound Italian pork sausage', '10 large eggs, beaten', '4 cups whole milk', '1 teaspoon dry mustard', '1/4 teaspoon onion powder', '1 teaspoon kosher salt', 'Fresh ground pepper to taste', '5 cups cubed day old bread (we recommend rustic French or Italian loaf), cut into 3/4-inch to 1 inch-wide cubes', '2 cups shredded sharp cheddar cheese', '1/2 cup sliced mushrooms (optional)', '1/2 cup peeled, cored, chopped tomatoes (optional)']",11,"['1 Brown the sausage: Heat a skillet on medium. Break up the sausage into chunks and cook, working in batches if need be, until cooked on all sides. As you cook the sausage, you can break up the larger chunks into smaller crumbles (which are easier to distribute evenly over the casserole).', 'When lightly browned, remove from pan to a paper towel lined plate to absorb any excess fat.', '2 In a large bowl whisk together the eggs, milk, dry mustard, onion powder, salt and pepper.', '3 Assemble the casserole: Place the cubed bread in a well-buttered 9x13 inch baking pan. Sprinkle with cheese. Sprinkle with chopped tomatoes and mushrooms, if using. Top with the browned crumbled sausage, distributing it evenly. Pour the egg milk mixture evenly over the bread and cheese.', '4 Cover and chill, if making ahead: At this point, the casserole can be covered and chilled in the fridge until ready to bake and serve, up to overnight.', 'If baking immediately, let the casserole sit for 10 minutes before putting in the oven (to give the bread a chance to absorb the milk-egg mixture.', '5 Bake the casserole: When ready to cook, preheat the oven to 325\\xc2\\xb0F. Bake uncovered for about one hour. Tent with foil if the top begins to brown too quickly.', '6 Serve: Let the casserole cool for about 10 minutes before serving. Leftovers will keep in the refrigerator for about a week.']",8
280,Easy Breakfast Casserole Recipe,15,50,65,"['For the breakfast casserole base:', '6 to 10 large eggs', '2 to 3 cups grated cheddar cheese', '6 slices day-old bread, cut into 3/4-inch to 1-inch-wide cubes', '2 cups milk', 'Salt', 'Pepper', 'For the possible additions: ', '1 cup corn (cooked or frozen)', '1/2 cup chopped broccoli (cooked or raw, raw will turn out crunchier)', '1/2 cup sliced mushrooms', '1/4 cup sliced green onions', '1 cup cubed ham and/or cooked Italian sausage', 'A few slices cooked bacon, chopped', '1 teaspoon Herbes de Provence, or other dried herbs, (or 1 tablespoon of fresh chopped herbs such as basil, rosemary, or thyme)', '1/4 to 1/2 teaspoon of cumin or curry powder', 'Special equipment:', '9x13 inch casserole dish']",18,"['1 Beat eggs, add milk and cheese: Preheat oven to 350\\xc2\\xb0F. Beat the eggs in a large bowl. Mix in the milk and cheese.', ""2 Add the bread and carefully stir until all pieces of bread are moistened (don't over mix or the bread may disintegrate)."", ""3 Add the additions: Add salt and pepper to taste (if using Italian sausage, you won't need either.) If you have a lot of additions, you might need a couple more eggs to make sure that everything is at least touching some egg mixture. Just whisk in 2 tablespoons of milk for every beaten egg you add."", '4 Bake: Butter a 9x13-inch casserole dish. Pour the mixture into the casserole dish.', 'Bake in a 350\\xc2\\xb0F oven for 50 minutes to an hour, until the top is browned and the center springs back when touched.', 'Remove from oven and let cool for 10 minutes before serving.']",6
281,Huevos Rancheros Recipe,0,20,20,"['1 tablespoon extra virgin olive oil', '1/2 medium onion, chopped (about a half cup)', '1 15-ounce can whole or crushed tomatoes, preferably fire-roasted, (or 1 -2 large fresh vine-ripened tomatoes, when in season)', '1/2 6-ounce can diced green Anaheim chiles', 'Chipotle chili powder, adobo sauce, or ground cumin to taste (optional)', '4 corn tortillas', 'Butter', '4 fresh eggs', '2 tablespoons fresh cilantro, chopped (optional)']",9,"['1 Make the sauce: Saut\\xc3\\xa9 the onions in a little olive oil in a large skillet on medium heat. Once the onions are translucent, add the tomatoes and their juices. If using whole canned tomatoes, break them up with your fingers or a spatula as you put them in the pan.', 'If you are using fresh tomatoes, chop them first, then add. Note that fresh tomatoes will take longer to cook as canned tomatoes are already cooked to begin with.', 'Add chopped green chilies. Add additional chili to taste, either chipotle chili powder, adobo sauce, regular chili powder, or even ground cumin.', 'Bring to a simmer, reduce heat to low, and let simmer while you do the rest of the cooking, stirring occasionally. Reduce to warm after it has been simmering for 10 minutes. Add salt to taste if needed.', '2 Warm the plates: Heat the oven to a warm 150\\xc2\\xb0F, place serving plates in the oven to keep warm.', '3 Prepare the tortillas: Heat a teaspoon of olive oil in a large non-stick skillet on medium high, coating the pan with the oil.', 'One by one (or more if your pan is big enough) heat the tortillas in the pan, a minute or two on each side, until they are heated through, softened, and pockets of air bubble up inside of them.', 'Then remove them and stack them on one of the warming plates in the oven to keep warm while you continue cooking the rest of the tortillas and the eggs.', '4 Fry the eggs: Using the same skillet as was used for the tortillas, add a little butter to the pan, about two teaspoons for 4 eggs. Heat the pan on medium high heat. Crack 4 eggs into the skillet and cook for 3 to 4 minutes for runny yolks, more for firmer eggs.', '5 Assemble and serve: To serve, spoon a little of the sauce onto a warmed plate. Top with a tortilla, then a fried egg. Top with more sauce, sprinkle with cilantro if desired.', ""Serve either one or two eggs/tortillas per plate, depending on how much you want to eat. I'm a 2-egg 2 tortilla person myself.""]",11
282,Chorizo and Eggs Recipe,10,10,20,"['Extra virgin olive oil or bacon fat', '1/3 cup chopped onions (green, red, or yellow onions) optional', '1/4 pound of Mexican chorizo sausage, removed from sausage casing', '3 tablespoons raisins - soaked in hot water for 10 minutes and drained', '5 to 6 eggs', 'Salt', 'Tortillas - optional', 'Cilantro - optional', '', ""Chorizo sausage from Whole Foods. Whole Foods has a standard recipe and spices for making chorizo sausage and may make some up for you upon request if you don't see it displayed.""]",10,"['1 Cook the onions: Heat a large skillet on medium high heat. Heat a tablespoon of olive oil or bacon fat in the pan. Add the chopped onions (optional) and cook until softened.', '2 Add the chorizo and raisins: Once softened, move the onions to the side of the pan and add clumps of chorizo into the pan. Use a wooden spatula to break up the pieces of sausage. Add the raisins.', 'Stir until the sausage is cooked through, though not necessarily browned. If you are not using lean chorizo, drain the excess fat from the pan before proceeding.', ""If you are not using lean chorizo, you may want to cook the chorizo first, draining the excess fat, then remove to a plate while you cook the onions in the remaining fat. We usually cook with lean chorizo, so excess fat isn't an issue."", '3 Add the eggs: Crack the eggs one at a time, into the pan. Break the yolks and stir the eggs into the sausage. Add a light sprinkling of salt.', 'Stir constantly until the eggs begin to set, but are still moist. Remove from heat.', 'Serve immediately with a side of warmed corn tortillas and cilantro as a garnish.']",7
283,Cloud Eggs (Egg Nests) Recipe,10,10,20,"['2 eggs', '2 small pinches of salt (a pinch of salt per egg)', '1/4 cup grated cheese such as Gruyere, Swiss, or Parmesan']",3,"['1 Preheat oven and prep baking sheet: Preheat the oven to 450\\xc2\\xb0F (230\\xc2\\xb0C) with a rack in the middle. Line a roasting pan, or baking sheet that can take high temperatures without warping, with parchment paper or Silpat.', '2 Separate the eggs: Separate the egg yolks from the whites. Make sure there are no little pieces of egg yolk in the whites or you will have difficulty getting the whites to beat properly. It helps if you are making more than one egg nest to keep each egg yolk in a separate prep bowl.', '3 Beat eggs to stiff peaks: Place the egg whites in a very clean mixer bowl (any residual oil in the mixer bowl will keep the egg whites from whipping up properly).', 'Add a small pinch of salt to the egg whites. Beat the egg whites with a whisk attachment in a mixer (or using a hand mixer), starting on low speed and then slowly increasing to high speed, until stiff peaks form.', '4 Gently fold in the grated cheese, taking care not to deflate the egg whites.', '5 Create two mounds of the egg white mixture on the lined baking sheet. Form the mounds so they look like nests, with indentations in the centers.', '6 Bake: Place in the 450\\xc2\\xb0F (230\\xc2\\xb0C) oven for 3 minutes. After 3 minutes, open the oven, pull out the rack with the egg white nests, and gently add an egg yolk to the center of each nest. Return the baking sheet to the oven and cook for 3 more minutes.', '', 'Serve immediately.']",9
284,Tomatillo Scrambled Eggs Recipe,8,12,20,"['1 Tbsp extra virgin olive oil', '1/2 pound tomatillos, papery husks removed and discarded, rinsed, roughly chopped', '1/2 cup chopped onion', '1 garlic clove, minced', '1 fresh or canned jalape\\xc3\\xb1o chile pepper, minced (more or less depending on how hot the pepper is, and how much heat you want)', 'Splash of lemon or lime juice (optional)', '5 to 6 eggs', 'Salt and pepper', 'Some chopped fresh cilantro for garnish']",9,"['1 Cook chopped tomatillos, onion, garlic, jalape\\xc3\\xb1o in skillet: Heat a tablespoon of oil in a medium-sized skillet on medium heat. Add the chopped tomatillos, onion, garlic, jalape\\xc3\\xb1o chile pepper, and if you want, a small squeeze of lemon or lime juice. Sprinkle with a little salt.', 'Cook on medium to medium heat for about 5 minutes, stirring occasionally, until the onions have softened, and the tomatillos are no longer bright green.', '2 Add eggs to pan, gently stir: Add the eggs directly to the pan (no need to whisk first). Break up the yolks with your stirring spoon. Cook gently, stirring and scraping the bottom of the pan with a wooden spoon. Salt and pepper to taste.', '3 Remove from heat: Remove from heat when the eggs begin to set, but are still moist, about 3 minutes.', 'Serve immediately. Add salt and pepper to taste. Sprinkle with chopped fresh cilantro for garnish.']",5
285,German Farmer\xe2\x80\x99s Breakfast Recipe,5,25,30,"['3 large potatoes, skinned and quartered lengthwise', '3 tablespoons bacon fat or extra virgin olive oil', '2 cups roughly chopped green and white onions (include the greens from the green onions)', '2 cups roughly chopped bell peppers', 'Salt to taste', '1-2 cups chopped ham', '1/4 cup chopped parsley', '4 eggs, whisked']",8,"['1 Boil the potatoes in a saucepan of lightly salted water for 10-15 minutes until just cooked (test for doneness). Drain, rinse with cold water to cool. Cut into 1-inch squares. Set aside.', '2 Brown the onions and bell peppers: Heat 2 Tbsp bacon fat (or olive oil) in a large skillet on medium high heat. Add the onions and chopped bell peppers. Increase the heat to high. Brown the onions and bell peppers, stirring frequently, about 2-3 minutes.', '3 Add the potatoes and then the ham: Push the vegetables to the side of the pan, add the potatoes and another Tbsp of bacon fat (or olive oil) to the pan.', 'Brown the potatoes for about 2 minutes, stirring frequently. Sprinkle on salt to taste as you cook.', 'Add the ham to the potatoes and cook, stirring frequently until the ham is heated through, 1-2 minutes.', '4 Add parsley, eggs: Mix all of the vegetables, potato and ham together and mix in the parsley. Add the eggs, stirring to distribute the eggs among the vegetables and ham.', 'As soon as eggs begin to firm up, remove from heat.', 'Serve immediately. Great with ketchup on top.']",8
286,Huevos a la Mexicana Recipe,5,15,20,"['6 fresh eggs', '2 green onions, chopped all the way including the green parts', '1 fresh tomato, peeled and chopped if in season, (2 tomatoes from a can if good fresh tomatoes are not available)', 'One canned jalape\\xc3\\xb1o pepper, sliced', '2 Tbsp olive oil', 'Oregano, a sprinkling of fresh if available, dry if not', 'Salt, one shake from a salt shaker for every egg used', 'Cilantro leaves, fresh and chopped, a couple of Tbsp']",8,"['1 Saut\\xc3\\xa9 onions, add tomatoes, oregano, jalape\\xc3\\xb1o: Heat olive oil in a large frying pan on medium high heat. Add the onions and brown them for a minute or two.', ""Add the chopped tomatoes and let them cook for a few minutes on medium high until they are somewhat cooked and mushy and some of the moisture has evaporated. It's okay if the tomatoes brown a bit."", 'Add the oregano. Add the jalape\\xc3\\xb1o.', '2 Add eggs and scramble them into the sauce: Crack the eggs directly into the pan with the sauce. Add salt. Stir the mixture with a spatula to mix in the sauce and to lightly scramble the eggs.', 'Remove from heat when the eggs are cooked to the desired consistency.', 'If you are using a cast iron pan, remove the eggs from the pan and put into a serving bowl. Otherwise the eggs will continue to cook in the heat of the pan.', '3 Serve: Sprinkle the eggs with chopped fresh cilantro. Serve with bread or heated tortillas. Serves 2 or 3, depending on how many eggs per person you want.']",7
287,Crunchy French Toast Recipe,20,20,40,"['2 or 3 slices of bread, cut into quarters', '1 cup cornflake cereal', '2 large eggs', '1/3 cup milk', '1/2 teaspoon all-purpose flour', '2 drops of vanilla', 'Butter and pancake syrup']",7,"['1 Preheat oven, prepare baking sheet: Preheat oven to 400\\xc2\\xb0F. Line a baking sheet with parchment paper or a silicone mat.', '2 Lightly toast bread in oven: Put the bread pieces on a lined baking sheet into the warming oven (it does not need to be at full temperature) to toast lightly for 5 minutes. Cool the bread completely.', '3 Crush the Corn Flakes: Seal the Corn Flakes in a heavy plastic bag. Crush them with a rolling pin to the size of rolled oats. Pour into a pie pan or a shallow dish. Set aside.', '4 Soak bread slices in egg mixture: In a large bowl, whisk to mix the eggs, milk, flour and vanilla until blended. Be sure there are no lumps of unmixed flour. Pour into a pie pan or shallow dish. In batches, lay the bread pieces in the egg mix. Soak about 1 minute on each side in the egg mixture. Be careful not to rip the bread.', '5 Coat with crushed Cornflake crumbs: Place the bread pieces in the cornflake crumbs. Coat both sides with the crumbs. Place on the lined baking sheet.', '6 Bake: Bake at 400\\xc2\\xb0F for 10 minutes on one side. Then flip over with tongs or a spatula and bake another 5 to 10 minutes, until the crumbs begin to turn brown.', 'Eat warm with butter and pancake syrup.']",7
288,Ham and Potato Hash Recipe,10,40,50,"['3 tablespoons butter', '1 small onion, finely chopped', '1/2 green bell pepper, finely chopped', '2 medium potatoes, peeled', '1 cup finely diced cooked ham', '1/4 teaspoon salt, or to taste', '1/8 teaspoon ground black pepper', '1/4 teaspoon dried crumbled thyme']",8,"['1 Partially cook the potatoes, then dice: Cut the potatoes in half, cook in a saucepan of simmering water until not quite done and still firm, about 10 minutes. Rinse in cold water to stop cooking. Drain. Dice to 1/2-inch thick pieces. Set aside.', '2 Cook the onion and bell pepper in butter: Melt butter in a large cast-iron* skillet over medium low to medium heat. Add onion, cook until softened, about 4 minutes. Add the chopped bell pepper, cook another 2 minutes.', '3 Add the potatoes, ham, salt, pepper, and thyme: Add remaining ingredients; mix well. Cook hash until well browned, about 10 minutes, stirring occasionally.', '*The hash will brown better in a cast iron pan than in a stick-free pan. ']",4
289,Lemon Ricotta Pancakes Recipe,10,20,30,"['4 large eggs', '1/3 cup plus 1 tablespoon sugar, divided', '1 cup all-purpose flour', '1 teaspoon baking powder', '1/2 teaspoon salt, plus 1 pinch for beating the egg whites', '1 cup whole milk ricotta', '3 tablespoons lemon juice', '2 teaspoons finely grated lemon zest', '1/2 cup whole or 2% milk', 'Butter or vegetable oil, for the griddle', 'Fresh berries, to serve', 'Maple syrup, to serve']",12,"['1 Separate the eggs: Carefully separate the eggs, placing the yolks and the eggs in separate bowls.', '2 Beat the egg whites: In a squeaky clean mixer bowl, beat the egg whites with a pinch of salt at high speed until very frothy. With the mixer still on high, slowly add 1 tablespoon of sugar. Continue beating until stiff peaks form, about 5 minutes. Set aside.', '3 Mix the dry ingredients: In a bowl, whisk the flour, baking powder and 1/2 teaspoon of the salt until blended. Set aside.', '4 Make the ricotta mixture: In a large bowl, whisk the egg yolks and the remaining 1/3 cup of sugar together. Add the ricotta, lemon zest, and lemon juice and whisk until smooth. Stir in the milk until blended.', '5 Make the batter: Add the flour mixture to the egg yolk mixture and stir with a spatula just until combined. Fold in one-third of the beaten egg whites to lighten the batter. Add the remaining egg whites and gently fold until only a few streaks of white remain.', '6 Cook the pancakes: Set a griddle, cast iron pan, or non-stick skillet over medium-low heat and brush with oil. When the pan is hot enough that a flick of water sizzles on contact, use a 1/2-cup measure to scoop the batter and drop onto the pan. With the back of a spoon, spread the batter of each pancake into a 4- to 5-inch round.', 'Keep the temperature of the pan at medium to medium-low. Cook each pancake for 2 to 3 minutes, or until bubbles form on top. Flip and cook for 1 to 2 minutes longer, until the pancakes are cooked through.', 'Serve each batch immediately or transfer the pancakes to a sheet pan in a warm oven to keep warm until ready to serve.', '7  Serve: Serve warm with butter, maple syrup and fresh berries.']",9
290,Biscuits and Gravy Casserole Recipe,25,35,60,"['For the biscuits:', '2 1/4 cups (315 g) all-purpose flour (see Recipe Note)', '3 tablespoons cornstarch', '1 tablespoon baking powder', '3/4 teaspoon kosher salt', '1/2 cup unsalted butter, cold', '1 cup buttermilk, cold', 'For the gravy:', '1 tablespoon olive oil', '1/2 pound sliced mushrooms', '1/4 cup chopped yellow onions', '1 pound breakfast pork sausage', '6 tablespoons all-purpose flour', '1/2 teaspoon ground sage', '1/2 teaspoon freshly ground black pepper', '1/8 teaspoon ground nutmeg', '3/4 teaspoon kosher salt', '2 1/2 cups milk, preferably whole', 'For topping:', '1 tablespoon unsalted butter, melted', 'Special equipment:', '2-quart glass or ceramic baking dish, rectangular or square', '2 1/2-inch biscuit cutter']",23,"['1 Preheat the oven to 400\\xc2\\xb0F.', '2 Make the biscuit dough: Combine the flour, cornstarch, baking powder, and salt in a large bowl. Cut the butter into 1/2-inch chunks and sprinkle it over the dry ingredients. Using a pastry blender, a butter knife, or a fork, cut the butter into the dry ingredients until most of it is the size of peas. Don\\xe2\\x80\\x99t overwork it; you want to leave some of the butter in chunks.', 'Add the buttermilk and toss the mixture with a spatula until it starts to look shaggy, and most of the buttermilk has been absorbed. It won\\xe2\\x80\\x99t form a dough yet; that\\xe2\\x80\\x99s OK.', '3 Bring the dough together: Turn out the contents of the bowl onto a clean surface dusted with a little flour. Gather the dough together with your hands into a mound, then roll it out until it is about 10-inches wide. Again, don\\xe2\\x80\\x99t worry if the dough is crumbly!', '4 Fold the dough to create flaky layers: Use a spatula (like the kind you use to make fried eggs) or bench scraper and flip 1/3 of the dough over from the left to the center. Then flip the other side over that side. You\\xe2\\x80\\x99re basically folding the dough over like a letter.', 'Rotate the dough 90-degrees and roll it out again to about a 10-inch square. It will start to feel more like a dough and less crumbly at this point, but there will still be some loose chunks. Just press them back into the dough if they fall out, and resist the urge to add more liquid.', 'Repeat the process of rolling out and folding two more times. By the fourth time, the biscuit dough will hold together and feel like actual dough.', '5 Cut the biscuits: Roll out the dough to a 10-inch square that\\xe2\\x80\\x99s roughly 1/2 inch thick. Using a 2 1/2-inch biscuit cutter, cut out 16 circles. When you press down to cut out the dough, don\\xe2\\x80\\x99t twist the biscuit cutter, which will \\xe2\\x80\\x9cseal\\xe2\\x80\\x9d the edges of the dough. Instead, just cut straight down, so the biscuit will rise and be as flaky as possible.', '5 Bake the bottom layer of biscuits: Set aside 12 of the biscuit rounds. Place the remaining 4 biscuit rounds on the bottom of a 2-quart glass or ceramic casserole dish. Cut up the remaining scraps of dough and jigsaw-puzzle the remaining dough into the bottom of the casserole dish, making sure to cover the bottom in a single layer.', 'Place on a rimmed baking sheet (for ease of removal from the oven and to catch any drips). Bake in the oven for 15 minutes or until the top of the biscuits start to look dry but not brown at all. (There might be a slight darkening around the edges, but don\\xe2\\x80\\x99t be alarmed if the biscuits still look pale white.)', '6 Meanwhile, make the gravy: While the bottom biscuits are baking, make the gravy by placing the oil, mushrooms, and onions in a large saut\\xc3\\xa9 pan. Cook on high heat, stirring constantly, until the mushrooms start to soften, and the onions start to look translucent, about 5 minutes. Add the sausage, breaking it up with a wooden spoon or spatula, and cook until the sausage starts to brown, about 5 minutes.', 'Keep the heat on high, and add the flour, sage, black pepper, nutmeg, and salt to the pan. Stir until the ingredients are absorbed. Pour in the milk, reduce heat to medium, and cook, continuing to stir until the liquid has started to bubble and thicken, about 3 to 7 minutes. You\\xe2\\x80\\x99re now ready to assemble the casserole!', 'If the first layer of biscuits isn\\xe2\\x80\\x99t done baking, lower the heat on the gravy to a simmer until the biscuits are done. If you still need time to finish the gravy, but the biscuits are done\\xe2\\x80\\x94remove the casserole dish from the oven, and let it sit on the counter or stovetop while you finish the gravy.', '7 Assemble and bake the casserole: Once the gravy has thickened and the first layer of biscuits is done baking, pour or spoon the gravy over the biscuit layer in the casserole dish. Place the 12 reserved biscuits over the gravy and brush the top of the biscuits with the melted butter.', 'Return the dish to the oven and bake until the biscuits are golden brown and the gravy is bubbling and thick, about 18 to 23 minutes.', '8 Cool and serve: Let cool 10 minutes before serving warm from the casserole dish.']",16
291,French Toast Casserole Recipe,15,40,55,"['For the casserole:', '1 large loaf good-quality French loaf, sourdough, ciabatta, or challah (enough to yield 10 cups of chunks of bread)', '1/2 cup (45g) chopped pecans', '5 large eggs', '1 1/2 cups whole milk', '1/4 cup (50g) granulated sugar', 'Zest from one medium orange (optional)', '1/2 teaspoons ground cinnamon', '1/4 teaspoon salt', 'For the topping:', '4 tablespoons unsalted butter, melted', '3 tablespoons (40g) dark brown sugar', '1 teaspoon ground cinnamon', 'Pinch of salt', 'Optional toppings for serving:', 'Dried cranberries', 'Powdered sugar', 'Maple syrup']",18,"['1 Preheat the oven to 375F (190C). Place an oven rack in the center position.', '2 Slice the bread into 1-inch slices and then cut them into 1-inch cubes. You can also tear the bread apart with your hands. Leave the crusts on.', '3 Layer the bread and pecans in a baking dish: Lightly grease a 2-quart (if you want thicker slices) or 3-quart baking dish (if you want thinner slices) with cooking spray or butter. Add enough bread cubes to cover the bottom. Sprinkle a few tablespoons of pecans on top. Continue layering the bread chunks and pecans.', '4 Prepare and add the custard: In a small bowl, whisk the eggs together. Add the milk, sugar, orange zest, 1/2 teaspoon of cinnamon, and salt, and mix well. Pour the egg and milk mixture evenly over all the bread chunks. (I found it easier to pour the mixture into a large measuring cup with a spout first before pouring the mixture over the bread.)', 'At this point, the casserole can be baked right away, or covered and refrigerated overnight.', '5 Drizzle with topping: In another bowl, mix the melted butter with the brown sugar, 1 teaspoon cinnamon, and a pinch of salt. Using a spoon, drizzle the mixture evenly over all the bread chunks.', '6 Bake the casserole for 35 to 45 minutes. I baked mine for about 38 minutes. Leave the casserole in the oven longer if you want the chunks of bread on the top to be more brown and crunchier.', '7 Remove the casserole from the oven and let it cool for about 10 minutes before serving. Sprinkle dried cranberries and dust powdered sugar on top, if you like. Serve with maple syrup at the table.']",8
292,Tater Tot Breakfast Casserole Recipe,10,35,45,"['12 ounces ground pork breakfast sausage', '6 ounces (1 1/2 cups) shredded cheddar cheese, plus extra to sprinkle over top', '8 large eggs', '1/2 cup (whole) milk', '1 teaspoon kosher salt', '1/4 teaspoon ground black pepper', 'One 32-ounce bag frozen tater tots', 'Thinly sliced chives, for serving', 'Special equipment:', '12-inch cast iron skillet, or other oven-safe skillet']",10,"['1 Preheat the oven to 350\\xcb\\x9aF.', '2 Cook the sausage: Warm a 12-inch oven-safe skillet over medium heat, and add the sausage. Cook, breaking it apart with a wooden spoon, until browned and cooked through, 5 to 7 minutes. Remove the pan from heat.', '3 Assemble the casserole: Whisk together the eggs, milk, salt and pepper in a medium bowl.', 'Spread the sausage into an even layer over the bottom of the skillet. Sprinkle with the shredded cheese, and pour the egg mixture over the top.', ""Arrange the frozen tater tots over the egg mixture in concentric circles, starting with a row around the rim of the pan and working your way in, or vice versa. (You won't use the entire bag; reserve remaining tater tots for another use.)"", '4 Bake the casserole. Bake until the eggs have fully set and the cheese has melted, 35 to 40 minutes. If desired, sprinkle some additional cheese over top and bake an extra minute or two, until the cheese has melted.', '5 Serve: Let the casserole cool slightly before cutting into wedges. Sprinkle with some sliced chives and serve. Leftovers will keep for about 5 days.']",7
293,"Bagel Breakfast Casserole with Sausage, Egg, and Cheese Recipe",20,45,65,"['6 (20-ounce package) everything bagels', '7 large eggs', '2 1/2 cups half-and-half', '1 teaspoon kosher salt', '1/8 teaspoon black pepper', '1/2 tablespoon vegetable oil', '1 pound breakfast sausage (I used sage-flavored)', '1 red bell pepper, diced (about 1 cup)', '1 small yellow onion, peeled and diced (about 1 cup)', '2 tablespoons chopped fresh parsley, divided', '3 cups (8 ounces) sharp cheddar cheese, shredded and divided']",11,"['1 Prep the oven: Preheat your oven to 350\\xc2\\xb0F, then lightly grease or butter a 13\\xe2\\x80\\x9dx 9\\xe2\\x80\\x9d casserole dish.', '2 Prep the bagels: Using a serrated bread knife, cut each bagel into bite-size pieces. I like to cut the bagel in half (from top to bottom) and then cut each half into fourths. Try to cut the bagel into pieces that are no larger than an inch.', '3 Make the egg mix and combine with the bagels: In a large mixing bowl, whisk together the eggs, half-and-half, salt, and pepper until no yolk is visible and the mixture is smooth.', 'Add the cut bagels to the egg mixture and, using a large spoon or spatula, toss to coat the bread in the liquid. Set this to the side to allow the bread to soak while you brown the sausage.', '3 Cook the sausage, onion, and pepper: Heat the oil in a large skillet over medium-high heat until it begins to shimmer (this should take about a minute).', 'Add the breakfast sausage to the pan and begin to brown it. Break up the sausage into small chunks with a wooden spoon until the sausage is about the size of pistachios. It should not look minced.', 'Once the sausage has cooked through and browned (about 5 minutes), create a well in the center of the pan using your spoon. Add the diced peppers and the onions. Stir them with the sausage and cook the mixture for an additional 3 to 4 minutes, or until the veggies are glossy and soft.', 'Drain any excess fat by straining the mixture in a colander, then allow the mixture to cool for 5 minutes. This is a great time to shred your cheese if you haven\\xe2\\x80\\x99t already.', '4 Combine the sausage, bagel and egg mixture. Once your sausage mix has cooled slightly, add it to the bagel and egg mixture. Add 1 tablespoon of the parsley and 2 cups of the cheddar cheese. Toss the ingredients together to combine evenly.', '5 Assemble the casserole: Pour the mixture into the prepared casserole dish and cover with aluminum foil.', 'Make-ahead step: At this point, you can place the dish into the refrigerator overnight and bake in the morning. Once you\\xe2\\x80\\x99re ready to bake, remove the casserole dish twenty minutes prior to baking, then proceed as follows.', '6 Bake the casserole: Bake, covered with foil, in the preheated oven for 20 minutes and then carefully remove the pan from the oven and remove the foil.', 'Return the pan to the oven and bake for an additional 25 minutes or until the middle is no longer jiggling, and the surface has browned.', '7 Cool and serve: Remove the pan from the oven and immediately top with the remaining cheese and parsley. Allow the casserole to cool for 10 minutes prior to serving.']",14
294,Zucchini Breakfast Casserole Recipe,25,40,65,"['6-8 eggs', '1 cup ricotta cheese (about 245 g)', '1 cup freshly grated Parmesan cheese (130 g)', '1/4 teaspoon Tabasco sauce or other hot chili sauce', '1 teaspoon salt', '1/4 teaspoon freshly ground black pepper', '3 cups grated zucchini (from 2-3 fresh zucchinis, about 390 g)', '1 1/2 cups chopped plum tomatoes (from 4-5 fresh tomatoes, about 370 g),', '1/2 cup sliced fresh basil (from about 20 leaves)*', '4 cups cubed day-old bread (from about 4 slices, rustic French or Italian bread works best)', 'Extra virgin olive oil', '*Chiffonade basil by stacking a few leaves on top of each other, roll them up like a cigar, slice thin, starting at one end of the cigar and working your way down.']",12,"['1 Make the egg cheese base: In a large bowl beat the eggs. Add the ricotta and beat until smooth. Mix in the grated Parmesan cheese, Tabasco, salt and pepper.', '2 Prep the vegetables and bread, add to egg mixture: Preheat oven to 350\\xc2\\xb0F (175\\xc2\\xb0C). Prepare the vegetables and bread. Once you chop the tomatoes, squeeze excess moisture out of them by pressing them in a sieve, or wrapping in paper towels and squeezing. Add the tomatoes, basil, and zucchini to the egg mixture.', 'Moisten the bread cubes with a little water then squeeze out any excess moisture using paper towels. Mix the bread cubes into the egg mixture.', '3 Bake: Coat the bottom and sides of a 9x13 baking dish generously with olive oil. Pour the egg vegetable mixture into the baking pan and even it out in the pan. Place in the middle rack of the oven.', ""Bake for 30 minutes at 350\\xc2\\xb0F (175\\xc2\\xb0C). The casserole should puff up and brown lightly. If it hasn't browned enough after 30 minutes at that temp, increase the heat to 425\\xc2\\xb0F (220\\xc2\\xb0C) and cook for 5-10 minutes further."", 'Remove from oven and let cool on a rack for 10 minutes before cutting into squares to serve.']",6
295,Baked Blueberry French Toast Casserole Recipe,10,75,85,"['1 pound loaf rustic bread, cut into 1-inch cubes (about 10 cups of cubes)', '1 1/2 (or 2) cups blueberries, frozen or fresh', '5 large eggs', '2 cups milk (whole or 2%)', '1 cup heavy cream', '1/2 teaspoon vanilla extract', '8 tablespoons sugar, divided', '1 tablespoon lemon zest', '1/8 teaspoon kosher salt', '2 tablespoons unsalted butter, diced']",10,"['1 Assemble the dry ingredients: Butter a 9x13 (or other 3-quart) baking dish. Spread half of the bread cubes in an even layer in the prepared pan. Top with 2/3 of the blueberries, followed by the remaining bread cubes and blueberries.', 'If using frozen blueberries, add them to the casserole while still frozen (do not thaw). This helps prevent the berries from coloring the casserole too much.', '  2 Whisk the liquids: Beat the eggs, milk, cream, vanilla, 6 tablespoons of the sugar, lemon zest, and the salt together. Pour the mixture over the bread cubes, pressing down gently (so you don\\xe2\\x80\\x99t burst the berries) to make sure the egg mixture is absorbed.', '3 Soak at least 30 minutes, or overnight: If soaking overnight, cover the pan with plastic wrap and refrigerate overnight.', '4 Preheat the oven to 350\\xc2\\xb0F about 15 minutes before you plan to bake the casserole.', '5 Bake the casserole: Just before baking, sprinkle the top of the casserole with the remaining sugar and dot with the diced butter. Bake for 45 minutes, until slightly puffed and golden brown. (Casserole that chilled overnight might take a few minutes longer.)', '6 Serve: Let the casserole cool for about 10 minutes before cutting. Serve with a dusting of powdered sugar over top or a drizzle of maple syrup.', 'Leftovers will keep, refrigerated, for about a week and can be reheated in the microwave.']",8
296,Ham and Cheese Breakfast Casserole Recipe,20,2940,2960,"['Butter (for the dish)', '1 loaf sliced white toasting bread', '3/4 pound mild cheddar, grated', '8 small tomatoes, or 16 cherry tomatoes, thinly sliced', '1 thick slice (3/4 pound) flavorful baked ham, cut into 1/4-inch dice (About 2 1/2 cups diced)', '10 large eggs', '3 cups whole milk', 'Salt and pepper, to taste']",8,"['1 Prepare the bread: Butter a deep 9-by-13-inch baking dish. Cut the bread slices on a diagonal to make large triangles. Fit as many triangles as you can in the bottom of the dish, cutting smaller pieces to wedge between the larger ones, if necessary, to completely cover the bottom.', '2 Begin layering the casserole: Sprinkle the bottom layer of bread with half the cheese. Lay half the tomato slices here and there over top, and sprinkle with half the ham. Add another layer of bread, again cutting smaller pieces, if necessary, to make a solid layer. Sprinkle with all but 2 tablespoons of the remaining cheese, and the remaining tomatoes and ham. Cover with a third layer of bread. (You may have a few slices of bread leftover.)', '3 Whisk together the eggs and milk: In a bowl, beat the eggs, milk, and a generous pinch of salt and pepper. Pour the mixture carefully over the bread. With your hands, press the bread into the egg mixture. Sprinkle the remaining 2 tablespoons cheese over top.', '4 Cover and refrigerate. Refrigerate for at least 12 hours, or for up to 48 hours.', '5 When ready to bake, let the dish sit at room temperature for 30 minutes. Heat the oven to 375F. Remove the plastic wrap from the dish and set it on a large rimmed baking sheet to catch any drips.', '6 Bake the casserole for 55 to 60 minutes, or until it is puffed and golden brown and cooked through in the middle. A thermometer inserted into the center of the dish should register 160F. If the casserole needs to cook longer, cover it loosely with foil and continue cooking for 5 to 10 minutes.', '7 Let the casserole sit for 5 minutes before cutting into squares.']",7
297,Baked Cherry French Toast Casserole Recipe,15,60,75,"['For the casserole:', 'Butter (for the baking dish)', '6 large eggs', '1 3/4 cups whole milk', '1/4 cup honey', 'Grated zest of 1 lemon (about 1 tablespoon)', '1 teaspoon ground cinnamon', '1/2 teaspoon pure almond extract, or 1 teaspoon vanilla extract', '1/4 teaspoon salt', '1 1-pound loaf good quality, sturdy bread (such as French Pullman, sourdough, or ciabatta), cut into 3/4-inch cubes', '2 cups (8 ounces) frozen pitted dark cherries, cut in half', 'Topping:', '4 tablespoons (1/2 stick) unsalted butter, melted', '3 tablespoons sugar', '1 1/2 teaspoons cinnamon', '1/3 cup sliced almonds', 'For the cherry sauce:', '2 cups (8 ounces) frozen pitted dark cherries (left whole)', '1/4 cup sugar', '2/3 cup orange juice', '1 tablespoon cornstarch', '2 tablespoons water']",22,"[""1 Preheat the oven and prepare the pan: Set an oven rack in the middle position. (If making this casserole ahead, wait to heat the oven until you're ready to bake; see Step 3.)"", 'Preheat the oven to 350\\xc2\\xbaF. Butter a shallow 3-quart baking dish.', '2 Assemble the casserole: In a large bowl, whisk the eggs, milk, honey, lemon zest, cinnamon, almond extract or vanilla, and salt until well combined. Add the bread cubes and toss to coat them.', 'Transfer half of the cubes to the baking dish. Distribute the halved cherries over the bread. Top with the remaining bread cubes. Pour excess egg mixture over the top if there is any. Gently press the bread down into the egg mixture with the flat of one hand.', '3 Let the casserole rest: Set the casserole aside for about 20 minutes to allow the bread to absorb the egg mixture. Before baking, gently press the bread into the custard one more time.', 'Alternatively, the casserole can be covered with plastic wrap and refrigerated overnight. Preheat the oven as directed in step 1 before baking.', '4 Make the topping: In a small bowl, stir together the melted butter, sugar, cinnamon and almonds for the topping. Spoon the mixture evenly over the casserole just before baking.', '5 Bake the casserole: Set the casserole on a rimmed baking sheet and bake for 35 to 40 minutes, or until the eggs are set and the top is golden and crunchy. (Add a few extra minutes if the casserole was refrigerated before baking.)', '6 While the casserole bakes, make the cherry sauce: In a medium saucepan, stir together the cherries, sugar, and orange juice. Bring to a boil over medium heat, stirring often.', 'In a small bowl, stir the cornstarch with the water until smooth. Add to the cherries and cook, stirring, for 1 minute, or until the sauce thickens. Serve warm or cold.', '7 To serve: With a large spoon, scoop a serving of the French toast into a shallow bowl. Surround with the sauce and enjoy.']",11
298,Slow Cooker Chocolate Milk French Toast Recipe,50,285,335,"['1 pound challah, brioche, or sweet Hawaiian bread, cut into 1 to 1 1/2 inch cubes', '2 tablespoons light brown sugar', '1 teaspoon ground cinnamon', '1 1/2 teaspoons orange zest (from one small naval orange)', '1/2 teaspoon kosher salt', '5 large eggs', '2 cups whole chocolate milk', '1/2 cup heavy cream', '1 tablespoon unsalted butter, softened', '4 ounces (110 grams) semi-sweet chocolate, chopped (or chocolate chips), divided']",10,"['1 Toast the challah: Preheat your oven to 300\\xc2\\xb0F. Arrange the cubes of challah in a single layer on a half sheet pan.', 'Toast the bread for 15 minutes, tossing once half-way through the toasting time. Remove the pan from the oven and let the bread cool while you prepare the chocolate milk custard.', '2 Mix the custard: In a large mixing bowl, combine the brown sugar, cinnamon, orange zest, salt, and eggs. Whisk the ingredients together until smooth. ', 'Combine the chocolate milk and heavy cream and add them to the egg mixture. Whisk until the custard is no longer clumpy. ', '3 Assemble the casserole: Grease the ceramic insert of your slow cooker with the butter.', 'Add half of the bread cubes to the insert and top with a quarter of the chocolate pieces.', 'Add the remaining bread cubes and sprinkle on another quarter of the chocolate chunks. Reserve the rest of the chocolate for sprinkling on the finished casserole. ', '4 Soak the casserole: Pour all of the chocolate milk custard over the bread. Use a large spoon to toss the bread in the custard before covering with the lid and refrigerating for at least 2 or up to 24 hours. ', '5 Warm the ceramic insert: Before cooking the casserole, set the ceramic insert on the countertop for 30 minutes to take some of the chill off of it. This will keep it from shattering when it\\xe2\\x80\\x99s heated. ', '6 Cook the casserole: Place the insert into the slow cooker and cook the casserole on high for 2 1/2 hours. The internal temperature of the fully-cooked casserole should be 160-165\\xc2\\xb0F', '7 Cool and serve: Once the casserole is cooked, sprinkle the remaining chocolate chunks over the casserole. Cool briefly, then spoon the casserole into individual plates and serve.']",11
299,Cheesy Grits Souffl\xc3\xa9 Bake Recipe,30,40,70,"['2 cups water', '2 cups whole or 2% milk', '1 teaspoon kosher salt', '1 cup grits (I prefer yellow, but white grits are fine)', '2 to 4 tablespoons unsalted butter', '2 cups grated cheddar cheese', '1/8 teaspoon cayenne pepper', '1/8 teaspoon black pepper', '1/2 cup thinly sliced scallions or chives, optional', '3 large eggs', '1/2 cup sour cream', 'Special equipment:', '2-quart casserole or 9 x 13-inch baking dish']",13,"['1 Heat the oven: Adjust the oven rack to the middle position. Preheat the oven to 350\\xc2\\xb0F.', '2 Cook the grits: In a medium saucepan, bring the water and milk to a boil. Add the salt, then gradually whisk in the grits (this keeps them from clumping). Cook over medium heat, whisking frequently, until creamy and thickened, about 20 minutes.', 'Remove from heat. Add the butter, cheese, cayenne, black pepper, and scallions or chives, if using. Switch to a spatula and stir until the butter and cheese are melted. Cover to keep warm and set aside.', '3 Separate the eggs: Separate the egg yolks from the egg whites. Put the whites in a large, grease-free bowl.', 'In a separate, medium bowl, stir the egg yolks and sour cream until combined.', '4 Beat the egg whites: With electric beaters or the largest whisk you have, beat the egg whites until they are fluffy and pillowy-soft, like clouds. They should mostly hold their shape but not be completely stiff.', '5 Stir the yolks into the grits: Working quickly, stir the sour cream and yolk mixture into the grits with a large spatula.', '6 Fold the egg whites into the grits: Push the egg whites to the side of the bowl, and dump the hot grits mixture on the emptier side. Still using the spatula, fold the egg whites into the grits until you see no (or very few) streaks of egg white.', '7 Bake the casserole: Scrape the mixture into the baking dish. Bake until the top is puffy and golden-brown, 35 to 45 minutes. Let sit 5 minutes before serving. Leftovers will keep, covered and refrigerated, for up to 4 days.']",9
300,Easy Baked Brie in Puff Pastry Recipe,5,30,35,"['1 large sheet of puff pastry dough or 1 tube of refrigerated crescent dinner rolls', '1 round or wedge of Brie cheese (do not remove rind)', '2 tablespoons raspberry jam, or other sweet jam', '1 tablespoon brown sugar', '1/4 cup of maple syrup']",5,"['1 Preheat oven to 350\\xc2\\xb0F (175\\xc2\\xb0C). ', ""2 Slice the top off the brie: If you want, start with chilled brie and use a sharp knife to carefully cut off the thin top rind of the cheese. This may help the crust stay with the cheese when served. The rind is edible so you don't have to do this step if you don't want to."", '3 Place brie on puff pastry: On a lined baking sheet, lay out the puff pastry or the crescent rolls flat. Place the brie round or wedge on top of the puff pastry.', '4 Spread jam on top, fold dough over brie: Spread jam on brie, fold dough over top, cutting off excess dough. Drizzle maple syrup and sprinkle brown sugar on top.', '5 Bake: Bake at 350\\xc2\\xbaF (175\\xc2\\xb0C) for 30 minutes, pastry should be golden brown. Let cool for 10 minutes before serving.', 'Serve with crackers or apple slices.']",6
301,Caramelized Onion Tart with Gorgonzola and Brie Recipe,10,50,60,"['2 tablespoons extra virgin olive oil', '4 cups of sliced onions, sliced root-to-top into 1/4-inch thick slices (about 2-3 med onions)', '1 tablespoon brown sugar', '2 tablespoons balsamic vinegar', '1/2 teaspoon salt', '1/2 teaspoon pepper', '8 oz frozen puff pastry (defrosted a couple hours in the fridge)', '2 oz chilled Brie cheese, rind removed and diced', '2 oz Gorgonzola or other blue cheese, diced', '2 tablespoons chopped fresh tarragon']",10,"['1 Caramelize the onions: Heat oil in a large deep pan on medium-high heat. Add onions and cook for about 10 minutes or until wilted and starting to brown. Add sugar, vinegar, salt and pepper.', 'Reduce heat and cook gently, uncovered for 20-25 minutes or until richly caramelized. Add a little water if the onions look like they are starting to dry out. Cool.', '2 Roll pastry into a 10-to-14-inch rectangle (or whatever shape you want). Place pastry on a baking sheet lined with parchment paper. Prick with a fork at a couple inch increments to prevent the pastry from forming big bubbles while baking.', '3 Spread onions over pastry, all the way to the edges of the pastry. Dot with cheese. Sprinkle with tarragon. Refrigerate if not baking immediately.', '4 Bake in a preheated oven at 400\\xc2\\xb0F for 18-20 minutes or until cheese has melted and pastry is crispy. Cool for 5 minutes. Cut into wedges or squares and enjoy!']",5
302,"Pasta with Tomato, Spinach, Basil, and Brie Recipe",10,20,30,"['2 cloves garlic, minced', '1/4 cup extra virgin olive oil', '1 pound chopped fresh, ripe tomatoes (about 2 medium tomatoes)', '6 ounces brie cheese, rind removed, cheese cut into small chunks', 'Zest and juice of one lemon (about 1 teaspoon zest and 3 Tbsp juice)', 'A handful of basil leaves, chiffonade or sliced thin', '5 ounces baby spinach, rinsed, patted dry', '1/2 to 3/4 pound of linguine or fettuccine pasta', '1/2 cup grated Parmesan', 'Salt and pepper taste']",10,"['1 Cook the pasta: Heat a large pot of salted water for making the pasta (1 tablespoon of salt for every 2 quarts of water). While the water is heating, prep the ingredients.  Once water is boiling, add the pasta and cook until al dente (cooked through, but still a little firm to the bite).', '2 Heat brie with tomatoes, garlic, olive oil, lemon, in microwave: While the pasta is cooking, place the garlic, olive oil, chopped tomatoes, chunks of brie (make sure to cut away the white rind!), lemon zest, and lemon juice into a large, microwave safe bowl.', ""Microwave for 2-3 minutes, or until the brie is melty and soft. (If you don't have a microwave, place the ingredients in a bowl and let sit for an hour or two, so the brie softens.)"", '3 Toss cooked pasta with tomatoes and brie, add spinach and basil: Once the pasta is done, drain it and place it in the bowl with the cheese and tomatoes. Add the basil and baby spinach.', 'Toss together so that the spinach, basil, cheese, and tomatoes are well dispersed through the pasta. Break up or smash any large pieces of cheese.', '4 Sprinkle with grated Parmesan cheese and freshly ground black pepper, and toss more to incorporate. Add more salt to taste.']",6
303,Instant Pot Beef Brisket Recipe,15,90,105,"['2 1/2 to 3 1/2 pounds beef brisket (certified kosher, if needed)', '1 1/2 teaspoons kosher salt, divided', '1/2 teaspoon ground black pepper', '1 tablespoon olive oil', '3 medium yellow onions, sliced', '3 large garlic cloves, peeled', '1/2 cup water', '1/2 cup dry red wine', '1/4 cup ketchup', '1 teaspoon dried rosemary', '1 teaspoon dried thyme leaves', '1 teaspoon paprika', 'Special equipment:', '6-quart electric or stovetop pressure cooker, or larger (like an Instant Pot)', 'Immersion blender, or regular blender']",15,"['1 Prepare the brisket: Rinse the brisket and pat it dry with paper towels. If your brisket has more than 1/4-inch layer of fat, trim off the excess. Season it on both sides with 1 teaspoon of the salt and the ground pepper.', '2 Sear the brisket: Select the \\xe2\\x80\\x9cSaut\\xc3\\xa9\\xe2\\x80\\x9d program on your pressure cooker, adjust it to its highest heat setting, and add the oil to the pot. (If you are using a stovetop pressure cooker, heat the oil over medium high heat.)', 'Use a pair of tongs to lower the brisket into the pot with the side with the most fat facing down, and let it sear for 6 minutes. Turn it over and sear it for 6 more minutes. Both sides should be a rich, dark brown color.', 'Transfer the seared brisket to a plate.', '3 Cook the onions and garlic: Adjust your pressure cooker to its medium ""Saut\\xc3\\xa9"" setting. (If you are using a stovetop pressure cooker, lower the heat to medium.) There should be plenty of fat left in the pan after searing the brisket; if not, add another teaspoon or two of olive oil to cook the onions.', 'Add the onions, garlic, and the remaining 1/2 teaspoon of salt. Cook, stirring frequently, until the onions are soft and beginning to brown, about 10 minutes. Scrape the bottom of the pot as you stir the onions to help release all of the browned bits from the bottom of the pot.', '4 Stir the water, wine, ketchup, and spices into the onions and garlic.', '5 Cook the brisket: Use a pair of tongs to lower the seared brisket back into the pressure cooker, with the side with the most fat facing up. Place the lid on your pressure cooker. Make sure that the pressure regulator is set to the \\xe2\\x80\\x9cSealing\\xe2\\x80\\x9d position.', 'Select the \\xe2\\x80\\x9cManual\\xe2\\x80\\x9d program, then set the time to 50 minutes at high pressure. (For stovetop pressure cookers, cook for 45 minutes at high pressure.)', 'It will take about 10 minutes for your pressure cooker to come up to pressure, and then the actual cooking will begin. Total time from the time you seal the pressure cooker to the finished dish is about 60 minutes.', '6 Release the pressure: You can either perform a quick pressure release by moving the vent from \\xe2\\x80\\x9cSealing\\xe2\\x80\\x9d to \\xe2\\x80\\x9cVenting,\\xe2\\x80\\x9d or you can let the pot depressurize naturally (this takes about 20 minutes). (For stovetop pressure cookers, perform a quick pressure release.)', '7 Separate the brisket, onions, and cooking liquid: Use tongs to transfer the brisket to a plate or carving board. Strain the cooking liquid into a fat separator, collecting the cooked onions and garlic in the strainer.', ""8 Make the gravy: Return the drained onions and garlic to the pressure cooker pot. Pour the cooking liquid from the fat separator back into the pot, discarding the fat that is left behind. (If you don\\'t have a fat separator, wait for the fat to rise to the top of the liquid, then skim off as much as you can.)"", ""With an immersion blender, blend the cooking liquid, onions and garlic into a thick gravy. (Alternatively, transfer the liquid, onions, and garlic to a blender to puree. Don\\'t fill the blender more than halfway, and be careful of the steam when opening the blender pitcher."", '9 To serve: Slice the brisket against the grain into thin (1/4-inch) slices. Pour the gravy over the brisket and serve hot.']",15
304,Chicken Tikka Masala Recipe,15,20,35,"['For the chicken:', '1 1/4 pounds boneless skinless chicken breasts, thighs, or a mix', '6 tablespoons plain whole milk yogurt', '1/2 tablespoon grated ginger', '3 cloves of garlic, minced', '1 teaspoon cumin', '1 teaspoon paprika', '1 1/4 teaspoons salt', 'For the tikka masala sauce:', '2 tablespoons canola oil, divided', '1 small onion, thinly sliced (about 5 ounces, or 1 1/2 cups sliced)', '2 teaspoons grated ginger', '4 cloves garlic, minced', '1 tablespoon ground coriander', '2 teaspoons paprika', '1 teaspoon garam masala', '1/2 teaspoon turmeric', '1/2 teaspoon freshly ground black pepper', '1 (14-ounce) can crushed fire-roasted tomatoes (regular crushed tomatoes work, too)', '6 tablespoons plain whole milk yogurt', '1/4 to 1/2 teaspoon cayenne pepper', '1/2 teaspoon salt', 'Cooked rice, to serve', 'Cilantro, to garnish']",24,"['1 Prepare the chicken: Trim chicken thighs of any extra fat. Chop into bite-sized pieces about 1/2 to 1-inch wide. Place the chicken thigh pieces to a medium bowl.', 'Add the yogurt, ginger, garlic, cumin, paprika and salt. Using your hands, combine the chicken with the spices until the chicken is evenly coated.', '2 Marinate the chicken: Cover the bowl with plastic wrap and let the chicken marinate in the fridge for at least 45 minutes or as long as overnight. (Marinating for 4 to 6 hours is perfect.)', '3 Cook the chicken: In a large skillet, heat 1 tablespoon of canola oil over medium-high heat. Add the chicken thigh pieces and cook for about 6 to 7 minutes, until they\\xe2\\x80\\x99re cooked through. Transfer to a plate and set aside.', '4 Toast the spices: Wipe down the pan you used to cook the chicken. Heat remaining canola oil over medium heat. Add the onions and cook for 5 minutes, until softened, stirring often.', 'Add the grated ginger, minced garlic, coriander, paprika, garam masala, turmeric, black pepper, salt, and cayenne. Let the spices cook until fragrant, about 30 seconds to a minute.', '5 Make the sauce: Add the crushed tomatoes to the pan with the spices and let everything cook for 4 minutes, stirring often. Add the yogurt and stir to combine.', '6 Simmer the sauce: Reduce the heat to medium-low and let the sauce simmer for another 4 minutes. Add the chicken pieces to the pan and coat with sauce.', '7 Serve: Serve over cooked basmati rice and garnish with cilantro.']",9
305,Classic English Toad-in-the-Hole Recipe,35,30,65,"['1 1/2 cup  (180 g) of all purpose flour', '1/2 teaspoon salt', 'Pinch of freshly ground black pepper', '3 eggs, beaten', '1 1/2 cup (350 ml) milk', '2 tablespoons melted butter', '1 tablespoon vegetable oil', '1 pound (450 g) of bangers (an English sausage made with pork and breadcrumbs), or good quality pork or beef sausage links (in casings)']",8,"['1 Make batter: In a large bowl, whisk together the flour with the salt and a pinch of pepper. Make a well in the center of the flour. Pour in the eggs, milk, and melted butter into the well and whisk into the flour until smooth. Cover and let stand 30 minutes.', '2 Pre-heat baking dish: Coat the bottom and sides of an 8x12 or 9x9 ceramic or metal casserole dish with vegetable oil. Place a rack in the bottom third of the oven. Put the empty dish on the rack. Preheat the oven with the dish in it to 425\\xc2\\xb0F(220\\xc2\\xb0C).', '3 Brown the sausages: While the oven is coming to temperature, heat a tablespoon of vegetable oil in a skillet on medium high. Add the sausages and brown them on at least a couple sides.', '4 Pour batter over sausages: When the sausages have browned, and the dish in the oven hot, pull the oven rack out a bit, put the sausages in the casserole dish, and pour the batter over the sausages.', '5 Bake: Bake at 425\\xc2\\xb0F(220\\xc2\\xb0C) for about 20-30 minutes or until the batter is risen and golden.', 'Serve at once.']",6
306,Chicken Mulligatawny Soup Recipe,15,45,60,"['2 tablespoons butter', '1 tablespoon extra virgin olive oil', '1 large onion, chopped (about 2 cups)', '2 ribs celery, chopped (about 1 cup)', '2 carrots, chopped (about 1 cup)', '2 bay leaves', '4 teaspoon yellow curry powder', '1 1/4 pound (570 g) boneless, skinless chicken thighs, trimmed of visible fat', '2 cups (475 ml) chicken stock', '2 cups (475 ml) water', '1 1/2 teaspoons kosher salt (or 1 teaspoon sea salt)', '1/4 cup uncooked basmati rice', '2 tart apples, cored, peeled, and chopped (about 2 cups)', '1/4  (60 ml) cup heavy whipping cream', '1/4 cup (60 ml) plain yogurt for garnish', '1 tablespoon minced chives for garnish']",16,"['1 Saut\\xc3\\xa9 onions, celery, carrots in olive oil and butter, add bay leaves, curry powder: Heat butter and olive oil on medium high heat in a large (4 to 5 quart), thick-bottomed pot. Add the onions, celery, and carrots. Cook for 5 minutes until just starting to soften. Add the bay leaves. Add the curry powder and mix to coat.', '2 Add chicken, stock, salt: Add the chicken thighs and stir to coat with the curry mixture. Add the stock and water to the pot. Add the salt. Bring to a simmer and reduce the heat to maintain a simmer. Cover and cook for 20 minutes.', '3 Remove chicken, let cool to touch: Remove the chicken pieces from the pot. (They should be just cooked through. If not, return them to the pot for another 5 minutes or so, until they are cooked through.) Place on a cutting board and allow to cool to the touch.', '4 Add rice, apples: Add the rice and the chopped apples to the soup. Return to a simmer on high heat, then lower the heat to maintain a low simmer. Cover and cook for 15 minutes, or until the rice is cooked through.', '5 Shred the chicken, return to soup, add cream: While the apples and rice are cooking in the soup, shred the chicken, discarding any tough bits. Once the rice and apples in the soup are cooked, add the chicken back to the pot. Heat for 5 minutes more. Then stir in the cream.', 'Serve with yogurt and chives.']",6
307,Queen Elizabeth\xe2\x80\x99s Drop Scones Recipe,10,15,25,"['3 cups (400 g) all-purpose flour', '2 teaspoons baking soda*', '3 teaspoons cream of tartar*', '1/4 teaspoon salt**', '2 eggs', '1/4 cup of superfine sugar, or a heaping 1/4 cup white, granulated sugar', '1 1/2 cup (350 ml) of whole milk (and maybe a little more if needed)', '2 tablespoons butter, melted', ""*If you don't have cream of tartar, substitute the 2 teaspoons of baking soda and the 3 teaspoons of cream of tartar with 5 teaspoons of baking powder (make sure your baking powder is less than 6 months old or it may be flat and unable to provide leavening)."", '**If using salted butter, skip the added salt.']",10,"['1 Whisk together the flour, baking soda, cream of tartar, and salt in a large bowl.', '2 In a separate medium sized bowl, whisk together the eggs and sugar. Then whisk in most of the milk.', '3 Make a well in the middle of the flour and pour in the milk egg mixture. Whisk until smooth, adding more milk until you get the right consistency - thin enough to spread on the pan, but not so thin as to run. Fold in the melted butter.', '4 Heat a griddle or large cast iron pan on medium to medium low heat. Coat the pan with a little butter, spreading it with a folded over paper towel. Drop large spoonfuls of batter on the griddle to form pancakes. When bubbles start to appear on the surface (after 2 to 3 minutes), use a metal spatula to flip the pancakes over. Cook for another minute, until lightly browned. Remove to a plate and cover with a clean tea towel to keep warm while you cook the rest of the drop scones.', 'Serve with butter, jam, or golden syrup (Americans sub maple syrup).']",5
308,Sheet Pan Fish and Chips Recipe,30,40,70,"['6 tablespoons olive oil, or more if needed', '2 1/2 pounds Yukon Gold or other yellow potatoes (3 large or 6 medium), unpeeled', '1 teaspoon salt', '1 cup Panko, or other unseasoned dry white breadcrumbs', '1/2 teaspoon ground black pepper', '2 pounds firm-fleshed white fish fillets, skins removed, such as haddock, halibut, pollock, flounder, whiting, redfish, cod, or other fish in your region', '1 tablespoon chopped fresh parsley', '1 lemon, cut into wedges, to serve', 'Tartar sauce, to serve']",9,"['1 Heat the oven to 450F. Arrange 2 oven racks in the top and bottom third of the oven. Line 2 baking sheets with foil and coat with olive oil (about 1 tablespoon per baking sheet) or with nonstick cooking spray.', '2 Prepare the potatoes: Quarter the potatoes lengthwise, then cut each quarter in half again so you get 8 spears from each potato. In a bowl, toss the potatoes with 2 tablespoons of the oil and 1/2 teaspoon salt. Spread the potatoes on one of the baking sheets with their wedges pointing up, if possible, so the cut sides are exposed (some may not stand; that\\xe2\\x80\\x99s OK).', ""3 Roast the potatoes: Roast the spears on the lower rack in the oven for 40 minutes. Rotate the pan partway through (after 20 minutes of cooking) and use a wide metal spatula to stir the potatoes. At this point, it\\'s fine if the potatoes fall on their sides; the sides touching the pan will become extra-crispy and golden."", '4 Toast the panko: Once the potatoes are in the oven, start on the panko and the fish. To toast the panko, warm a heavy skillet over medium high heat. Add the panko (no oil needed), and lower the heat to medium. Slowly toast the panko, stirring frequently, for 10 to 15 minutes or until a deep golden brown.', 'Remove the skillet from heat. Stir 1 tablespoon of olive oil, 1/2 teaspoon salt, and 1/2 teaspoon black pepper into the panko breadcrumbs until they are well coated. Transfer the crumbs to a shallow bowl.', '5 Prepare the fish: Cut the fish into large strips (""fingers"") or big 3-inch pieces, however you prefer. Rub all the pieces with the remaining tablespoon of olive oil.', '6 Coat the fish with panko: Press the fish into the panko so the pieces are coated all over. Set the fish on the second baking sheet, spaced slightly apart.', '7 When the potatoes are 15 to 20 minutes away from being done, bake the fish:  Cook thick (2-inch) fish fillets for 15 to 18 minutes and thinner (1 1/2-inch or thinner) fillets for 10 to 13 minutes, or until the fish is firm and the coating is starting to brown. Err on the side of caution and do not over-bake.', '7 Serve the fish and chips: Arrange fish and potato spears on plates, sprinkle with parsley, serve with lemon and tartar sauce.']",9
309,Sheet Pan English Breakfast Recipe,10,45,55,"['1 1/2 pounds pork or chicken sausage (preferably links weighing 6-8 ounces each)', '1 cup grape tomatoes, halved', '8 to 10 ounces baby cremini mushrooms, halved', '3 tablespoons olive oil, divided', '1 (15-ounce) can pinto beans', '1 tablespoon packed brown sugar', '1 tablespoon ketchup', '1 tablespoon barbecue sauce', '4 large eggs', 'Salt and pepper', '3 whole sprigs fresh thyme', 'Toast, to serve']",12,"['1 Preheat oven to 400\\xc2\\xb0F. Rub sheet pan with 1 tablespoon of olive oil to prevent the food from sticking.', '2 Begin cooking the sausage: Arrange sausage links on the sheet pan and cook for 15 minutes.', '3 Flip the sausage and add the tomatoes: Remove sheet pan from the oven and using tongs. Add the grape tomatoes, cut side up and season with a pinch of salt and pepper. Return to oven and bake for another 15 minutes.', '4 Meanwhile, prep the remaining ingredients. Toss the mushrooms with 1 tablespoon olive oil and a pinch of salt and pepper, and set aside. Drain and rinse pinto beans and stir them together with brown sugar, ketchup, and barbecue sauce. Transfer beans to a small oven-safe skillet or dish.', '5 Pour off liquid and add the mushrooms. Remove the sheet pan from the oven (at this point, the sausages have been cooking for 30 minutes and the tomatoes for 15 minutes). If there is a lot of liquid on the sheet pan, carefully pour off the liquid; do not stir the tomatoes (they tend to fall apart if stirred and are better left alone).', 'Add prepared mushrooms to the sheet pan and return to the oven.', '6 Add the beans and the eggs. After 15 more minutes (40-45 total minutes of baking), remove the sheet pan and again drain off any excess liquid. Flip the sausages again, but the other ingredients can be left alone.', 'Clear a little space on the sheet pan and nestle the dish of beans inside. (Alternatively, if you\\xe2\\x80\\x99re running out of space, you can bake the beans on a separate oven rack.)', 'Make four little pockets of space on the sheet pan for the eggs. Drizzle a tiny amount of oil in each area and crack in eggs. Place the fresh thyme sprigs here and there over the ingredients.', '7 Bake the eggs: Bake for a final 5 minutes, just until the whites of the eggs set. (If you want the eggs cooked through with hard yolks, bake them for 8 minutes total.)', 'While the eggs bake, make the toast.', '8 Season and serve: Remove sheet pan from the oven and allow to cool briefly. Sprinkle everything with salt and pepper. Slice sausage and divide between plates. Serve with beans, roasted tomatoes and mushrooms, eggs, and crispy toast.']",12
310,Savory Scones with Goat Cheese and Chives Recipe,15,20,35,"['2 cups all purpose flour', '2 teaspoons baking powder', '1 teaspoon sugar', '1/2 teaspoon baking soda', '1/2 teaspoon salt', '1/4 teaspoon freshly ground black pepper', '1/4 cup (1/2 stick) chilled butter, cut into 1/2-inch cubes', '1/4 cup to 1/2 cup of freshly chopped chives (can also use chopped green onions)', '1 5-ounce log soft fresh goat cheese, crumbled', '1 cup buttermilk (plus an extra tablespoon for finish)']",10,"['1 Preheat oven to 400\\xc2\\xb0F. Line 2 heavy baking sheets with silpat or parchment paper.', '2 Make the dough: Whisk flour, baking powder, sugar, baking soda, salt and pepper in a large bowl. Using fingertips, rub butter into dry ingredients until coarse meal forms.', 'Stir in the chives. Add cheese and buttermilk; stir with fork just until a sticky dough forms (bits of cheese will be visible in dough).', '3 Knead the dough and form into rounds, cut into wedges: Turn dough out onto a lightly floured surface and knead gently 8 times with floured hands. Do not over-knead!', 'Form into a round, about 3/4-inch to an inch thick. Cut the round into 8 wedges.', '4 Use a pastry brush to brush on some extra buttermilk over the surface of the wedges.', '5 Bake: Arrange wedges about 1/2 inch apart on an un-greased large baking sheet and bake at 400\\xc2\\xb0F in the middle of the oven until golden brown, about 20 minutes.', 'Cool on a rack.', 'Best eaten just baked and warm, with a little butter.']",9
311,Classic Shortbread Cookies,10,15,25,"['2 cups (256g) all-purpose flour', '1 cup (115g) powdered sugar', '3/4 teaspoon kosher salt', '1 cup (227g) unsalted butter, room temp and cut into pieces']",4,"['1 Heat the oven and prepare the baking sheets: Preheat the oven to 325\\xc2\\xb0F and line 3 baking sheets with parchment paper.', '2 Combine all the ingredients: Place the flour, powdered sugar, salt, and butter into the bowl of a food processor and pulse until all of the butter is incorporated, about 10 to 15 one-second pulses, but could be more depending upon your food processor.', 'It\\xe2\\x80\\x99s ready when the mixture looks like wet sand and clumps together when pressed. Stop when the mixture begins to climb up the bowl.', '3 Bring the dough together: Dump everything onto the counter and gently press it together into a crumbly mound. I use a flexible bowl scraper to scoop and press the mound together at first, then knead the dough a few times and form it into a square shape.', '4 Roll and cut the dough: Roll the dough out on a well-floured surface to 1/4- to 1/2-inch thickness (depending on how thick you like your cookies) and either use a knife to cut out rectangles or use a cutter to make shapes.', '5 Transfer and chill the cookies: Transfer the cookies to one of the parchment-lined baking sheets. Chill the cookies on the sheet pan in the freezer for 15 minutes or until the cookies are solid to the touch.', 'Transfer the frozen cookies, in batches, onto the other baking sheets, leaving about 1/2 inch between each cookie.', '6 Bake the cookies: Bake the cookies, one pan at a time, for 15-18 minutes, or until the cookies are dry to the touch and the bottoms just begin to turn golden.', '7 Cool and store: Remove from the oven and cool on a rack before transferring to a container for storage. The baked and cooled cookies can be stored in an airtight container for several days.']",9
312,Banoffee Cheesecake Recipe,40,1020,1060,"['For the toffee sauce:', '3/4 cup heavy cream', '1/2 cup (1 stick) unsalted butter, sliced', '1/2 teaspoon kosher salt', '1 cup (197 g) packed light brown sugar', '3 tablespoons dark corn syrup', '1/2 teaspoon vanilla extract', 'For the banoffee cheesecake:', '2 (5-ounce) packages Walker\\xe2\\x80\\x99s shortbread cookies', '1 cup (200 g) granulated sugar, divided', '3 tablespoons melted unsalted butter', '4 (8-ounce) packages cream cheese, at room temperature', '1/2 teaspoon kosher salt', '4 large eggs', '3 ripe bananas, peeled and mashed', '1 teaspoon vanilla extract', '1 teaspoon banana extract', '1/3 cup cornstarch', 'To garnish:', 'Toffee sauce', 'Whipped cream', 'Dried banana chips']",22,"['1 Make the toffee sauce: Warm the heavy cream in the microwave for one minute, or on the stovetop over medium heat. The cream should steam, but not boil. Set this aside.', 'In a 4-quart saucepan, melt the butter over medium heat. Add the salt, brown sugar, and corn syrup. Whisking frequently, heat until the sugar has dissolved and the syrup bubbles gently. This should take anywhere from 3 to 5 minutes.', 'Turn the stove off and whisk in the warmed cream\\xe2\\x80\\x94be careful, as the sugar will bubble and steam once the cream is poured in. Add the vanilla extract to the sauce and set the pan back over medium heat.', 'Cook for another 5 minutes, or until the syrup is thick. Transfer the sauce to a glass jar and store in the refrigerator until ready to use, up to one week in advance.', '2 Prep the oven and the pan: Preheat your oven to 350\\xc2\\xb0F. Wrap a 10-inch springform pan in heavy duty aluminum foil and set aside; be very careful not to tear or puncture the foil.', '3 Make the shortbread crust: Use a food processor to pulse the shortbread cookies into fine crumbs. Add 1/4 cup of granulated sugar and the melted butter to the food processor bowl and pulse until the crumbs hold together.', 'Squeeze a handful of crumbs in the palm of your hand. If the mixture doesn\\xe2\\x80\\x99t hold together, add another tablespoon of melted butter, and re-mix.', '4 Pre-bake the crust: Press the shortbread mixture onto the bottom and an inch or so up the sides of the springform pan. Bake the crust for 10 minutes. Remove the pan from the oven and allow it to cool while you prepare the cheesecake filling.', '5 Heat water: While the crust bakes, heat 4 or 5 cups of water to boiling for the water bath.', '6 Prepare the banana cheesecake: In the bowl of a stand mixer with a paddle attachment (or in a large mixing bowl), blend together the cream cheese, the remaining 3/4 cup sugar, and the salt until smooth.', 'Add the eggs, one at a time, to the cream cheese mixture, stopping to scrape down the sides after each addition. Mix on low speed for an additional minute.', 'Add the banana puree and both extracts. Blend on low for another minute. Scrape down the mixing bowl and add the cornstarch. Blend on the lowest speed for 30 seconds, or until no lumps of cornstarch are visible, being careful not to over-mix. ', '7 Bake the cheesecake: Pour the batter into the prepared pan and set the foil-wrapped springform pan into a larger pan. Add enough hot water to reach halfway up the sides of the springform pan and carefully place the pan into the oven.', 'Bake the cheesecake for 55 minutes to an 1 hour, or until the top is a light golden brown and the cheesecake jiggles slightly when shaken. Turn the oven off and open the door a crack to allow the cheesecake to cool in the oven for 30 minutes.', '8 Cool the cheesecake completely: Once the cheesecake has cooled in the oven, carefully take it out of the oven and remove the foil. Cool the cheesecake on the countertop for an hour, then transfer it to the refrigerator to cool completely, at least 12 hours or up to 24 hours.', ""9 Decorate the cheesecake: Once the cheesecake is cold, remove the collar from the springform pan. Warm the toffee sauce slightly so that it's pourable but not runny (I set it in a dish of warm water), then drizzle one cup of the toffee sauce over the top of the cheesecake. Use a piping bag to pipe rosettes of whipped cream around the cheesecake and garnish each rosette with a banana chip."", 'Keep the cheesecake refrigerated until ready to serve, and be sure to keep leftovers chilled, too.']",17
313,Sesame Brittle Recipe,5,10,15,"['3/4 cup sugar', '1/4 cup honey', 'Pinch of salt', '1/4 teaspoon of ground nutmeg', '1 Tbsp water', '1 cup raw sesame seeds', '1 teaspoon of vanilla extract', '2 teaspoons butter', '1/4 teaspoon of baking soda']",9,"['1 Heat sugar, honey, water, salt, nutmeg: Put the sugar, honey, salt, nutmeg, and water into a small (1 1/2 quart), thick-bottomed saucepan. Heat on medium heat and stir until a smooth slurry is formed.', '2 Stir in the raw sesame seeds.', '3 Cook the sesame seed mixture, stirring often, until the mixture turns an amber caramel color, about 5 to 10 minutes.', 'If you have a candy thermometer, the temp should be 300\\xc2\\xb0F. At this point, remove the pan from the heat. Stir in the vanilla extract and the butter.', 'Once the butter has completely melted into the mixture, stir in the baking soda. The mixture will foam up a bit after you stir in the baking soda, as the baking soda reacts with the acid from the caramelization of the sugar.', ""4 Pour the mixture out onto a Silpat-lined baking sheet. (If you don't have Silpat, no worries, pour directly onto a buttered metal baking sheet and use a metal spatula to separate brittle from the pan once cooled.)"", '5 Once completely cooled and hardened (about 15-20 minutes), break into pieces.']",7
314,How to Steam Broccoli Perfectly Every Time,5,10,15,"['1 bunch of broccoli', 'Many options here:', 'Olive oil, butter, or mayonnaise (use olive oil if cooking vegan)', 'Freshly ground black pepper', 'Lemon zest or juice, balsamic vinegar, seasoned rice vinegar', 'Toasted almonds, toasted sesame seeds']",6,"['1 Prep the broccoli crowns and stems: Cut the crowns away from the large stems of the broccoli. Break the crown up into bite-sized florets. Rinse the broccoli florets thoroughly.', 'Peel and discard the thick outer skin of the stems. Slice the stems or cut them into quarters lengthwise.', ""2 Bring steamer water to a boil: Place 3/4 to 1 inch of water in a saucepan with a steamer and bring to a boil. (Note that is you don't have a steamer, you can simply put the broccoli directly into an inch of boiling water.)"", '3 Add broccoli, steam 5 to 6 min: Add the broccoli to the steamer and cover; reduce heat to medium and let cook for 5-6 minutes. The broccoli is done when you can pierce it with a fork. As soon as it is pierce-able, remove from heat, place in serving dish.', ""Note that green vegetables like broccoli will turn from vibrant green to drab olive green at about the 7 minute mark of cooking. So, watch the time, and don't let the broccoli overcook!"", '4 Dress with your favorite topping: Dress to taste with butter, olive oil, mayonnaise, lemon zest or juice, seasoned rice vinegar, balsamic vinegar, ground black pepper, toasted almonds, or sesame seeds.']",6
315,Roasted Broccoli with Parmesan Recipe,5,20,25,"['1 1/2 pounds (680g) broccoli, cut into florets of even size', '3-4 tablespoons extra virgin olive oil', 'Juice from half a lemon, about 1 Tbsp', 'Kosher salt', '2-3 garlic cloves, minced', 'Freshly ground black pepper', '1/4 cup grated Parmesan cheese, or to taste']",7,"['1 Preheat oven: Preheat oven to 425\\xc2\\xb0F (220\\xc2\\xb0C).', '2 Toss broccoli and garlic with olive oil, lemon juice, salt: In a large bowl toss the broccoli florets and minced garlic with olive oil and lemon juice until lightly coated. Sprinkle salt over the broccoli and toss to coat.', '3 Arrange florets in a single layer on baking sheet: Arrange the broccoli florets in a single layer on a baking sheet that has been rubbed with some olive oil or lined with parchment paper or aluminum foil.', ""4 Roast for 16-20 minutes: Roast at 425\\xc2\\xb0F (220\\xc2\\xb0C) for 16-20 minutes until cooked through (check by poking with a fork, should be fork tender) and lightly browned. The browned bits are the best! So don't worry if you see some charring."", '5 Toss with Parmesan and black pepper: Put the roasted broccoli back in the bowl and toss with lots of freshly ground black pepper and the grated parmesan cheese. Be generous with the black pepper, broccoli loves it!', 'Serve immediately.']",6
316,Broccoli Cheddar Bites Recipe,15,30,45,"['1 large bunch of broccoli florets', '2 eggs, lightly beaten', '1/2 cup, packed, torn fresh bread (no crust)', '1/4 cup grated onion', '1/4 cup mayonnaise', '1 cup (4 ounces, 114 g), packed, grated sharp cheddar cheese', '1 1/2 teaspoons lemon zest', '1/2 teaspoon kosher salt', '1/4 teaspoon freshly ground black pepper']",9,"['1 Steam and chop the broccoli: Place 1 inch of water in a pot with a steamer basket. Bring to a boil. Add the broccoli florets. Steam the broccoli florets for 5 minutes, until just tender. Rinse with cold water to stop the cooking.', 'Finely chop the steamed broccoli florets. You should have 2 to 2 1/2 cups.', '  2 Make filling: Place the beaten eggs and the torn bread in a large bowl. Mix until the bread is completely moistened.', 'Add the grated onion, mayonnaise, cheese, lemon zest, salt and pepper. Stir in the minced broccoli.', ""3 Distribute broccoli mixture in mini muffin pan wells:  Preheat oven to 350\\xc2\\xb0F. Coat the wells of 2 mini muffin pans (1 dozen wells each) with olive oil (so the bites don't stick). Distribute the broccoli mixture in the muffin wells."", '4 Bake: Bake at 350\\xc2\\xb0F for 25 minutes until cooked through and lightly browned on top.', ""If you don't have mini muffin pans, you can cook the bites freeform. Just grease a baking sheet and spoon large dollops of the mixture onto the pan. Baking time is the same.""]",7
317,Broccoli Cheddar Casserole Recipe,15,55,70,"['2 pounds (900g) broccoli, stems removed (can use vegetable peeler to peel, then slice and eat like celery) and crowns cut into florets (about 8 cups of broccoli florets)', '2 strips thick-cut bacon (about 2 ounces), cut crosswise into 1/4-inch wide strips', '5 large eggs, beaten', '1/3 cup (43g) all-purpose flour', '1/2 cup (118 ml) heavy cream', '1 cup (236 ml) whole milk', '2 to 3 teaspoons freshly ground black pepper (1 to 2 teaspoons if using fine ground black pepper)', '1/2 teaspoon salt', '2 teaspoons Dijon mustard', '8 ounces (225g) cheddar cheese, grated']",10,"['1 Blanch the broccoli florets: Bring a large pot of salted water to a boil (1 Tbsp salt for 2 quarts of water). Add the broccoli florets and boil for 3-5 minutes or until just tender enough so that a fork can easily pierce the floret, but still firm. Strain and rinse with cold water to stop the cooking.', '2 Cook the bacon: While the water in step one is coming to a boil, cook the bacon pieces on medium heat in a frying pan until lightly browned, but not crisp. Remove to a plate lined with paper towels to absorb the excess fat. Set aside.', '3 Make the egg mixture: Preheat oven to 425\\xc2\\xb0F (220\\xc2\\xb0C). Butter a 2 1/2 quart casserole dish. In a bowl, whisk the eggs into the flour, then whisk in the cream and milk. Add the black pepper (more or less to taste), salt, and mustard. Mix in about a third of the cheese.', '4 Assemble the casserole: Place the blanched broccoli florets in the casserole dish, sprinkling about a third of the cheese over the broccoli florets as you lay them down. Sprinkle the bacon pieces over the broccoli.', 'Pour the egg, cream, milk, cheese mixture over the broccoli, moving the broccoli pieces a bit so that the mixture gets into all the nooks and crannies. Sprinkle the casserole with the remaining cheese.', '5 Bake for 25 to 40 minutes, or until set. Once the top has browned, you may want to tent with aluminum foil to keep from burning.']",6
318,Broccoli Cheddar Soup Recipe,15,30,45,"['1 large head or two small heads broccoli (a little more than 1 pound), chopped into florets and stems', '1/4 cup unsalted butter', '1/2 white onion, chopped', '1 small carrot, peeled and grated', '1/4 cup all-purpose flour', '1 quart vegetable stock', '2 cups whole milk', '8 ounces cheddar cheese, grated', '1 teaspoon salt', '1/8 teaspoon fresh black pepper', 'Bread, for serving']",11,"['1 Blanch the broccoli: Bring a large pot of water to a boil and add a few big pinches of salt. Add broccoli stalks and blanch for 2 to 3 minutes until they are bright green and fork tender, but still slightly crispy.', 'Drain broccoli. Scoop out and set aside about 1 cup of the florets for the topping.', '2 Cook the onions and carrots: Wipe out the pot, place over medium heat, and melt the butter. Once melted, add the onions and carrots, and cook until veggies soften, 4 to 5 minutes, stirring regularly.', '3 Cook the soup: Stir in the all-purpose flour. The flour will form a paste with the veggies. Cook for a minute or two to coat the vegetables, and then start to slowly pour in vegetable stock. Stir constantly as you pour in the stock to avoid lumps.', ""Once all the stock is added, bring soup up to a low simmer. Add milk and the blanched broccoli (except what you're saving for the topping). Simmer for about 10 minutes over low heat."", '4 Puree the soup: Blend with an immersion blender, or let the soup cool until no longer steaming and blend in batches in a blender. (If using a blender, be careful to let the soup cool a bit and do not overfill the blender to avoid splattered hot soup!)', '5 Season to taste and serve: Add the grated cheese, salt, and pepper to the pureed soup and stir over low heat until the cheese has melted. Taste soup and season with additional salt and pepper to your liking.', 'Ladle the soup into bowls and garnish with some reserved broccoli and extra cheese on top. Serve with bread.']",8
319,Broccoli Beef Stir Fry Recipe,15,15,30,"['For the beef:', '1 teaspoon soy sauce', '1 teaspoon Chinese rice cooking wine or dry sherry', '1/2 teaspoon cornstarch', '1/8 teaspoon freshly ground black pepper', '3/4 pound flank or sirloin, sliced thinly across the grain', 'For the sauce:', '2 tablespoons oyster sauce', '1 teaspoon Chinese rice cooking wine or dry sherry', '1 tablespoon soy sauce', '1/4 cup chicken broth', 'For the stir fry:', '3/4 pound broccoli florets', '2 tablespoons high-heat cooking oil', '2 cloves garlic, very finely minced or pressed through a garlic press', '1 teaspoon cornstarch, dissolved in 1 tablespoon water']",16,"['1 Marinate the beef: Stir together the beef marinade ingredients (1 teaspoon soy sauce, 1 teaspoon Chinese rice wine, 1/2 teaspoon cornstarch, 1/8 teaspoon black pepper) in a medium bowl.', 'Add the beef slices and stir until coated. Let stand for 10 minutes.', '2 Prepare the sauce: Stir together the sauce ingredients (2 Tbsp oyster sauce, 1 teaspoon Chinese rice wine, 1 teaspoon soy sauce, 1/4 cup chicken broth) in a small bowl.', '3 Blanch or steam the broccoli: Bring a pot of water to a boil. Add the broccoli and cook until tender-crisp, about 2 minutes. Drain thoroughly.', '4 Stir-fry the beef: Heat a large frying pan or wok over high heat until a bead of water sizzles and instantly evaporates upon contact. Add the cooking oil and swirl to coat.', 'Add the beef and immediately spread the beef out all over the surface of the wok or pan in a single layer (preferably not touching).', 'Let the beef fry undisturbed for 1 minute. Flip the beef slices over, add the garlic to the pan and fry for an additional 30 seconds to 1 minute until no longer pink.', '5 Add sauce, cornstarch, and broccoli: Pour in the sauce and the cornstarch slurry (1 teaspoon cornstarch dissolved in 1 tablespoon of water). Stir until the sauce boils and thickens, 30 seconds. Stir in the the broccoli.', '6 Serve immediately: Serve the stir fry immediately, either on its own or over cooked rice.']",9
320,Sheet Pan Chicken with Roasted Broccoli and Potatoes Recipe,10,30,40,"['2 pounds chicken thighs, bone-in and skin on', '1 pound marble-sized baby potatoes (or small waxy potatoes cut into bite-sized pieces)', '1 tablespoon olive oil, divided', '1/2 teaspoon paprika (sweet, hot, or smoked \\xe2\\x80\\x93 your choice)', '1 teaspoon garlic granules, or garlic powder', '1 teaspoon onion granules, or onion powder', '3/4 teaspoon salt', '1/4 teaspoon pepper', 'A pinch of cayenne (optional)', '1 1/2 pounds broccoli, cut into small florets', 'Zest of 1 lemon, to serve', 'Mince chives, to serve', 'Lemon wedges, to serve']",13,"['1 Place baking sheet in oven and preheat to 500F for at least 15 minutes.', '2 Season the chicken and potatoes: Combine the chicken and potatoes in a bowl. Sprinkle with 1/2 tablespoon of oil, paprika, garlic granules, onion granules, 1/2 teaspoon of the salt, pepper, and cayenne.', 'Use your hands to toss the chicken and potatoes with the oil and spice, mixing until everything is evenly coated.', '3 Roast the chicken and potatoes: Pull the hot pan out of the oven and place the chicken skin-side down. Scatter the potatoes around the chicken. Place the pan with the chicken and potatoes in the oven. and immediately lower the heat to 425F.', 'Roast for 15 minutes.', ""4 Add the broccoli: Toss the broccoli in a clean mixing bowl with the remaining 1/2 tablespoon of olive oil and sprinkle with the remaining 1/4 teaspoon salt. Remove the pan from oven (and close the oven door so the heat doesn't escape). Use tongs to flip the chicken and potatoes. Arrange the broccoli on the pan around the chicken."", 'Roast for another 15 to 20 minutes until the chicken is cooked through and registers at least 165F in the thickest part of the thigh. The potatoes and broccoli should also be tender.', '5 To serve: Rest chicken thighs for 5 minutes before serving. Sprinkle the chicken, broccoli, and potatoes on the sheet pan with lemon zest and chives, then serve with lemon wedges']",8
321,Potato and Broccoli Curry Recipe,20,20,40,"['3 large (1 1/4 pounds, 670 g) Yukon Gold or other golden potatoes', '3 big stalks broccoli with fist-sized crowns, or one larger melon-sized crown', '1 piece (2 inches) fresh ginger, peeled and coarsely chopped', '1 clove garlic, chopped', '1 can (14 to 16 ounces, 400 to 453 g) diced tomatoes', '3/4 cup roasted unsalted whole almonds', '1/2 teaspoon salt, or more to taste', '2 tablespoons canola oil', '1 teaspoon ground coriander', '1 teaspoon ground cumin', '1/2 teaspoon red chili powder', '1/2 teaspoon ground turmeric', '3 cups vegetable stock', '1 stick cinnamon', '2 tablespoons chopped fresh cilantro, for garnish', '2 to 3 cups cooked rice, to serve', 'Special equipment:', 'Dutch oven, or other large, heavy pot with a lid', 'Food processor or blender']",19,"['1 Prepare the potatoes: Without peeling, cut the potatoes into 1/2-inch cubes. Steam the potatoes over boiling water in a vegetable steamer, tightly covered, for 10 minutes. When done, the potatoes should be firm, but tender and easily pierced with a fork. Drain.', '2 Prepare the broccoli: Cut the stems from the crown. Use a paring knife to peel the tough outer skin from the broccoli stems. Slice the stems into 1/4-inch pieces. Cut the crown into florets about 3-inches long.', '3 Make the sauce: In a food processor or blender, combine the ginger, garlic, tomatoes, 1/2 cup of the almonds (set aside the remaining 1/4 cup for garnish), and salt. Pulse the mixture until it is smooth.', '4 Cook the spices: In a Dutch oven or other large, heavy pot with a lid, heat the canola oil over medium heat. Add the chili powder, coriander, cumin, and turmeric. Cook, stirring, for 1 minute until the spices are fragrant.', '5 Simmer the sauce: Add the pureed tomato mixture to the pot with the spices \\xe2\\x80\\x93 stand back as it may splutter as you add it to the pan. Cook, stirring, for 2 minutes. Add the stock and cinnamon stick. Bring to a boil. Simmer uncovered, stirring occasionally, for 10 minutes.', '6 Cook the vegetables: Add the potatoes and broccoli to the sauce and bring to a boil. Cover the pot and simmer for 8 minutes, or until all the vegetables are tender when pierced with a skewer.', '7 Serve the curry: Remove the cinnamon stick. Coarsely chop the remaining 1/4 cup almonds. Ladle the curry into bowls with rice and garnish with almonds and cilantro.']",7
322,Broccoli Stir Fry with Ginger and Sesame Recipe,10,15,25,"['1 tablespoon sesame seeds', '1/2 cup chicken or vegetable stock (use vegetable stock for vegan option)', '1 tablespoon soy sauce (use gluten-free soy sauce for gluten-free option)', '1 tablespoon dark sesame oil', 'Peanut oil or canola oil', '1 pound broccoli florets, rinsed, patted dry, cut into bite-sized pieces', '2 cloves of garlic, minced (about 1 Tbsp)', '1 Tbsp minced fresh ginger']",8,"['1 Toast the sesame seeds: Toast the sesame seeds by first heating a small, stick-free saut\\xc3\\xa9 pan on medium high heat. Add the sesame seeds and jiggle the pan so they spread out in a single layer.', 'Let them cook until lightly browned, stirring occasionally, about 2-3 minutes. Do not walk away from them while cooking, as once they start to brown they can easily burn. Once lightly toasted remove from heat and put into a small bowl.', '2 Mix stock, soy sauce, sesame oil: Mix the stock, soy sauce, and dark sesame oil together in a small bowl, set aside.', '3 Saut\\xc3\\xa9 the broccoli, garlic, ginger: Heat 1 tablespoon of peanut oil or canola oil in a large, cover-able saut\\xc3\\xa9 pan on medium high heat. Add the broccoli florets, stir to coat the florets with the oil, Saut\\xc3\\xa9 for about a minute.', 'Clear a space in the middle of the broccoli and add the ginger and garlic. Add a little more oil to the ginger and garlic (about a teaspoon) and saut\\xc3\\xa9 for half a minute, stirring just the garlic and ginger, until fragrant. Then stir the garlic and ginger in with the broccoli.', '4 Add the stock soy mixture and simmer: Add the stock soy sesame oil mixture to the pan. Bring to a simmer, reduce the heat and cover. Let cook for 2-3 minutes, until broccoli is still firm, but can be pierced with a fork. Remove from heat.', 'Remove broccoli with a slotted spoon to a bowl. Return pan to heat, increase heat to high and boil down the liquid until just a couple tablespoons remain.', 'Turn off heat, return broccoli to the pan, add the toasted sesame seeds, toss with the liquid. Put into a serving bowl.']",8
323,Broccoli Cheddar Mac and Cheese Recipe,10,40,50,"['1 bunch of broccoli, cut into florets', 'Salt', '2 cups dry elbow macaroni', '4 Tbsp butter', '3 Tbsp all purpose flour', '3 cups milk (low fat or whole)', '1/2 teaspoon dry mustard', 'Pinch of ground nutmeg', '1 1/2 teaspoons freshly grated black pepper', '1/4 teaspoon paprika', '1/2 teaspoon Worcestershire sauce', '2 cups (packed) grated sharp cheddar cheese (8 ounces), divided 1 1/2 cups and 1/2 cup', '1/2 cup grated Parmesan cheese']",13,"['1 Boil the pasta: Heat 4 quarts of water with 2 Tbsp salt in a large pot on high heat (for pasta). When the water comes to a boil, add the pasta and cook uncovered at a rolling boil for 2 minutes less than the time given on the pasta package instructions. (You want to cook the pasta al dente because it will continue to cook with the cheese mixture.) Rinse quickly in cold water to stop the cooking, drain and set aside.', '2 Steam the broccoli: While the pasta water is coming to a boil, steam the broccoli. Put a steamer rack in a pot with an inch of water. Bring to a boil. Add the broccoli florets, sprinkle with a little salt, and cover. Steam for 4 minutes. Then remove the broccoli from the pot to a bowl.', '3 Heat the milk: In a microwave or in a small pot on the stovetop, heat the milk until steamy. (Preheating the milk saves time in the next step when you are making the bechamel sauce.)', '4 Preheat oven broiler at 500\\xc2\\xb0F.', '5 Make roux with butter and flour: Melt 4 Tbsp butter in a thick-bottomed oven-safe pot on medium high heat. When the butter is melted and starts to foam sprinkle with 3 Tbsp of flour. Whisk to combine. Lower the heat to medium and cook for 1 to 2 minutes.', '6 Add milk and spices to roux: Pour in the hot milk and whisk vigorously to combine, breaking up any clumps of flour. Lower the heat to medium low and let cook, whisking frequently, until the sauce is smooth and thick enough to coat the back of a spoon.', 'Stir in the dry mustard, paprika, nutmeg, black pepper, Worcestershire sauce, and 1 teaspoon of salt.', '7 Whisk in cheeses: Whisk in 1 1/2 cups grated cheddar and the 1/2 cup of Parmesan cheese. Stir until the cheese is melted and the sauce is smooth.', '8 Stir in broccoli, top with cheese, broil: Stir in the broccoli and the pasta until well combined. Sprinkle the remaining 1/2 cup grated cheddar cheese on top and place under preheated broiler for 5 to 7 minutes until bubbly and lightly browned.', 'Add more salt and pepper to taste.']",10
324,Broccoli and Cheddar Quesadillas Recipe,15,15,30,"['2 cups broccoli florets', '12 ounces grated cheddar cheese (about 4 loosely-packed cups)', '4 large 12-inch flour tortillas', 'Vegetable oil, for tortillas', '1 medium avocado, sliced thin or chopped for serving', 'Sour cream, for serving', 'DAD ADD: Quick Spicy Pico de Gallo', '1/2 red onion, minced', '1 ripe tomato, minced', '1 jalape\\xc3\\xb1o, seeded and minced', 'Fresh lime juice', 'Pinch of salt']",12,"['1 Blanch and chop the broccoli: Bring a medium pot of salted water to a boil. Add the broccoli and blanch until it\\xe2\\x80\\x99s bright green and fork tender, about 3 minutes. Then drain the broccoli, let it cool slightly and chop it finely.', '2 Make the pico de gallo: If you\\xe2\\x80\\x99re using the Dad Add, now would be a good time to chop that stuff up (highly recommended). Combine the minced ingredients in a bowl and set aside.', ""3 Preheat a large skillet over medium-low heat. If you haven't already grated your cheese, do it now."", '4 Assemble and cook the quesadillas: Brush one tortilla lightly with vegetable oil on one side and add it to the warmed skillet, oiled side down. Sprinkle a loosely packed cup of grated cheese (about 3 ounces) on one half of the tortilla. Top with 1/2 cup of chopped broccoli.', 'Fold the tortilla over to cover the filling and form a half-circle. Cook the quesadilla for about 3 minutes per side until it\\xe2\\x80\\x99s crispy and the cheese is melted.', 'Repeat with making the other quesadillas. (Though if you\\xe2\\x80\\x99re good\\xe2\\x80\\x94and your skillet is large enough\\xe2\\x80\\x94you can make two at a time in the same skillet!)', '5 Serve the quesadillas: Cut the quesadillas into triangular segments, and serve with sour cream, avocado, and the spicy pico!']",7
325,Oven Roasted Broccolini Recipe,5,8,13,"['2 bunches broccolini (about 1 1/4 pound total), trimmed', '3 cloves garlic, minced (about 3 teaspoons)', '4 tablespoons extra virgin olive oil', 'Salt', 'Pepper']",5,"['1 Preheat oven broiler.', '2 Line a roasting pan with aluminum foil. Spread the broccolini out in an even layer. Sprinkle the garlic over the broccolini. Drizzle the olive oil over the broccolini. Sprinkle with salt and pepper.', '3 Place under the broiler and cook for 6 to 8 minutes (keep an eye on it!), until lightly browned and the stalks are fork tender.', 'Serve immediately.']",4
326,"Broccoli, Chicken, and Almond Saut\xc3\xa9 Recipe",10,20,30,"['1/2 pound to 3/4 pound boneless skinless chicken breasts', 'Kosher salt', 'Extra virgin olive oil', 'Your favorite spice rub for grilling (optional)', '1 pound broccoli florets', '1/4 teaspoon chile flakes (more to taste)', '1/3 to 1/2 cup toasted almonds, roughly chopped', '1 teaspoon dark sesame oil', 'Freshly ground black pepper']",9,"['1 Put salted water on to boil: Put a 2 quart pot of salted water (about 1 Tbsp of salt) on to boil. While the water is heating, start the chicken cooking in the next step.', '2 Season the chicken breasts: Place the chicken breasts in a bowl and sprinkle seasoning on all sides. Use at a minimum some salt. Or if you have a favorite spice rub, you can use that too.', ""3 Sear and slice the chicken breasts: Heat a grill pan, or prepare a grill, for high, direct heat. (If you don't have a grill pan or grill, use a cast iron skillet, and only season the chicken with salt.)"", 'Rub some olive oil all over the chicken breasts. Grill the breasts for a few minutes on each side to get some nice char marks, then lower the temperature to low and leave on the grill until the breasts are just almost cooked through.', ""They'll cook a little longer in the saut\\xc3\\xa9 pan, so they can still be a little pink in the middle at this point."", 'Remove from pan or grill, set aside for a minute, then thinly slice.', '4 Blanch broccoli florets: Once the chicken has cooked and the water is boiling, add the broccoli florets to the salted boiling water. Allow the water to come back to a boil, and once boiling again, let cook for about 1 minute. Drain.', '5 Stir-fry chili flakes, broccoli, chicken, toasted almonds: Heat a tablespoon of olive oil in a large saut\\xc3\\xa9 pan on high heat. Add the red chili flakes. Once the red chili flakes are sizzling, add the broccoli florets, sliced grilled chicken, and toasted almonds.', 'Drizzle dark sesame oil over the broccoli and chicken, sprinkle with salt and freshly ground black pepper to taste. Toss and cook until all of the chicken pieces are no longer at all pink in the center, a minute or two.', 'Serve immediately.']",10
327,Sous Vide Chicken and Broccoli Recipe,20,120,140,"['4 medium chicken breasts (6 to 8 ounces each)', '1 teaspoon salt', '1/4 teaspoon black pepper', '1 lemon, sliced thin', '1 1/2 pounds broccoli florets', '2 teaspoons sesame oil', '1/2 teaspoon red pepper flakes', 'Pinch of Kosher, sea or table salt', 'Special equipment:', 'Sous vide immersion circulator', 'Gallon-sized zip-top plastic freezer bags']",11,"['You can do this in the pot of water as it heats. (Just be careful if the water is already steaming!)', 'Set the chicken aside on a kitchen towel until the water has finished heating. At this point you can also freeze the bag if you want to store the prepared chicken for later.', '4 Prepare the broccoli: Place the florets in a gallon-sized zip-top freezer bag, and season with red pepper flakes and sesame oil. To weight the broccoli down, add a few heavy soup spoons to the bag (or plan to place a heavy bowl over the top of the water bath to keep the broccoli submerged).', 'Use the same water displacement technique to seal the broccoli bag.', ""5 Cook the broccoli and chicken. Once the water has come to temperature, add the chicken and broccoli to the water and cook for 2 hours. Make sure your cooking bags are completely submerged in the water; place a heavy bowl over the pot if the spoons aren't keeping the broccoli submerged."", 'I also like to rotate all the bags halfway through cooking to make sure they are cooking evenly, as sometimes they can get jostled around in the water.', 'When cooking time ends, remove from the water and turn off the circulator.', '   6 Serve the chicken: Remove the chicken and broccoli and portion in lunch-sized portions or serve for dinner.']",8
328,Broccoli Apple Soup Recipe,15,40,55,"['1 large bunch of broccoli (about 3 heads with stems)', '3 Tbsp butter', '1 cup of thinly sliced or finely chopped yellow or white onion', '1 good cooking apple (a non-tart apple such as Jonagold, golden delicious, McIntosh), peeled, cored, chopped', '3 cups of chicken stock', '1 cup of unfiltered apple juice or apple cider (not hard cider)', '4 sprigs of lemon thyme or thyme', '2 long strips of lemon zest', '1 Tbsp chopped fresh chives for garnish']",9,"['1 Prep the broccoli: Separate the broccoli florets from the stems. Peel the outer tough skin of the stems with a vegetable peeler. Slice the stems into rounds and chop finely (a mini chopper food processor works well for this step).', '2 Cook the sliced onions and apples in butter: Heat a thick-bottomed medium large (4-quart) saucepan on medium heat. Melt the butter in the pan. Add the onion and the apple and lower the heat to low. Cover and cook for 10 minutes, until onions are translucent and apples are softened.', '3 Add broccoli, stock, cider, thyme, lemon zest: Add the broccoli florets and the chopped broccoli to the apple onion mixture. Add the stock and the cider.', 'Tie up the thyme sprigs with kitchen string and add to the pot. Add strips of lemon zest to the pot as well.', 'Increase the heat, bring to a boil, reduce the heat to maintain a low simmer, covered. Cook for 20 to 25 minutes.', '4 Pur\\xc3\\xa9e soup: Remove from heat. Remove thyme and lemon peels from the soup (discard)! Working in batches, filling up the blender bowl to no more than one third full at a time, pur\\xc3\\xa9e the soup.', '5 Adjust seasonings: Return soup to the pot, reheat and adjust seasonings to taste. Garnish with chopped fresh chives to serve.']",7
329,Romanesco Salad Recipe,20,30,50,"['2 heads romanesco (2 1/2 to 3 pounds total)', 'Salt', '2 stalks celery, thinly sliced', '1/2 large red onion, or one small red onion, thinly sliced', '1 cup loosely packed fresh parsley leaves', '2 tablespoons capers, rinsed and drained', '1 teaspoon grated lemon zest', 'Freshly ground black pepper', 'For the dressing:', '1 clove garlic', '3 tablespoon red wine vinegar', '1/2 teaspoon salt', '1/2 anchovy, minced (optional, omit if cooking vegetarian)', '1/4 cup high quality extra virgin olive oil']",14,"['1 Steam romanesco wedges: Cut the romanesco heads into quarters, stalk to tip. Cut out the tough core and any outside green leaves. Cut again lengthwise.', 'Place into a steamer basket in a pot with about an inch of water.  Sprinkle the romanesco florets with a little salt. Bring water to a boil. Cover and steam until just tender, about 7 to 10 minutes.', 'Remove romanesco florets from steamer, place into a bowl, and chill.', '2 Soak onion slices in water a few minutes: Thinly slice the red onion, across the grain. Place the red onion slices in a bowl and cover with water. This will take the onion-y edge off the onion, making it easier to eat raw in the salad.', ""3 Make dressing: Smash the whole clove of garlic (not cut, just smash with the flat side of a chef's knife) and place in the bottom of a small bowl. Add the vinegar and salt, stir to dissolve the salt. Add the minced anchovy if using. Then whisk in the olive oil."", '4 Marinate the salad: Break up the wedges of romanesco into smaller chunks of florets. Place into a large serving bowl. Add celery, onions (drained of the water), parsley, capers, and lemon zest.', 'Remove the garlic clove from the dressing and add dressing to the romanesco salad. Toss to coat with the dressing. Let marinate for at least 15 minutes, preferably an hour. Even better overnight.', 'Sprinkle with freshly ground black pepper to serve.']",8
330,"Roasted Broccoli Salad with Feta, Barley, and Pomegranate Recipe",15,30,45,"['For the salad:', '2/3 cup pearl barley', '2 pounds broccoli with the stems', '2 tablespoons olive oil', '1/4 teaspoon salt', 'Freshly-ground black pepper', '1/3 cup sliced almonds', '4 handfuls fresh baby spinach leaves', '1/2 cup crumbled feta', 'Seeds (arils) from 1/2 pomegranate, about 1/2 cup', 'For the dressing:', '2 tablespoons balsamic vinegar', '1 tablespoon lemon juice', '1 teaspoon Dijon mustard', 'Salt and pepper, to taste', '1/3 cup olive oil']",16,"['1 Cook the barley: Bring a medium saucepan of salted water to a boil. Add the barley, turn the heat to simmer, and cook, uncovered, for 30 minutes, or until tender. Drain and set aside.', '2 Meanwhile, begin heating the oven to 450F. Line a rimmed baking sheet with parchment.', '3 Prep the broccoli: Separate the broccoli crowns from the stems. Separate the crowns into florets. Peel off the tough outer skin from the stems with a vegetable peeler, and then cut into bite-size pieces.', '4 Roast the broccoli: On the baking sheet, spread the broccoli florets and stems and sprinkle with the oil. Use your hands to massage the oil into the broccoli so it is well coated, and spread in one layer. Sprinkle with 1/4 teaspoon salt and some freshly-ground black pepper.', 'Roast for 15 minutes, or until tender. Remove and let cool.', ""5 Toast the almonds: As the broccoli roasts, spread the almonds in one layer on a baking sheet and toast in the oven for 3 to 5 minutes, or until golden. Watch carefully so they don't burn. Remove and let cool"", '6 Make the dressing: In a small bowl, whisk the vinegar, lemon juice, mustard, salt and pepper together. Gradually whisk in oil.', '7 Assemble the salad: In a bowl, toss the barley, broccoli and spinach with the dressing. Transfer to plates or bowls and sprinkle with the almonds, feta and pomegranate seeds.']",8
331,"Grilled Pizza with Red Peppers, Broccoli, and Onions Recipe",20,15,35,"['1 (1-pound) ball pizza dough, store-bought or homemade', 'Olive oil for saut\\xc3\\xa9ing vegetables, and coating and brushing the dough', '1/2 cup sliced red onions', '1/2 bell pepper, thinly sliced', 'Kosher salt and freshly ground pepper to taste', '1/2 cup chopped broccoli', '1/2 cup sliced black olives', 'Coarsely ground cornmeal or flour for rolling and stretching the dough', '1 cup tomato sauce, store-bought or homemade', '2 cups (8 ounces) shredded mozzarella cheese, preferably fresh', '1/4 cup slivered fresh basil leaves (optional)']",11,"['1 Divide and rest the dough: Divide the dough in half and gently shape into two balls. Gently coat each with olive oil and allow the dough to come to room temperature for about an hour, either in a large bowl or on the counter covered with a dishtowel.', '2 Prep the toppings: Heat 1 tablespoon olive oil in a large skillet with a lid over medium heat.  Add the onions and peppers, season with salt and pepper, and saut\\xc3\\xa9 for 6 minutes, until tender and lightly browned.', 'Add the chopped broccoli and saut\\xc3\\xa9 for another minute. Add 2 tablespoons water, and cover the pan with a lid. Cook for 1 minute, then remove the lid, and saut\\xc3\\xa9 for another minute or two until the broccoli is just tender and the water has evaporated. Stir in the olives and transfer the vegetables to a plate.', '3 Shape the pizza rounds: Sprinkle a lightly oiled baking sheet with cornmeal or flour. Use two baking sheets if you want more space or are making multiple pizzas. Gently begin to stretch or roll each ball into a 12-inch circle, or a rectangle shape.', 'You will need to stretch or roll it a bit, give it a few minutes to relax, and then continue to stretch it so that it doesn\\xe2\\x80\\x99t keep springing back into a smaller shape, which is easier to do when your dough is at room temperature. The goal is about to get it about 1/4 inch thick (it will puff up on the grill). Give it one final stretch and don\\xe2\\x80\\x99t worry if it\\xe2\\x80\\x99s unevenly shaped.', '4 Heat the grill and gather your toppings: Heat a gas or charcoal grill to medium heat. Put your sauce in a small bowl, and bring that along with a brush, grill tongs, a grill spatula, the cheese, the dough, and the vegetables out to the grill.', '5 Grill the dough on the first side: Brush the top of the shaped pizza rounds with olive oil, and with a swift motion, pick up one round of the dough by one edge and flip it, oiled-side down, onto the grill. Repeat with the other round of dough.', 'Close the lid and don\\xe2\\x80\\x99t open it for 2 minutes, so the dough can rise a bit and firm up. Open the lid, peek underneath the dough using tongs, and check to see that it\\xe2\\x80\\x99s firm on the bottom (no wet dough), lifts easily, and has some light grill marks.', 'Lightly brush the unbaked tops of the crusts with olive oil, and then flip them over to the other side.', '6 Immediately add the sauce and toppings: Carefully brush the surface of each crust with the sauce. Sprinkle the cheese evenly over the tops followed by the toppings.', 'Close the lid and cook for 4 minutes. Lift the lid and check the pizzas: the cheese should be completely melted and the crust should have a nicely browned underside and barely bend when you lift it with tongs.', '7  Serve the pizzas: Remove the pizza from the grill with a large spatula, sprinkle with the fresh basil if using Let it sit for 1 to 2 minutes for the cheese to firm up slightly before cutting it into pieces.']",12
332,Sheet Pan Salmon and Broccoli with Miso Butter Recipe,10,25,35,"['4 tablespoons (1/2 stick) unsalted butter, at room temperature', '2 tablespoons red, white or yellow miso', '1 1/2 pounds whole broccoli heads or crowns, with stems', '2 tablespoons olive oil', '1/2 teaspoon salt', '1/4 teaspoon black pepper', '4 (6-ounce) center-cut salmon fillets, 1 to 1 1/2 inches thick', '2 tablespoons chopped parsley, to garnish', '2 scallions, thinly sliced, to garnish', 'Baked or roasted potatoes, to serve (optional)', 'Special equipment:', 'Rimmed baking sheet']",12,"['1 Preheat the oven: Center a rack in the oven and preheat the oven to 450\\xc2\\xbaF.', '2 Make the miso butter: In a small bowl, stir the miso and butter until smooth.', '3 Prepare the broccoli: With a paring knife, cut a sliver off the tough end of the broccoli stalk. Separate the stalk from the head\\xe2\\x80\\x94where the stalk starts to branch. Peel the stalk with a vegetable peeler and slice it into 3- to 4-inch sticks. Cut the crown lengthwise into 3 to 4 pieces.', '4 Roast the broccoli: Mound the broccoli in the center of the baking sheet. Sprinkle with the oil, salt, and pepper and use your hands to massage the oil over the broccoli.', 'Spread the oiled broccoli on the baking sheet in one layer. Roast in the oven for 15 minutes, stirring and flipping the veggies halfway through. Remove the broccoli from the oven and turn the temperature down to 425\\xc2\\xbaF.', '5 Roast the salmon: Make space on the baking sheet for the salmon, and place the salmon on the sheet with the skin side down. Sprinkle lightly with salt and pepper. Use a butter knife to spread the miso butter over the fillets.', 'Roast the salmon and broccoli together for 10 minutes longer, or until a thermometer inserted into the thickest part of the salmon registers 135\\xc2\\xbaF. Remove from the oven.', '6 Finish under the broiler. Move an oven rack close (3- to 4-inches) to the broiler and turn on the broiler. If necessary, spread the now-softened miso butter evenly over the fillets, and broil for 1 to 2 minutes, or until the fillets are charred at the edges.', 'Remove and let the salmon rest for 5 minutes. Sprinkle with parsley and chopped scallions and serve with baked potatoes, if you like.']",9
333,Loaded Baked Potatoes Recipe,10,60,70,"['6-8 strips bacon', '6 medium-large russet potatoes, scrubbed well', '2 tablespoons olive oil', '1 teaspoon kosher salt', '1 pound fresh broccoli, cut into florets (or use frozen)', '8 ounces grated sharp cheddar cheese', 'To serve:', 'Sour cream', 'Fresh chives', 'Dad Add: Quick Home Fries (serves 2):', '1 baked potato, diced', '1 tablespoon olive oil', '1/2 teaspoon seasoned salt', 'Eggs, for serving']",14,"['1 Prepare the bacon: Line a baking sheet with foil, then top with a wire baking rack (cookie cooling rack). Lay the bacon strips on the wire rack perpendicular to the wires, making sure the bacon pieces don\\xe2\\x80\\x99t overlap.', '2 Bake the bacon and scrub the potatoes: Place the bacon in a cold oven and set the temperature to 375\\xc2\\xb0F. Bake for 15-20 minutes. Check the bacon around the 18-minute mark. Some types of bacon cook faster than others. (See How to Make Bacon in the Oven for full details.)', 'While the bacon bakes, scrub potatoes well and then stab each potato about 10 times with a fork to prevent the possibility of a potato exploding in the oven. (It can happen!)', 'Remove the bacon from the oven; transfer to a paper towel-lined plate.', '3 Bake the potatoes: Increase the heat to 400\\xcb\\x9aF. Place potatoes on a baking sheet, drizzle well with olive oil, and sprinkle with coarse salt. Bake potatoes for about an hour until the skins are shriveled slightly and the potatoes are very tender. (See How to Bake a Potato for more details.)', '4 Blanch the broccoli: While the potatoes bake, cook your broccoli. Bring a large pot of water to a boil. Add a big pinch of salt to the water to season it. Add broccoli to the water and boil for 3 minutes until the broccoli is just tender, but not mushy at all.', 'Drain broccoli once it is tender and set aside for assembly. We will warm everything up once the potatoes are assembled at the end.', '5 Open the potatoes: Once your potatoes are baked, let them cool slightly so you can handle them. Cut each potato down the center, being careful not to cut all the way through. Then cut two perpendicular cuts near the end of each potato; this will allow you to open each potato up easier. I like to use a small paring knife to slice up the interior of the potato, making it easier to unfold and stuff.', '5 Stuff the potatoes: Sprinkle some cheese over the potato. I like a lot of cheese, but feel free to use as much or as little as you\\xe2\\x80\\x99d like. Top with about 1/2 cup of cooked broccoli and 1 piece of crumbled bacon. Sprinkle the broccoli with more cheese and more broccoli or bacon depending on the size of the potato and the size of your appetite!', '6 Reheat the potatoes: Place the stuffed potato back in the oven for 5-10 minutes to really melt the cheese and warm the fillings.', '7 Serve: Top the warm potatoes with sour cream and chives and serve.', 'Leftovers: Store any extra potatoes before filling them. Leftover potatoes can be used within a week for baked potatoes, loaded potatoes, or quick Dad Add home fries!', '8 How to Make Dad Add Home Fries: Cut a leftover potato into about 1/4-inch cubes. Into a medium skillet set over medium heat, add the olive oil. When the oil starts to shimmer, add the potato cubes and seasoned salt. Cook for 10-12 minutes, stirring occasionally, until the potatoes are crispy and browned on the edges. Remove from skillet and serve with eggs.']",13
334,Cheesy Crustless Quiche with Broccoli and Ham Recipe,15,30,45,"['Vegetable oil spray (for the pan)', '1 medium stalk broccoli, stem and crown', '5 ounces ham steak, cubed', '1 1/2 cups grated cheddar (about 7 ounces)', '2 large eggs', '3 large egg yolks', '1 1/2 cups heavy cream', '1/4 teaspoon salt', '1/8 teaspoon black pepper', 'Special equipment:', '9-inch round baking dish or pie pan']",11,"['1 Prepare the oven and baking dish: Place a rack in the center of the oven. Preheat the oven to 375\\xc2\\xb0F. Spray a 9-inch round ceramic baking dish or pie pan with vegetable oil. Have a baking sheet on hand.', '2 Prepare the broccoli: Bring a large saucepan of salted water to a boil. Cut a sliver off the bottom of the broccoli stem and peel the stem with a vegetable peeler. Slice the stem into 1/2 inch-thick, bite-size pieces. Cut the broccoli crown into small florets.', 'Cook the broccoli in the boiling water for 4 to 5 minutes, or until tender. Strain the broccoli to remove the water, and spread the broccoli over the bottom of the baking dish.', '3 Add the ham and cheese to the baking dish: Distribute the ham cubes over the broccoli. Reserve 1/2 cup of the cheese to sprinkle on top of the filled quiche. Sprinkle the remaining cheese over the broccoli.', '4 Make the custard: In a medium bowl, whisk the eggs and egg yolks together. Whisk in the cream, salt, and pepper. Pour the cream mixture over the filling in the pan and sprinkle the top with the reserved cheese.', '5 Bake the quiche: Set the baking dish on the baking sheet and place it in the oven. Decrease the oven temperature to 350\\xc2\\xbaF.', 'Bake the quiche for 30 minutes, or until the top is golden and the center puffs, but is still slightly wobbly in the center.', '6 Cool the quiche: Set the baking dish on a wire rack to cool for at least 30 minutes before cutting into wedges. Quiche can be served warm or at room temperature.']",8
335,Charred Skillet Broccoli Recipe,5,10,15,"['1 medium head broccoli (about 1 pound)', '1 tablespoon olive oil', 'Salt and pepper to taste']",3,"['1 Prep the broccoli: Rinse the broccoli. Trim off and discard the woody lower part of the stem (likely an inch or half an inch). Cut the remaining stem off from the head.', 'With a vegetable peeler, peel the outer layers of the stem off and discard them. Cut the tender centers into coins across the grain, then chop those up into little bits. Shred up the blossom ends of the broccoli. You\\xe2\\x80\\x99re aiming for pieces between the size of a pea and an almond.', '2 Cook the broccoli: Set a large skillet over medium-high heat for a minute or less. Add the olive oil; when it shimmers, add the broccoli. Stir it around every minute or so. Season generously with salt.', 'After 5 minutes of cooking, reduce the heat incrementally so the broccoli does not burn. You\\xe2\\x80\\x99ll end at medium heat. Some bits will get charred and brown, while others steam and become soft and sweet. This is exactly what you want.', 'After about 10 total minutes of cooking, your broccoli will be ready. The volume will have reduced by about half, and there will not be any raw pieces of broccoli left.', '3 Season and serve: Taste the broccoli, and, if needed, adjust the seasoning with salt and pepper. Serve hot. Leftovers will keep about 5 days in the refrigerator, or 6 months in the freezer.']",6
336,Broccoli Rabe with Caramelized Onions Recipe,5,30,35,"['3 tablespoons extra virgin olive oil', '1 yellow onion, sliced into slivers, lengthwise (with the grain)', '1 large bunch of broccoli rabe (raab, rapini), rinsed and cut into 2-inch long pieces', '2-3 garlic cloves, sliced', '1/4 teaspoon red chili flakes', 'Salt', 'Freshly ground black pepper']",7,"['1 Brown the onions: Heat 2 tablespoons of olive oil in a large saut\\xc3\\xa9 pan on medium heat. Add the onions, spread out in a thin layer. Cook, stirring occasionally until softened and then lightly browned.', '(Tip: to speed up the caramelization process you can sprinkle a pinch of sugar over the onions.) If the onions start to dry out at all, lower the heat (you can add a little water to them too.) They should brown, but not get dried out.', ""2 Blanch the broccoli rabe: After you start the onions, bring a large pot of water to a boil. The onions take at least 15 minute to cook, so you'll have time to get the water boiling. Salt the water (about a tablespoon of salt for 3 quarts of water)."", 'Prepare an ice bath, fill a large bowl half way with ice water.', 'Add the rabe to the boiling water. Blanch for 1 minute. Use a slotted spoon to remove from the boiling water and put in the ice bath to stop the cooking. Shocking the rabe with ice water will also help keep the rabe bright green colored.', ""Note that some people blanch their rabe, some do not. Rabe can be rather bitter, so blanching will help take the edge off of the bitterness. If your rabe isn't particularly bitter, or you like bitter greens, you can easily skip this blanching step."", 'Drain the ice water from the rabe. Use a clean tea towel to gently wring out the excess moisture from the rabe.', '3 Saut\\xc3\\xa9 the rabe and onions with chili flakes and garlic: Once the onions are lightly browned, remove them from the pan to a bowl. Using the same pan, add another tablespoon of olive oil and heat the pan on high heat. Add the chili flakes. Once the chili flakes start to sizzle, add the garlic.', 'Once the garlic just starts to brown at the edges add the broccoli rabe and the onions.', 'Toss the rabe mixture so that it gets well coated with the olive oil. Cook on high heat until most of the moisture is gone, about 5 minutes if you blanched first, a minute or too longer if you skipped the blanching.']",10
337,Shell Pasta with Sausage and Greens Recipe,15,30,45,"['1 pound (450 g) shell or ear-shaped ""Conchiglie"" pasta', 'Salt', '1 1/2 cups (350 ml) water or chicken stock', '12 ounces (340 g) Italian sausage, sweet or hot, or a mixture of both', '12 ounces (340 g) bunch of kale, broccoli rabe, or other green, chopped (if using kale, or leafy green, remove and discard center stem)', '2 green onions, chopped', '6 garlic cloves, minced', '1/4-1/2 teaspoon hot red pepper flakes', '1/4 cup (25 g) grated fresh Parmesan cheese']",9,"['1 Cook pasta in salted water: Bring 2 quarts of salted water to a boil (1 tablespoon of salt for 2 quarts of water). Add the pasta and cook as directed on the package, until al dente.', '2 Cook the greens in salted water: While pasta is being prepared, heat 1 1/2 cups of water with 1/2 teaspoon of salt in a saucepan until simmering. (Can use chicken stock instead for added flavor). Add the kale or rabe and cook for 8 minutes, or until tender. Strain and set aside.', '3 Lightly brown the sausage: While greens are cooking, remove the sausage from their casings (if in links) and crumble onto a large saut\\xc3\\xa9 pan. Heat on medium heat and gently cook until lightly browned, about 8 minutes. Use a slotted spoon to remove the sausage from the pan to a bowl, set aside.', '4 Cook green onions and garlic: Add the chopped green onions to pan, saut\\xc3\\xa9 until soft. Add garlic and cook for a minute more.', '5 Combine pasta, onions, sausage, greens, Parmesan: When pasta is done, drain and add to the pan with the green onions. Add the sausage and kale (or rabe) to the pan and toss to combine. Sprinkle with Parmesan cheese. Add chile pepper flakes to taste.', 'Note: You might want to try experimenting with adding some saut\\xc3\\xa9ed bell pepper.']",6
338,Broccoli Rabe with Pasta and Sun Dried Tomatoes Recipe,15,15,30,"['1 pound (a large bunch) broccoli rabe, rinsed, cut into 1 1/2 to 2 inch pieces', 'Salt', '2 tablespoons extra virgin olive oil', '1/4 to 1/2 teaspoon red pepper flakes (depending on how spicy you like things)', '1 large clove garlic, chopped (about 1 to 2 teaspoons chopped)', '2 ounces sun dried tomatoes (packed in oil), roughly chopped', '8 ounces penne pasta (or other favorite short pasta)', '1/2 ounce freshly grated Parmesan cheese', 'More salt', 'Freshly ground black pepper']",10,"['1 Blanch the broccoli rabe: Bring two large pots (4-quart pots filled at least half-way) of water to a boil, one pot for blanching the broccoli rabe, the other for the pasta.', 'Whichever pot comes to a boil first, into it place the broccoli rabe. Blanch only for one minute, then use a slotted spoon to remove the rabe from the hot water to a large bowl of ice water to stop the cooking.', 'Drain the rabe and pat dry with paper towels.', '2 Cook the pasta: Typically penne pasta takes about 10 minutes to cook to al dente. So start the pasta before you start saut\\xc3\\xa9ing the rabe.', 'When the water comes to a rolling boil, add a tablespoon of salt to it, let the salt dissolve, then add the pasta.', 'Once the water returns to a boil, start the timer. Let the pasta cook, at a rolling boil, uncovered, for whatever time is necessary to cook it to al dente, cooked through but still a little firm.', '3 Saut\\xc3\\xa9 the blanched broccoli rabe with garlic and chili flakes: Once the pasta is in the water, heat 2 tablespoons of olive oil in a large saut\\xc3\\xa9 pan on medium to medium high heat.', 'Add the chopped garlic and the red chile flakes. Cook until the garlic just begins to brown at the edges.', 'Then add to the pan the blanched broccoli rabe. Toss to coat with the olive oil, chile flakes, and garlic. Sprinkle with salt.', '4 Add sun dried tomatoes, pasta, and Parmesan: Cook the broccoli rabe about 5 minutes, until just tender. Stir in the chopped sun dried tomatoes.', 'When the pasta is done, drain it and add it to the rabe.', 'Sprinkle everything with black pepper and the grated Parmesan cheese. Toss to combine.', 'Serve immediately.']",13
339,Roasted Broccolini with Creamy Mustard Sauce Recipe,5,15,20,"['For the sauce (makes 1 1/4 cups):', '1 cup raw unsalted cashews', '1/2 cup water', '1/4 cup fresh lemon juice', '2 tablespoons extra-virgin olive oil', '2 tablespoons Dijon mustard', '1 teaspoon apple cider vinegar', '1/2 teaspoon onion powder', '1/2 teaspoon garlic powder', '1/2 teaspoon fine sea salt (or regular salt)', '1/8 teaspoon red pepper flakes', 'For the broccolini:', '1 pound (460g) broccolini', '3 1/2 tablespoons extra-virgin olive oil', '1/2 teaspoon salt, plus more to taste', '1/8 teaspoon freshly ground black pepper, plus more to taste', '2 tablespoons finely chopped fresh garlic', '1/2 cup sliced raw almonds', '1 1/2 tablespoons fresh lemon juice', '1/2 teaspoon finely grated lemon zest, plus more to taste']",20,"['1 Soak the cashews for the sauce: Soak the cashews for 2 hours in a bowl covered with filtered water, then drain. Alternatively, quick-soak the cashews by covering them with boiled water and soaking for 10 minutes, then draining.', '2 Preheat the oven to 425F. Line a baking sheet with parchment paper.', '3 Roast the broccolini: Toss the broccolini with 2 tablespoons of the olive oil, 1/4 teaspoon of the salt, and the pepper. Roast for 10 to 15 minutes or until tender and slightly crispy.', '4 While the broccolini is roasting, make the dressing. Throw the soaked and drained cashews, water, lemon juice, olive oil, mustard, vinegar, onion powder, garlic powder, salt, and red pepper flakes into your blender. Blast on high for 30 to 60 seconds until smooth and creamy.', '5 Prepare the garlic and almonds: In a small pan over medium-low heat, warm the remaining 1 1/2 tablespoons of olive oil and cook the garlic for 1 to 2 minutes until fragrant and just starting to brown.', 'Add the almonds, and stir for about 1 minute, or until just warmed. Stir in the lemon juice and zest. Remove the pan from heat.', '6 Top the broccolini and serve: Remove the roasted broccolini from the oven and transfer to a platter. Sprinkle the almond mixture over the top of the broccolini, and season with additional lemon juice, zest, salt, and pepper to taste.', 'Drizzle with a small amount of the sauce, and pass the remaining sauce at the table. Serve warm.']",8
340,Oatmeal Chocolate Chip Cookies Recipe,30,20,50,"['1 cup (2 sticks, 8 ounces, 225 g) unsalted butter', '1 1/2 cups all-purpose flour', '1 teaspoon salt', '1 teaspoon baking soda', '1 teaspoon cinnamon', '1/4 teaspoon nutmeg', '1 cup brown sugar, packed', '1/2 cup white granulated sugar', '2 large eggs, lightly beaten', '1 teaspoon vanilla extract', '2 tablespoons water', '1 1/2 cups semi-sweet or bittersweet chocolate chips', '1 cup chopped pecans (optional)', '1 cup sweetened, shredded coconut (optional)', '3 cups rolled oats (old fashioned or quick oats, do not use steel cut or instant)']",15,"['1 Prep the oven and the baking sheets. Preheat the oven to 350\\xc2\\xb0F. Butter two large cookie sheets, or line them with silicone mats or parchment paper.', ""2 Brown the butter: Place sticks of butter in a thick-bottomed medium sized stainless steel saucepan or other pan with a light, reflective interior. Otherwise you won\\'t be able to see the butter browning."", 'Heat on medium. Melt the butter, whisking so that the butter melts evenly.', 'Continue to cook the butter. As it cooks, the butter will foam up, and then the foam will subside. Whisk frequently to check underneath the bubbly surface.', ""At some point, browned bits will form at the bottom of the pan and the butter will begin to smell nutty. Watch carefully\\xe2\\x80\\x94it\\'s easy for the butter to go from browned to burnt."", 'When the browned bits begin to form, remove the pan from the heat. Pour the melted butter, with the browned bits, into a glass or metal bowl. Allow to cool a bit while you prepare the other ingredients.', '3 Mix the dry ingredients: Vigorously whisk together the flour, salt, baking soda, nutmeg, and cinnamon together in a large bowl.', '4 Make the dough: Place the browned butter (along with the browned bits) in the bowl of a stand mixer. Add the brown and white sugar. Beat on medium-high until smooth, about 3 minutes.', 'Add the eggs and vanilla. Beat for 3 more minutes on medium speed until smooth and light.', '5 Stir in flour mixture and some water: Using a wooden spoon, stir the flour mixture into the batter.', 'Stir in 2 tablespoons of water (note that if you are using jumbo eggs, and not large eggs as the recipe calls for, you will probably not need this much extra liquid.)', '6 Stir in chocolate chips and oats: Stir in the chocolate chips, and the pecans and shredded coconut (if using). Stir in the rolled oats.', 'Up to this point you can make the dough up to a day and a half ahead and store in the refrigerator.', '7 Spoon cookie dough onto lined cookie sheets: Spoon out heaping tablespoons of cookie dough and lay them on lined cookie sheets. Make sure you have about 2"" of space between each cookie, as they will flatten a little and spread on the cookie sheet as they bake.', '8 Bake: Bake at 350\\xc2\\xb0F for 10 minutes, or until they are just brown around the edges, but still soft in the center. They will firm up as they cool. (If you want them crispier, you can bake them from 12 to 14 minutes, but 10 minutes will yield a more chewy cookie.)', '9 Cool: Take the cookies out of the oven and let them cool for two or three minutes on the hot baking sheet. Then, using a metal spatula, carefully transfer the still-hot cookies to a wire rack to cool.', 'They will continue to be soft until completely cooled. Once completely cooled, store in an airtight container for 3 to 5 days.']",17
341,How to Make Brown Butter,0,0,0,['Unsalted butter'],1,"['1 Melt the butter: Heat a thick-bottomed skillet on medium heat. Add the butter (if you slice it, it will melt more evenly) whisking frequently. Continue to cook the butter.', '2 Watch for brown specs and nutty aroma: Once melted the butter will foam up a bit, then subside. Watch carefully as lightly browned specks begin to form at the bottom of the pan. Smell the butter; it should have a nutty aroma.', '3 Remove from heat and pour into a bowl to stop the butter from cooking further and perhaps burning.', ""It's pretty easy to overcook browned butter and go from brown to burnt. If the butter starts to blacken, I suggest dumping it and starting over (something I've had to do on occasion), unless you want beurre noir which has a different taste than nutty brown butter."", 'If you want to make sage brown butter sauce, add some fresh sage leaves to the butter once it has melted. Allow the butter to brown and remove from heat.', 'Use browned butter immediately or store covered in the refrigerator for future use.']",6
342,Butternut Squash with Brown Butter and Thyme Recipe,15,35,50,"['1 1/2 pounds butternut squash, peeled, seeds removed, flesh diced into 1/2-inch pieces (about 4 cups)', '3 tablespoons butter', '1 tablespoon chopped fresh thyme (or 1 teaspoon of dried)', 'Salt and freshly ground black pepper']",4,"['1 Brown the butter: Heat a large skillet on medium heat. Add the butter, whisking frequently. Once melted the butter will foam up a bit, then subside. Honey-colored browned milk solids will begin to form. The butter should have a wonderful nutty aroma.', 'Remove from heat. Add the thyme, whisking continuously. If using fresh thyme, the mixture will foam up a bit.', ""(Note that it doesn't take much time to go from browned butter to burnt butter. You will want to remove the pan from the heat element and place it on a cool surface to help stop the cooking of the butter. If the butter burns, I recommend dumping it and starting over, something I've had to do on occasion when not paying close attention.)"", '2 Brown the cubed squash in the butter: Add the cubed butternut squash pieces to the pan and return the pan to the burner, heating to medium high.', 'Use a wooden or metal spoon to stir the squash pieces so they are all well coated with the butter thyme mixture.', 'Sprinkle generously with salt and pepper.', 'Spread the squash pieces out in an even layer and let cook, without stirring, so that they brown a bit on one side (several minutes). Stir and spread the pieces out again and let cook without stirring so more sides get browned.', '3 Lower the heat, cover and cook: Reduce the heat to low, cover the pan, and let cook until the squash is tender, 10 to 20 minutes, depending on how big you cut the pieces.', 'Add more salt and pepper to taste, sprinkle with a bit more chopped fresh thyme before serving.']",9
343,Brown Butter Chocolate Chunk Cookies Recipe,20,25,45,"['1 cup (2 sticks, 8 ounces, 225 g) unsalted butter', '2 1/2 cups all purpose flour', '1 teaspoon salt', '1 teaspoon baking soda', '1/2 teaspoon cinnamon', '1 cup brown sugar, packed', '1/2 cup white sugar', '2 large eggs', '1 teaspoon vanilla extract', '9 ounces milk chocolate (or semi-sweet or dark if you prefer) bars, roughly chopped into chunks, about 2 cups', '1 cup chopped walnuts or pecans (optional)']",11,"['1 Preheat oven to 350\\xc2\\xb0F.', '2 Brown the butter: Melt the butter in a medium sized, thick-bottomed, stainless steel saucepan (use stainless steel so you can tell when the butter has browned) on medium heat.', 'Continue to cook while the butter goes through various stages of bubbling up and releasing its moisture.  Whisk frequently over several minutes.', 'When you start to smell the nutty aroma of the butter browning, and you can whisk aside some of the foam to see small browned bits at the bottom of the pan, remove from heat and pour off into a bowl. Do not dawdle at this point as it is easy for the butter to go from browned to burnt.', '3 Whisk together dry ingredients: Place the flour, salt, baking soda, and cinnamon in a bowl and vigorously whisk together.', ""4 Beat brown butter and sugars, then add eggs and vanilla: Pour browned butter into the bowl of a stand-up mixer (if you don't have a mixer, you can just beat by hand). Add the sugars and beat until smooth. Add the eggs, beating after each addition.  Add the vanilla extract and beat for 3 more minutes."", '5 Add flour mixture to wet ingredients, then stir in chocolate chunks: Stir the flour mixture into the butter sugar mixture a third at a time. Stir in the chocolate chunks and the nuts (if using).', 'Up to this point you can make ahead a day or two and store the cookie dough in the refrigerator until ready to cook.', '6 Spoon out cookie dough to lined baking sheet: Line cookie sheets with Silpat or parchment paper (or just lightly butter) rimmed cookie sheets.', 'Spoon out heaping tablespoon hunks of batter onto the cookie sheets, separated by at least 2 inches, allowing room for the cookies to spread as they cook.  You may need to work in batches.', '6 Bake at 350\\xc2\\xb0F for about 12 minutes, the edges of the cookies should be just a little browned. Remove from the oven, let cool on the cookie sheet for 5 minutes. Then remove the cookies to cool completely on a rack.']",11
344,Seared Scallops with Brown Butter Caper Sauce Recipe,5,25,30,"['6 tablespoons (3 ounces) unsalted butter', '2 tablespoons extra virgin olive oil or canola oil', '1 pound sea scallops (about a dozen)*', '3/4 cup dry white wine', '2 tablespoons capers, drained', '2 teaspoons lemon zest', '*Sea scallops are the large scallops (about 1 1/2 inches wide), different from their much smaller cousins, bay scallops.']",7,"['1 Brown the butter: Cut up the butter into pieces (a tablespoon each or so) and place in a stainless steel saucepan. Melt the butter on medium heat. Allow the butter to foam up and recede. Watch carefully. After a few minutes, the milk solids will form and sink to the bottom.', 'Once the milk solids begin to turn caramel-colored brown, the butter will have a lovely nutty aroma.', ""Remove from heat and pour the browned butter into a separate bowl to stop the cooking. (Pay attention! If you wait too long, you\\'ll have blackened butter, not browned butter.) Set aside."", '2 Remove ""foot"" and pat dry scallops: Remove the ""foot"" of the scallop from each scallop. (The foot is a small tough piece of meat that attaches the scallop to the shell.) Pat dry the scallops.', '3 Sear the scallops on both sides on high heat: Heat the oil in a cast iron pan or hard-anodized aluminum saut\\xc3\\xa9 pan on high heat.', 'When the oil is shimmery hot, pat dry the scallops again and carefully place them in the pan, flat side down.', ""You may need to work in batches so you don\\'t crowd the pan."", ""Once you\\'ve placed the scallops in the pan, do not move them. Allow them to sear."", 'Once you can see that the edges of the scallops touching the pan have browned, use tongs to turn the scallops over and sear the other side. Depending on the size of the scallops and the heat of your burner, this should take 3 to 4 minutes per side.', 'Once both sides are browned, remove the scallops to a warm plate, and turn off the burner.', '4 Deglaze pan with white wine: Pour out the remaining oil from the pan, leaving any browned bits in the pan. Add the white wine to the pan and return the pan to the burner on high heat.', 'Let the wine boil and reduce until you have 2 tablespoons of liquid left in the pan.', '5 Add capers, lemon zest, brown butter: Then turn off the heat, add the capers, lemon zest, and brown butter to the pan. Swirl to combine.', '6 Serve scallops with sauce: Place scallops on serving plates and pour sauce over them. Serve immediately.']",14
345,Broiled Lobster Tail with Brown Butter Sauce Recipe,20,25,45,"['1/4 cup unsalted raw hazelnuts', '8 tablespoons unsalted butter', '2 tablespoons minced shallots', '1 teaspoon chopped fresh parsley', '1/4 teaspoon grated lemon zest', 'Pinch of salt', '2 lobster tails (6 to 8 ounces each), fresh or frozen']",7,"['If starting with frozen lobster tails, while the lobster tails are defrosting, prepare the hazelnut brown butter sauce to save time.', '1 Toast the hazelnuts: Toast hazelnuts in a small skillet on medium to medium high heat. When fragrant and lightly browned, remove hazelnuts from pan and place in the center a dry, clean dish towel.', 'Rub the hazelnuts together inside of the dish towel to remove as much of the papery dark skins as you can. Coarsely chop them and set aside.', '2 Brown the butter: In a small stainless steel saucepan, melt the butter on medium heat. (Use stainless so you will easily be able to tell when the butter is browning.)', 'After the butter melts, it will foam up, and recede. The milk solids will fall to the bottom of the pan.', 'Continue to heat and the milk solids will start to brown giving the melted butter a wonderful nutty aroma.', 'Let most of the milk solids brown and then remove from heat and strain through a fine mesh strainer into a bowl, to remove the browned milk solids.', 'Remove 2 tablespoons of the melted brown butter and set aside (they will be brushed on to the lobster tails before broiling. (See more details in How to Brown Butter.)', '3 Complete the sauce: To the remaining brown butter, add the chopped hazelnuts, parsley, shallots, lemon zest and salt. Set aside.', '4 Prepare lobster tails for broiling: Place rack in medium position in oven. Preheat broiler. Place a layer of foil over a broiling pan or roasting pan.', 'Using kitchen shears or strong scissors, cut the top side of the lobster tail shells lengthwise, from open end to the base of the tail.', 'To help make the shell easier to deal with, put the tail upside-down in the palm of your hand and squeeze to break the translucent bottom shell (see this useful video I found on YouTube).', 'Grip the sides of the shell and pull open by about an inch or two.', 'Using your finger, carefully wiggle between the lobster meat and the shell and separate the meat from the shell.', ""Then gently pull the meat up through the crack you've created, keeping the meat attached to the tail, and let the lobster meat sit on top of the shell. Place the tails on the foil-lined broiling pan."", '5 Brush lobster tails with browned butter and broil: Pull back the lobster meat to expose as much of it as possible. Brush the exposed lobster meat with the unadorned browned butter you set aside in step 2.', 'Broil for 7 to 10 minutes until the meat is cooked through (less time for smaller lobster tails), and the shells are bright red.', 'I recommend using a meat thermometer, which should read 145\\xc2\\xb0F when the lobster is done.', '6 Serve with browned butter hazelnut sauce: When the lobster tails are done, remove from oven and place on serving plates. Spoon the browned butter hazelnut sauce over the lobster meat of the lobster tails to serve.']",19
346,Cauliflower Mashed \xe2\x80\x9cPotatoes\xe2\x80\x9d with Brown Butter Recipe,5,15,20,"['1 large cauliflower (about 1 1/4 pound or 565 g), core removed, cut into large florets (see How to Cut and Core Cauliflower)', '1 cup (235 ml) water', '1/2 teaspoon salt', '2 tablespoons butter', '4 tablespoons (60 ml) sour cream', 'Chopped chives, green onions, and/or parsley for garnish', 'Salt and pepper to taste']",7,"['1 Steam/boil the cauliflower: Place 1 cup water in a medium saucepan. Add 1/2 teaspoon of salt. Add the cauliflower florets.', 'Bring to a boil on high heat. Lower the heat to a simmer.', 'Cover and let the cauliflower cook for 10-14 minutes, until very tender.', '2 Brown the butter: While the cauliflower is cooking, melt the butter in a small saucepan (easier to use a stainless steel pan so that you can see the browning occur) on medium heat.', 'Once the butter melts, it will begin to foam up a bit. When the foam subsides, look for amber colored bits forming at the bottom of the pan.', 'When the butter begins to brown, smell it. It will have a lovely nutty aroma.', 'When you can see lots of flecks of browned bits, and the melted butter smells wonderful, remove it from the heat and pour into a bowl (glass or metal).', 'Butter can quickly go from browned to burnt, so keep an eye on it and work quickly when the butter starts to brown! (See our more detailed instructions on How to Brown Butter.)', '3 Strain the cooked cauliflower: When the cauliflower is cooked through and tender enough to mash with a fork, strain out all but a tablespoon or two of the remaining water.', ""4 Mash with a potato masher and stir in the brown butter and sour cream. (Make sure to scrape in all the browned bits from the butter; that's where the flavor is!)"", '5 Pur\\xc3\\xa9e to desired consistency: Use an immersion blender or a standing blender and blend the mashed potatoes to as smooth a consistency as you would like. Or just mash more with a potato masher if you like a chunky consistency.', 'Add salt and pepper to taste. Top with chopped chives, green onions, or parsley to serve.']",12
347,"Squid Ink Pasta with Pumpkin, Sage and Brown Butter Recipe",20,70,90,"['4 small sugar pumpkins, each about 1 pound to 1 1/2 pound', 'Salt', '2 to 4 teaspoons of white sugar, or 2 to 4 Tbsp of brown sugar (to taste)', '1 pound squid ink pasta', '6 tablespoons butter', '1/4 cup thinly sliced fresh sage leaves (with a few small whole leaves for garnish)', 'A splash of apple cider vinegar']",7,"['1 Prepare and bake the pumpkin shells: Heat the oven to 350\\xc2\\xb0F. Slice off the top quarter of each pumpkin and scoop out the insides. (Save the seeds to make toasted pumpkin seeds.)', 'Using a strong metal spoon or a small sharp knife, scrape all the fibrous insides out of the pumpkins. Sprinkle the insides of the pumpkins with salt and sugar.', 'Set the pumpkins on a baking sheet and bake at 350\\xc2\\xb0F for 1 hour, or until a fork easily pierces the flesh and the edges are lightly browned.', ""2 Start cooking the pasta: Prepare the pasta water while the pumpkins are cooking. Bring a large pot of well salted water (it should taste like the sea) to a boil. When the pumpkins have about 10 minutes to go before they're done, add the pasta to the boiling water."", 'When the pumpkins are cooked remove them from the oven to a serving dish or plates.', '3 Make the brown butter sauce with sage: While the pasta is cooking, prepare the brown butter sauce. Heat the butter in a saut\\xc3\\xa9 pan over medium heat. Add the sage leaves and cook until browned bits begin to form in the butter and there is a lovely nutty aroma.', 'Remove any whole sage leaves you are using for garnish.', 'Remove the pan from the heat and pour the brown butter into a large serving bowl (this will stop the butter from cooking further). Browned butter can easily turn to blackened butter, which is not the flavor you want for this recipe.', '4 Stir in the pasta into the brown butter sauce, add vinegar, salt: When the pasta is ready (al dente, slightly firm, but cooked through), use tongs to remove the pasta from the pot to the large bowl with the brown butter.', 'Allow some of the water from the pasta to drip into the bowl, it will help with the sauce. Toss the pasta with the brown butter.', ""Splash a little cider vinegar over it. Taste for salt, it will likely need a bit more, especially if you've used unsalted butter. Add more if needed."", '5 Serve: Serve the pasta in the baked pumpkin shells. Garnish with reserved whole sage leaves that you had cooked with the sliced sage in the butter.']",12
348,"Mashed Potatoes with Brown Butter, Goat Cheese, and Sage Recipe",10,30,40,"['1 1/2 pounds yukon gold potatoes, peeled and quartered', '1 teaspoon salt', '3 Tbsp butter', '1 teaspoon chopped fresh sage', '4 ounces goat cheese', '3 Tbsp milk', 'Pepper']",7,"['1 Boil the potatoes: Place the potatoes and salt in a pot and fill the pot with cold water until the potatoes are covered.', 'Bring to a boil over high heat, then lower the heat and simmer for 15-20 minutes or until a fork easily pierces the potatoes.', 'Drain the water from the potatoes.', '2 Brown the butter: Place the butter in a small saucepan over low heat. (Use a stainless steel saucepan so you can see the butter browning.) Let the butter melt and continue to watch it as it cooks. The butter will foam for a bit and then calm down.', 'After a few minutes, flecks of brown will appear at the bottom of the pan. When you see this, and the melted butter takes on a nutty aroma, take it off the heat. (See How to Brown Butter.)', '3 Add sage and pour over potatoes: Add the chopped sage to the butter (it may cause some foaming). Pour over the potatoes.', '4 Add the goat cheese and milk and mash the potatoes with a potato masher until smooth and all ingredients are well incorporated. Salt and pepper to taste and serve immediately.']",7
349,Brownie in a Mug Recipe,3,2,5,"['1/4 cup flour (30 g)', '1/4 cup sugar (50 g)', '2 tablespoons (13 g) cocoa (natural, unsweetened)', 'Pinch of salt', 'Tiny pinch of cinnamon', '1/4 cup water (60 ml)', '2 tablespoons (30 ml) melted butter, or neutral oil', '1/8 teaspoon vanilla extract', '1 small scoop of ice cream or 1 or 2 teaspoons heavy whipping cream to serve']",9,"['1 Add the dry ingredients to the mug and stir: Place flour, sugar, cocoa, salt, and cinnamon in a microwave safe ceramic mug. Stir with a fork or spoon to mix well and break up any clumps.', '2 Add the wet ingredients and stir: Add the butter or oil, water, and vanilla to the cup and stir until the mixture is smooth and there are no lumps.', '3 Zap in microwave: Place in microwave and heat on high until the mixture is cooked through, about a 1 minute and 40 seconds for a 1000 watt microwave, or 1 minute 10 seconds on a 1650 watt microwave.', ""You may have to experiment and adjust the time for less or more powerful microwaves. If you don't know the power level on your microwave, start with 60 seconds and increase until the brownie is done. It should still be moist when cooked through, not dry."", '4 Top with ice cream! Let cool for a minute and serve with a scoop of vanilla ice cream or a teaspoon or two of whipping cream poured over.']",5
350,Best Chocolate Brownies Recipe,20,25,45,"['10 tablespoons (1 1/4 sticks, 140 g) unsalted butter', '1 1/4 cups (250 g) granulated sugar', '3/4 cup plus 2 tablespoons (85 g) unsweetened cocoa powder (natural or Dutch-process)', '1/4 teaspoon salt', '1/2 teaspoon almond extract', '2 cold large eggs', '1/2 cup (65 g) all-purpose flour', '2/3 cup (90 g) pecan pieces']",8,"['1 Preheat oven and line baking pan: Preheat oven to 325\\xc2\\xb0F (160\\xc2\\xb0C), with a rack in the lower third of the oven.', ""Line the bottom of an 8-inch square baking pan with foil or parchment paper in such a way as there is an overhang on two opposite sides to make it easy to lift the brownies out when they're done."", '2 Heat butter, cocoa, sugar, salt in a bowl over simmering water: Place the butter, cocoa, sugar, and salt in a medium-sized metal bowl. Fill a large skillet halfway with water and bring to a bare simmer. Set the bowl of the butter cocoa mixture in skillet of simmering water.', 'Stir the butter cocoa mixture until the butter has melted and the mixture is smooth and hot to touch.', 'Remove the bowl from the skillet and let it cool down a bit, from hot to warm.', '3 Stir in almond extract, eggs, flour, beat with spoon, add pecans: Stir in the almond extract. Stir in the eggs, one at a time, beating strongly after each addition.', 'Once the batter is well mixed and shiny and thick, stir in the flour. Beat for 40 strokes with a wooden spoon.', 'Mix in the pecans.', '4 Pour batter into lined pan: Pour the batter into the prepared lined pan and smooth the surface evenly.', '5 Bake: Bake 20 to 25 minutes at 325\\xc2\\xb0F (160\\xc2\\xb0C), until a bamboo skewer or toothpick inserted into the center comes out still a little moist with the brownie batter. Cool completely on a rack.', '6 Cut: When cooled, lift up the sides of the foil or parchment liner to remove the brownies from the pan. Place them on a cutting board and cut into 16 to 25 squares or rectangles.']",11
351,Fudgy Gluten-Free Chocolate Brownies Recipe,15,150,165,"['3 tablespoons ground flax', ""1 cup (148 grams) gluten-free flour blend, like Bob\\'s Red Mill"", '1/2 cup (40 grams) dairy-free cocoa powder', '1 teaspoon baking powder', '1/2 teaspoon kosher salt', '1/2 cup coconut oil at room temperature, plus more for the pan', '5 ounces (140g) bittersweet dairy-free chocolate, chopped', '1 1/2 cups (300 grams) sugar', '1 tablespoon pure vanilla extract']",9,"['1 Heat the oven to 350\\xc2\\xb0F and prepare the pan: Line an 8\\xc3\\x978 square baking pan with parchment paper, and grease the parchment paper and pan with a little coconut oil.', '2 Prepare the flax ""egg"": Combine the flax with 8 tablespoons of water in a small bowl. Let stand for 7 to 10 minutes to thicken. (This will be used as an egg replacer in this recipe.)', '3 Whisk dry ingredients: In a small mixing bowl, whisk together the flour, cocoa powder, baking powder, and salt.', '4 Melt the coconut oil and chocolate: In a small saucepan over low heat, warm the coconut oil and chopped chocolate, stirring until the chocolate is completely melted, about 2 minutes.', '5 Add the sugar and vanilla: Whisk the sugar and vanilla into the chocolate mixture, stirring vigorously until combined. The mixture will be a little grainy at this point, which is perfectly okay.', '6 Make the batter: Pour the chocolate mixture into a large mixing bowl, scraping everything from the pan. Fold in the flax eggs.', 'Add the dry ingredients and stir well with a wooden spoon or rubber spatula until well combined. The batter will be quite thick and will gather into a ball\\xe2\\x80\\x94it won\\xe2\\x80\\x99t be loose and thin like many traditional brownie batters.', '7 Scoop the batter into the prepared pan, and use a rubber spatula or the palm of your hand to press it into the pan in an even layer.', '8 Bake the brownies for 30 to 35 minutes, or until the edges are set and no longer jiggly. The tops of the brownies will still feel very soft and may even be bubbling a little; they\\xe2\\x80\\x99ll firm up as they cool.', '9 Cool: Let the brownies cool completely before slicing, at least 2 to 3 hours. Because these are so fudgy, they really will slice best if you allow them to fully cool.', '10 Slice, serve, and store: Using the parchment paper as a handle, lift the cooled brownies up out of the pan and onto a cutting board. Slice into a 4x4 grid (making 16 small squares). Leftover brownies can be stored in an airtight container at room temperature for up to 5 days.']",11
352,Peanut Butter Swirl Brownies Recipe,15,34,49,"['6 ounces semisweet chocolate chips', '8 tablespoons (1 stick, 4 ounces) unsalted butter', '2 large eggs', '1/2 cup granulated sugar', '1/2 cup dark brown sugar', '1 tablespoon instant espresso coffee powder', '1 teaspoon vanilla extract', '2/3 cup all-purpose flour', '2/3 cup unsweetened cocoa powder', '1/2 teaspoon salt', '1/4 teaspoon baking powder', '1/2 cup smooth peanut butter', '2 tablespoons powdered sugar']",13,"['1 Preheat the oven to 350\\xcb\\x9aF. Line an 8-inch square baking dish with parchment paper; set aside.', '2 Melt the chocolate and butter: Set the chocolate and butter in a heat-proof bowl over a pot of simmering water\\xe2\\x80\\x94the bottom of the bowl should not touch the water. Stir until the chocolate has melted. Remove from heat.', ""  3 Make the batter: Whisk together the eggs, both sugars, coffee powder, and vanilla extract. Add in the flour, cocoa powder, salt, baking powder, and melted butter-chocolate mixture and stir until evenly combined. (The batter will be very thick, but don't worry! That's how it's supposed to be.)"", 'Press the brownie batter into the prepared baking dish in an even layer.', ""   4 Add the peanut butter swirl. Warm the peanut butter in the microwave until it's loosened enough to drizzle, about 30 seconds on high. Stir the powdered sugar into the peanut butter, then drizzle over the top of the brownie batter."", 'Use a butter knife to swirl the peanut butter mixture into the top of the brownie batter. Be careful not to over mix the peanut butter into the brownie mixture.', ""5 Bake the brownies: Bake the brownies until a toothpick inserted in the middle comes out mostly clean, about 35 minutes. (The peanut butter will probably stick to the toothpick a little bit; that's fine.) Transfer to a wire rack to cool."", ""6 Cool and slice: Let the brownies cool completely to room temperature before cutting them. For cleaner slicing with fewer crumbs, pop the pan in the freezer for a few minutes once it's cooled to room temperature to help with slicing to help keep them from sticking to the knife.""]",8
353,Speculoos Brownie Cake + First Look at Baker\xe2\x80\x99s Royale Cookbook Recipe,10,85,95,"['For the brownie cake', 'Nonstick cooking spray', '1/2 cup (113 g) unsalted butter', '31/2 ounces (100 g) bittersweet chocolate, chopped', '11/3 cups (270 g) lightly packed light brown sugar', '1 teaspoon pure vanilla extract', '1/2 teaspoon instant espresso powder', '3 large eggs, at room temperature', '1/2 cup (60 g) all-purpose flour', '1 teaspoon baking powder', '1/2 teaspoon salt', 'For the speculoos frosting', '3/4 cup (205 g) speculoos cookie butter', '6 tablespoons (85 g) unsalted butter, at room temperature', '2/3 cup (70 g) confectioners\\xe2\\x80\\x99 sugar', '1/4 teaspoon salt', '2 tablespoons heavy whipping cream', 'Chocolate shavings, for garnish', 'Special equipment:', '9-inch springform pan']",20,"['1 Get ready to bake: Preheat the oven to 350\\xc2\\xb0F (180\\xc2\\xb0C). Lightly coat a 9-inch/23 cm springform pan with nonstick cooking spray.', '2 Make the brownie batter: In a medium saucepan over medium heat, melt the butter. Remove the pan from the heat, add the bittersweet chocolate, and let sit for about 30 seconds, then whisk it all together until smooth and glossy.', 'Add the brown sugar, vanilla, and espresso powder and whisk until smooth. Whisk in the eggs, 1 at a time, then sprinkle in the flour, baking powder, and salt. Use a sturdy spatula to fold it all together until there is no flour visible.', '3 Bake the brownie cake: Spread the brownie mixture in the prepared springform pan and bake for 20 to 25 minutes, or until the cake has puffed slightly and the top is shiny and just barely cracked.', 'Transfer to a wire rack to cool completely before removing the sides of the springform pan. In the meantime, make the speculoos frosting.', '4 Make the speculoos frosting: In a large bowl, using an electric mixer on medium speed, mix together the speculoos and butter for a full minute so it\\xe2\\x80\\x99s light and fluffy. Add the confectioners\\xe2\\x80\\x99 sugar, salt, and cream and beat for another minute, or until the mixture is fluffy and spreadable.', '5 Finish the cake and serve: Spread the frosting on the cake, garnish with chocolate shavings, and cut into wedges to serve.']",7
354,Classic Ice Cream Sandwiches Recipe,20,15,35,"['1 cup all-purpose flour', '1/4 teaspoon baking powder', '1 stick (1/2 cup) unsalted butter', '4 ounces semisweet chocolate, chopped', '1 1/2 teaspoons vanilla extract', '1/2 teaspoon salt', '1 cup firmly packed brown sugar', '1/4 cup granulated sugar', '2 large eggs', '1/2 gallon vanilla ice cream in a paper, rectangle container', 'Special equipment:', 'Half-sheet Jelly Roll Pan Sheet Pan, roughly 15x11-inch', 'Offset spatula', 'Parchment paper']",14,"['1 Prepare the oven and pan: Preheat the oven to 350\\xc2\\xb0F. Butter the bottom of the jelly roll pan, then line it with parchment, leaving enough to hang over the sides. The butter will help the parchment stick to the pan when you spread the batter. The jelly roll pan should be about 15x11, give or take a little on either side.', '2 Combine dry ingredients: In a small bowl, whisk together the flour and baking powder. Set aside.', '3 Make the chocolate sauce: In a medium sauce pan set over low heat, slowly melt the butter, chocolate, vanilla, and salt together, stirring constantly. Once melted, remove from heat.', '4 Finish the batter: Stir the brown and white sugar into the chocolate mixture. Add the eggs one at a time, stirring until well combined. Fold in the flour mixture.', '5 Spread the batter in the pan: Using an offset spatula or standard spatula, spread the batter into a thin, even layer on the prepared baking sheet. Bake for 15 minutes. When finished, the brownie should have puffed up just a little, and the top should look dry.', '6 Cool and cut the cookies: Let cool completely. Once cool, use the parchment sides to lift the cookie out of the pan. Transfer to a large cutting board.', 'Use a ruler to trim about 1/4 of an inch off each side so you have smooth even edges. Measure the trimmed cookie. Then use the ruler to measure\\xe2\\x80\\x94and a long knife to cut\\xe2\\x80\\x946 long strips the same width. Each strip should be about 2 to 2 1/2 inches wide. Measure the long strips to find the halfway point, and cut them across the center. Once cut, you should have 12 thin, rectangular brownies.', 'Use an offset spatula or knife and run it between one of the rectangular brownies and the parchment. Put one brownie on top of the next just to make sure the tops are the same size as the bottoms. Trim if necessary. Take the top brownie off, and put it back where it was. Lift up the parchment and slide the cookies to the side.', '7 Assemble the ice cream sandwiches: Get a piece of plastic wrap ready. Take the half-gallon of ice cream out of the freezer. Remove the cardboard container either by unfolding it or removing the lid. Cut it down the middle like a T, and then around the bottom, and set the block of ice cream on a cutting board.', 'Slice it longways into 1-inch thick slabs. Do this one slab at a time. Place your slab on a cutting board. Your slabs will be larger than the brownie. Place one brownie on top of the ice cream slab. Cut the ice cream to size.', 'Lift the ice cream and brownie up; place it brownie down on the plastic wrap; put the other brownie on top of the ice cream. Then, wrap the ice cream sandwich in plastic wrap. Repeat this until all the sandwiches are made and wrapped. Freeze until you\\xe2\\x80\\x99re ready to enjoy.', 'You probably won\\xe2\\x80\\x99t use all the ice cream. Scoop what remains into a Tupperware container and freeze for another day.']",12
355,"Smoked Salmon, Dill, and Goat Cheese Quiche Recipe",30,60,90,"['Crust:', '1 1/4 cups all purpose flour', '1/2 teaspoon salt', '10 tablespoons (1 1/4 stick, 5 ounces) butter', '2 to 2 1/2 tablespoons of water', 'One 9-inch x 2-inch high tart pan with removable bottom (or can use a 10-inch pie pan)', 'Filling:', '1 tablespoon extra virgin olive oil', '4 medium shallots, thinly sliced (about 1/2 cup)', '6 ounces smoked salmon, chopped', '4 ounces goat cheese, crumbled', '6 large eggs', '2 cup milk', '1 cup cream', '2 tablespoons chopped fresh dill', '1 teaspoon lemon zest', '2 1/2 teaspoons salt', '1/8 teaspoon freshly ground black pepper']",18,"['1 Make the dough: Whisk together the flour and salt in a medium bowl. Cut the butter into cubes and add to the flour. Use your clean hands to work the butter into the flour until you have a mixture that a coarse meal with pieces of butter no bigger than the size of a pea.', 'Add the water a tablespoon at a time, working it into the dough with your hands until the dough can be formed into a ball.', 'Flatten the ball into a disk. Wrap with plastic wrap and chill for 1 to 2 hours.', '2 Roll out the dough: When ready to roll out, remove the disk from the refrigerator and let sit for 10 minutes to come closer to room temperature.', 'Roll out on a lightly floured clean, flat surface to 1/8-inch thickness to an inch or two wider than your pie  or tart pan. Drape over the tart or pie pan and press the dough into the sides of the pan.', 'Use a rolling pin over the top to remove the excess dough and level the dough with the top of the pan. Place in freezer for 30 minutes to an hour.', 'If you want, at this point you can ""blind bake"" the frozen crust. Blind baking it will help you have a well browned crust on the bottom. I often skip this step because it takes extra time and I don\\\'t mind having the bottom crust not browned.', 'But, if that is what you want, then line the inside of the frozen crust with aluminum foil and fill to the top with ""pie weights"", which can be beans, sugar, or rice. The weights are to keep the sides of the pie crust from sliding down when baking.', 'Bake for 45 minutes at 350\\xc2\\xb0F, then remove the weights and foil, and let cool a bit before adding the filling. (See our detailed instructions on blind baking.)', '3 Prepare the filling: Preheat oven to 375\\xc2\\xb0F. Heat oil in a small skillet on medium heat. Add the shallots and cook until translucent, a couple minutes, remove from heat.', 'Whisk eggs in a medium bowl. Whisk in goat cheese. Whisk in milk, cream, dill, lemon zest, salt, and black pepper. Whisk in the shallots.', '4 Layer the salmon and filling into the quiche crust: Line the bottom of the quiche crust with half of the smoked salmon. Pour half of the egg/cheese/milk/cream mixture over the salmon in the quiche shell.', 'Layer down the remaining salmon, and pour the remaining egg/milk/cream mixture over it.', '5 Bake: Place the quiche pan on a foil-lined rimmed baking sheet. Transfer to oven. Bake at 375\\xc2\\xb0F for 15 minutes.', 'Then lower the heat to 350\\xc2\\xb0F and bake until just set in the center, about 30 to 40 minutes.', 'Remove from oven and cool on a wire rack for 15 minutes before serving.']",16
356,Oatmeal Buttermilk Pancakes Recipe,10,15,25,"['3 cups old-fashioned rolled oats', '1/2 teaspoon baking powder', '1/2 teaspoon baking soda', '1/2 teaspoon ground cinnamon (optional)', '1/4 teaspoon salt', '2 large eggs', '1 1/2 to 2 cups buttermilk', '2 tablespoons vegetable oil or melted butter', '2 tablespoons honey', '1 teaspoon vanilla extract', 'Vegetable oil (for the skillet)', 'Special equipment:', 'Food processor']",13,"['1 Grind the oats: Set aside 1/2 cup of the oats to add to the batter later. In a food processor, grind the remaining 2 1/2 cups oats until the mixture resembles coarse whole-wheat flour, with a few particles of oats.', '2 Make the batter: Add the baking powder, baking soda, cinnamon, salt, eggs, 1 1/2 cups of the buttermilk, oil or melted butter, honey, and vanilla to the food processor bowl and pulse a few times, until blended.', 'Pour the batter into a bowl and stir in the remaining 1/2 cup oats. Let stand for 5 to 10 minutes. The mixture will not be not completely smooth, and it will thicken as it sits. If the batter becomes too thick at any point feel free to thin with some of the remaining buttermilk.', '3 Heat a skillet or griddle: Pour a few drops of oil into the skillet or griddle and spread with a paper towel. Set the pan over medium heat. The pan is hot enough when you drop a few drops of water on it and they sizzle. Turn the heat to medium-low.', '4 Cook the pancakes: Ladle about 1/3 cup of batter for each pancake onto the skillet. With the back of the ladle, spread the batter into 4-inch circles. Cook for 2 to 3 minutes, or until bubbles form on top and the bottoms look brown when you peek under the pancakes with a spatula. Turn them and cook for another 2 minutes, or until browned. Repeat until all the batter is used.', '5 Serve the pancakes: Serve them hot off the griddle or keep them warm in a 325\\xc2\\xbaF oven on a wire rack set over a baking sheet. Serve with lots of butter, fresh fruit (if you wish), and maple syrup.']",6
357,Bruschetta with Tomato and Basil Recipe,15,20,35,"['6 or 7 ripe tomatoes (about 1 1/2 lbs)', '2 cloves garlic, minced (about 2 teaspoons)', '1 Tbsp extra virgin olive oil', '1 teaspoon balsamic vinegar', '6-8 fresh basil leaves, thinly sliced* or chopped', '3/4 teaspoon sea salt, more or less to taste', '1/2 teaspoon freshly ground black pepper, more or less to taste', '1 baguette French bread or similar Italian bread', '1/4 cup (60 ml) olive oil', '*To thinly slice basil leaves, stack the leaves on top of each other and roll up like a cigar. Then make thin slices from one end of the basil cigar to the other.']",10,"['1 Blanch and peel the tomatoes: Bring 2 quarts of water to a boil. As the water is heating make shallow cuts in a cross pattern at the tip ends of the tomatoes (this will make the tomatoes easier to peel).', 'Once the water is boiling, remove the pot from the heat. Put the tomatoes in the hot water and blanch for 1 minute.', 'Remove with a slotted spoon and let sit until cool enough to handle. Then gently peel off the tomato skins. Cut out the stem base with a paring knife.', 'Cut the tomatoes into halves or quarters and squeeze out most of the juices and seeds.', '2 Preheat oven to 450\\xc2\\xb0F (230\\xc2\\xb0C) with a rack in the top slot of the oven.', '3 Chop tomatoes, toss them with garlic, olive oil, vinegar, basil, salt and pepper: Finely chop the tomatoes and place them in a medium bowl. Mix in the minced garlic, 1 Tbsp extra virgin olive oil, and the balsamic vinegar.', 'Stir in the thinly sliced basil and add salt and freshly ground black pepper, adding more to taste. Note, tomatoes love salt; you may need to add more than you expect.', '4 Toast the baguette slices: Use a bread knife to slice the baguette on the diagonal making half-inch thick slices. Brush one side of each slice with olive oil (a pastry brush helps here) and place olive oil-side down on a baking sheet or roasting pan.', 'The baguette slices will toast best in the top rack of your oven, so you may need to work in batches to toast them all.', 'When the oven has reached 450\\xc2\\xb0F (230\\xc2\\xb0C) place the slices in the oven on the top rack and toast for 5 to 6 minutes until lightly browned around the edges.', 'If you want you can toast the bread slices without coating them first in olive oil. Toast them until lightly browned on both sides. Then cut a clove of garlic in half and rub over one side of the toast. Then brush with olive oil. (See Easiest Ever Garlic Bread.)', '5 Serve toasted bread with tomato mixture: Arrange the toasted bread on a platter, olive oil side facing up (the olive oil will help create a temporary barrier keeping the bread from getting soggy from the chopped tomatoes).', 'Either serve the toasts plain with a bowl of the tomato bruschetta mixture on the side for people to top their own, or use a spoon to gently top each toasted bread slice with some of the tomato mixture. If you top each slice individually, do it right before serving.']",13
358,Cheesy Bruschetta Chicken Cutlets Recipe,5,10,15,"['For the bruschetta topping:', '1 (14.5 ounce) can diced tomatoes, drained', '1 clove garlic, minced or pressed in a garlic press', '1 tablespoon olive oil', '1/2 teaspoon Italian seasoning or 1/4 teaspoon each dried basil and oregano', '1/4 teaspoon ground black pepper', 'For the chicken:', '1 1/2 pounds (4 cutlets) chicken breast cutlets or thinly sliced chicken breasts, 1/4-inch thick', '1/2 teaspoon salt', '1/4 teaspoon ground black pepper', '2 tablespoons olive oil', '3/4 cup (3 ounces) shredded mozzarella cheese', '1/4 cup (1 ounce) shredded Parmesan cheese', '1/4 cup chopped fresh parsley']",14,"['1 Heat your oven broiler to its highest setting. Place a rack a few inches below the broiler.', '2 Make the bruschetta topping: In a medium mixing bowl, stir together all of the bruschetta topping ingredients. Set aside.', '3 Sear the chicken: Season the chicken cutlets on both sides with the salt and pepper.', ""Heat the olive oil in a large (12-inch), oven-safe skillet over medium high heat. I like to use either a cast iron or stainless steel skillet -- nonstick and enameled cast iron cookware usually aren't meant to be used above 500\\xc2\\xbaF, so they aren\\xe2\\x80\\x99t broiler safe."", 'When the oil is shimmering, sear the chicken cutlets for 3 minutes on one side, just so they get a little bit of color.', 'It\\xe2\\x80\\x99s ok if they are not cooked through, since they will finish cooking in the oven.', '4 Flip and season the cutlets: Flip the cutlets over, then spoon on the bruschetta topping and sprinkle with the mozzarella and Parmesan cheese. Let them cook in the pan for 1 1/2 to 2 minutes.', '5 Broil the chicken: Place the skillet under the broiler. Broil until the cheese is bubbly and brown and the chicken is cooked through, about 3 minutes.', 'Check for doneness by cutting into one of the cutlets to see if it\\xe2\\x80\\x99s opaque in the center, or by checking the temperature of one of the cutlets with an instant-read thermometer (the chicken should be 165\\xc2\\xbaF or higher in the center).', 'At this point, your chicken should be ready, but if you used cutlets that were thicker than 1/4-inch you may have to return it to the stovetop to cook for another 1-3 minutes.', '5 Serve: Sprinkle the parsley on top of the chicken and serve the cutlets hot.']",11
359,Roasted Brussels Sprouts Recipe,10,35,45,"['1 pound Brussels sprouts, rinsed, ends trimmed, and rough outer leaves of larger sprouts removed', '1 tablespoon minced garlic (about 3 cloves)', '1 teaspoon lemon juice (can sub apple cider vinegar)', '2 tablespoons extra virgin olive oil', 'Salt', 'Freshly ground black pepper', '1/4 cup freshly grated Parmesan cheese (optional)']",7,"['1 Preheat oven to 400\\xc2\\xb0F.', '2 Prep the Brussels sprouts: Place the trimmed Brussels sprouts in a large bowl. Toss with garlic and lemon juice. Toss the sprouts with olive oil to coat them well.', 'Spread the Brussels sprouts out in a large cast iron frying pan or roasting pan in a single layer with plenty of space between them. Sprinkle generously with salt (at least half a teaspoon) and a few turns of black pepper.', '3 Roast in oven: Put the sprouts in oven on the top rack, roast for 25-30 minutes, stirring the sprouts about halfway through the cooking.', 'Adjust the timing depending on the size of the sprouts and your particular oven. When the sprouts are ready, they should be nicely browned and some of the outside leaves crunchy. The interior should be cooked through, so that the sprouts are easily pierced with a fork.', 'If the sprouts look like they are getting too browned (they should be well browned, not burnt), move them to a lower rack or lower the heat.', ""If after cooking for 30 minutes the sprouts aren't browned enough, put them under the broiler (or increase the heat to 500\\xc2\\xb0F) for 5 minutes."", '4 Sprinkle with Parmesan: Toss with Parmesan (if using) and add more salt to taste to serve.']",8
360,Brussels Sprouts Gratin Recipe,20,60,80,"['2 pounds Brussels sprouts, trimmed of outer leaves and sliced in half', 'Salt', '2 ounces pancetta, diced', '1 tablespoon butter', '3 shallots, peeled, halved, and sliced', '2 tablespoons all purpose flour', '1 3/4 cup whole milk', 'Scant pinch of freshly ground nutmeg', 'Thyme leaves from 2 sprigs of thyme or 1/2 teaspoon dry thyme', '4 ounces of grated Gruyere cheese, divided 3 ounces and 1 ounce']",10,"['1 Blanch the Brussels sprouts: Heat a large pot of salted water, 4 quarts of water, 1 tablespoon salt. Blanch the halved Brussels sprouts for 3 to 4 minutes, until just barely tender. Remove from pot, drain, rinse with cold water to stop the cooking, set aside.', '2 Brown the pancetta and render the fat: Place diced pancetta in a large pot on medium low heat. Cook until most of the fat is rendered, about 8 to 10 minutes. Remove the pancetta from the pan, set aside, leaving the rendered fat in the pan.', '3 Saut\\xc3\\xa9 shallots: Add butter to the pot and melt on medium heat. Add the shallots and gently cook until softened, about 4 to 5 minutes.', '4 Make roux: Add the flour to the butter shallot mixture to make a roux, whisk for 1 to 2 minutes.', 'Slowly add the milk while stirring with a wooden spoon until the roux is incorporated into the milk.', 'Cook over medium low heat for several minutes, stirring, until the sauce thickens and coats the back of your spoon. Add fresh thyme and sprinkle with nutmeg.', '5 Add cheese, then half of the pancetta to white sauce: Add 3 ounces of grated Gruyere cheese into the white sauce and stir until the cheese is melted and incorporated into the sauce. Add half of  the cooked pancetta back to the sauce. Taste and add more salt if necessary.', '6 Add Brussels sprouts, transfer to gratin dish, sprinkle with pancetta, more cheese, bake: Preheat oven to 400\\xc2\\xb0F. Butter an 8""x12"" gratin dish or casserole . Add the Brussels sprouts into the cheese sauce. Transfer the cheesy Brussels sprouts into the casserole or gratin dish. Sprinkle with the remaining pancetta and the remaining 1 ounce of grated Gruyere cheese.', 'Bake for 25 minutes until top is lightly browned and bubbly. Remove from oven and let sit for 10 minutes before serving.']",9
361,Roasted Brussels Sprouts with Pomegranate-Balsamic Glaze Recipe,30,25,55,"['For the glaze:', '1 cup pomegranate juice', '2/3 cup balsamic vinegar', '2 tablespoons brown sugar', 'For the Brussels sprouts:', '1 1/2 pounds Brussels sprouts', '3 tablespoons olive oil', '1/2 to 2/3 cup pomegranate arils']",8,"['1 Make the glaze: Combine the pomegranate juice, balsamic vinegar, and brown sugar in a saucepan and bring to boil over medium heat. Reduce the heat to medium-low and let the liquid simmer for 25 to 30 minutes, until reduced to a syrupy glaze that coats the spoon. Stir occasionally. You should have about 2/3 cup of pomegranate balsamic glaze when done. (Once cool, store the glaze in the refrigerator for up to a month.)', '2 Preheat oven to 375F. Move the oven racks to the upper third and lower third positions. Line 2 baking sheets with parchment paper.', '3 Roast the Brussels sprouts: Trim the ends of the Brussels sprouts and slice them in half. Chop very large sprouts into quarters. Toss with the olive oil and a good pinch of salt. Divide the sprouts between 2 baking sheets and roast for 20 to 25 minutes, stirring halfway through.', '4 Toss the sprouts with the glaze: Let the Brussels sprouts cool for a few minutes before tossing them with 2 to 3 tablespoons of the pomegranate balsamic reduction and the pomegranate arils. Taste and add more glaze if you like. Serve immediately.']",4
362,Balsamic Roasted Brussels Sprouts and Shallots Recipe,20,45,65,"['2 pounds Brussels sprouts, tough outer leaves removed, base trimmed, sprouts cut in half', '2 tablespoons extra virgin olive oil', 'Several large shallots, peeled and thickly sliced, about a cup', '4 cloves garlic, peeled, sliced in half', '2 tablespoons plus 2 teaspoons balsamic vinegar', 'Salt', 'Pepper', '3/4 teaspoon fresh thyme leaves or 1/4 teaspoon dried thyme', '1/2 cup walnuts, toasted (optional)']",9,"['1 Saut\\xc3\\xa9 shallots in olive oil: Heat the olive oil in an oven-safe saut\\xc3\\xa9 pan on medium high heat. Add the shallots, spread them out in an even layer, lower the heat to medium low, and let them cook for 6 to 8 minutes, until softened and lightly browned.', '2 Add Brussels sprouts, garlic, balsamic: Preheat oven to 425\\xc2\\xb0F. Add the Brussels sprouts and the garlic to the shallots. Cook for 5 to 6 minutes more, until the sprouts begin to brown.', 'Drizzle with 2 tablespoons of balsamic vinegar. Sprinkle with salt and pepper. Toss to coat.', '3 Bake in oven: Place in oven, uncovered. Roast at 425\\xc2\\xb0F for 15 to 20 minutes, until cooked through and caramelized on the edges.', '4 Sprinkle with balsamic, thyme, walnuts, salt, pepper: Remove from oven. Sprinkle with remaining 2 teaspoons of balsamic vinegar, the thyme, and toasted walnuts (if using). Stir to combine. Add more salt and pepper to taste.']",5
363,Brussels Sprouts with Toasted Almonds Recipe,15,15,30,"['1 lb fresh brussels sprouts, trimmed of ragged or old-looking outer leaves', '4-6 Tbsp butter', '1/2 onion, chopped', 'Salt and Pepper', '1 teaspoon lemon juice or 1 Tbsp Meyer lemon juice, fresh squeezed', '1/4 cup toasted slivered almonds']",6,"['1 Parboil the brussels sprouts: Bring 2 quarts of salted water (1 Tbsp of salt) to a rolling boil. Add the brussels sprouts and parboil them for 3 minutes or until just tender. (You could also steam them if you prefer.) They should be almost cooked all the way through (split one in half to test).', 'Remove the sprouts with a slotted spoon to a bowl of ice water for a minute to shock the brussels sprouts and help them retain their bright green color.', 'Remove them from the ice water and cut the sprouts into halves.', '2 Saut\\xc3\\xa9 onions, then brussels sprouts: Heat 2-3 Tbsp of butter in a large saut\\xc3\\xa9 pan on medium heat. Add the chopped onions and cook until translucent, about 4-5 minutes.', 'Add 2-3 Tbsp more of butter and the brussels sprouts halves. Increase the heat to medium high and cook for several more minutes. Salt and pepper to taste, while the brussels sprouts are cooking.', ""Do not overcook! Overcooked brussels sprouts are bitter and are the main reason why some people don't like them."", '3 Stir in lemon juice, add toasted almonds: Remove the pan from the heat, stir in the lemon juice and half of the toasted almonds. Add salt and pepper to taste. Place in serving dish and garnish with the rest of the toasted almonds.']",7
364,Honey Chipotle Roasted Brussels Sprouts Recipe,5,25,30,"['1 pound Brussels sprouts', '2 tablespoons olive oil', '1/4 teaspoon salt', '1/4 teaspoon black pepper', '2 chipotle peppers, from a can of chipotles in adobo', '1/4 cup honey', '1 tablespoon adobo sauce, from chipotle can']",7,"['1 Preheat oven to 400\\xc2\\xb0F.', '2 Prepare the sprouts: Cut Brussels sprouts in half through the end and toss with olive oil, salt, and pepper. Spread out sprouts on an even layer on a baking sheet. Roast for 15 minutes.', '3 Prepare the honey-chipotle sauce: Using a small knife, split chipotle peppers in half and remove seeds. Then mince the peppers and add to a small bowl with honey and one tablespoon of adobo sauce from the can.', '4 Finish the sprouts: Remove the sprouts from the oven and stir to ensure even cooking, then spread them again into an even single layer on the baking sheet. Toss with the honey chipotle mixture, but reserve a few tablespoons for finishing the sprouts. Return to oven and bake for another 10 minutes.', '5 Serve! Drizzle with the remaining few tablespoons of sauce, and serve sprouts while warm.']",5
365,Shaved Brussels Sprouts with Lemon Recipe,15,10,25,"['1 pound Brussels sprouts, tough or wilted outer leaves peeled off and discarded', '2 teaspoons lemon juice', '2  extra virgin olive oil', '1 garlic clove, minced', '1 tablespoon mustard seeds', '2 tablespoons dry white wine (or Vermouth)', '2 teaspoons lemon zest', 'Salt and pepper to taste']",8,"['1 Thinly slice the brussels sprouts and toss with lemon juice: Put the lemon juice in a large bowl. Peel off any large wilted outer leaves from the brussels sprouts and cut off the bottoms and discard.', 'Cut the sprouts in half lengthwise. Then thinly slice the sprouts crosswise. As you slice the sprouts, put the slices into the bowl with the lemon juice. Toss them to separate the leaves and coat with a little of the lemon juice.', '2 Saut\\xc3\\xa9 shredded brussels sprouts with garlic and mustard seeds: Heat the oil over high heat in a large skillet. When the skillet is hot, add the brussels sprouts, garlic, mustard seeds.', 'Saut\\xc3\\xa9 them until the shaved sprouts are just lightly wilted and cooked, but still green and firm, about 3 to 4 minutes.', '3 Finish with white wine, salt, pepper, lemon zest: Add the wine to the pan. Sprinkle with salt and pepper. Saut\\xc3\\xa9 a minute more.', 'Remove from heat and sprinkle with lemon zest. Add more salt and pepper to taste.', 'Serve immediately.']",7
366,Maple Glazed Roasted Delicata Squash and Brussels Sprouts Recipe,20,35,55,"['1 large delicata squash (about 1 1/4 pound)', '1 pound Brussels sprouts, trimmed of ragged outer leaves and stem', '3 large shallots, peeled, cut lengthwise in half or thirds', '2 tablespoons extra virgin olive oil', '3 tablespoons pure maple syrup (divided 2 tbsp and 1 tbsp)', '1 tablespoon apple cider vinegar', '1 teaspoon Kosher salt (plus more to taste)', '1/4 cup fresh pomegranate arils']",8,"['1 Seed and slice the squash: Cut the delicata squash in half crosswise, and then in half again lengthwise. Use a metal spoon to scrape out the seeds and strings. Cut the squash into half rounds, about 1/2-inch thick.', '2 Preheat oven to 400\\xc2\\xb0F.', '3 Sprinkle vegetables with olive oil, maple syrup, vinegar, salt: Place the squash, brussels sprouts, and shallots into a large bowl and toss with 2 Tbsp olive oil. Sprinkle on 2 Tbsp of maple syrup and one Tbsp of cider vinegar, and toss to coat. Sprinkle with 1 teaspoon of kosher salt.', '4 Spread out on baking sheet and roast: Spread a little olive oil over the bottom of a large baking sheet. Arrange the squash, brussels sprouts and shallots on the baking sheet in a single layer.', 'Roast at 400\\xc2\\xb0F for 30 to 35 minutes, turning the vegetables over after the first 20 minutes. The squash should be lightly browned and the brussels sprouts well browned.', '5 Toss with pomegranate arils and maple syrup to serve: Remove from oven to a serving dish. Gently toss with fresh pomegranate arils and drizzle with the remaining 1 Tbsp maple syrup.']",6
367,Hoisin Glazed Brussels Sprouts Recipe,15,15,30,"['1 pound Brussels sprouts, rinsed, any older outer leaves discarded, stems trimmed slightly, sprouts sliced in half through the stem end', '1 Tbsp peanut oil, or other vegetable oil', '1/2 large onion, sliced thinly root to tip', '2 teaspoons minced ginger', '1 garlic clove, minced, about 1 teaspoon', '1 Tbsp seasoned rice vinegar', '2 teaspoons soy sauce', '3 Tbsp hoisin sauce', '1 teaspoon dark sesame oil', 'Salt to taste']",10,"['1 Whisk together the seasoned rice vinegar, soy sauce, and hoisin sauce in a small bowl, set aside.', '2 Pre-steam the brussels sprouts: Place a steamer rack in a medium pot, add an inch of water. Heat the water to a boil, then add the brussels sprouts to the pot. Cover the pot and steam the brussels sprouts for 5 minutes.', 'Remove the sprouts from the pot and lay them out on a baking sheet to cool while you cook the onions in the next step.', '3 Saut\\xc3\\xa9 the onions: Heat the peanut oil in a wok or large saut\\xc3\\xa9 pan over high heat on your most powerful burner until the surface of the oil shimmers. Add the sliced onions and toss to coat with the oil.', 'Sear over high heat until the edges of the onion slices begin to brown, about 4-5 minutes.', '4 Add the ginger, garlic and brussels sprouts to the pan and toss to combine. Stir-fry for 2 minutes, or until the brussels sprouts begin to brown.', '5 Add the rice vinegar, soy sauce and hoisin sauce mixture to the sprouts and toss to combine. Stir-fry for a minute or two (watch the sides of the pan and turn off the heat if you see any of the sauce scorch on the side of the pan).', 'Drizzle with sesame oil and add salt to taste. Serve at once.']",8
368,Buckwheat Pancakes Recipe,5,20,25,"['Vegetable oil for coating the pan', '3/4 cup (100g or 3.5 oz) buckwheat flour', '3/4 cup (100g or 3.5 oz) all-purpose flour (can sub with buckwheat flour for a 100% gluten-free buckwheat pancake if you wish)', '3 Tbsp sugar', '1/2 teaspoon salt', '1 teaspoon baking soda', '3 Tbsp unsalted butter, melted', '1 egg (optional)', '2 cups (475 ml) buttermilk']",9,"['1 Pre-heat skillet: Heat a well-seasoned griddle, cast iron skillet, or stick-free pan on medium heat. The pan or griddle should be ready for the batter as soon as it is mixed.', '2 Make pancake batter: Whisk together the dry ingredients\\xe2\\x80\\x94the flours, sugar, salt, baking soda\\xe2\\x80\\x94in a large bowl.', 'In Pour the melted butter over the dry ingredients and start stirring.', 'Beat the egg with a fork and stir it into half of the buttermilk. Add the buttermilk/egg mixture to the dry ingredients, then slowly add in the rest of the buttermilk as needed to get to the right consistency for your batter (you may not need all of the buttermilk, depending on what type of buttermilk you are using and the brand of flour).', 'Stir only until everything is combined. Do not over-mix! A few lumps are fine.', '3 Ladle batter onto hot pan: Put a small amount (a half teaspoon) of vegetable oil on the pan or griddle and spread it around with a paper towel to coat.', 'Ladle the batter onto the hot surface to the desired size, about 4-5 inches wide. (A 1/4 cup measure will ladle about a 4-inch pancake.) Reduce the heat to medium-low. Allow the pancake to cook for 2-3 minutes on this first side.', '4 Flip pancakes over to other side: Watch for bubbles on the surface of the pancake. When air bubbles start to rise to the surface at the center of the pancake, flip the pancake. Cook for another 1-2 minutes, or until nicely browned.', '5 Keep finished pancakes warm: Keep your pancakes warm on a rack in the oven set on ""warm,"" or stack them on a plate and cover with a towel as you make more. Spread more oil on the pan as needed between batches of pancakes.', 'Serve with butter and maple syrup.']",10
369,Buckwheat Waffles Recipe,15,20,35,"['1 1/2 cups buckwheat flour', '2 teaspoons baking powder', '1 teaspoon baking soda', 'Pinch of salt', 'Pinch of cinnamon', '2 eggs, separated, plus 2 additional egg whites for extra lightness', '2 Tbsp sugar', '1 cup milk (low fat or regular)', '1/4 cup water', '1 cup plain yogurt', '1/2 cup (1 stick) butter, melted', 'Extra pats of butter for serving', 'Heated maple syrup for serving', 'Berries for serving']",14,"['1 Turn on waffle maker, whisk dry ingredients: Turn on your waffle maker, with the setting on medium. In a large bowl, whisk together the buckwheat flour, baking powder, baking soda, salt, and cinnamon.', '2 Beat egg whites: Place the egg whites in a medium bowl and beat with a hand mixer or egg beater. Sprinkle in the sugar as you beat the egg whites.  Beat egg whites until you have soft peaks.', '3 In a medium bowl, whisk together the egg yolks, the melted butter, yogurt, milk, and water.', ""4 Combine wet and dry ingredients: Pour the yogurt/milk/butter/egg mixture into the buckwheat flour mixture and stir until just combined. It's okay if it's a little lumpy."", '5 Fold in egg whites: Stir a third of the beaten egg whites into the batter until completely incorporated. Gently fold the remaining beaten egg whites into the batter until just combined, and there are no streaks of egg whites. Be gentle so that you do not deflate the egg whites too much.', ""6 Make the waffles: When your waffle maker is ready, working in batches, pour or spoon the batter into the wells, until they almost come to the edge. You will know if you've over-filled it because the batter will spill out of the waffle maker. No harm done, but it's a little messy."", 'I like to grease the inside of my waffle maker with a little butter, to help make it easy to remove the waffles.', 'Cook until the waffle maker indicator indicates that the waffles are ready, or wait until steam stops rising out of the waffle maker. Gently pull the waffles out with a fork.', 'As you make the batches, the batter may thicken while it sits. If you want, thin it out a bit with some water.', 'Getting the right balance of doneness is key here. Lightly browned means the waffles will be fluffy, but not crisp. Dark brown means the waffles may be crispy, but a little dry inside. It depends on your preference and your waffle maker. You may need to experiment with a few test waffles to see what works best for you.', '7 Serve: Serve with pads of butter, warmed maple syrup, and fresh berries.']",11
370,Gluten-Free Banana Bread Recipe,10,55,65,"['1 1/2 cup mashed overripe bananas, from 3-4 bananas', '1/3 cup unsalted butter, melted', '3/4 cup granulated sugar', '1 large egg, beaten', '1 teaspoon vanilla extract', '1 1/2 cups gluten-free all purpose flour', '3/4 teaspoon baking soda', '3/4 teaspoon baking powder', '1/2 teaspoon salt', 'Special equipment:', '8x4 inch loaf pan']",11,"['1 Preheat oven to 350\\xc2\\xb0F.', '2 Prepare the loaf pan: Grease an 8x4-inch loaf pan generously with cooking spray.', '3 Mix the wet ingredients: In a large mixing bowl, add mashed bananas and stir in melted butter, sugar, egg, and vanilla.', '4 Mix the dry ingredients and combine: In a smaller bowl, add flour, baking soda, baking powder, and salt. Whisk to combine. Add the flour mixture to the larger bowl with the wet ingredients and stir until fully combined. (Note that it will be slightly lumpy because of the pieces of mashed banana.)', '5 Bake: Pour batter into the prepared loaf pan, scraping the bowl to assist. Bake for 50 minutes to 1 hour, or until a tester comes out clean.', '6 Serve: Cool on a rack at least 15 minutes before removing the loaf from the pan. Cool completely before slicing and serving.']",6
371,"Brothy Clams with Chorizo, Tomatoes, and Grilled Bread Recipe",20,20,40,"['For the clams:', '1 tablespoon extra-virgin olive oil', '1 large yellow onion, chopped', '4 cloves garlic, minced', '2 1/2 ounces (3/4 cup) Spanish chorizo, skin (casing) removed and cut into thin slices', '2 medium tomatoes, chopped', '1/2 teaspoon dried crushed red pepper (optional)', '1 cup dry white wine', '1 1/2 cups water', '3 1/2 pounds littleneck clams', '1 tablespoon salted butter', '1/3 cup roughly chopped parsley', 'For the bread:', '1 loaf crusty bread, such as sourdough levain, baguette, Italian, or ciabatta', 'Olive oil', 'Salt']",16,"['1 Sort the clams: Throw out clams that are cracked or broken. If any clams are slightly open, tap them on the counter. If they don\\xe2\\x80\\x99t close, throw them out.', '2 Prep the clams: If you harvested the clams yourself or bought them from a small purveyor, soak them in cool, salted water covered with a dish towel for 30 minutes to purge them of sand. Rinse clams in the sink under cool water, rubbing off any dirt with your thumbs.', '3 Make the broth: Heat the olive oil in a large pot or Dutch oven set over medium heat. Add the onion and saut\\xc3\\xa9 until tender and translucent, about 2 minutes. Add the garlic and chorizo and saut\\xc3\\xa9 for a few minutes more to infuse the vegetables with smoky flavor.', 'Add the tomatoes, crushed red pepper, white wine, and water, and raise the heat so the liquid boils gently. Cook a few minutes more to soften the tomatoes and allow the flavors to develop.', '4 Cook the clams: Add the clams, cover with a lid, and simmer until the clams open, about 10 minutes. Break the butter into pieces and add to the pan, stir, and scatter with parsley. Turn off the heat.', '5 Toast the bread: While the clams cook, cut several thick slices of bread (one or two slices per person is a good place to start), brush lightly with olive oil, and sprinkle with salt. Toast on a hot grill or under a broiler. This should only take minute or two. When finished set aside to serve with clams.', '6 Serve: Spoon clams and broth in shallow bowls with a slice of bread on the side.']",7
372,Easy Shepherd\xe2\x80\x99s Pie Recipe,15,50,65,"['1 1/2 to 2 pounds potatoes (about 3 large potatoes), peeled and quartered', '8 Tablespoons (1 stick) butter', '1 medium onion, chopped (about 1 1/2 cups)', '1-2 cups vegetables\\xe2\\x80\\x94diced carrots, corn, peas', '1 1/2 lbs ground round beef', '1/2 cup beef broth', '1 teaspoon Worcestershire sauce', 'Salt, pepper, other seasonings of choice']",8,"['1 Boil the potatoes: Place the peeled and quartered potatoes in medium sized pot. Cover with at least an inch of cold water. Add a teaspoon of salt. Bring to a boil, reduce to a simmer, and cook until tender (about 20 minutes).', '2 Saut\\xc3\\xa9 vegetables: While the potatoes are cooking, melt 4 tablespoons of the butter in a large saut\\xc3\\xa9 pan on medium heat. Add the chopped onions and cook until tender, about 6 to 10 minutes.', 'If you are including vegetables, add them according to their cooking time. Carrots should be cooked with the onions, because they take as long to cook as the onions do.', 'If you are including peas or corn, add them toward the end of the cooking of the onions, or after the meat starts to cook, as they take very little cooking time.', '3 Add the ground beef, then Worcestershire sauce and broth: Add ground beef to the pan with the onions and vegetables. Cook until no longer pink. Season with salt and pepper.', 'Add the Worcestershire sauce and beef broth. Bring the broth to a simmer and reduce heat to low. Cook uncovered for 10 minutes, adding more beef broth if necessary to keep the meat from drying out.', '4 Mash the cooked potatoes: When the potatoes are done cooking (a fork can easily pierce), remove them from the pot and place them in a bowl with the remaining 4 Tbsp of butter. Mash with a fork or potato masher, and season with salt and pepper to taste.', '5 Layer the meat mixture and mashed potatoes in a casserole dish: Preheat oven to 400\\xc2\\xb0F. Spread the beef, onions, and vegetables (if using) in an even layer in a large baking dish (9x13 casserole).', 'Spread the mashed potatoes over the top of the ground beef. Rough up the surface of the mashed potatoes with a fork so there are peaks that will get well browned. You can even use a fork to make creative designs in the mashed potatoes.', '6 Bake in oven: Place in a 400\\xc2\\xb0F oven and cook until browned and bubbling, about 30 minutes. If necessary, broil for the last few minutes to help the surface of the mashed potatoes brown.', ""(Be careful when broiling using Pyrex or glass dishes, they have been known to shatter under the high heat of the broiler. It's not a worry if you are using a ceramic or metal casserole dish.)"", 'Suggested variations:', 'Put a layer of creamed corn between the ground beef and the mashed potatoes.', 'Sprinkle grated cheddar cheese over the top of the mashed potatoes before baking.']",14
373,Cheesy Potato Casserole Recipe,15,50,65,"['1/4 cup butter, plus more for the casserole dish', '1 yellow onion, diced', '3 cloves garlic, minced', '1/4 cup all-purpose flour', '3 cups vegetable or chicken stock', '2 cups grated cheddar cheese', '1/2 teaspoon salt', '1/2 teaspoon black pepper', '30 ounces frozen hash browns', 'DAD ADD: Fried Serrano Rings:', '3 serranos, sliced', '2 tablespoons olive oil', 'Coarse salt']",13,"['1 Preheat the oven and prepare the casserole dish: Preheat oven to 400\\xcb\\x9aF. Lightly butter or grease a 9x13 baking dish.', '2 Make the cheese sauce: In a medium pot, melt 1/4 cup butter over medium heat. Add diced onion and cook for 3-4 minutes until onions turn translucent but not browned. Then add minced garlic and cook for 30 seconds.', 'Stir in flour and continue to cook for a minute or two until the flour turns a tan color. Slowly whisk in stock and bring sauce to a slight simmer. The sauce will thicken as it heats. Once the sauce is thick like gravy, stir in the cheddar cheese and season with salt and pepper. Remove from heat.', '3 Combine the potatoes and the sauce: In a large bowl add the frozen hash browns and pour the sauce over the hash browns. Stir together well to combine and transfer to the prepared baking dish. Smooth the top.', '4 Bake the casserole: Place the casserole in the center rack of your oven and bake for 45 minutes at 400\\xcb\\x9aF. Then turn on the broiler and broil for 5 minutes on high to crisp up the top of the casserole. If your casserole dish is not broiler-safe, then turn the oven up to 500\\xcb\\x9aF and bake for 3 more minutes.', '5 Serve: Let the casserole cool slightly but serve while warm.', '6 Make the Crispy Serrano Rings (Optional DAD ADD): Slice serrano peppers into thin coins. Heat a few tablespoons of olive oil over medium heat in a small skillet. Once it is hot, add serrano coins and cook for 2-3 minutes until they start to brown. Remove the coins from the skillet and let drain on a paper towel. Season with a pinch of salt.', 'LEFTOVERS!', 'Leftovers keep in the fridge for 5 days. Reheat in the microwave until warmed through.']",9
374,Loaf Pan Lasagna for Two Recipe Recipe,25,40,65,"['2 tablespoons olive oil', '2 Italian chicken sausages (about 1/2 pound)', '1 can (28 ounces) whole, peeled tomatoes', '1 clove garlic, thinly sliced', '1 teaspoon dried oregano', '1/2 teaspoon salt', '1/4 teaspoon sugar', '1 large egg', '1 cup ricotta cheese', '1/3 cup finely grated Parmesan', 'Pinch ground nutmeg', 'Pinch ground black pepper', 'Oil or oil spray (for the loaf pan)', '4 no-boil lasagna noodles', '1/2 cup shredded mozzarella', 'For garnish:', 'Chopped parsley']",17,"['1 Cook the sausage: In a medium skillet over medium-high heat, add 1 tablespoon of the oil. Either slice the sausage into rounds or remove the casing from the sausage by slicing lengthwise down the side and cook it like ground sausage.', 'When the oil shimmers, add the sausage to the pan, and cook for about 6 minutes or until browned. Use a cooking utensil to break the sausage up as you cook it. Transfer to a plate.', '2 Snip the tomatoes: Open the can of tomatoes and use a large pair of scissors to snip and break them up in the can into chunky pieces. You will mash them a little more in the skillet.', '3 Make the sauce: In the same skillet you used to brown the sausage, heat 1 tablespoon oil over medium heat. Add the sliced garlic and oregano. Cook for 30 seconds, or until the garlic sizzles. Add the tomatoes with their juices, salt, and sugar. Bring to a simmer and cook for 2 to 3 minutes or until the sauce is hot.', 'Use a potato masher to break up the tomatoes into smaller pieces (this is easiest to do when tomatoes soften in the heat). You are aiming for a chunky sauce.', 'Add the sausage back to the pan and cook for 10 minutes. Taste, and add more salt and sugar, if you like.', '4 Make the ricotta mixture: Meanwhile, in a small bowl, stir the egg, ricotta, Parmesan, nutmeg, and pepper together.', '5 Preheat the oven to 400\\xc2\\xb0F. Brush or spray a 4x8-inch loaf pan with oil.', '6 Assemble the lasagna: In the bottom of the loaf pan, ladle about 1/2 cup tomato-sausage sauce. Top with 1 noodle. Spread with 1/2 cup sauce, and then spread 1/3 mounded cup of the ricotta mixture over it.', 'Place a second noodle on top of the sauce. Spread 1/3 mounded cup ricotta mixture over it, and top with 1/2 cup tomato-sausage sauce.', 'Place a third noodle on top of the sauce. Spread with remaining ricotta and spoon 1/2 cup tomato-sausage sauce over it, using up all of the remaining sausage pieces in this layer.', 'Place a fourth noodle on top of the sauce and spoon the remaining sauce on top. Sprinkle with the mozzarella.', '6 Bake the lasagna: Place the loaf pan on a baking sheet. Fold a large piece of foil in half and fold it in half again. Make a tent over the loaf pan (so it does not stick to the cheese.) Bake for 25 minutes.', 'Remove the pan from the oven and remove the foil tent. Check to see if the lasagna is uneven or if it peaks in the middle. If it\\xe2\\x80\\x99s uneven, use the back of a spoon to press the top layer lightly to make it level in the loaf pan and submerge the noodles in the sauce.', 'Turn the oven down to 375\\xc2\\xb0F. Return lasagna to the oven and continue to bake for 15 minutes, or until the sauce bubbles and the cheese is golden brown. (If you like stretchy rather than browned cheese, check after 10 minutes.)', '7 To serve: Allow the lasagna to rest for 10 minutes before serving. Sprinkle with chopped parsley, if you like.']",16
375,How to Make an Omelette,0,5,5,"['2 large eggs', '1 tablespoon unsalted butter', '2 tablespoons grated cheese, any kind', '3 to 4 cherry tomatoes, cut in half and sprinkled lightly with salt', '2 tablespoons chopped basil, parsley, or herb of your choice', 'Special equipment:', '8-inch nonstick skillet']",7,"['1 Prep the eggs:  In a bowl, beat the eggs with a fork.', '2 Melt the butter: In an 8-inch nonstick skillet over medium-low heat, melt the butter.', '3 Add the eggs and cook the omelette: Add the eggs to the skillet and cook without stirring until the edges begin to set. With a silicone spatula, push the edges toward the center of the pan and tilt the pan so the uncooked eggs move to the edge.', 'Repeat until the eggs are somewhat set but still a little soft in the center, about 6 minutes.', '4 Fill the omelette: Place the cheese, tomatoes, and herbs in a line down the center of the omelette and cook for about 1 minute longer, or until the eggs are mostly set but still a little soft in the center.', '5 Fold and plate the omelette: Slide the spatula around one side of the omelette at the edge to loosen it. Slip it under the eggs, and use it to carefully fold the omelette in half. Slide the spatula under the folded omelette to loosen it from the pan. Tilt the pan over a plate and use the spatula to nudge it onto the plate. Voila!']",6
376,Pasta with Tuna and Capers in White Wine Sauce Recipe,5,20,25,"['Salt', '4 ounces bow tie (farfalle), linguini, or spaghetti pasta', '2 tablespoons extra virgin olive oil (plus more)', '1/2 medium onion, chopped', 'Pinch chili pepper flakes', '1 (6-ounce) can tuna packed in olive oil, drained', '1 tablespoon capers', '1/4 teaspoon salt', '1/4 cup dry white wine', '2 tablespoons chopped flat leaf parsley', 'Freshly ground black pepper']",11,"['1 Cook the pasta: Bring a large pot of water to a boil, add salt (1 1/2 teaspoons for every quart of water), return to a boil. Add the pasta and cook according to package directions until cooked through, but still firm (al dente).', '2 Cook the onions and chili pepper flakes: While the water is coming to a boil and the pasta is cooking, prepare the rest of the recipe. In a large, wide saut\\xc3\\xa9 pan, heat a couple tablespoons of olive oil on medium heat. Add the chopped onion and chili pepper flakes and cook until translucent, about 5 minutes or so.', '3 Mix in the canned tuna, the capers, and the salt. Add the wine, bring to a simmer then lower the heat to low. Cook for 10 minutes or longer, while the pasta is cooking. If the mixture begins to dry out, add a little more wine.', '4 Add the drained pasta to the tuna mixture: When the pasta is ready, drain it and add it in to the pan with the tuna. Toss to mix.', 'Drizzle on a bit more olive oil over it all, then add the chopped parsley and a few grinds of black pepper to taste.']",5
377,How to Make a Grilled Cheese Sandwich,5,5,10,"['3 ounces (about 2/3 to 1 cup) shredded cheddar, swiss, jack, or fontina cheese', '2 slices sandwich bread, preferably 1/2-inch thick', '2 teaspoons mayonnaise or butter']",3,"['1 Preheat the pan and grate the cheese: Put a heavy-bottomed medium skillet over medium-low to medium heat (everyone\\xe2\\x80\\x99s stove is a little different). As the skillet heats, grate the cheese. If you are using more than one kind of cheese, toss them together in a bowl until nicely combined.', '2 Mayo or butter the bread: Spread one side of each slice of bread evenly with mayonnaise or butter. Lay the slices butter-side-down in the preheated skillet.', '3 Add the cheese and let it melt: Distribute the cheese evenly over both slices of bread. If you have a lid for your skillet, put it on; this will help the cheese melt more evenly.', 'Now, stay put! The second you walk away is the second your sandwich will burn. Look for the cheese to begin melting. The time it takes will depend on your stove, your skillet, and the cheese you are using. Lower-moisture cheeses like aged cheddar will take longer to melt. It could take 2 minutes, or up to 5 minutes. You don\\xe2\\x80\\x99t want the cheese to be totally melted\\xe2\\x80\\x94just halfway melted.', '4 Close the sandwich and finish grilling: (If you want to add a filling, like sliced tomato, add it now.) Close the sandwich and continue grilling, flipping the sandwich with a turner as needed, until both sides are golden brown, another 2-3 minutes per side.', 'Usually, the second side takes less time than the first. Press down on the sandwich gently but firmly with your turner to compact it a little, but don\\xe2\\x80\\x99t smoosh it. You may need to turn the heat down to medium-low to keep the bread from charring.', 'Peek in the sandwich to see if the cheese is fully melted. If the bread is grilled to your liking but the cheese needs more time, turn the heat down and grill it a few minutes longer.', '5 Serve the sandwich: Cut the sandwich the way you like best (I like cutting on the diagonal, creating four pointy corners to dip in tomato soup) and let it cool a minute or so before eating, unless you like burning your mouth on molten cheese. Serve immediately.']",8
378,Ham and Potato Soup Recipe,10,90,100,"['2 tablespoons extra virgin olive oil', '1 1/2 cups chopped onion', '3/4 cup chopped parsnips or carrots', '3/4 cup chopped celery', '1 minced garlic clove', '1 meaty ham bone from a ham, or a meaty ham shank', '6 cups low sodium chicken stock', '2 bay leaves', '2 sprigs thyme', '2 pounds Russet potatoes, peeled, and cut into 3/4-inch cubes', '1 1/2 cups cubed ham (if using a ham bone), 3/4-inch dice', '1/2 teaspoon ground pepper', '1/4 cup whipping cream', 'Salt to taste']",14,"['1 Cook onions, parsnips or carrots, celery, garlic in olive oil: Heat olive oil in a large, thick-bottomed pot or Dutch oven on medium high heat.', 'Add the onions, parsnips or carrots, celery, and saut\\xc3\\xa9 for 7 to 8 minutes. Add the garlic and cook for a minute more.', '2 Add ham bone or shank, stock, bay leaves, thyme: Add the ham bone or ham shank to the pot. Add 6 cups of stock. Add bay leaves and thyme. Bring to a boil, lower the heat to maintain a simmer. Cover and simmer for 45 minutes.', '3 Add potatoes: Add the potatoes and simmer for 15 more minutes, until they are cooked through.', '4 Remove ham bone or shank, pur\\xc3\\xa9e half the soup: Remove the ham bone or ham shank from the soup. Pur\\xc3\\xa9e half of the soup so that some of the potatoes get pur\\xc3\\xa9ed to give the soup body, and there are still whole chunks of potatoes for texture.', '5 Add chopped ham: If using a ham shank, cut away the meat and chop into 3/4-inch cubes. Add the chopped ham and black pepper to the soup.', '6 Stir in the cream. Taste for salt and pepper and add more if needed.']",7
379,How to Cook Rice on the Stovetop,0,0,0,"['1 cup long-grain white rice', '1 3/4 cup water', '1/4 teaspoon salt, optional']",3,"['1 Rinse the rice: Put the rice in a wire mesh sieve or strainer and rinse it under cold water for about 30 seconds, or until the water runs clear. Swish it around to get the excess water off.', '2 Combine the rice and liquid: In a medium saucepan (about 2 quarts), combine the rice and water. Add the salt, if using.', '3 Cover and bring to a boil: Put on the lid. Turn the heat to medium-high and bring the rice to a boil. The liquid can quickly boil over and make a big mess, so watch the pot for steam, or listen for the lid making jiggling sounds.', '4 Turn down the heat and set the timer: Once the rice comes to a boil, set a timer for 10 minutes. Reduce the heat to medium-low, or as low as it can go while still maintaining a very gentle simmer (look for wisps of steam around the lid). It\\xe2\\x80\\x99s okay to take off the lid a few times to check on the progress of the rice but try to keep it to a minimum.', '6 Turn off the burner and let the rice steam: Turn off the heat. Let the rice sit with the lid on for 10 minutes so it can steam. Even though the pot is not on the heat, this is part of your cooking time. It\\xe2\\x80\\x99s what makes the rice nice and fluffy, like restaurant rice.', '7 Fluff and serve: Use a fork or spoon to fluff the rice before serving it.']",6
380,Classic Baked Chicken,15,50,65,"['One 3 to 4 pound chicken, cut into 8 parts (2 breasts, 2 thighs, 2 legs, 2 wings), excluding the back', 'Extra virgin olive oil', 'Kosher salt', 'Freshly ground black pepper', '1/2 cup low sodium chicken stock (see Recipe Note) or white wine for the gravy (optional)']",5,"['1 Trim and salt the chicken: Trim the chicken pieces of excess fat. Pat the chicken pieces dry with a paper towel. Sprinkle all sides with salt. Let the chicken pieces sit for 15 to 20 minutes to take the chill off.', '2 Preheat the oven to 400\\xc2\\xb0F (205\\xc2\\xb0C).', '3 Prep the chicken: Pat the chicken pieces dry with a paper towel. Rub olive oil over the chicken pieces and on the bottom of the roasting pan.', 'Sprinkle the chicken pieces all over with black pepper and a little more salt.', 'Arrange the chicken pieces in the pan so that all the pieces are skin-side up, and the largest pieces (the breasts) are in the center of the pan.', ""Don't crowd the pan; allow room in between the pieces."", '4 Bake the chicken: Bake (uncovered) in the oven for 30 minutes at 400\\xc2\\xb0F (205\\xc2\\xb0C). This initial high heat will help brown the chicken.', 'Then lower the heat to 350\\xc2\\xb0F (175\\xc2\\xb0C) and bake for and additional 10-30 minutes more until the juices run clear (not pink) when poked with a sharp knife or the internal temperature of the chicken breasts is 165\\xc2\\xb0F (74\\xc2\\xb0C), and of the thighs is 170\\xc2\\xb0F (77\\xc2\\xb0C) when tested with a meat thermometer.', ""If the chicken isn't browning well enough, place the chicken under the broiler for the last 5 minutes of cooking, until browned sufficiently."", '5 Let it rest: Remove from oven and transfer the chicken to a serving dish. Tent with aluminum foil and let rest for 5 to 10 minutes before serving.', '6 Make gravy: If you would like to make gravy with the drippings from the chicken, place the roasting pan with all its drippings on the stovetop and set the burner to medium heat.', 'Use a metal spatula to scrape up the stuck drippings from the bottom of the pan. When the pan is hot, pour in some white wine or chicken stock to help loosen the drippings from the pan.', 'Transfer the drippings and stock/wine mixture to a saucepan and heat on medium high until reduced to your desired thickness.', 'If you want the gravy even thicker, you can make a slurry with a little cornstarch or flour (a teaspoon) and water (1/4 cup), and add that to the gravy while it cooks.', '7 Serve: Serve with steamed rice, mashed potatoes, or Spanish rice.']",15
381,Penne Pasta with Meat Sauce Recipe,10,45,55,"['1/2 pound penne pasta (use rice pasta for gluten-free version)', 'Salt', '2 tablespoons extra virgin olive oil', '2 cups chopped onion (from about 1 large onion)', '2 cloves garlic, chopped', '1 teaspoon Italian seasoning (blend of dried basil, oregano, rosemary, thyme, marjoram, and savory)', 'Dash red pepper flakes', '1/2 teaspoon fresh thyme (or a pinch of dried)', 'Salt and freshly ground black pepper', '1 pound (16% fat) ground beef', '3 fresh basil leaves, chopped (or a 1/2 teaspoon of dried)', '2 1/2 cups canned chunky tomato sauce (almost 1 28-ounce can, Muir Glen brand if you can get it)', '1 teaspoon sugar', '1 tablespoon chopped fresh parsley']",14,"['1 Cook the penne pasta: Heat to boiling a large pot with 4 quarts of water in it. Once the water is boiling, salt it with 2 Tbsp of salt. Once the water returns to a boil add the pasta to the pot.', 'Leave uncovered, let cook on high heat with a vigorous boil. Put the timer on for 8-10 minutes, or whatever your pasta package says is appropriate for al dente (cooked but still a little firm). Drain.', ""2 Saut\\xc3\\xa9 onions, garlic, with seasonings: Once you've started to heat the water, start working on the sauce. Heat olive oil in a very large skillet on medium heat. Add the chopped onion, Italian seasoning and red pepper flakes."", 'Cook for 5 minutes, stirring occasionally, until the onions are softened. Add the garlic, fresh thyme, season with salt and pepper. Cook for an additional minute, until the garlic is fragrant. Remove from heat and set aside.', '3 Brown the ground beef: Heat a large cast iron pan on high heat. Salt the bottom of the pan generously. Once the pan is hot, break up small chunks of ground beef and add them to the pan, without stirring. (You may need to work in batches; do not crowd the pan.) You want the meat to get well browned.', 'If the pan is too hot and the meat is burning, not browning, take the pan off the heat for a little, and reduce the heat to medium high. On our coil electric stove, it takes the high heat setting for the meat to brown sufficiently, but your stove may be different.', 'Once the meat is browned on one side (a couple of minutes), use a metal spatula to flip the meat over to brown on the other side. At this point, assuming you are using a cast iron pan, you can remove the pan from the heat. The residual heat in the pan will finish cooking the meat.', '4 Add beef and tomato sauce to onions: Use a slotted spoon to lift the meat from the cast iron pan and add it to the pan with the seasoned onions.', 'Add tomato sauce. Use the edge of your metal spatula to break up the bigger chunks of meat into smaller pieces.', 'Add basil. Add a teaspoon of sugar. Bring to a simmer on low heat, let cook, uncovered, for 15 minutes.', '5 Adjust seasonings and add the pasta: Once the sauce has simmered for 15 minutes, adjust seasonings. Add salt and pepper to taste. Add a little more sugar if the sauce is too acidic. Add more tomato sauce if the sauce is a little dry. Stir in the cooked penne pasta. Sprinkle with chopped parsley. Serve immediately.']",11
382,Hamburger and Macaroni Recipe,5,20,25,"['2 cups uncooked macaroni (use rice pasta or gluten-free pasta for gluten-free version)', '1 Tbsp extra virgin olive oil', '1 pound ground beef', '1 yellow onion, chopped (or mixed chopped green onion greens and yellow onion)', '1/2 teaspoon seasoned salt', 'Pinch chili pepper flakes', '1/2 teaspoon celery seed', '1 large can (28 oz) of diced tomatoes', '2 Tbsp Worcestershire sauce', '1/4 cup chopped fresh parsley', 'Salt  and freshly ground black pepper to taste']",11,"['1 Start cooking the pasta: Get a large pot of salted hot water (1 tablespoon of salt for 2 quarts of water) heating and begin cooking the macaroni as per the directions on the macaroni package.', '2 Brown the beef and onions: While the water is heating and macaroni cooking, prepare the sauce. In a skillet, brown the ground beef in a tablespoon of olive oil on high heat. Stir only infrequently so that the ground beef has an opportunity to brown.', 'When the beef has mostly browned, add the onions to the pan and toss to combine. Cook until the onions are soft, about 4-6 minutes.', '3 Add seasonings, tomatoes: Add the celery seed, a dash of crushed red pepper and seasoned salt. Pour in canned tomatoes, add the Worcestershire sauce and stir to combine. Simmer for 5 minutes.', '4 Add cooked pasta: Reserve a half cup of the pasta cooking water. Mix in the drained and cooked macaroni and the parsley. Cook for another 5 minutes. Add in some of the pasta water if the dish is too dry.', 'Add freshly ground black pepper and salt to taste.']",6
383,Baked Cod with Ritz Cracker Topping Recipe,10,20,30,"['2 pounds skinless cod fillets', 'Salt', '1 sleeve of Ritz crackers (about 34 crackers)', '5 Tbsp unsalted butter', 'Lemon and parsley for garnish (optional)']",5,"['1 Prepare oven, baking pan, fish: Preheat the oven to 350\\xc2\\xb0F. Grease a small baking pan or casserole pan with butter or a little oil. Rinse off the fish fillets with cold water, pat dry. Use long nose pliers to remove any pin bones from the fillets.', '2 Place fillets in bottom of dish: If you want, cut the fillets into large serving pieces. Place the fillets at the bottom of the pan, sprinkle with salt.', '3 Top fish with Ritz Cracker butter mixture: Melt the butter. Crush the Ritz crackers and place in a bowl; they should look like coarse breadcrumbs. Mix the melted butter with the breadcrumbs. Pack the crumb mixture over the top and sides of the fish fillets.', '  4 Bake: Place in the 350\\xc2\\xb0F oven and bake for 20 minutes, or until the fish flakes easily. (Thin fillets may take less time, very thick fillets may take longer.)', 'Serve the fish with lemon and parsley.']",5
384,Easy Buttered Noodles Recipe,10,8,18,"['1/2 pound egg noodles', '2 Tbsp butter', '2 Tbsp grated Parmesan cheese', '1 Tbsp chopped fresh parsley', 'Salt and pepper to taste']",5,"['1 Cook the noodles: Heat 2 quarts of water with 1 Tbsp kosher salt in a large pot on high heat until boiling. Add the egg noodles. Cook for 5 minutes. Reserve 1/4 cup of the pasta cooking liquid and drain the noodles.', '2 Add butter, cheese, parsley: Place the drained hot noodles in a large bowl. Add the butter and Parmesan and stir until the butter has melted. Stir in a tablespoon or two of the pasta cooking water. Stir in the chopped parsley. Add salt and freshly ground black pepper to taste.']",2
385,Pepperoni Pizza Penne Pasta Recipe,5,30,35,"['12 ounces penne pasta', '1 cup marinara sauce, homemade or store-bought', '1/2 teaspoon dried oregano', '4 ounces mini pepperoni (see Recipe Note)', '8 ounces mini mozzarella balls', 'Basil chopped, garnish', 'DAD ADD: Spicy Breadcrumb Topper', '2 tablespoons butter', '1/2 cup breadcrumbs', '1/4 teaspoon red pepper flakes', 'Pinch of salt and pepper']",11,"['1 Cook the pasta: Add penne pasta to salted water and cook according to package instructions.', '2 While the pasta cooks, make the spicy breadcrumb topper: If you\\xe2\\x80\\x99re making the Dad Add (highly recommended), melt the butter in a small skillet over low heat. Add breadcrumbs and red pepper flakes and cook, stirring regularly, for 4 to 5 minutes until breadcrumbs are toasted and browned. Season with a pinch of salt and pepper.', '3 Assemble the pasta: When the penne has cooked, drain it and return to hot pot. Stir in marinara sauce and oregano.', 'Off the heat, fold in mini pepperoni and mini mozzarella balls.', '4 Serve: Divide pepperoni pizza penne between bowls and garnish with fresh basil and spicy crispy breadcrumbs, if using.']",5
386,Hamburger Stroganoff Recipe,10,25,35,"['Butter', '1 pound ground chuck beef', 'Salt and pepper', '1 yellow onion, chopped (about 1 cup)', '8 ounces sliced cremini mushrooms (can substitute button mushrooms), sliced', '1/3 cup of dry sherry, dry white wine, or water', '1/2 cup chopped parsley, loosely packed', '1 1/4 cups full fat sour cream (room temperature)', '1 teaspoon lemon juice', '1/4 teaspoon paprika or more to taste', '8 ounces egg noodles']",11,"['1 Heat pasta water: Put a large pot of salted water (1 teaspoon salt for every quart of water) on to heat, for the pasta.', '2 Brown the ground beef: Heat a large saut\\xc3\\xa9 pan on medium high heat. Melt 1 teaspoon butter in the pan and swirl it around.', 'Working in batches as not to crowd the meat (crowding it will make it hard to brown), break up the ground beef and add it to the pan. Sprinkle the meat with salt. Do not stir the meat, as stirring will prevent browning.', 'Once the meat is well browned on one side (a couple minutes, depending on how hot the pan), use tongs or a fork or a metal spatula to flip to the other side.', 'Once that side is browned as well, use a slotted spoon to remove from the pan and set aside.', 'Continue to brown the meat in batches, adding a teaspoon of butter to the pan with each batch if needed, and salting the pan and the meat, until it is all browned. Remove meat from pan. Drain excess fat from pan.', ""3 Saut\\xc3\\xa9 the onions: Add the onions to the pan. If you are working with very lean meat, you may not have any residual fat in the pan. If this is the case, you'll want to add in a tablespoon of olive oil or butter to the pan."", 'Cook the onions, scraping up the meat drippings, until soft, about 5 minutes. Remove onions from the pan (add to the meat).', '4 Start cooking pasta: Depending on the cooking times of your particular brand of pasta, this is likely a good time to add the pasta to the (should be now) boiling, salted water.', '5 Saut\\xc3\\xa9 mushrooms, add sherry: While the pasta is cooking, add a tablespoon of butter to the pan, increase the heat to medium high. Add the sliced mushrooms. Saut\\xc3\\xa9 until nicely browned (about 4 minutes).', 'Add the sherry (or dry white wine or water) to the pan to deglaze the pan, scraping up any browned bits. Let the sherry reduce by at least a half, then lower the heat to low.', '6 Stir in sour cream, paprika, lemon juice, meat, onions, parsley: Remove the pan from the heat. Mix in the sour cream and paprika until smooth. Return the pan to very low heat, and not let the sour cream boil (or it may curdle). You may add a few tablespoons of water to the mixture to thin it out a bit at any time.', 'Stir in the lemon juice, and about 1/4-1/2 teaspoon of salt (taste).', 'Stir in the meat and onions. Stir in the chopped parsley. Add more salt, pepper, and/or paprika to taste.', '7 Serve with noodles: Keep the stroganoff on warm heat until the noodles are done cooking. When the noodles are ready (al dente) drain.', 'Serve the hamburger stroganoff on top of egg noodles.']",16
387,Chicken Paprikash Recipe,10,35,45,"['2 to 2 1/2 pounds of chicken pieces, preferably thighs and legs', 'Salt', '2-3 Tbsp unsalted butter', '2 pounds yellow onions, (about 2-3 large onions)', 'Black pepper to taste', '2 Tbsp sweet paprika, preferably Hungarian', '1 teaspoon (or to taste), hot paprika or cayenne', '1 cup chicken broth', '1/2 cup sour cream']",9,"['1 Salt the chicken pieces well and let them sit at room temperature while you cut the onions. Slice the onions lengthwise (top to root).', '2 Brown the chicken pieces: Heat a large saut\\xc3\\xa9 pan over medium-high heat and melt the butter. When the butter is hot, pat the chicken pieces dry with paper towels and place them skin-side down in the pan.', 'Let the chicken pieces cook 4-5 minutes on one side, until well browned, then turn them over and let them cook 2-3 minutes on the other side. (Take care when turning so as not to tear the skin if any is sticking to the pan.)', 'Remove the chicken from the pan to a bowl, set aside.', '3 Saut\\xc3\\xa9 the onions: Add the sliced onions to the saut\\xc3\\xa9 pan and cook them, stirring occasionally, scraping up the browned bits from the chicken, until lightly browned, about 7 minutes.', '4 Add the paprika and some black pepper to the onions and stir to combine. Let cook for a minute.', '5 Add the chicken broth, place chicken on onions, cover and cook: Add the chicken broth, again scraping up the browned bits from the bottom of the pan, and then nestle the chicken pieces into the pan, on top of the onions.', 'Cover and cook on a low simmer for 20-25 minutes (depending on the size of your chicken pieces).', 'When the chicken is cooked through (165\\xc2\\xb0F if you use a thermometer, or if the juices run clear, not pink when the thickest part of the thigh is pierced with a knife) remove the pan from the heat.', '(If you want, you can also keep cooking the chicken until it begins to fall off the bone, which may take another 30 minutes or so.)', '6 Remove chicken, stir in sour cream: When the chicken is done to your taste, remove the chicken from the pan. Allow the pan to cool for a minute and then slowly stir in the sour cream and add salt to taste.', 'If the sour cream cools the sauce too much, turn the heat back on just enough to warm it through. Add the chicken back to the pan and coat with the sauce.', '7 Serve: Serve with dumplings, rice, egg noodles or potatoes. (If cooking gluten-free, serve with rice, potatoes or gluten-free noodles or dumplings.)']",13
388,African Chicken Peanut Stew Recipe,20,115,135,"['2-3 pounds chicken legs, thighs and/or wings', '3 Tbsp vegetable oil', '1 large yellow or white onion, sliced', 'A 3-inch piece of ginger, peeled and minced', '6-8 garlic cloves, chopped roughly', '2-3 pounds sweet potatoes, peeled and cut into chunks', '1 15-ounce can of crushed tomatoes', '1 quart chicken stock', '1 cup peanut butter', '1 cup roasted peanuts', '1 Tbsp ground coriander', '1 teaspoon cayenne, or to taste', 'Salt and black pepper', '1/4 to 1/2 cup of chopped cilantro']",14,"[""1 Brown the chicken. Heat the vegetable oil in a large soup pot set over medium-high heat. Salt the chicken pieces well, pat them dry and brown them in the oil. Don't crowd the pot, so do this in batches. Set the chicken pieces aside as they brown."", '2 Saut\\xc3\\xa9 the vegetables. Saut\\xc3\\xa9 the onions in the oil for 3-4 minutes, stirring often and scraping any browned bits off the bottom of the pot. Add the ginger and garlic and saut\\xc3\\xa9 another 1-2 minutes, then add the sweet potatoes and stir well to combine.', '3 Cook the stew. Add the chicken broth, crushed tomatoes, peanut butter, peanuts, coriander and cayenne and stir well to combine. Add the chicken. Bring to a simmer and taste for salt, adding more if needed.', 'Cover the pot and simmer gently for 90 minutes (check after an hour), or until the chicken meat easily falls off the bone and the sweet potatoes are tender.', '4 Remove bones and chop the cooked chicken. Remove the chicken pieces and set them in a bowl to cool, until cool enough to touch. Remove and discard the skin if you want, or chop it and put it back into the pot.', 'Shred the meat off the bones and put the meat back in the pot.', '5 Adjust seasonings. Adjust the seasonings for salt and cayenne, then add as much black pepper as you think you can stand\\xe2\\x80\\x94the stew should be peppery. Stir in the cilantro and serve by itself, or with simple steamed rice.']",7
389,Slow Cooked Boston Baked Beans Recipe,0,480,480,"['1 pound (2 to 2 1/4 cups) dry white beans such as Navy beans or Great Northern beans (can also use kidney beans)', '1/3 cup molasses', '1/3 cup brown sugar', '3-4 Tbsp Dijon mustard', '1/8 teaspoon ground cloves', '3 cups hot water', '1/2 pound salt pork (can sub bacon), cut into 1/2-inch to 1-inch pieces', '1 medium onion, (1 1/2 cups) chopped']",8,"['1 Soak beans in water: Place beans in a large pot and cover with 2 inches of water. Soak overnight and drain. Alternatively, bring a pot with the beans covered with 2 inches of water to a boil, remove from heat and let soak for a hour, then drain.', '2 Mix molasses, brown sugar, mustard, ground cloves with water: Whisk together the molasses, brown sugar, mustard, and ground cloves with 3 cups of hot water.', '3 Add ingredients to slow-cooker, layering them, starting with the salt pork: Line the bottom of a slow-cooker (or a Dutch oven if you are cooking in the oven) with half of the salt pork (pick the fattiest pieces). Layer over with half of the drained beans. Add all of the chopped onion in a layer.', 'Top with another layer of beans and the remaining salt pork. Pour the molasses water mixture over the beans to just cover the beans.', '4 Slow cook until beans are tender: Cover and cook in a slow-cooker on the low setting for 8 hours (or in a 250\\xc2\\xb0F oven), until the beans are tender. Check the water level a few hours in, and if the beans need more water, add some. Add additional salt to taste if needed.', 'Note that fresher beans will cook faster than older beans. Your beans may be ready in less than 8 hours, or they may take longer. Best the next day.', 'Serve with Boston brown bread.']",7
390,Bean and Bacon Soup Recipe,15,570,585,"['1 pound dry Great Northern white beans, covered with a couple inches of water and soaked overnight', '5 ounces of bacon, cut into 1/2-inch wide pieces', '2 cups chopped onion (1 large onion)', '3/4 cup chopped celery (about 2 ribs of celery)', '3/4 cup chopped carrots (1 large carrot)', '3 cloves garlic, minced (about 1 tablespoon)', '6 cups chicken stock', '2 bay leaves', '1 Tbsp fresh thyme', '2 1/2 teaspoons kosher salt', '1/4 teaspoon black pepper', '3 Tbsp tomato paste', '1/2 teaspoon paprika', '1 ounce bacon (1 to 2 slices), cooked and crumbled for garnish (optional)', '2 Tbsp chopped fresh parsley for garnish (optional)']",15,"[""1 Drain the beans: Drain the beans that have been soaking in water. (If you haven't already soaked the beans, and you don't have time to do so overnight, you can put them in a large pot of water, bring to a boil, remove from heat and let sit for an hour, then drain.)"", '2 Cook the bacon and vegetables: Put the bacon into a large (5 to 6 quart) thick-bottomed Dutch oven on medium high heat. Let the bacon cook for a minute or two to start rendering out some of its fat, then add the chopped onion, celery, and carrots.', 'Lower the heat to low, cover and cook for 12 to 15 minutes, until vegetables are completely cooked through and softened. Add the garlic and cook a minute more.', '3 Add beans, stock, seasonings, simmer: Add the drained beans to the pot. Add the stock, the bay leaves, thyme, salt and pepper.', 'Increase heat to high to bring to a simmer, then lower the heat to maintain a simmer, partially covered, for 1 hour or until the beans are very soft.', '4 Add tomato paste and paprika: Stir in the tomato paste and the paprika. Cook for 5 more minutes.', ""5 Pur\\xc3\\xa9e half the soup: Remove the bay leaves. Using an immersion blender, pur\\xc3\\xa9e most of the soup. You don't want the soup to be perfectly smooth, but you want to pur\\xc3\\xa9e enough of it so that the beans create a creamy base."", 'Add more salt and pepper to taste.', 'Garnish with crumbled cooked bacon and chopped parsley to serve.']",9
391,Refried Black Beans Recipe,70,180,250,"['Ingredients for cooking the dry beans:', '1 pound dry black beans', '1 tablespoon extra virgin olive oil', '1/2 teaspoon ground cumin', '1/2 large white onion, chopped (about 1 1/2 cups)', '1 garlic clove, minced', '2 teaspoons salt', '1/2 cup chopped fresh cilantro (leaves and tender stems)', ""Additional ingredients for frying the beans after they've been cooked:"", '1 teaspoon chipotle chili powder', '1 teaspoon chili powder', '1/2 teaspoon ground cumin', '1/2 large white onion, chopped (about 1 1/2 cups)', '1 garlic clove, minced', 'Green onion', 'Cilantro', 'Crumbled cotija or queso fresco cheese (omit for vegan version)', 'Tortilla chips or corn tortillas']",18,"['1 Soak dry beans: Place dry black beans in a bowl and add enough water to cover the beans by two inches. Let sit overnight.', ""Alternatively, if you don't have time to soak the beans overnight, place the dry beans in a large bowl and pour boiling water over the beans, covering the beans with at least an inch of water, and let sit for one hour."", 'Note, if your dry beans are a little old, or if you have reason to believe that they will be tough to cook (beans stored in hot or humid climates can get tough), you can add some salt to the water (1 1/2 teaspoons of salt 2 quarts of water) which at this stage will help the beans soften when they cook later.', '2 Saut\\xc3\\xa9 cumin, onion, garlic:  Heat a tablespoon of olive oil in a large thick-bottomed pot (the pot you will use to cook the beans) on medium high heat.', 'Add the cumin. Once the cumin is sizzling, add the chopped onion. Cook for 5 minutes or so, until translucent. Add the minced garlic and cook for a minute more.', '3 Add drained beans and water, simmer 2 hours: Once the beans have soaked, they should have expanded noticeably. Drain the soaking liquid.', 'Add the drained beans and 2 quarts of water to the onions. Bring to a simmer. Partially cover the pot and lower the heat to maintain a simmer. Simmer for 2 hours.', '4 Add Salt and Cilantro, cook 30 min more: After the beans have simmered for 2 hours, add 2 teaspoons of salt (if you salted the soaking water in step 1, then taste first, and only add a teaspoon or so more of salt if you think it needs it).', 'Add 1/2 cup chopped fresh cilantro. Let cook uncovered for another half hour, or until the beans are tender.', '5 Saut\\xc3\\xa9 the spices, then add onions and cook: Heat 2 Tbsp of olive oil in a large frying pan on medium high heat. Add the chipotle powder, chili powder, and cumin.', 'Once the spices are sizzling, add the chopped white onion and cook until translucent.', 'Add the garlic and cook a minute more.', '6 Add beans, then mash: Add the cooked black beans (and liquid from the pot) to the frying pan. Use a potato masher to mash the beans in the pan.  Let them cook 3 to 4 minutes longer.', 'If the beans are a little soupy for your taste, just let them cook longer. If too thick or dry, add more water. Adjust seasonings to taste.', '7 Serve: Garnish with chopped green onions, fresh cilantro, and crumbled cotija or queso fresco cheese.', 'Serve with tortilla chips or corn or flour tortillas (corn if you are gluten-free). Great in tacos or burritos, or for a dip, or a side with steak.']",16
392,Chicken Scampi with Angel Hair Pasta Recipe,5,15,20,"['1/2 pound angel hair pasta', '2 tablespoons unsalted butter', '2 tablespoons olive oil', '1/2 pound boneless, skinless chicken cutlets', '1/2 teaspoon salt', '1/4 teaspoon ground black pepper', '4 cloves garlic, minced', '1/8 teaspoon (a pinch) crushed red pepper flakes', '1/2 cup dry white wine, such as Sauvignon Blanc', 'Zest and juice of 1 lemon, plus more lemon wedges for serving (about 1 tablespoon of zest and 3 tablespoons of juice)', '1/4 cup chopped parsley']",11,"['1 Make the pasta: Cook the pasta in a large pot of salted boiling water, according to package instructions or until al dente. Scoop out about a cup of the pasta cooking water and set it aside. Drain the pasta.', '2 Cook the chicken:  Meanwhile, melt the butter with the olive oil in a large skillet over medium heat. Pat the chicken dry and season both sides with the salt and a few grinds of fresh black pepper. Add the chicken to the skillet and cook about 2 minutes per side, until golden brown and cooked through.', 'Transfer the chicken to a cutting board to rest, leaving the fat in the pan.', '3 Make the sauce: Add the garlic and red pepper flakes to the skillet and cook until fragrant, about 1 minute. Add the wine and lemon juice, scraping up any browned bits from the bottom of the pan, and simmer until reduced by about half, 3 to 5 minutes.', ""4 Finish the pasta: Add the cooked pasta, lemon zest, parsley, and 1/2 cup of the reserved pasta water to the skillet and toss to combine. If it seems too dry or like the sauce isn't coating the pasta, stir in some more of the reserved pasta cooking water."", 'Cut the chicken into slices and toss with the pasta. Serve with extra lemon wedges for squeezing over the scampi.']",6
393,One Pot Chicken and Orzo Recipe,5,30,35,"['2 1/2 to 3 pounds bone-in, skin-on chicken thighs, trimmed of excess fat', '2 teaspoons extra virgin olive oil', '1 teaspoon butter', '2 cups (12 ounces or 340 g) orzo pasta', '1 1/2 cups chopped onion (about 1 medium onion)', '2 cloves garlic, minced', '2 1/4 cups chicken stock', '3/4 cup canned crushed tomatoes (including juices)', '1/2 teaspoon black pepper', '1 teaspoon salt', '2 tablespoons chopped fresh parsley']",11,"['1 Prep and salt the chicken: Trim the chicken thighs of excess skin and fat. Sprinkle both sides with a little salt.', '2 Brown the chicken thighs: Heat olive oil and melt butter on medium high heat in a large skillet (large enough to fit all of the chicken pieces) to coat the bottom of the pan. When the oil is hot, pat the chicken pieces dry on both sides with paper towels and place skin-side down in the pan. Let cook for 5 minutes or until the chicken has browned on one side.', 'Then turn the chicken pieces over and cook for another 4 minutes until lightly browned. Remove the chicken from the pan, set aside.', '3 Brown the orzo pasta, add onions, garlic: Add the orzo pasta to the pan. Stir to coat and let the pasta brown. Once the orzo starts to brown, stir in the chopped onions.', 'Reduce the heat to medium and let cook, stirring often for 2 to 3 minutes until the onions begin to soften. Add the minced garlic and cook a half minute more.', '4 Stir together stock  tomatoes, salt, pepper: In a large measuring cup, stir together the chicken stock, crushed tomatoes, 1/2 teaspoon pepper, and 1 teaspoon of salt.', '5 Add back chicken, pour stock mixture over orzo: Place the chicken pieces skin-side up, on top of the orzo.', 'Pour the stock tomato mixture over the orzo. Increase heat to medium high and let the stock in the pan come to a full boil.', '6 Cover and cook: Lower the heat to the lowest heat you need to maintain a bare simmer. Cover and let cook until the orzo has completely absorbed the liquid and the chicken is cooked through, about 10 to 12 minutes.', 'Remove from heat and let sit for 5 minutes before serving.', 'Taste for salt and pepper and add more if needed. Sprinkle with fresh chopped parsley to serve.']",11
394,Baked Chicken with Cherry Tomatoes and Garlic Recipe,5,50,55,"['2 pounds (900 g) bone-in, skin-on chicken thighs, trimmed of excess fat', '1/2 teaspoon kosher salt', '2 cups of cherry tomatoes (a heaping basket or 25 to 30 cherry tomatoes)', '6 whole cloves garlic, peeled', '1 1/2 tablespoons balsamic vinegar', '1 1/2 teaspoons extra virgin olive oil', '2 sprigs fresh rosemary (or 1/2 teaspoon dry rosemary)']",7,"['1 Arrange chicken thighs in casserole dish, sprinkle with salt: Place chicken thighs in a baking dish that allows for a little room between the thighs. Sprinkle both sides of the chicken thighs with salt.', '2 Preheat oven to 375\\xc2\\xb0F (190\\xc2\\xb0C).', '3 Prep cherry tomatoes with garlic, vinegar, oil: Cut the cherry tomatoes in half. Place in a bowl with the whole garlic cloves. Sprinkle with balsamic vinegar and olive oil.', '4 Place tomatoes, garlic, rosemary around chicken: Pour the cherry tomatoes over the chicken pieces and arrange so that they are squeezed around the chicken pieces. You want the chicken skins to be exposed so they brown in the oven. Lay sprigs of rosemary over the tomatoes.', '(If you are using dry rosemary instead of fresh sprigs, just mix it in with the tomatoes.)', '5 Bake: Bake, uncovered for 45 minutes, until the chicken is well browned on the top and cooked through. Remove from oven and cool for 5 minutes. Skim the excess chicken fat with a ladle.', 'Serve with toasted crusty bread, buttered noodles, or rice. (Skip for paleo option, skip bread and noodles for gluten-free versions.)']",7
395,Shrimp Pasta alla Vodka Recipe,10,20,30,"['12 ounces fettuccine pasta', 'Salt', '2 tablespoons butter', '1 1/2 cups finely chopped onion', '4 cloves garlic, minced, about 4 teaspoons', '1/4 teaspoon red pepper flakes', '1 28-ounce can crushed tomatoes', '1/4 cup vodka', '6 tablespoons heavy whipping cream', '1 teaspoon lemon zest', '1 pound peeled, deveined raw shrimp', '3 tablespoons chopped fresh parsley', 'Freshly ground black pepper']",13,"['1 Put pasta water on to boil: Put a large pot of salted water (1 Tbsp salt for every 2 quarts of water) on to boil for the pasta.', '2 Saut\\xc3\\xa9 onions, garlic, red pepper flakes: Melt butter in a large, thick-bottomed pot on medium high heat. Add the onion and saut\\xc3\\xa9 5 to 7 minutes, until lightly browned.', 'Lower the heat to medium, add the garlic and red pepper flakes and cook a minute more.', '3 Add tomatoes, vodka, cream, zest: Add the crushed tomatoes to the onions. Stir in the vodka, cream, and lemon zest. Increase heat to bring to a simmer, then lower the heat to maintain a simmer.', '4 Start cooking pasta: As soon as you start simmering the sauce, add pasta to boiling salted water. Pasta should be done in 10 minutes.', ""5 Add raw shrimp to sauce: After the sauce has simmered for 5 minutes, about halfway through the pasta cooking time, taste for salt and add salt to taste (you'll likely need about 1 teaspoon). Add the raw peeled and deveined shrimp to the sauce."", 'Cook until the shrimp is just cooked through, about 5 minutes, then remove from heat.', '6 Add cooked pasta to sauce and shrimp: When the pasta is done, al dente, strain it and add it to the vodka tomato sauce and shrimp.', 'Sprinkle with parsley and freshly ground black pepper to serve.']",9
396,Deviled Egg Salad Recipe,10,15,25,"['12 large eggs', '1/4 cup chopped green onion', '1/2 cup chopped celery', '1/2 cup chopped red bell pepper', '2 tablespoons Dijon mustard', '1/3 cup mayonnaise', '1 tablespoon cider, white wine or sherry vinegar', '1/4 teaspoon Tabasco or other hot sauce (more or less to taste)', '1/2 teaspoon paprika (more or less to taste)', '1/2 teaspoon black pepper (more or less to taste)', '1/4 teaspoon salt (more to taste)']",11,"[""1 Hard boil the eggs: The easiest way to make hard boiled eggs that are easy to peel is to steam them. Fill a saucepan with 1 inch of water and insert a steamer basket. (If you don't have a steamer basket, that's ok.)"", 'Bring the water to a boil, gently place the eggs in the steamer basket or directly in the saucepan. Cover the pot. Set your timer for 15 minutes. Remove eggs and set in icy cold water to cool.', 'For more advice, see our How to Steam Hard Boiled Eggs. (You can also pressure cook them.)', '2 Prep the eggs and veggies: Chop the eggs coarsely and put them into a large bowl. Add the green onion, celery, and red bell pepper.', '3 Make the salad: In small bowl, mix together the mayo, mustard, vinegar, and Tabasco. Gently stir the mayo dressing into the bowl with the eggs and vegetables. Add the paprika and salt and black pepper. Adjust seasonings to taste.', 'Best served chilled.']",6
397,Skillet Chicken Puttanesca Recipe,10,20,30,"['1 can (28 ounces) whole peeled tomatoes, with their juices', '4 anchovy fillets, coarsely chopped (optional)', '1 cup pitted Kalamata or other black olives, coarsely chopped', '1/4 cup capers', '1 teaspoon crushed red pepper, or more to taste', '3 tablespoons chopped fresh oregano', '4 skinless, boneless chicken breasts (about 3 pounds)', '1/2 teaspoon salt, or more to taste', '1/4 teaspoon ground black pepper, or more to taste', '3 tablespoons olive oil, divided', '2 cloves garlic, finely chopped', 'Extra sprigs fresh oregano, for garnish', 'Crusty bread, to serve (skip if serving gluten-free)', 'Special equipment:', '12-inch skillet with a lid']",15,"['1 Prep the tomato sauce: Pour the tomatoes into a bowl and crush with your hands or with a wooden spoon until you have uneven 1-inch pieces (you can also use scissors to snip the tomatoes into small pieces).', 'Mix in the anchovies, olives, capers, red pepper, and 2 tablespoons of the oregano to the bowl. Set aside.', '2 Sear the chicken: Sprinkle the chicken all over with salt and black pepper. In a large skillet over medium-high heat, heat 2 tablespoons of the olive oil until hot.', 'Add the chicken and cook without disturbing for 3 minutes, or until browned. If you are using a cast-iron or stainless steel skillet, do not turn until the chicken moves easily without prodding.', 'Turn and cook the other side for 3 minutes. Transfer to a plate.', '3 Make the sauce: In the skillet over medium heat, heat the remaining 1 tablespoon oil. Add the garlic and cook, stirring, for 1 minute.', 'Add the tomato mixture \\xe2\\x80\\x93 be careful since the juices will splutter when you add them to the pan. Cook for 1 minute or until the spluttering stops. Stir well, turn down the heat, and simmer for 5 minutes. Taste for seasoning and add more salt, black pepper, or red pepper, if you like.', '4 Add the chicken and finish the sauce: Add the chicken breasts and any juices to the skillet and spoon a little sauce over top.', 'Cover the pan and simmer for 5 to 8 minutes, or until a meat thermometer inserted into the thickest part of the chicken registers 165F.', '5 Serve: Serve straight from the skillet or transfer to a serving platter. Sprinkle the remaining 1 tablespoon oregano over the top and garnish with oregano sprigs. Serve with plenty of crusty bread.']",10
398,Paprika Chicken with Chickpeas Recipe,10,40,50,"['2 tablespoons smoked paprika', '1 1/2 teaspoons salt', '3/4 teaspoon black pepper', '1/2 teaspoon garlic powder', '1/4 teaspoon ground oregano', '2 pounds chicken thighs (we used bone-in, skin-on), trimmed of excess fat', '1 medium onion, thinly sliced', '1 14-ounce can chickpeas, drained', '2 tablespoons extra virgin olive oil', '1 teaspoon lemon zest', '1 tablespoon lemon juice', '1/4 cup chopped fresh cilantro or parsley']",12,"['1 Coat chicken with spices: Stir together the smoked paprika, salt, garlic powder, pepper, and ground oregano in a large bowl. Place the chicken thighs in the bowl and toss to coat completely with the spices.', 'You can do this several hours ahead, or right before cooking. Your choice. The longer the chicken sits in the rub, the more the flavors will permeate.', '2 Preheat oven to 350\\xc2\\xb0F.', '3 Layer a casserole dish with sliced onions: Place the thinly sliced onions in the bottom of a casserole dish large enough to hold the chicken pieces with room in between.', 'Toss with about 1 teaspoon of the olive oil and spread out in an even layer at the bottom of the dish.', '4 Add chickpeas, lemon, oil to chicken: Add drained chickpeas, lemon zest, lemon juice, and remaining olive oil (2 Tbsp minus 1 teaspoon) to the bowl with the chicken and spices.', 'Toss to coat the chicken evenly with the lemon and oil, and make sure that the chickpeas are coated with the spice mixture as well.', '5 Arrange chicken and chickpeas over onion slices: Arrange chicken pieces, skin-side up, on top of the sliced onions in the casserole dish. Arrange the chickpeas between the chicken pieces.', '6 Bake: Bake uncovered at 350\\xc2\\xb0F for 40-45 minutes, or until the internal temperature of the chicken thighs is at least 165\\xc2\\xb0F when tested with a meat thermometer, and the top is lightly browned.', 'Sprinkle with chopped fresh cilantro or parsley. Add more salt and pepper to taste.', 'Serve with a side salad.']",11
399,"Pasta Skillet with Chicken Sausage, Cheese & Spinach Recipe",10,30,40,"['For the marinara sauce (or substitute 2 1/2 to 3 cups store-bought sauce):', '1 1/2 tablespoons olive oil', '1 1/2 cups (180g) diced red onions', '2 cloves garlic, minced', '1 28-oz. (795g) can of crushed tomatoes', '1 tablespoon honey or sugar', '1/4 cup (5g) chopped fresh parsley', '1/4 cup (5g) chopped fresh basil', '1 teaspoon dried oregano', 'For the pasta:', '8 ounces (225g) penne pasta', '1 1/2 tablespoons olive oil', '1 pound (450g) chicken sausage, cut into bit-sized pieces', '4 to 6 cups (100g to 150g) baby spinach', '1 1/2 cups (140g) shredded mozzarella cheese', 'Chopped parsley, to garnish']",16,"['1 Preheat the oven to 350F.', '2 Make the marinara sauce (or substitute store-bought sauce): Heat 1 1/2 tablespoons of olive oil in a large oven-safe saut\\xc3\\xa9 pan over medium-high heat. Add the onions and cook for 3 to 4 minutes, stirring occasionally, until the onions are softened and translucent. Add the minced garlic and cook for 30 seconds. Add crushed tomatoes and cook until the sauce starts bubbling at a rapid simmer, 1 to 2 minutes.', 'Reduce heat to low and let the sauce continue slowly simmering for 5 to 7 minutes, stirring occasionally. Mix in honey, parsley, basil and oregano and cook for another minute. Season sauce with salt to your taste. Turn off heat. (Makes 2 1/2 to 3 cups; keeps 4 to 5 days refrigerated or 3 months frozen.)', '3 Cook the pasta: Bring 2 quarts of water to boil in a pot. Season with a generous pinch of salt. Once the water boils, add pasta and cook for 7 to 9 minutes, depending on how you like your pasta. Drain and run pasta under cold water. Set aside.', '4 Make the sausage and spinach sauce: Heat 1 1/2 tablespoons of olive oil in a large skillet over medium-high heat. Add chopped sausage and cook for 5 to 7 minutes, until the meat is cooked through. Add pasta sauce and heat for a minute. Add spinach and fold it into the sauce. The spinach should start wilting in 30 seconds.', '5 Bake the pasta: Add pasta to the pan and stir until combined. Top with mozzarella cheese. Put the skillet in the oven and bake for 10 to 12 minutes until the cheese is bubbly and slightly browned at the edges. For a quicker alternative, skip the oven and just stir the cheese into the pasta until the cheese is melted.', '6 Top the pasta with chopped parsley and season with salt and pepper to taste. Serve hot.']",7
400,Parmesan Chicken Recipe,15,15,30,"['1 clove garlic, minced (1 teaspoon)', '1 stick butter (1/2 cup or 1/4 pound), melted', '1 cup dried bread crumbs', '1/3 cup grated Parmesan cheese (or 2/3 cup if you are using a Microplane zester)', '2 Tbsp chopped fresh parsley', '1/4 teaspoon salt', '1/4 teaspoon garlic salt (can sub regular salt)', 'A large pinch of Italian seasoning (herb mix)', '1/8 teaspoon ground black pepper', '2 lbs of skinless, boneless, chicken meat, cut into 1-inch to 2-inch wide pieces']",10,"['1 Preheat oven to 450\\xc2\\xb0F.', '2 Pat chicken pieces dry: Pat the chicken pieces dry with paper towels. Patting the chicken pieces dry will help the chicken pieces have crispy breading when baked.', '3 Prepare melted butter and breadcrumbs: In a small bowl, stir the minced garlic into the melted butter. In another bowl mix together the breadcrumbs, Parmesan, parsley, salt, garlic salt, Italian seasoning, and pepper.', '4 Dredge chicken pieces in butter and Parmesan mixture: Piece by piece, dip the chicken pieces into the garlic melted butter, and then dredge into the Parmesan breadcrumb mixture to coat.', 'Note that if your chicken pieces are cold, they may cause the melted butter to thicken, leaving too much butter sticking the chicken pieces. If you see this happening, just reheat the butter.', '5 Place chicken on roasting dish: Place coated chicken pieces on to a 9x13 (or larger) roasting dish. Try to leave a little room between each piece. (You may need to use more than one roasting pan.) Drizzle with remaining garlic butter.', '6 Bake: Bake uncovered at 450\\xc2\\xb0F 15 minutes, or until chicken is cooked through and juices run clear. Note that the chicken will get much more browned on the bottom side than on the top.']",7
401,Cauliflower Cheddar Soup Recipe,20,40,60,"['2 Tbsp butter', '2 cups sliced onion', '1 1/2 cups sliced celery (about 2 to 3 ribs)', '1/2 cup sliced carrot (1 small carrot)', '1 1/2 Tbsp minced garlic', '2 Yukon gold potatoes, peeled and thinly sliced, about 1 1/2 to 2 cups', '6 cups chicken stock', '6 cups roughly chopped cauliflower (see How to Cut and Core Cauliflower)', '2 bay leaves', '1 1/2 teaspoons fresh thyme leaves, or 1 teaspoon dried thyme', '1 teaspoon kosher salt', '1/8 teaspoon freshly ground black pepper', '1 1/2 cups grated sharp cheddar cheese (about 6 ounces)', '1 teaspoon Worcestershire sauce']",14,"['1 Saut\\xc3\\xa9 the onions, celery, carrots, garlic: Heat butter in a large 5- to 6- quart Dutch oven or thick bottomed pot on medium high heat. Add the onions, celery, and carrots.', 'Cook for 5 to 8 minutes until the onions are softened. Add the minced garlic and cook a minute more.', '2 Add the potatoes, stock, cauliflower, bay leaves, thyme, salt and black pepper. Heat on high and bring the stock to a simmer. Lower the heat to maintain a simmer. Partially cover and cook for 12 to 15 minutes, or until the vegetables are completely tender.', '3 Pur\\xc3\\xa9e until smooth: Remove from heat and remove the bay leaves. Either using an immersion blender or a standing blender, pur\\xc3\\xa9e the soup mixture until completely smooth.', '4 Add the cheddar cheese and Worcestershire: Slowly add the grated cheddar cheese, continuing to pur\\xc3\\xa9e the soup as you add the cheese, until completely blended. Stir in the Worcestershire sauce.', 'Add more salt and pepper to taste, if needed.']",6
402,Baked Chicken Marinara Recipe,5,35,40,"['Sauce:', '2 tablespoons extra virgin olive oil', '3 shallots, peeled, finely chopped', '4 garlic cloves, finely (about 4 teaspoons)', '1 28-ounce can crushed tomatoes', '2 teaspoons dried oregano', '1/4 teaspoon dried crushed red pepper flakes', '1/2 cup chopped fresh basil', 'Chicken:', '3/4 cup breadcrumbs', '3/4 cup grated Parmesan cheese', '1/2 cup all purpose flour', '2 large eggs, beaten', '9 boneless chicken thighs (skinless or skin-on, your preference), if large pieces, then cut in half', '4 tablespoons extra virgin olive oil', '3/4 cup grated mozzarella cheese']",16,"['1 Make the sauce: Heat 2 tablespoons olive oil in heavy large saucepan over medium heat. Add the shallots and saut\\xc3\\xa9 until tender, about 4 minutes. Add the garlic and cook a minute more.', 'Add the tomatoes, oregano, and crushed red pepper flakes. Simmer until sauce thickens, about 10 minutes. Stir in the basil and season to taste with salt and pepper. Set aside.', '2 Bread the chicken pieces: Combine the grated Parmesan and the breadcrumbs in a shallow bowl. Put the flour in another separate bowl, and the beaten eggs in another bowl.', 'Dredge each piece of chicken first in the flour, then dip in the beaten eggs, and then dredge in the breadcrumb mixture.', '3 Preheat oven to 350\\xc2\\xb0F.', '4 Brown the chicken on the stovetop: Heat 4 Tbsp of olive oil in heavy large nonstick skillet over medium-high heat.', 'Working in batches if necessary, add chicken and saut\\xc3\\xa9 until golden brown and cooked through, about 4 minutes per side.', '5 Bake the chicken with the sauce and cheese: Place chicken pieces on an oven-proof serving dish. Spoon sauce over chicken pieces. Sprinkle with Mozzarella cheese.', 'Bake for 10 minutes at 350\\xc2\\xb0F, or microwave on high heat for 10-20 seconds, just until the cheese has melted.']",9
403,Easy Mexican Chicken and Rice Soup Recipe,5,20,25,"['2 tablespoons olive oil', '1 medium onion, diced', '1 teaspoon dried oregano', '1/4 teaspoon salt, or to taste', '1/8 teaspoon black pepper, or to taste', '1 (15-ounce) can fire-roasted diced tomatoes, with juices', '6 cups low-sodium chicken broth', '1 cup fresh or frozen corn kernels', '1/3 cup medium- or long-grain white rice (not cooked)', '2 cups cooked and shredded chicken (See Recipe Note)', 'Leaves from 1/2 bunch fresh cilantro sprigs, for garnish', '1 to 2 limes, quartered, for garnish', 'Corn or flour tortillas, to serve']",13,"['1 Cook the onion: In a large pot over medium heat, warm the oil. Add the onion and oregano. Cook, stirring often for 3 to 4 minutes, or until the onion begins to soften. Stir in the salt and pepper.', '2 Simmer the soup: Add the tomatoes, chicken broth, corn, and rice. Bring to a boil over high heat. Turn down the heat and simmer for 18 to 20 minutes, or until the rice is tender.', '3 Add the chicken: Add the chicken and simmer for 1 to 2 minutes, or until the chicken is hot. Taste, and season with more salt and pepper, if you like.', '4 Serve the soup: Ladle the soup into bowls and serve hot with the cilantro and lime wedges on top, and warm tortillas on the side.']",4
404,Curried Ground Turkey with Potatoes Recipe,20,40,60,"['3-4 Tbsp vegetable oil (or ghee or coconut oil)', '1 pound ground turkey (thigh meat if you can get it)', '1 chopped onion', '1-2 chopped fresh red chiles (optional)', 'Salt to taste', 'A 1-inch piece of peeled ginger, grated fine', '2 garlic cloves, minced (about 2 teaspoons)', '1 Tbsp garam masala (or curry powder)', '1 teaspoon turmeric', '1 teaspoon ground cumin', '1 teaspoon ground coriander', '1/2 cup water', '2 large Yukon Gold potatoes, peeled and cut into 1-inch chunks', '2-4 Roma or other plum tomatoes, diced', '1 cup fresh or frozen peas', '1/2 cup (loosely packed) chopped cilantro or parsley']",16,"['1 Brown the ground turkey: Heat the vegetable oil over medium-high heat in a large pot with a lid. When the oil is hot, add the ground turkey, spreading it out over the pan.', 'Try not to crowd the meat (you may need to cook in batches). Cook the meat without stirring, until it begins to brown.', '2 Add onion and chiles: Add the chopped onion and chiles. Stir and saut\\xc3\\xa9 for 4-5 minutes, or until the onion begins to color a bit. Sprinkle salt over everything.', '3 Add ginger and garlic: Add the grated ginger and garlic, mix well and saut\\xc3\\xa9 for another 1-2 minutes.', '4 Add spices, water, potatoes, then simmer: Mix in the spices (garam masala, turmeric, cumin, coriander), water, and the potatoes. Stir to combine and cover. Turn the heat down to medium-low and simmer for 15-20 minutes, or until the potatoes are tender.', '5 Add tomatoes and peas: When the potatoes are tender, add the diced tomatoes and peas. Mix well and cover the pot. Cook 2-3 minutes. Add salt, if needed, to taste.', '6 Stir in chopped cilantro to serve: Right before you serve, mix in the chopped cilantro. Serve alone or with flatbread or white rice.']",7
405,Pulled Pork Sandwich Recipe,10,165,175,"['For the sauce:', '1 large onion, chopped', '6 garlic cloves, peeled', '1 pickled jalape\\xc3\\xb1o pepper, seeded and chopped', '2 teaspoons Chipotle chile powder', '1 tablespoon tomato paste', '2 tablespoon Dijon mustard', '3/4 cup distilled white vinegar', '1 teaspoon paprika', '1/3 cup ketchup', '2 teaspoons Worcestershire sauce', '1/4 cup light brown sugar', 'Salt', 'For the pork:', '1 bay leaf', '3 pounds pork butt shoulder roast', 'Hamburger buns']",17,"['1 Pur\\xc3\\xa9e sauce ingredients in blender: Pur\\xc3\\xa9e all of the sauce ingredients (everything except the bay leaf, the pork and the buns) in a blender until smooth.', 'If you have extra time, marinate the pork in the sauce overnight or for several hours before cooking.', '2 Simmer pork: Put sauce, bay leaf, and pork into a large pot and add 1 quart of water. Bring mixture to a boil, then reduce to a simmer. Cook, covered, turning frequently, for 2 hours or until the meat pulls apart easily with a fork.', '3 Shred the pork: Remove from heat and cool pork in the sauce. When cool enough to touch, remove the pork from the sauce and shred into small pieces. Set aside.', '4 Reduce sauce, return pork to sauce: Put the sauce back on the stove and bring it to a low boil. Let the sauce boil down until it has been reduced by two thirds. Add the pork back to the sauce. Salt to taste.', '5 Serve: Remove the bay leaf before serving. Serve the pork hot over open-face hamburger buns.']",6
406,Tuna and Tomato Pasta Casserole Recipe,5,40,45,"['4 tablespoons unsalted butter', '1 28-ounce can of tomatoes, whole or crushed', 'Salt', '1 pound pasta shells', '1/2 cup ricotta cheese', '1 6-ounce can tuna packed in olive oil', '1/4 cup fresh basil, chopped or torn', 'A generous 1/2 cup grated parmesan cheese']",8,"['1 Simmer tomatoes with butter 30 min: Melt the butter in a medium pot on medium heat and add the can of tomatoes, including the juice. If you are using whole canned tomatoes (or fresh ones) crush them with your (clean) fingers as you put them in the pot. Simmer gently, partially covered, for 30 minutes.', '2 Cook pasta: While the sauce is cooking, heat a large pot of well salted water to a strong boil. Add the shell pasta to the boiling water and cook at a vigorous boil, uncovered, until al dente, cooked through but still a bit firm to the bite, which is usually whatever the time specified on the pasta package minus about 2 minutes. Drain and set aside.', '3 Combine tuna, tomato sauce, ricotta, pasta, basil: Pour off the excess oil from the tuna can and stir the tuna into the tomato sauce. Add the ricotta cheese, and add salt to taste. Turn off the heat. Mix the sauce with the pasta in a large bowl. Mix in the basil.', '4 Put into casserole, top with parmesan, broil: Pour the pasta into a 2 to 3-quart casserole dish and top with the parmesan cheese. Put under a hot broiler for 4-6 minutes, until the cheese is melted and lightly browned. Serve hot.']",4
407,Salmon Macaroni Salad Recipe,10,20,30,"['1/2 pound (about 2 cups) dry macaroni pasta', 'Salt', '2 (7-ounce) cans salmon', '1/2 cup mayonnaise (plus more to taste or for added smoothness)', '1 teaspoon mustard', '1 teaspoon lemon zest', '1 Tbsp lemon juice', '1/3 cup chopped shallots, red onions, or green onions (with onion greens)', '2 Tbsp chopped fresh parsley', '1 Tbsp chopped fresh dill (or 1/2 teaspoon dried dill)', '2 stalks celery, chopped', 'Tabasco to taste (we used about 10 drops)', 'Freshly ground black pepper']",13,"['1 Boil the macaroni pasta: Bring a pot of water (2 quarts) to a boil. Add 1 Tbsp salt. Add the dry macaroni pasta and cook, uncovered, in a rolling boil for about 10 minutes, or until the macaroni is al dente (slightly firm). Remove from heat, drain, rinse briefly in cold water (macaroni should be still warm after rinsing) and drain again.', '2 Mix salmon and other ingredients in a large bowl: In a large bowl mix the salmon, mayonnaise, mustard, lemon zest, and lemon juice. Mix in the shallots, parsley, dill, and celery.', '3 Stir in drained, warm macaroni: Mix in the cooked macaroni while it is still warm. Add Tabasco and freshly ground black pepper to taste. As the macaroni absorbs the mayonnaise, you may need to add some water to the salad to keep it from being dry. Adjust seasonings.', 'Chill before serving.']",4
408,Chorizo Mac and Cheese Recipe,10,50,60,"['2 cups elbow macaroni', '1 cup milk', '1 teaspoon cornstarch', '4 ounces shredded cheddar cheese (about 1 cup)', '4 ounces shredded pepper jack cheese (about 1 cup)', '6 ounces Mexican chorizo', '1/2 cup minced red onion', '2 Tbsp flour', '2 teaspoons lime juice', '2 Tbsp breadcrumbs', '1 Tbsp butter']",11,"['1 Mix the cornstarch with the 2 cheeses in a bowl and set aside. The cornstarch will help prevent the cheese sauce from getting too stringy.', '2 Heat the milk: Put the milk into a small saucepan and heat until steamy. Keep warm while you are preparing the recipe, do not let boil.', '3 Cook the macaroni pasta: Put 2 quarts of water, salted with 1 Tbsp salt, into a large pot and heat to a boil. Once the water is at a full boil, add the macaroni to the pot. Return to a boil, and cook, uncovered, for about 2 minutes less than the macaroni package specifies, so that it is al dente, cooked, but still firm to the bite.', '4 Cook the chorizo and onion: While the water is heating and the macaroni cooking, prepare the chorizo cheese sauce.', 'Remove chorizo from its casing and put into a medium thick-bottomed saucepan on medium high heat. When the chorizo begins to sizzle, reduce the heat to medium. Cook the chorizo, stirring often, for 2 minutes.', 'Add the minced red onion and cook the mixture until the onions soften, about 3-4 minutes.', '5 Drain macaroni, preheat oven: When the macaroni is cooked, but still a bit firm, drain it and set aside. Preheat oven to 375\\xc2\\xb0.', '6 Make the chorizo cheese sauce: Add the flour to the pot with the chorizo and mix well. Everything will clump up. Reduce the heat to medium-low and cook, stirring constantly and scraping the bottom of the pot, for 2 minutes.', 'Add the hot milk a tablespoon at a time, stirring constantly. When all the milk has been added, heat the mixture to a gentle simmer and cook for 2 minutes.', 'Mix the grated cheese into the chorizo milk sauce.', '7 Add the cooked macaroni to the chorizo cheese sauce. Stir in the lime juice.', '8 Bake: Pour the macaroni and cheese into a small casserole dish. Make sure the top is level. Dust the top with the breadcrumbs, then dot with the butter. Bake until the breadcrumbs are golden, about 20 to 25 minutes.', 'If you want, serve with chopped avocados, crema fresca, and chopped fresh cilantro.']",13
409,Salisbury Steak with Mushroom Gravy Recipe,10,45,55,"['For the steaks:', '1 pound ground beef', '1/3 cup plain breadcrumbs', '1 large egg', '1/2 teaspoon salt', '1/4 teaspoon ground black pepper', '2 tablespoons neutral-flavored oil cooking oil (I use avocado oil)', 'For the mushroom sauce:', '8 ounces crimini or brown mushrooms, sliced', '1 small yellow onion, sliced', '1 clove garlic, chopped', '2 tablespoons tomato paste', '1 1/2 teaspoons prepared yellow mustard', '1 1/2 cups low sodium beef broth', '2 teaspoons cornstarch', '1 tablespoon water', '2 tablespoons chopped fresh parsley, for garnish (optional)']",17,"['1 Make the beef patties: In a mixing bowl, use your hands to mix together the ground beef, breadcrumbs, egg, salt, and pepper.', 'Divide the mixture into four equal pieces, then use your hands to gently shape each piece into a 1/2-inch-thick patty.', '2 Sear the patties in a skillet: Heat the oil in a large skillet over medium heat. When the oil is shimmering, sear the patties on one side for 3 minutes, then flip them with a thin, flexible spatula. Sear them on the other side for another 3 minutes.', 'Transfer the patties to a plate.', '3 Cook the mushrooms, onions, and garlic: There should be a few teaspoons of fat left in the pan from cooking the patties, but add additional oil if needed. Still over medium heat, add the mushrooms, onions, and garlic to the skillet.', 'Cook, stirring often, until the mushrooms have given up their liquid and just begun to brown, 6 to 8 minutes.', '4 Stir in the liquids and braise the patties: Stir the tomato paste, mustard, and beef broth into the mushrooms and onions. Use a spoon to scrape up any brown bits from the skillet.', 'Return the patties to the skillet, spooning a bit of the cooking liquid, mushrooms, and onions over each one. Cover the skillet turn the heat down to low. Let the patties braise in the covered skillet for 30 minutes.', 'While the patties are simmering, you can boil a pot of noodles, make mashed potatoes, and/or prepare any other vegetable quick side dishes.', '5 Thicken the cooking liquid into a gravy: Uncover the skillet and use a spoon to nudge the patties to the side of the skillet. In a small bowl, stir together the cornstarch and water. Stir in the cornstarch mixture and let it boil for about a minute, until the gravy has thickened, then turn off the heat.', '6 Serve the Salisbury steaks: Transfer the patties to plates and ladle the gravy over top. Sprinkle with chopped parsley, if you like, and serve hot with egg noodles or mashed potatoes alongside.']",11
410,Skillet Lemon Rosemary Chicken Recipe,10,85,95,"['2 tablespoons fresh rosemary, chopped', 'Zest of one lemon (1 to 2 teaspoons)', '3 cloves of garlic, roughly chopped', '2 teaspoons kosher salt', '1/4 teaspoon ground black pepper', '1 tablespoon extra virgin olive oil', '2 tablespoons lemon juice', '  2 to 2 1/2 pounds bone-in, skin-on chicken thighs (about 6 pieces)', '2 tablespoons extra virgin olive oil', '4 cloves garlic, peeled and crushed', '3 or more shallots, peeled, halved (optional, can use 1/2-inch thick wedges of red onion, or skip)']",11,"[""1 Make rub with the rosemary, zest, garlic, salt, and pepper: Place the rosemary, lemon zest, chopped garlic, salt, and pepper in a mini-chopper and pulse until well ground. (If you don\\'t have a mini-chopper, just mince the rosemary and garlic very fine, and mix with the rest). Then add the tablespoon of olive oil and pulse again."", '2 Marinate chicken thighs with rosemary lemon rub: Place the chicken thighs in a (non-reactive) bowl and rub all over with the rosemary lemon herb rub. Arrange the thighs skin-side down and sprinkle with the lemon juice. Let marinate for an hour at room temperature, or chill several hours or overnight, and let sit at room temp for an hour before cooking.', '3 Preheat oven to 350\\xc2\\xb0F.', '4 Sear the chicken thighs: Heat 2 Tbsp olive oil in a cast iron (10 to 12-inch) or other large relatively stick-free oven-proof skillet (hard anodized aluminum will work well) on medium high to high heat.', 'As soon as the oil is shimmery hot, pat dry the chicken thighs with paper towels and lay them skin-side down in the pan.', 'Sear the thighs without moving them for 3-5 minutes or until nicely browned.', 'Turn the thighs over in the pan so they are skin-side up. Remove the pan from heat.', '5 Arrange garlic and shallots between chicken thighs and roast in oven: Place garlic cloves and either shallots or onion wedges in between the chicken thigh pieces in the pan. Place in the oven and cook for 20 minutes or until the internal temperature of the chicken thighs reach 170\\xc2\\xb0F.', 'Remove from oven.', ""As a safety note (having burned my hand in the past), I recommend rubbing an ice cube on the handle of the hot pan as a way to cook it down quickly. Then be sure you keep the handle covered with a pot holder so that someone (including yourself) doesn\\'t inadvertently pick up the pan with the hot handle on their bare hands."", 'Serve with a side of rice, pasta, bread, or potatoes, or over a bed of baby arugula or spinach leaves for a low carb option.']",11
411,Breaded and Baked Chicken Drumsticks Recipe,15,20,35,"['1/4 cup mayonnaise', '1/4 cup Dijon or whole grain mustard', '2 teaspoons Worcestershire sauce', '3/4 cup dry breadcrumbs', '2 Tbsp finely chopped chives or green onion greens', 'Salt', '6 large chicken drumsticks, about 1 1/3 lbs', 'Extra virgin olive oil']",8,"['1 Preheat oven, prepare pan: Place rack on upper third of oven. Preheat oven to 425\\xc2\\xb0F. Coat the bottom of a shallow roasting pan or baking sheet with a thin layer of olive oil.', '2 Prepare coatings: Mix together the mayonnaise, mustard, and Worcestershire sauce in a medium bowl. Mix together the breadcrumbs and minced chives in a separate medium bowl.', '3 Dip drumsticks in coatings: Sprinkle each drumstick with salt. One by one, dip each drumstick in the mayonnaise mixture, turning to coat. Then dip the drumstick in the breadcrumbs mixture, turning to coat. Place the drumsticks on the prepared roasting pan.', '4 Bake: Bake chicken at 425\\xc2\\xb0F for 20-25 minutes, until just cooked through, and juices run clear (not pink) when poked with a sharp knife.']",4
412,Fettuccine Alfredo with Mushrooms Recipe,15,30,45,"['8 ounces baby cremini mushrooms, sliced', '8 ounces small shiitake mushrooms, sliced', '1/4 cup butter', '1/2 teaspoon salt', '1/2 teaspoon black pepper', '3 tablespoons all-purpose flour', '2 cups whole milk', '1 1/2 cups grated Parmesan cheese', '1 pound fettuccine, spaghetti, or your favorite pasta', '1/4 cup chopped fresh parsley, to garnish']",10,"['1 Cook the mushrooms: Melt the butter in a deep saut\\xc3\\xa9 pan over medium heat. Add the mushrooms and cook for 6 to 8 minutes until they have released their liquid and become tender. Season with salt and pepper (give one a taste!).', '2 Add the flour: Add the flour to the pot and stir it in to coat the mushrooms. The flour will form a paste on the mushrooms and the pan will look quite dry. Cook for a minute and turn heat down to low.', '3 Make the sauce: Slowly add the milk while stirring; the flour will dissolve in the milk. If any lumps of flour form, break them up against the side of the pan with the back of your spoon. Simmer for 1 to 2 minutes until the sauce has thickened slightly, and then add Parmesan cheese.', 'Lower the heat, cover, and keep warm until ready to serve, up to 10 minutes. If the sauce thickens too much before you\\xe2\\x80\\x99re ready to serve, add a splash of milk to thin it out again.', '4 Make the pasta: Bring a large pot of salted water to a rolling boil and cook the pasta until al dente. Drain and set aside.', '5 Serve: Divide the pasta between plates and top with a generous serving of the sauce. Garnish with fresh parsley and serve.']",6
413,Mom\xe2\x80\x99s Easy Macaroni Salad Recipe,10,15,25,"['2 cups (about 1/2 pound) dry macaroni pasta (use rice or gluten-free pasta for gluten-free version)', 'Salt', '1/4 cup chopped spring onion or green onion', '1/2 teaspoon lemon juice or vinegar', '1 hard boiled egg, chopped', '1 roasted red bell pepper, chopped', '1 tablespoon fresh chopped parsley', 'A generous amount of mayonnaise (1/3 to 1/2 cup)', 'Several pinches of paprika', 'Freshly ground black pepper to taste']",10,"['1 Cook the pasta: In at least 2 quarts of salted water (1 1/2 teaspoons of salt per quart of water), cook the pasta according to package directions until al dente\\xe2\\x80\\x94still slightly firm. Remove from heat, drain and rinse with cool water until the pasta reaches room temperature.', '2 Soak the onions: While macaroni is cooking, put the chopped onions into a small bowl and sprinkle the lemon juice or vinegar, and a little water over them. This will take the edge off the onions.', '3 Assemble the macaroni salad: Combine cooked macaroni, onions, and all other ingredients in a large serving bowl. Adjust seasonings to taste.']",3
414,Creamy Cheesy Turkey Enchiladas Recipe,15,45,60,"['1 Tbsp butter', '1 cup finely diced onion', '1/2 teaspoon ground cumin', '4 ounces cream cheese, room temperature', '3/4 cup cooked sweet potato (can sub cooked carrots, squash, or pumpkin)', '2 1/2 cups chopped cooked turkey meat', '1 teaspoon kosher salt', '1 cup heavy cream', '1 cup prepared tomatillo salsa verde', '1 1/2 cups grated Monterey Jack cheese', '8-10 flour tortillas, about 8-inches wide', '1/3 cup sliced black olives', '2 Tbsp sliced green onions, including greens', 'Equipment needed', 'A 9x13-inch casserole dish']",15,"['1 Saut\\xc3\\xa9 onions in butter, add cumin: Melt butter in small saucepan on medium high heat. Add the finely diced onion and saut\\xc3\\xa9 until golden and lightly browned. Stir the ground cumin into the onions and cook for a minute more. Remove from heat and let cool.', '2 Mix together the cream cheese, sweet potato, cooked chopped turkey, the cooked onions, and a teaspoon of salt with your (clean) hands in a medium bowl.', '3 Roll up tortillas with filling: Preheat oven to 350\\xc2\\xb0F. Butter the inside of a 9x13-inch casserole dish. Working one flour tortilla at a time, place about 1/4 to 1/3-cup of the filling mixture into the center of a tortilla, spreading it out in a line from one side to the other.', 'Roll up the tortilla and place it seam-side down in the casserole dish. Repeat with the rest of the tortillas until the dish is filled.', '4 Add cream, salsa, cheese: Pour heavy cream over all of the enchiladas in the dish. Spread one cup of tomatillo salsa over the top of the enchiladas. Sprinkle with the grated jack cheese.', '5 Bake in a 350\\xc2\\xb0F oven, uncovered, for 25 minutes, or until the cheese is completely melted and the enchiladas are heated through.', '6 Sprinkle with olives and green onions: Remove from oven and sprinkle with sliced black olives and chopped green onions. Serve immediately.']",7
415,Buffalo Cauliflower Tacos with Ranch Sauce Recipe,10,15,25,"['For the tacos:', '2 cups cauliflower, chopped into bite-size pieces', '2 teaspoons neutral oil', 'Pinch of sea salt', '2 tablespoons cashew cream', '2 tablespoons Frank\\xe2\\x80\\x99s Red Hot Sauce', '4 8-inch corn tortillas, warmed', 'For the cashew ranch sauce:', '2 teaspoons minced fresh, flat-leaf parsley', '2 teaspoons minced fresh chives', '1 teaspoon minced fresh dill', '1/4 teaspoon garlic powder', 'Pinch of salt', 'Pinch of pepper', '1/4 cup cashew cream', 'For serving:', '1/2 avocado, diced', '1 tablespoon chopped parsley, to garnish']",18,"['1 Cook the cauliflower: Heat a skillet over medium heat and add the oil followed by the cauliflower. Cook, stirring frequently, until the cauliflower is tender and starting to brown, 8 to 10 minutes.', '2 Add the buffalo sauce: In a small bowl, combine the cashew cream with the hot sauce. Add to the pan with the cooked cauliflower and toss to coat the cauliflower. Add more hot sauce, if desired.', 'Remove the pan from heat until ready to serve.', '3 Make the cashew ranch: Combine the parsley, chives, dill, garlic powder, salt, pepper, and cashew cream in a bowl. Stir to combine.', '4 Warm the tacos: In a dry skillet over medium-high heat, toast the tortillas one at a time until they are warm and show a few charred spots. Keep warm under a clean kitchen towel.', '5 Assemble the tacos: Divide the cooked cauliflower between the tortillas. Top with diced avocado, a drizzle of the cashew ranch, and some chopped parsley.']",6
416,"Autumn Tabbouleh with Cauliflower, Carrots, and Golden Beets Recipe",5,50,55,"['1 cup bulgur wheat', '1/2 teaspoon kosher salt', '1/4 head medium cauliflower', '2 medium carrots, peeled and trimmed', '2 small golden beets, peeled and trimmed', '1/4 cup freshly squeezed lemon juice', '1 teaspoon kosher salt', '1/4 cup olive oil', '2 cups minced parsley', '1 bunch scallions, trimmed and minced', '1 tablespoon sherry vinegar', 'Ground black pepper or to taste', 'Special Equipment:', 'Mandolin']",14,"['1 Make the bulgur: Bring 3 cups of water to a boil in a small saucepan. When the water boils, stir in the bulgur and salt. Cover the pan and remove from heat. Let the bulgur sit for 20 to 30 minutes or until tender. Strain bulgur with a mesh strainer, shaking to remove as much water as possible.', '2 Prep the vegetables: Break the cauliflower into large florets and carefully slice them 1/16-inch thick on a mandolin. Next, switch to a julienne blade and julienne 1/8-inch thick to julienne carrots and beets. (The vegetables can be shredded on a box grater or in a food processor, instead.)', '3 Marinate the vegetables: Combine the vegetables in a large serving bowl and toss with salt and lemon juice. Set aside 20 minutes to marinate, until crisp-tender.', '4 Finish the salad: To the bowl with the vegetables, add the olive oil, cooked bulgur, parsley, scallions, and sherry vinegar. Stir to combine. Taste and add salt, lemon juice, or olive oil as needed.', '5 Let stand 30 minutes before serving: Cover and let mixture marinate at room temperature for at least 30 minutes before serving to give the flavors time to combine. (If marinating longer, set in the fridge.)', 'Salad will keep well covered in the fridge for 3 days.']",6
417,Caramel Apple Monkey Bread Recipe,150,35,185,"['For the dough:', '1 1/4 cups (237 mL) whole milk, warmed (not hot)', '2 teaspoons active dry or instant yeast', '1/4 cup (50 grams) sugar, divided', '4 cups (560 grams) all-purpose flour', '1 1/2 teaspoons kosher salt', '3 tablespoons (42 grams) unsalted butter, melted', 'For the apples:', '1 tablespoon (14 grams) unsalted butter', '1 medium sweet-tart apple, peeled and diced (about 1 1/2 cups; I used honeycrisp)', '1/4 teaspoon ground cinnamon', 'Pinch kosher salt', 'For the caramel sauce:', '1 cup (200 grams) sugar', '1/2 cup + 2 tablespoons (118 mL) apple cider, divided', '2 tablespoons (28g) unsalted butter', '1/2 teaspoon salt', '2 tablespoons heavy cream', 'To assemble:', '1/2 cup (56 grams) unsalted butter', '1 cup (200 grams) sugar', '1 1/2 teaspoons ground cinnamon', 'Special equipment:', 'Bundt pan']",24,"['1 Make the dough: Whisk the warmed milk with the yeast and 2 tablespoons of the sugar in a measuring cup. Set it to the side to become foamy.', 'In the bowl of a stand mixer fitted with the dough hook, whisk together the remaining sugar, flour, salt, 3 tablespoons of melted butter. Add the yeast-milk mixture. Mix on low speed until a shaggy dough forms, then turn the mixer up to medium-low and knead for 10 minutes (set a timer!). When done, the dough should form a ball and spring back when you poke it.', ""2 Let the dough rise for one hour, or overnight: Gather the dough into a ball with your hands and place into a greased bowl. Cover well with plastic wrap. Let the dough rise on the counter for 1 hour, until doubled in size, or place in the fridge to rise overnight. (The dough may not quite double in size if you\\'re refrigerating overnight, but it should look risen and puffed.)"", ""3 Make the apples while the dough rises (or before assembling, if you\\'ve chilled the dough overnight): Melt the butter for the apples in a medium skillet. Add the diced apples, cinnamon, and a pinch of salt. Cook over medium heat for about five minutes until the apples are just tender. Remove from the heat and set aside to cool. (The apples can be made up to a day ahead and kept refrigerated.)"", '4 Make the caramel sauce: In a large saucepan, combine the sugar and 1/2 cup of the apple cider, and stir over low heat until the sugar has dissolved. Once the sugar has dissolved, stop stirring, increase the heat to medium-low, and bring the mixture to a boil.', 'Continue to boil (without stirring!) until the sugar turns a deep golden caramel color, 320F to 330F. Remove from the heat and stir in the butter, followed by the salt, cream, and remaining 2 tablespoons of cider. Whisk until smooth. (Caramel sauce can be cooled and refrigerated for several days; warm briefly in the microwave or on the stovetop, until it\\\'s a ""drizzle"" consistency, before assembling.)', '5 Assemble the monkey bread: Grease a bundt pan well and set aside. Melt the butter needed for assembly. In a separate bowl, mix together the sugar and cinnamon.', 'Tear off walnut- or golf ball-sized pieces of dough and roll into balls between your hands, They don\\xe2\\x80\\x99t have to be uniform! Dip each dough ball into the melted butter, roll in cinnamon sugar, and place in the bottom of the prepared bundt until there is a good layer on the bottom of the pan (using up about half the dough).', 'Spoon all of the apples over the dough, followed by a third of the caramel sauce. Continue rolling the remaining dough and layering in the pan. Drizzle another third of the caramel sauce over the top. (Save the rest of the caramel sauce for serving).', ""6 Let the monkey bread rise for 30 to 60 minutes: Cover the monkey bread with plastic wrap. Room temperature dough will take about 30 minutes to rise; dough that\\'s cold from the fridge will take 30 to 60 minutes. Let the monkey bread rise until the top looks slightly puffed and pillowy."", '7 Preheat the oven to 350\\xc2\\xb0F.', '8 Bake the monkey bread: Uncover the bundt pan and transfer to a sheet pan (to catch butter drips!). Place in the oven and bake for 30 to 35 minutes. When done, the top should have risen slightly over the top of the pan and the bread should be a deep golden brown.', '9 Cool and serve! Cool the monkey bread in the bundt pan on a wire rack for 15 minutes. Place a serving plate over the pan, and using oven mitts, flip the pan over to unmold the monkey bread onto the plate.', 'Drizzle with the remaining caramel sauce and serve. Be careful, the bread will still be hot!']",14
418,Chocolate Zucchini Cake Recipe,20,50,70,"['2 1/2 cups regular all-purpose flour, unsifted', '1/2 cup natural, unsweetened cocoa', '2 1/2 teaspoons baking powder', '1 1/2 teaspoons baking soda', '1 teaspoon salt', '1 teaspoon cinnamon', '3/4 cup soft butter', '1 cup white granulated sugar', '1 cup brown sugar', '3 eggs, room temperature', '2 teaspoons vanilla extract', '2 teaspoons grated orange peel', '3 cups coarsely shredded zucchini (from about 1 pound of zucchini, or 3 medium zucchini)', '1/2 cup milk', '1 cup chopped walnuts or pecans', 'Glaze (directions follow)', 'Glaze:', '2 cups powdered sugar', '3 Tbsp milk', '1 teaspoon vanilla extract']",20,"['Preheat the oven to 350\\xc2\\xb0F (175\\xc2\\xb0C).', '1 Drain the shredded zucchini: Set the shredded zucchini to drain in a sieve over a bowl. If no moisture drains out and the zucchini feels dry, sprinkle some water over it and let the excess drain.', '2 Whisk together dry ingredients: Vigorously whisk together the flour, cocoa, baking powder, soda, salt, and cinnamon in a bow, and set aside.', '3 Mix wet ingredients: With a mixer, beat together the butter and the sugars until smooth. Add the eggs to the butter and sugar mixture one at a time, beating well after each addition. With a wooden spoon, stir in the vanilla, orange peel, and zucchini.', '4 Mix dry with wet ingredients to make batter: Alternately stir in the dry ingredients and the milk into the zucchini mixture, including the nuts with the last addition.', '5 Prep pan, add batter: Spray the inside of a 10-inch bundt pan or tube pan lightly with cooking spray (or grease with butter). Wipe off the excess. Pour in the batter and use a rubber spatula to level the top of the batter.', '6 Bake: Bake in the oven at 350\\xc2\\xb0F (175\\xc2\\xb0C) for about 50-55 minutes or until a wooden pick inserted in the center comes out clean (test at 45 min).', 'Cool in pan 15 minutes; turn out on wire rack to cool thoroughly.', '7 Make glaze: Make the glaze by mixing together the glaze ingredients. You can easily do this by hand with a whisk or a spoon. If the glaze is too runny, add some more powdered sugar. If too thick, add more milk.', '8 Drizzle glaze over cake.', 'Cut in thin slices to serve.']",11
419,Classic Vanilla and Chocolate Marbled Bundt Cake Recipe,20,90,110,"['To grease the pan:', '1 tablespoon unsalted butter, at room temperature', '2 tablespoons all-purpose flour', 'For the chocolate syrup:', '1/2 cup (100 g) granulated sugar', '1/2 cup (55 g) natural cocoa powder (not Dutch-process)', '1/2 cup freshly brewed strong hot coffee', '1/4 cup (85 g) mild-tasting honey', '1/2 teaspoon vanilla extract', 'For the cake batter:', '2 cups (400 g) granulated sugar', '1 cup (225 g or 2 sticks) unsalted butter, at room temperature', '2 teaspoons vanilla extract', '4 large eggs, at room temperature', '1 teaspoon baking powder', '1 teaspoon baking soda', '1/2 teaspoon kosher salt', '2 3/4 cups (385 g) all-purpose flour', '1 cup buttermilk', '1 cup (210 g) semisweet chocolate chips', 'For the vanilla bean glaze:', '1 vanilla bean or 1 tablespoon vanilla extract', '1/4 cup whole milk', '2 to 2 1/2 cups (230 g to 290 g) powdered sugar', 'For decoration:', 'Chocolate pearls, chocolate shavings, or chocolate sprinkles (optional)', 'Special equipment:', '12-cup bundt pan (I have this one)']",28,"['1 Grease the pan: Preheat the oven to 350\\xc2\\xb0F. Place the butter in a 12-cup Bundt pan and grease the pan with your fingers, making sure to grease all the nooks and crannies. Sprinkle the flour all over the pan and knock out the excess.', '2 Make the chocolate syrup: Combine the sugar, cocoa powder, coffee, and honey and in a small saucepan and cook over medium heat until the sugar has dissolved and the syrup starts to boil. Bring to a simmer, whisking to make sure there are no lumps. Remove from the heat and stir in the vanilla.', '3 Make the cake batter: Place the sugar and butter in the bowl of a stand mixer fitted with the paddle attachment. Beat on medium speed until the butter looks light in color and fluffy, about 2 minutes. Add the vanilla and mix until incorporated.', 'Add the eggs one at a time, beating until completely incorporated and scraping down the sides and bottom of the bowl between each addition. Add the baking powder, baking soda, and salt and beat until the dry ingredients are absorbed.', 'Add the flour in three additions and the buttermilk in two, alternating between the flour and buttermilk and ending with the flour. Beat until incorporated and scrape down the sides and bottom of the bowl between each addition. Gently fold in the chocolate chips.', '4 Spoon one-third of the batter into a medium bowl and add the chocolate syrup. Stir to incorporate completely and set aside.', '5 Layer the batter in the bundt: Spoon half of the remaining vanilla batter into the prepared Bundt pan. Scrape the chocolate batter on top. Spread the remaining vanilla batter on top of the chocolate batter.', '6 Swirl the vanilla and chocolate layers: Insert a butter knife or chopstick into the batter and make \\xe2\\x80\\x9cfigure eight\\xe2\\x80\\x9d motions throughout the entire cake to marble the batter. You may want to sometimes dig deep to the bottom and sometimes lift up to make sure the batter really moves around. Just don\\xe2\\x80\\x99t overmix the batters, or else they will blend together instead of marbling.', '7 Bake the bundt cake: Place the pan on a rimmed baking sheet. Bake until a toothpick or skewer inserted in the center comes out clean and the cake springs back when pressed down lightly, 50 to 60 minutes.', '8 Let cool in the pan on a wire rack for 20 to 30 minutes and then invert onto a serving plate while still warm. If the cake doesn\\xe2\\x80\\x99t unmold, gently slip a very thin knife between the cake and the pan all the way around to loosen it and then try again.', '9 Make the vanilla bean glaze: Slice the vanilla bean lengthwise, if using, and scrape the seeds into the milk in a large bowl. Chop the bean in half and toss the pod in with the milk as well. Let steep in the refrigerator as the cake cools.', 'Once the cake has cooled completely (after about 2 hours), remove the vanilla bean from the milk and sift 2 cups powdered sugar into the milk. (If using the vanilla extract, add it to the milk right before sifting the powdered sugar; no need to steep it.) The glaze should be thin enough to pour, but thick enough to hold its shape on the cake, similar to honey in consistency. If the glaze is too thin, add more powdered sugar, 1 tablespoon at a time, until it reaches the desired thickness.', ""10 Drizzle the glaze on top of the cake, making sure the glaze drips down the sides of the cake. [Emma\\'s Tip: Tuck parchment paper under the cake while you drizzle to catch the drips, then remove once the icing is set.] If decorating with chocolate pearls, shavings, or sprinkles, sprinkle them randomly on the cake before the glaze dries.""]",13
420,Lemon Poppy Seed Bundt Cake Recipe,15,60,75,"['For the cake:', '3 cups (374g) all-purpose flour', '3/4 teaspoon baking powder', '1/2 teaspoon baking soda', '1 1/2 teaspoons kosher salt', '1/4 cup (43g) poppy seeds', '1 1/2 cups (339g) unsalted butter, softened', '2 cups (400g) sugar', '3 tablespoons lemon zest (from 4 to 6 lemons)', '4 large eggs, at room temperature', '1/4 cup lemon juice (from about 2 lemons)', '1 cup buttermilk', 'For the lemon syrup:', '1/2 cup lemon juice (from about 4 lemons)', '1/2 cup (100g) sugar', 'For the lemon glaze:', '1 1/2 cups (170g) powdered sugar', '2 tablespoons lemon juice (from 1 lemon)', '1 to 2 tablespoons milk', 'Pinch of kosher salt', 'Special equipment:', '10-cup bundt pan']",22,"['1 Prep the pan: Preheat the oven to 350\\xc2\\xb0F with a rack in the middle position. Generously spray a 10-cup capacity bundt pan with baking spray.', '2 Mix the dry ingredients: In a large mixing bowl, whisk together the flour, baking powder, baking soda, salt, and poppy seeds.', '3 Make the batter: In the bowl of a stand mixer, beat the butter until creamy. Add the sugar and lemon zest, beat for 3 to 4 minutes, or until pale and fluffy. Scrape down the sides of the bowl and beat in the eggs one at a time, scraping the bowl after each addition.', 'Whisk the lemon juice and buttermilk together in a measuring cup. With the mixer on medium-low, beat in a third of the flour mixture, followed by a third of the milk mixture. Continue to add the flour and milk, alternating between the two and scraping down the sides of the bowl as needed.', '  4 Bake the cake: Scrape the batter into the prepared pan and even the top. Tap the pan on the counter a few times to make sure the batter settles into the crevices of the pan.', 'Bake in the center of the preheated oven for 60 to 75 minutes, or until a toothpick inserted in the center of the cake comes out clean and the top of the cake springs back to the touch.', '5 Cool the cake: Remove the cake from the oven and cool in the pan for 15 minutes before unmolding on a wire rack. The cake should still be warm.', '6 Make the syrup and drizzle over the cake: While the cake is cooling in the pan, make the lemon syrup. Combine the lemon juice and sugar in a saucepan and bring it to a boil over high heat. Boil until the sugar has dissolved, then remove from heat.', 'Brush the syrup over the still-warm, unmolded cake. You should use up all the syrup. Cool completely before icing.', '6 Ice the cake: To make the icing, whisk the powdered sugar and lemon juice together, followed by 1 tablespoon of the milk and the salt. Whisk in additional milk as needed until the icing is thin enough to pour, but still holds a ribbon on the surface.', 'Spoon the icing over the cooled cake. This cake keeps well, glazed or unglazed, at room temperature wrapped in plastic for 3 days. (If glazed, let the glaze set until dry to the touch before wrapping in plastic.)']",11
421,Chocolate Bundt Cake Recipe,25,75,100,"['7 ounces bittersweet chocolate', '4 ounces (1 stick) butter (plus more for greasing the pan)', '1 3/4 cups of strong coffee', '1/4 cup bourbon whisky (if skipping the whisky, just use more coffee)', '3/4 teaspoon of salt (if using salted butter, reduce to 1/8 teaspoon of salt)', '2 cups all purpose flour', '1 teaspoon baking soda', '2 eggs', '1 1/2 cups sugar', '1 teaspoon vanilla extract', '3 Tbsp cocoa for dusting the bundt pan', '1 Tbsp powdered sugar for dusting the cake (optional)', 'Special equipment:', 'One 2 1/2-quart capacity bundt pan (or two 4x8x2 loaf pans)']",14,"['1 Preheat oven, prep bundt pan: Preheat oven to 275\\xc2\\xb0F. Grease inside of a 2-quart bunt pan with a thin layer of butter. Sprinkle cocoa over the butter. Set aside.', '2 Melt chocolate butter, coffee, bourbon, salt: Place a metal bowl over a saucepan filled with an inch or two of water, make sure that the water is not touching the bottom of the metal bowl. Place the chocolate, butter, coffee, bourbon, and salt in the metal bowl. Heat the saucepan to a low simmer. (Basically you are creating a double boiler to gently melt the chocolate mixture.)', 'Stir occasionally as the chocolate melts. Once the mixture is melted and smooth, remove the bowl from heat and let sit to cool for 15 minutes (you can chill in the refrigerator if you want to speed up this process.)', '3 In a medium bowl, vigorously whisk together the flour and baking soda.', '4 In a large mixing bowl, beat the eggs, sugar, and vanilla together until light and foamy (you can use a hand mixer for this, or a stand up mixer).', ""5 Make batter: Once the chocolate mixture has cooled sufficiently, slowly whisk it into the egg sugar mixture. Then, stir in the flour mixture, a third at a time. Whisk until smooth. (The batter will be rather liquid-y. Don't worry about it.)"", '6 Bake: Pour batter into the prepared bundt pan. Place on the middle rack of the preheated oven. Bake at 275\\xc2\\xb0F for 1 hour 15 minutes, until a tester inserted into the center comes out clean.', '7 Cool in the pan for 15 minutes, then gently remove from the pan and cool on a rack until completely cooled to room temperature.', '8 Sprinkle with powdered sugar: Transfer cake to a serving platter. Sprinkle with powdered sugar, if using. Slice with a serrated bread knife to serve. Serve with whipped cream or ice cream.']",9
422,How to Grill the Best Burgers,10,5,15,"['2 pounds 80/20 ground beef, cold', '4 cloves minced garlic', '2 tablespoons minced onion', '1 tablespoon Worcestershire sauce', '1 3/4 teaspoons freshly ground pepper', '1 1/2 teaspoons salt', '6 hamburger buns', 'Butter for buns']",8,"['1 Make the burger mix: Put the cold ground beef in mixing bowl. Sprinkle the other ingredients evenly over top. Fold the meat over a few times to get everything incorporated. This entire process should only take about 30 to 45 seconds. Don\\xe2\\x80\\x99t over handle the meat.', '  2 Shape the burger patties: Rather than forming the patties in your hand, form them on a tray. This makes it easier to shape the patties without over-handling or warming the meat. I like to use a cookie sheet lined with parchment paper, but any tray or platter will do.', 'On the tray, divide the meat into 6 equal parts (about 5 1/4 ounces each). Gently form each portion into a patty that is 4-inches across with 1-inch sides and a shallow depression in the middle (see photos below). You want the outer 1/2 inch of the patty to be slightly taller than the inside. This keeps the patty from shrinking too much and from puffing up in the center during grilling', 'Cover the patties with plastic wrap and transfer to the fridge while you heat up your grill and butter your buns.', '  3 Heat the grill: Heat a gas or charcoal grill to 450 to 500\\xc2\\xb0F, or hot enough that you can only hold your hand above the grill grates for about 1 second.', 'Butter the insides of all the buns and set them near the grill.', '4 Grill the burgers: Place patties on the grill over direct heat. Cook to your desired doneness:', 'For rare burgers, cook for 4 minutes total (125\\xc2\\xb0F)', 'For medium-rare burgers, cook for 5 minutes total (135\\xc2\\xb0F)', 'For medium burgers, cook for 6 to 7 minutes total (145\\xc2\\xb0F)', 'For well-done burgers, cook for 8 to 9 minutes total (160\\xc2\\xb0F)', 'Flip the burgers at least once during cooking, or as often as you wish. Do not press down on the patties at any time.', '  5 Add the cheese and toast the buns: When you have about 1 minute left on the cooking time, add the cheese to the burgers and the buttered buns to the grill over indirect heat.', '6 Rest the burgers: Remove burgers and buns from grill and transfer to a clean platter. Let the burgers rest for 1 minute before serving.', '7 Serve: Serve with tomato jam, mayonnaise, bacon jam, garlic aioli, blue cheese sauce, saut\\xc3\\xa9ed mushrooms, Thousand Island, or the classic and always wonderful lettuce, tomato, pickles and red onion.']",15
423,Spicy Turkey and Zucchini Burger Recipe,25,25,50,"['1 pound ground turkey meat', 'Just under 2 cups, lightly packed, coarsely grated zucchini (from about 2 to 3 small zucchinis or one medium zucchini)', '3 green onions, thinly sliced, onion greens included', '2 tablespoons chopped fresh mint (spearmint)', '2 tablespoons chopped fresh cilantro (tender stems included)', '1 clove garlic, crushed and minced', '1 teaspoon ground cumin', '1 teaspoon Kosher salt', '1/2 teaspoon freshly ground black pepper', '1/2 teaspoon cayenne', '3 tablespoons extra virgin olive oil', 'Sour cream sauce:', '1/4 cup sour cream', '1/3 cup plain Greek yogurt', '1 teaspoon grated lemon zest', '1 tablespoon lemon juice', '1/2 teaspoon minced garlic', '2 teaspoons extra virgin olive oil', '1/4 teaspoon salt', 'Pinch of freshly ground black pepper']",20,"['1 Make the sour cream sauce by placing all of the sauce ingredients in a bowl and stirring until combined. Chill until ready to use.', '2 Mix the turkey zucchini mixture: In a large bowl place the grated zucchini, sliced green onions, chopped mint, cilantro, and garlic, ground cumin, salt, pepper, and cayenne. Stir to combine.', 'With your hands, mix in the ground turkey until the zucchini mixture is well distributed through the ground turkey.', '3 Form patties: Use your hands to form 3 to 4 inch wide patties, placing them on a baking sheet. Note that the patties will be rather wet, so they may be a little tricky to handle.', '4 Fry gently: Heat 3 Tbsp of olive oil in a large frying pan on medium high heat. Once the oil is hot, lower the heat to medium.', 'Working in batches, place the patties in the pan. Let cook for about 5 minutes, then flip the patties over and cook for another 5 to 6 minutes.', ""You want them to brown and to gently cook all the way through. If the temperature is too high, they'll get browned on the outside but the inside will still be raw. So, cook them gently."", ""If the outsides are browned and the insides still aren't done, lower the heat and cook longer."", '5 Remove to paper-towel lined plate: Once the first batch of patties are done, remove to a paper towel-lined plate while you cook the second batch. Or you can keep the patties warm in a 200\\xc2\\xb0F oven.', 'Makes 8 large patties or up to 18 small ones. Serve with the sour cream sauce.']",10
424,Danish Pork Burgers Recipe,10,20,30,"['1 pound ground pork', '1 red onion, finely diced', '16 saltine crackers, crumbled', '1/2 cup whole milk', '2 eggs, lightly beaten', '1 teaspoon kosher salt', '1/2 teaspoon freshly ground black pepper', 'Vegetable oil for cooking', 'Dijon mustard for serving']",9,"['1 Make the ground pork mixture: Using your hands to combine, mix together the pork, saltines, onion, eggs, milk, salt, and pepper in a large bowl.', '2 Fry the patties: Lightly brush a large, nonstick frying pan with vegetable oil. Heat the pan on medium high. Divide the pork mixture into 8 equal portions.', 'Working in batches, drop each portion into the hot pan, spacing them as not to crowd the pan.', 'Pat them down with the back of a spoon to form them into patties. Cook the patties, turning once, for 4 to 5 minutes per side, until golden brown.', 'Serve the pork burgers with Dijon mustard.']",5
425,Hawaiian Pork Burger Recipe,15,25,40,"['1 pound ground pork', '1/4 cup minced green onion', '1/2 teaspoon ground ginger', '1/8 teaspoon ground allspice', '1/8 teaspoon salt (more to taste, but be careful, the BBQ sauce is salty, as is the ham)', 'Pinch black pepper', '4 pineapple rings, fresh or canned', '1/4 cup your favorite barbecue sauce', '4 burger buns', '4 large lettuce leaves (use leafy lettuce)', '1/4 pound thinly sliced ham']",11,"[""1 Make burger mixture: Use your (clean) hands to mix the ground pork, green onion, allspice, salt, pepper and ground ginger together in a large bowl until just combined. Don't knead the mixture too much or the burgers will be tough."", '2 Form patties: Gently form 4 equal patties, with a slight indentation in the middle (the burgers will contract as they cook, the indentation helps keep the burgers from bulging in the middle too much).', 'If you want, you can separate the patties with wax paper and store them for a few hours in the fridge before grilling.', '3 Grill the patties: Prepare your grill for medium high, direct heat. Scrape down the grill grates and coat with vegetable oil.', 'Place the pork patties on the hot grill and paint the top with barbecue sauce.', 'Cover the grill and cook for 5-7 minutes. Flip the burgers and paint with more barbecue sauce.', ""4 Grill pineapple rings: After you've flipped the burgers, lay the pineapple rings down on a hot part of the grill. Cook the burgers for another 5 to 7 minutes, until cooked through."", 'Cook the pineapple rings for 3-5 minutes, or until you have nice grill marks on one side. Flip the pineapple and grill another 1-2 minutes.', 'Remove the pineapple and burgers from the grill and let them rest 5 minutes.', '5 Toast burger buns on grill: While the meat is resting, toast the burger buns on the hot grill until the edges brown nicely, about 1-2 minutes.', '6 Assemble the burgers: To construct the burger, lay some lettuce on the bun, add the burger patty and paint with a little more barbecue sauce. Top with the ham, then the pineapple, then the other bun.', 'Serve immediately.']",12
426,Tuna Burgers with Dill Olive Mayo Recipe,15,18,33,"['For the dill olive mayo:', '1/3 cup mayonnaise', '1 tablespoon chopped fresh dill or 1 teaspoon dried dill', '1 tablespoon sliced green olives, minced', '1 teaspoon lemon juice', '1/2 teaspoon Creole seasoning', 'For the tuna burgers:', '1 large egg', '1/4 cup of mayonnaise', '2 (5-ounce) cans tuna in water, drained', '3/4 cup unseasoned Panko bread crumbs', '2 cloves garlic, minced or microplaned', '1/2 cup corn (frozen or fresh)', '1/2 cup finely grated carrot', '1/4 cup minced red bell pepper', '1/4 cup minced yellow onion', '3/4 teaspoon Creole seasoning', '3 tablespoons olive oil (stove top method) or cooking spray to bake', 'For the topping:', 'Sliced red onion (optional)', 'Lettuce (optional)', 'Hamburger buns']",22,"['1 Make the dill olive mayo: In a small bowl, combine the mayonnaise, dill, olives, lemon juice, and Creole seasoning. Cover and place in refrigerator until the tuna burgers are ready to be served.', '2 Make the tuna mix: In a small bowl, use a fork to combine the egg and mayonnaise. Add the tuna and stir to combine. In a separate, medium bowl combine panko, garlic, corn, carrot, red pepper, yellow onion, and Creole seasoning.', 'Add the mayonnaise and tuna mixture to the panko mixture. Stir until well combined.', '3 Shape the patties: Use a 1/3 cup measuring cup to measure out a heaping scoop of tuna mixture and form into 6 patties.', '4 Cook the patties in the oven or on the stovetop:', 'To make in the oven: Place a large cast iron skillet in your oven, then preheat the oven to 375\\xc2\\xb0F. When it reaches the desired temperature, remove skillet from the oven with oven mitts. You want the skillet good and hot, which will help sear the burgers.', 'Spray the inside of the skillet and both sides of the tuna burgers with cooking spray; it helps mimic that crisp edge you get when you actually fry something. Add the burgers to the skillet and return it to the oven. Bake for about 7 minutes or until the bottoms of the burgers are golden brown and crispy.', 'Flip the burgers and cook until the other side is golden. This should take about 7 to 9 additional minutes.', 'To make this on the stovetop: Heat 3 tablespoons of oil in a large skillet over medium heat. When the oil begins to shimmer, add the tuna burgers to the skillet and cook on each side for about 3 to 4 minutes, until the surface is golden brown and crispy. Drain on a paper towel.', 'Serve on toasted hamburger buns with the dill olive mayonnaise, sliced red onion, and lettuce.', 'Make-ahead instructions: Feel free to shape the patties up to 24 hours in advance. Cover with plastic wrap and keep in the fridge until ready to use. Reheat previously cooked patties by heating a teaspoon of oil in a pan over medium heat. When the oil begins to shimmer, add the patties. Flip them once and cook until they are warmed through\\xe2\\x80\\x94about 5 minutes.']",11
427,Indian Butter Chicken Recipe,30,540,570,"['For the chicken and marinade:', '1 pound boneless, skinless chicken thighs, cut into roughly 1-inch cubes', '1/4 cup full-fat plain yogurt', '1 tablespoon olive oil', '1 tablespoon ginger garlic paste', '1 teaspoon dried coriander', '1 teaspoon Kashmiri Lal Mirch', '1 teaspoon cumin', 'Salt to taste', 'For the sauce:', '8 to 10 whole almonds', '8 to 10 whole cashews', '2 tablespoons unsalted butter, divided', '1 tablespoon ginger garlic paste', '1 teaspoon sugar', '1 (15-ounce) can canned diced tomatoes', '2 tablespoons dried coriander', '1 1/2 teaspoons ground Garam Masala', '1/2 teaspoon ground Kashmiri Lal Mirch', '1/2 teaspoon salt', '1 cup water', '1/4 cup heavy cream', '1/2 tablespoon Kasuri Methi', 'To serve:', 'Cooked rice, roti, or naan bread']",25,"['1 Marinate the chicken: Bring the chicken and the rest of the marinade ingredients together in a large bowl. Using your hands, massage the marinade into the chicken.', 'Cover with plastic wrap and refrigerate for at least 1 hour, or up to overnight.', '2 Soak cashews and almonds in water for at least an hour to (or up to overnight) before preparing the rest of the recipe.', '3 Cook the chicken: Heat a skillet or grill pan over medium-high heat. Drizzle a teaspoon of oil to the pan.', 'Working in batches, remove chicken from the marinade and grill them on the pan for 3 to 5 minutes on each side, until the chicken is cooked through (clear juice runs out of it when you cut into it). Do not crowd the pan.', 'Once cooked, transfer the chicken into a separate dish. Cover and set aside for later.', '4 Start making the sauce: Melt 1 1/2 tablespoons of the butter in a medium sized Dutch oven or a skillet on medium low heat. As soon as the butter melts, add the ginger garlic paste followed by sugar. Saut\\xc3\\xa9 for 1 to 2 minutes.', 'Stir in the tomato and cook for 8 to 10 minutes on medium high heat, until all the extra liquid is cooked off. The sauce should be a loose, paste-like consistency.', 'Add coriander, garam masala, Kashmiri Lal Mirch, and salt. Stir and cook on medium heat for 2 to 3 minutes. Turn off the heat.', '5 Puree the sauce with the nuts: Transfer the paste to a blender or the bowl of a food processor. Add the soaked cashews and almonds. Blend into a smooth paste.', '6 Finish the dish: Return the paste to the cooking pan over medium heat. Add the water to the paste and stir to make a smooth sauce.', 'As the sauce begins to boil, add the grilled chicken and heavy cream. Stir well. Cover the pan and simmer for 5 minutes.', '7 Rest the butter chicken: Turn off the heat and uncover the pan. Stir in the remaining 1/2 tablespoon butter and the kasuri methi. Cover again, and let the dish rest for 8 to 10 minutes so the flavor of kasuri methi can marry into the butter chicken.', '8 Serve: Serve the butter with a side of steamed basmati rice, roti, or naan. Leftovers will keep refrigerated, covered, for five days.', 'You can freeze this dish in an airtight covered container or a zip-top bag for a month. Thaw and reheat in a saucepan over medium-low heat to retain the texture.']",15
428,Lemon-Garlic Butter Sauce for Seafood Recipe,5,15,20,"['1/2 cup clam juice (can substitute chicken stock)', '1/2 cup dry sherry', '1/2 cup whole milk (OR 3 Tbsp cream with 5 Tbsp water)', '1 Tbsp minced garlic', '1 Tbsp minced shallots', '1 bay leaf', '1 Tbsp unsalted butter', '1 Tbsp flour', '1/2 pound (2 sticks) unsalted butter', '1/2 teaspoon salt', '1/2 teaspoon white pepper', '1 Tbsp lemon juice']",12,"['1 Simmer and reduce the liquids, with garlic, shallots, and bay leaf: Place first six ingredients (clam juice, sherry, whole milk, garlic, shallots, bay leaf) in a small saucepan.', 'Heat on medium high heat and let simmer until the liquids have reduced by about half.', '2 Make a roux: In a separate saucepan (1-qt minimum) prepare the roux. Heat one tablespoon of butter in the saucepan on medium heat until it is foamy.', 'Sprinkle in the flour, stirring a couple of minutes with a metal whisk until well mixed (tan, but not browned).', '3 Slowly add liquid mixture to roux: Slowly add the reduced mixture to the roux, stirring quickly to incorporate. When you first add some of the mixture, the roux will bubble up. Just keep adding the mixture and keep whisking to incorporate.', '4 Slowly incorporate butter, 2 Tbsp at a time: Lower the heat to low. Remove the bay leaf. Slowly whisk in the butter, 2 tablespoons at a time. Let the butter tablespoons fully melt and be incorporated into the sauce before adding more tablespoons.', '5 Stir in lemon juice, salt, and white pepper. Add some more clam stock or water if the sauce is too thick.']",7
429,Simple Soft Sugar Cookies Recipe,10,12,22,"['1 cup (225 g, or 2 sticks) unsalted butter at room temperature', '1 cup (200 g) granulated white sugar', '1/4 cup (55 g) packed light brown sugar', '2 teaspoons vanilla extract', '1 large egg', '2 1/4 cups (315 g) all-purpose flour', '1/2 teaspoon baking powder', '1/2 teaspoon kosher salt', 'To finish:', '1/2 cup (100 g) granulated white sugar']",10,"['1 Preheat the oven: Preheat oven to 375\\xc2\\xb0F (190\\xc2\\xb0C). Line a baking sheet with a silicon baking mat or parchment paper.', '2 Beat the butter and sugar: Place butter, both sugars and vanilla extract in the bowl of a stand mixer fitted with a paddle attachment. Beat the ingredients together until the butter is light, fluffy and clings to the side of the bowl.', '3 Add the egg and beat to incorporate. Scrape down the sides of the bowl with a spatula.', '4 Add the flour, baking powder and salt. Mix on low speed until the dry ingredients are mostly absorbed, then increase the speed until fully incorporated.', '5 Chill the dough: Chill in the fridge for at least one hour or overnight.', '6 Shape the cookies: Pinch off a lump of dough. Roll it between the palms of your hands to form a ball roughly 1 1/2 inches in diameter, about the size of a pingpong ball. Roll the dough in the granulated white sugar and place on the baking sheet. Repeat, spacing the cookies about 2 inches apart.', '7 Press the cookies into disks: Use the flat bottom of a glass to press down and form thick disks about 2 inches wide. Sprinkle some extra sugar on each disk', '8 Bake the cookies: Bake at 375\\xc2\\xb0F (190\\xc2\\xb0C) 11 to 13 minutes, or until the edges of the cookies are starting to turn golden brown. Let cool for 10 minutes on the baking sheet before moving cookies to a wire rack to cool completely.', 'Store in an airtight container for up to 3 days at room temperature.']",9
430,Homemade Flour Tortillas,20,45,65,"['2 cups all-purpose flour', '3/4 teaspoon fine table salt', '3 tablespoons unsalted butter, vegetable shortening, or vegetable oil, at room temperature', '1/2 cup plus 1 tablespoon hot water']",4,"['To mix the dough by hand: In a bowl, stir the flour and salt until blended. Add the shortening, butter, or oil and mix with your fingers until the fat is incorporated in small bits. Add the water and mix with your hands until blended. If the dough seems stiff and dry, add a little more water, 1 tablespoon at a time. On a lightly floured work surface, knead for a few minutes, or until the dough is smooth.', 'To mix the dough with a stand mixer: In the bowl of a stand mixer fitted with the paddle attachment, mix the flour and salt on low speed. If using shortening or butter, add it in pieces to the flour and mix on low speed until it is blended. If using oil, stream it into the flour until blended.', 'With the mixer on low speed, slowly stream in the hot water, mixing until it forms a dough. If the dough seems stiff and dry, add a little more water, 1 tablespoon at a time. Turn the mixer to medium-low and mix for about 2 minutes, or until the dough is smooth and supple.', '2 Roughly form the tortillas: Sprinkle a large plate or small baking sheet with flour. On a lightly floured work surface, roll the dough into a cylinder about 6-8 inches long. Cut it into four equal pieces and cut each piece in half, to make eight pieces that are all about the same size.', 'Roll the pieces into balls and flatten them into disks. You aren\\xe2\\x80\\x99t rolling them out just yet. Just getting the basic shape in place. They need to rest before the final roll. Place them on the plate, cover with plastic wrap, and allow to rest at room temperature for 30 minutes.', '3 Roll the tortillas: Lightly flour the work surface and the rolling pin. Start from the center of each disk and roll outward from the center towards the edge and then back towards you. Turn the disk 45 degrees and repeat. Keep rolling back and forth, turning, and flipping the circle of dough over from time to time, until the tortilla is about 7-inches in diameter.', 'Continue to roll the tortillas, stacking them between layers of parchment or waxed paper until they are all rolled. Let rest while you heat the pan.', '4 Cook the tortillas: Heat a cast iron pan, griddle, or another skillet over medium heat until hot. Line a plate with a clean dishtowel or napkin.', 'Place one tortilla on the hot pan and cook for about 30 seconds. Air bubbles will appear on the surface and they should have light brown spots on the bottom. Adjust the heat \\xe2\\x80\\x93 you may need to lower it \\xe2\\x80\\x93 so the tortillas cook gently without burning.', 'Turn them over and cook for another 20 to 30 seconds on the other side. The tortilla should look puffed up and opaque. If the tortilla needs a little longer, flip for a third time and cook and additional 10 or 12 seconds.', 'When finished with a tortilla, place it on the dishtowel-lined plate and cover it.', 'Continue to cook, stack, and cover the remaining tortillas. (No need to sandwich cooked tortillas between layers of paper.)', '5 Steam the tortillas: If you are eating them right away, wrap them in a cloth napkin and let them steam for 5 to 10 minutes.', 'If you are planning to store them to reheat later, turn a plastic zip-top bag inside out. Place the hot stack of tortillas in the bag, close the bag without sealing it, and let cool.', 'When cool, remove the tortillas, turn the bag right side out, and slip the stack inside the bag and seal it. The droplets of steam will now be on the outside of the bag and you can pat them dry with a dishtowel.', '6 Store the tortillas: Store the well-sealed bag in the refrigerator for up to four days, or freeze for up to two months.', '7 Reheat the tortillas: Just before serving, heat a skillet or griddle over medium heat. Place each tortilla on the hot pan, and cook for 10 to 12 seconds on each side, or until hot. You can also reheat them in a microwave for 15 to 20 seconds.']",17
431,Mini Garlic Butter Pretzels Recipe,20,90,110,"['3/4 cup warm water (100-105\\xcb\\x9aF)', '1 teaspoon sugar', '2 1/4 teaspoons or one packet (7 grams) of active dry yeast', '2 1/4 cups all-purpose flour', '1 teaspoon kosher salt', '6 cups water', '2 tablespoons baking soda', 'For the garlic butter sauce:', '6 tablespoons unsalted butter', '4 cloves garlic, chopped', 'Coarse salt', 'Fresh parsley, garnish']",12,"['1 Activate the yeast: In a small bowl, stir together warm water, sugar, and yeast. Let sit for 5 minutes so yeast can activate. It should be bubbling. (If not, your yeast is old and should be replaced.)', '2 Make the pretzel dough: In a large bowl, stir together flour and salt. Pour in yeast mixture and stir to form a dough. Knead the dough for 6-7 minutes in the bowl until it\\xe2\\x80\\x99s smooth and no longer sticky. If the dough is really sticky, add more flour by the 1/4 cup.', 'When dough is smooth, transfer to a clean bowl. Cover loosely with a towel or plastic wrap and place in a warm area to rise. Let dough rise for 60 minutes or until the dough at least doubles in size.', '3 Boil a pot of water: Fill a large pot with 6 cups of boiling water and 2 tablespoons baking soda. Bring to a boil. Get out two baking sheets. Line one with parchment paper. Place a wire-rimmed rack on top of the other.', '4 Preheat the oven to 400\\xcb\\x9aF.', '5 Shape the mini pretzels and boil: After the dough has risen, divide it into quarters and then each quarter into four pieces to make 16 small dough balls. Working with one dough ball at a time, roll the dough out into a thin strand about 12-14 inches long. Form a pretzel by twisting two ends together to form a loop and then folding the ends back up.', 'When your pretzel is formed, dunk it in the pot of boiling water. Wait until the pretzel floats (maybe 10 seconds) and then remove with a slotted spoon and place on the wire rack over a baking sheet. Let drain. Once all the pretzels have been boiled, move them to the lined baking sheet.', '6 Bake the pretzels: When all the pretzels are shaped, boiled, and placed on the baking sheet, transfer to the oven and bake for 10-12 minutes until they start to brown.', '7 Toss with the garlic butter sauce, then bake for 3-4 more minutes: In a small saucepan, melt butter with garlic over low heat. Once combined, remove from heat to avoid burning butter.', 'When pretzels come out of the oven, add them to a large bowl and toss with garlic butter mixture. Return to baking sheet, spooning any leftover sauce over each pretzel. Sprinkle pretzels lightly with coarse salt, then return pretzels to oven and bake a second time for 3-4 minutes.', '8 Let cool and serve: Remove pretzels and let cool. Garnish finished pretzels with fresh parsley.', 'Pretzels are best served slightly warm. Store pretzels in an airtight container on the counter for 1-2 days or in the fridge for up to a week. Reheat in a low 300\\xcb\\x9aF oven until warmed through, 3-4 minutes.']",12
432,Butter Pecan Cookies Recipe,15,15,30,"['3/4 cup pecans, chopped', '1/2 cup (1 stick, 112 g) unsalted butter, room temperature', '1/3 cup (70 g) sugar', '1 teaspoon vanilla extract', '1/8 teaspoon salt', '1 cup (140 g) all-purpose flour']",6,"['1 Make cookie dough: With an electric mixer, beat the butter for about a minute. Add 1/3 cup sugar and beat until light, about 1 minute more. Beat in vanilla, salt, and flour, scraping down sides of bowl, just until dough comes together. Fold in pecans.', '2 Roll into balls: Separate dough into 12 pieces; squeeze dough to shape into balls. Place, 3 inches apart, on a baking sheet.', '3 Gently flatten with the bottom of a glass (reshape sides if necessary).', '4 Bake at 350\\xc2\\xb0F (175\\xc2\\xb0C) until golden brown, rotating sheet halfway through, about 15 minutes. Cool cookies on a wire rack.']",4
433,Spatchcocked Grilled Chicken with Orange and Ginger Recipe,10,165,175,"['For the chicken:', '1 (4-pound) chicken', 'Salt and pepper, to taste', 'Oil, for the grill ', 'For the marinade:', '1 orange, zest and juice (about 1/2 tablespoon zest and 1/3 cup juice)', '1 lemon, juiced (about 2 tablespoons)', '3 tablespoons finely chopped fresh ginger', '2 tablespoons olive oil', '1 tablespoon honey', '1 tablespoon whole coriander seeds, crushed (or 1/2 teaspoon ground coriander)', '2 teaspoons paprika', '1/4 teaspoon salt', '  Special equipment:', 'Kitchen shears', 'Charcoal grill or gas grill']",16,"['1 Spatchcock the chicken (if not already spatchcocked at the butcher): With kitchen shears or a sharp knife, cut along each side of the backbone (cutting through the rib bones) and remove it. Save it for stock, if you like.', 'Turn the chicken over so it is lying breast side up on the cutting board. Press firmly on the breastbone to flatten it.', 'Pat the chicken dry, and sprinkle with salt and pepper on both sides. Place it in a baking dish.', '2 Make the marinade: In a small bowl, stir together the orange zest, orange juice, lemon juice, ginger, olive oil, honey, coriander, paprika and salt. Pour the marinade over the chicken, turning to coat.', 'Cover with plastic wrap, and refrigerate for at least 2 hours or up to overnight, turning occasionally in the marinade.', '3 Prepare a gas or charcoal grill: If using a gas grill, set one side to high temperature and the other side to low temperature. Heat the grill to at least 450F.', 'If using a charcoal grill, prepare a two-level fire. Arrange two-thirds of the charcoal on one side of the grill and spread the remaining one-third on the other side.', 'When your gas or charcoal grill is hot, use tongs to oil the grill grates with a small folded piece of paper towel dipped in oil.', '4 Grill the chicken: Set the chicken on the cool side of the grill with the skin side up and legs facing the hot side. Cover with the lid and cook for 20 minutes.', 'Rotate the chicken, still skin-side up, so that the breast side is closer to the hot side. Continue to cook for another 10 to 20 minutes, or until an instant read thermometer registers at least 165F when inserted into both the thigh and breast.', '(Exact cooking time will depend on the heat of your grill and the size of the bird, so always double-check the internal temperature.)', '5 Crisp the skin: Once the chicken has cooked through, carefully flip the chicken over onto the hot side of the grill. Cook for an additional 1 to 3 minutes, or until the skin is brown and crisp.', '6 Let the chicken rest: Transfer the chicken to a cutting board and let rest for 10 minutes. Cut into pieces and serve.']",13
434,Classic Buttermilk Waffles Recipe,10,30,40,"['2 cups (280g) all-purpose flour', '2 tablespoons sugar', '2 teaspoons baking powder', '1 teaspoon baking soda', '1/2 teaspoon salt', '2 cups buttermilk, well-shaken', '1/4 cup (1/2 stick) unsalted butter, melted', '2 large eggs', '1/4 cup melted butter for the waffle iron, optional', 'Special equipment:', 'Waffle iron']",11,"['1 Warm the oven to 250F. Set a wire metal cooling rack on top of a baking sheet and place in the oven. (You can also toast waffles directly on the oven rack, if you prefer.)', '2 Whisk together the flour, sugar, baking powder, baking soda, and salt.', '3 Whisk together the buttermilk and butter. Whisk in the eggs.', '4 Stir the buttermilk mixture into the flour. Continue gently stirring just until you see no more streaks of dry flour.', '5 Rest the batter while your waffle iron warms: Cover the batter with a clean kitchen towel and let it rest for at least five minutes while you warm the waffle iron. The waffle iron is ready when a drop of water sizzles on contact with the griddle.', ""6 Make the waffles: Brush the waffle iron with melted butter, if you like. This helps give your waffles a golden color and prevents sticking, but isn't crucial for the recipe. Scoop 1/3 to 1/2 cup of batter into each grid of the waffle iron and cook until golden, according to your waffle iron's instructions."", ""7 Transfer the cooked waffles to the oven: When the waffles are done, transfer them to the cooling rack on the baking sheet in the oven. Place them in one single layer so that they crisp evenly on top and bottom, and so steam isn't trapped between layers. Let them toast for 5 to 10 minutes."", '8 Cook the remaining waffles: Transfer each batch of waffles to the oven as they are ready. Waffles that have been toasting for a few minutes can now be stacked to make room for the following batches.', '9 Serve the waffles: Serve the waffles as soon as all batches are made and crisped. Let leftover waffles cool completely, then store in an airtight container in the refrigerator for up to a week, or freeze for up to 3 months. Reheat briefly in the toaster until warmed and crisped.']",9
435,Butternut Squash Apple Cranberry Bake Recipe,15,55,70,"['1 large butternut squash, peeled and cut into 1-inch cubes', '2 large tart cooking apples (like Granny Smith), peeled and cut into 1/2-inch thick slices', '1/2 cup fresh or frozen cranberries', '1/2 cup brown sugar', '1/4 cup (half a stick) butter', '1 Tbsp flour', '1 teaspoon salt', '1/2 teaspoon ground nutmeg or mace']",8,"['1 Preheat oven and prepare baking dish: Preheat oven to 350\\xc2\\xb0F. Lightly butter the sides and bottom of a 7x11-inch baking dish.', '2 Mix together the flour, brown sugar, salt, and nutmeg in a small bowl.', '3 Layer squash, apples, cranberries, and topping in baking dish: Put a layer of cut butternut squash on the bottom of the baking dish. Place apples on top and then sprinkle with cranberries. Sprinkle everything with the flour brown sugar mixture. Dot with butter.', '4 Bake: Bake 50-60 minutes at 350\\xc2\\xb0F until cooked through and lightly browned.']",4
436,Roasted Butternut Squash Kale Saut\xc3\xa9 Recipe,10,40,50,"['4 cups 3/4-inch cubes of butternut squash (from about 1 3/4 pound whole small butternut squash)', '1 teaspoon extra virgin olive oil', '1 teaspoon balsamic vinegar', '1/4 teaspoon salt', 'Sprinkling of black pepper', '2 tablespoons extra virgin olive oil', '1 large red onion, quartered and sliced (about 2 cups of sliced red onions)', '3 cloves garlic, minced (about 1 Tbsp)', '1 teaspoon balsamic vinegar', '6 cups thinly (3/4-inch) sliced kale (center ribs removed) (from about 1 bunch of kale)', '1/3 cup dried sweetened cranberries', '1/2 cup slightly broken up pecans', 'Salt and pepper to taste']",13,"['1 Roast cubed butternut squash: Preheat oven to 425\\xc2\\xb0F. Place cubed butternut squash in a bowl and toss with olive oil, balsamic vinegar, salt and pepper. Spread out onto a lined baking sheet. Roast in oven for 25 minutes or until the squash is cooked through and browned on the edges.', '2 Saut\\xc3\\xa9 onions and garlic: 15 minutes into roasting the butternut squash, start on the onions. Heat olive oil on medium high heat in a thick-bottomed 4 to 5 quart pot. Add the sliced red onion and toss to coat. Let cook for 7 to 8 minutes until softened. Add the garlic and cook a minute more.', ""3 Add balsamic and kale: Add the balsamic vinegar and the shredded kale. Stir until the kale is mixed well with the onions (it helps to use tongs to turn over the kale). Let cook for a minute or two until the kale is just wilted (don't overcook)."", '4 Add roasted squash, dried cranberries, pecans: Then stir in the roasted butternut squash, the dried sweetened cranberries, and pecans. Add salt and pepper to taste.']",4
437,Butternut Squash Risotto Recipe,10,40,50,"['6 cups (1.4 liters) chicken broth (use vegetable broth for vegetarian option, and gluten-free stock for gluten-free version)', '5 Tbsp (70g) unsalted butter, divided into 4 Tbsp (56g) and 1 Tbsp (14g)', '1 small onion, finely chopped (1 cup)', '2 cups (240g) butternut squash, peeled, and finely diced (1/4-1/2 inch)', '2 cups (400g) arborio rice (can substitute medium grained white rice, but arborio is preferred)', '1 cup (236 ml) dry white wine (such as Sauvignon Blanc)', '3/4 cup (1.5 oz, 40g) freshly grated Parmesan cheese, divided', '2 tablespoons chopped chives or garlic chives', 'Salt']",9,"['1 Heat broth in medium sized saucepan and keep warm over low heat.', '2 Cook onion and squash in butter: Melt 4 Tbsp of butter in a large saucepan; add onion and butternut squash. Cook over medium heat until onion is translucent, about 5 minutes.', '3 Add rice: Add arborio rice to onion and squash. Cook 1 to 2 minutes.', '4 Add wine: Add the wine and cook, stirring constantly until wine has been absorbed by the rice or evaporated.', '5 Start adding broth a ladle at a time, allowing rice to absorb broth: Add a few ladles of broth, just enough to barely cover rice. Cook over medium heat until broth has been absorbed.', 'Continue cooking, stirring rice enough to keep it from sticking to the pan, adding a little bit of broth at a time, cooking and stirring until the liquid is absorbed, and the rice is tender but still firm to the bite, about 15 to 20 minutes.', '6 During the last minutes of cooking, add remaining tablespoon of butter, 1/2 cup Parmesan, and chives. At this point the rice should have a creamy consistency. Add salt to taste. (The amount of salt you add will depend on how salty your broth was to begin with. I usually add at least a teaspoon of salt, sometimes more.)', 'Serve with remaining grated Parmesan.']",8
438,Roasted Eggplant and Butternut Squash with Tahini-Yogurt Sauce Recipe,10,70,80,"['For the sauce:', '1/2 cup whole-milk or low-fat plain yogurt', '2 tablespoons tahini paste', '2 tablespoons lemon juice', 'For the eggplant:', '2 medium eggplants (1 1/2 pounds total)', '2 teaspoons salt', '5 tablespoons olive oil', '1 teaspoon ground cumin', '1/2 peeled, seeded butternut squash, and cut into 1/2-inch slices (about 1 pound)', '1/2 teaspoon salt', '1/4 teaspoon pepper', '1/4 red onion, thinly sliced', '3 tablespoons white wine vinegar', '1 jalapeno or other small green chili pepper, cored, seeded, and thinly sliced', '1/2 cup whole parsley leaves', 'To serve:', 'Rice pilaf, made with 1 cup rice']",18,"['1 Make the yogurt-tahini sauce: In a bowl, whisk the yogurt, tahini, and lemon juice until smooth. Taste for seasoning and add salt and pepper, if you like.', '2 Prep and salt the eggplant: Cut the eggplant in half lengthwise. Use the tip of a paring knife to score the cut sides in a cross-hatch pattern about 1/2 inch deep.', 'Sprinkle with salt and set the eggplant on a large rimmed baking sheet, cut side up, for 30 minutes. You\\xe2\\x80\\x99ll see liquid coming out of the cuts.', 'After 30 minutes are up, rinse the eggplant and pat dry with paper towels. Use the towels to wipe the baking sheet.', '3 Roast the eggplant and squash: Heat the oven to 450 degrees F. Set the eggplant halves on the baking sheet cut sides up. Brush with 3 tablespoons of the olive oil and sprinkle with cumin. Arrange the sliced butternut in the spaces between the halves, and sprinkle with 1 tablespoon of the olive oil and salt.', 'Roast the eggplant and butternut for 35 to 40 minutes, or until the eggplant is golden brown, the squash is browned on the bottom, and both are tender when pierced with a skewer. If the eggplant isn\\xe2\\x80\\x99t browned, remove the butternut from the baking sheet and continue cooking the eggplant for 5 more minutes.', 'Keep the eggplant warm covered loosely with foil on the top of the stove while you finish the vegetable topping.', '4 Make the vegetable topping: In a large bowl, combine the red onion, vinegar, and a pinch of salt. Let them sit for 5 minutes to mellow the onion. With a large spoon, stir in the remaining 2 tablespoons oil.', 'Transfer the roasted butternut to a cutting board and cut into 1/2-inch pieces. Fold the butternut, jalapeno, and parsley into the bowl with the onions. Taste for seasoning and add more salt and pepper, if you like.', '5 Plate and serve: Scoop the pilaf on a serving platter, or divide between 4 plates. Add the eggplant halves and top with the butternut mixture. Drizzle with yogurt sauce and serve the remaining sauce separately.']",10
439,Butterscotch Cookies Recipe,30,13,43,"['12 tablespoons unsalted butter, cut into tablespoon sized slices', '1 3/4 cups packed dark brown sugar', '1/2 teaspoon salt', '1 large egg', '1 egg yolk', '1 tablespoon vanilla extract', '2 1/2 cups all-purpose flour', '1/2 teaspoon baking soda', '1/4 teaspoon baking powder', 'Sugar dredging mixture:', '1/4 cup packed dark brown sugar', '2 tablespoons white granulated sugar', 'Sprinkling salt:', 'Fleur de sel, Maldon, sea salt, or Kosher salt for sprinkling (See Recipe Note)']",14,"['1 Preheat oven to 375\\xc2\\xb0F and line baking sheets with parchment paper.', '2 Whisk the dry ingredients: Vigorously whisk together the flour, baking soda, and baking powder and set aside. Mix together the brown sugar white sugar dredging mixture in another bowl and set aside.', '3 Brown the butter: Place 10 tablespoons of butter into a thick-bottomed skillet over medium heat. The butter will foam a bit before subsiding. Once the butter takes on a tan color and begins to smell nutty take it off of the heat. Add the other two tablespoons of butter and mix it in until it melts. (See tutorial on how to brown butter.)', '4 Make the cookie dough: Pour the brown butter into a mixing bowl fitted with a paddle attachment. Add the brown sugar and salt and mix. Add the egg, egg yolk, and vanilla extract and mix together, scraping down the sides and bottom of the bowl at least once.', 'Add the flour mixture in three increments being sure to scrape down the sides and bottom once or twice. Mix just until the flour is incorporated. The dough will be very thick.', '5 Shape the cookies: Take 1/2 to full tablespoon-sized pieces of dough (you can make them a bit bigger or smaller to your liking, just make sure the pieces of dough are all the same size) and gently roll them into ball shapes.', 'Dredge them in the sugar dredging mixture until well-coated.', 'Place on the baking sheet and sprinkle with a little bit of the sprinkling salt (be reserved with the salt as very little goes a long way).', '6 Bake the cookies: Bake at 375\\xc2\\xb0F for 10-12 minutes or until the edges have browned a bit. Be careful not to over-bake.', '8 Cool and serve: Allow to cool on the sheet for one minute before transferring to a wire rack to cool completely. Tastes best with a glass of milk for dipping. Cookies will keep in an airtight container for about a week.']",10
440,Polish Hunter\xe2\x80\x99s Stew Recipe,40,180,220,"['1 ounce dried porcini or other wild mushrooms', '2 Tbsp bacon fat or vegetable oil', '2 pounds pork shoulder', '1 large onion, chopped', '1 head cabbage (regular, not savoy or red), chopped', '1 1/2 pounds mixed fresh mushrooms', '1-2 pounds kielbasa or other smoked sausage', '1 smoked ham hock', '1 pound fresh Polish sausage (optional)', '1 25-ounce jar of fresh sauerkraut (we recommend Bubbies, which you may be able to find in the refrigerated section of your local supermarket)', '1 bottle of pilsner or lager beer', '1 Tbsp juniper berries (optional)', '1 Tbsp black peppercorns', '1 Tbsp caraway seeds', '2 Tbsp dried marjoram', 'Salt', '20 prunes, sliced in half (optional)', '2 Tbsp tomato paste (optional)', '1 15-ounce can tomato sauce (optional)', '1-2 Tbsp mustard or horseradish (optional)']",20,"['1 Pour hot tap water over the dried mushrooms and submerge them for 20-40 minutes, or until soft. Grind or crush the juniper berries and black peppercorns roughly; you don\\xe2\\x80\\x99t want a powder. Cut the pork shoulder into large chunks, about 2 inches. Cut the sausages into similar-sized chunks. Drain the sauerkraut and set aside. Clean off any dirt from the mushrooms and cut them into large pieces; leave small ones whole.', '2 Heat the bacon fat or vegetable oil in a large lidded pot for a minute or two. Working in batches if necessary, brown the pork shoulder over medium-high heat. Do not crowd the pan. Set the browned meat aside.', '3 Put the onion and fresh cabbage into the pot and saut\\xc3\\xa9 for a few minutes, stirring often, until the cabbage is soft. Sprinkle a little salt over them. The vegetables will give off plenty of water, and when they do, use a wooden spoon to scrape any browned bits off the bottom of the pot. If you are making the tomato-based version, add the tomato paste here. Once the pot is clean and the cabbage and onions soft, remove from the pot and set aside with the pork shoulder.', ""4 Add the mushrooms and cook them without any additional oil, stirring often, until they release their water. Once they do, sprinkle a little salt on the mushrooms. When the water is nearly all gone, add back the pork shoulder, the cabbage-and-onion mixture, and then everything else except the prunes. Add the beer, if using, or the tomato sauce if you're making the tomato-based version. Stir well to combine."", '5 You should not have enough liquid to submerge everything. That\\xe2\\x80\\x99s good: Bigos is a \\xe2\\x80\\x9cdry\\xe2\\x80\\x9d stew, and besides, the ingredients will give off more liquid as they cook. Bring everything to a simmer, cover the pot and cook gently for at least 2 hours.', '6 Bigos is better the longer it cooks, but you can eat it once the ham hock falls apart. Check at 2 hours, and then every 30 minutes after that. When the hock is tender, fish it out and pull off the meat and fat from the bones Discard the bones and the fat, then chop the meat roughly and return to the pot. Add the prunes and cook until they are tender, at least 30 more minutes.', 'Bigos is best served simply, with rye bread and a beer. If you want a little kick, add the mustard or horseradish right before you eat it. Bigos improves with age, too, which is why this recipe makes so much: Your leftovers will be even better than the stew was on the first day.']",7
441,Sweet and Sour German Red Cabbage Recipe,7,40,47,"['1/2 large red cabbage, sliced 1/4-inch thick', '2 tablespoon butter', '2 tablespoon sugar', '1/4 cup balsamic vinegar', 'Kosher salt', 'Freshly ground black pepper']",6,"['1 Saut\\xc3\\xa9 the cabbage: Melt the butter in a large pot over medium heat. Add the thinly sliced red cabbage and toss to coat with the butter. Saut\\xc3\\xa9 until slightly wilted, about 5 minutes.', '2 Add seasonings and simmer: Sprinkle sugar over the cabbage and toss to coat evenly. Add the balsamic vinegar to the pot. Bring to a simmer, then reduce the heat to medium low.', 'Cover and simmer until the cabbage is completely tender, stirring often, about 30 minutes total. Season to taste with salt and pepper.']",3
442,Italian Sausage and Cabbage Stew Recipe,10,50,60,"['1 tablespoon extra virgin olive oil', '1 pound sweet Italian sausage, bulk, or removed from casings', '1 large yellow onion, half sliced and half minced', '2 garlic cloves, minced', '1 1/2 cups white wine', '1 15-ounce can of white beans (cannellini, Great Northern, or Navy), drained', '1 quart vegetable or chicken stock', '1 quart water', '1 teaspoon salt, more to taste', '1 large (2-pound) savoy cabbage, quartered, then sliced into 1/4-inch thick slices', '2 bay leaves', '1 cup chopped parsley, loosely packed', '1/2 cup to a cup of freshly grated Parmesan or pecorino cheese for garnish']",13,"['1 Cook the sausage: Heat the olive oil on medium heat in a large (8-quart), thick-bottomed pot. Add the sausage, breaking it up into pieces as you put it into the pot in a single layer.', 'When the sausage has cooked on all sides, remove it with a slotted spoon and set aside.', '2 Saut\\xc3\\xa9 onions, garlic: Add the minced onion (save the sliced onion for later) and saut\\xc3\\xa9 for 3-4 minutes, stirring often.', 'Once the onions give up some of their water, use a wooden spoon to scrape up any browned bits from the bottom of the pot.', 'Add the minced garlic and cook for another 1-2 minutes.', '3 Add wine, beans, boil, lower heat to simmer: Add the white wine and the beans and bring to a rolling boil. Reduce to a simmer. Cover and cook for 10 minutes. If you want, for a thicker base, use an immersion blender to blend some (or all) of the beans and onions.', '4 Add water, stock, salt, cabbage, sliced onion, bay leaves, sausage, then simmer: Add the water, stock, salt, cabbage, sliced onion half, bay leaves and browned sausage. Bring to a boil, reduce heat to a simmer. Cover and simmer for 10 minutes, then uncover and continue cooking until the cabbage is tender, about another 10-20 minutes.', 'To serve, sprinkle on chopped parsley and grated cheese.']",8
443,Pork Chops with Braised Cabbage Recipe,10,25,35,"['2 teaspoons bacon fat, butter or extra virgin olive oil', '1 large onion, sliced 1/4-inch, about 2 cups', '1/2 head of cabbage, sliced 1/4-inch wide slices', 'Salt', '1/4 teaspoon celery seed', '1 teaspoon caraway seed', '1/2 cup stock (chicken, beef, or vegetable) or water', '1 tablespoon mustard, preferably Dijon', '1 tablespoon malt or cider vinegar', 'Freshly ground black pepper', '1 tablespoon bacon fat or extra virgin olive oil', '4 pork chops']",12,"['1 Saut\\xc3\\xa9 the onions and cabbage: Heat the bacon fat (or butter or olive oil) in a large saut\\xc3\\xa9 pan over medium-high heat.', 'Add the onion and saut\\xc3\\xa9, stirring only occasionally, until the edges of the onions begin to brown, about 5 minutes. Sprinkle salt over the onions as they cook.', 'Add the sliced cabbage and toss to combine. Cook for a minute or two, then add the celery seed, caraway, and stock. Cover and reduce the heat to low. Cook, covered for 10 minutes.', '2 Stir in mustard and vinegar: After 10 minutes, remove from heat, but leave the cover on the pan. Wait another 5 minutes, then uncover the pan and mix in the mustard and vinegar. Add salt and black pepper to taste.', '3 Cook the pork chops in a separate pan: As soon as you cover the cabbage pan in step 1, heat a tablespoon of bacon fat or oil in a cast iron frying pan on medium high heat. Pat the pork chops dry with paper towels. Sprinkle them with salt and lay them in the pan, working in batches if necessary as to not crowd the pan.', 'Tip: Place the chops in the pan so that the thickest, boniest parts are near the center of the pan where they get the most heat.', 'As soon as the chops are nicely browned on one side, about 2 minutes or so, flip them and sear them on the other side. If your pork chops are less than 3/4-inch thick, and you are using a cast iron pan, once the chops are seared on the second side, remove the pan from heat and let the chops sit in the hot pan until cooked through (you can use the finger test to check for the doneness of the meat). If you are not using a cast iron pan, just remove the pan from heat and cover the pan for a few minutes until the chops are done.', 'If your chops are thicker than 3/4-inch, and you are using a cast iron pan, remove the pan from heat and cover it, letting the chops finish cooking for about 5 minutes. If not using a cast iron pan, keep the chops covered on low heat for another 5 minutes after searing.', '4 Let chops rest, serve with cabbage: Remove the chops from the pan and let rest for 5 minutes. Serve alongside the cabbage.']",9
444,Pot Sticker Stir-Fry Recipe,20,20,40,"['1 tablespoon ghee', '2 medium carrots, peeled and finely diced', '2 shallots, minced', '1/4 pound shiitake mushrooms, stemmed and thinly sliced', 'Kosher salt', '4 garlic cloves, minced', '1 tablespoon finely grated ginger', '2 pounds ground pork', '1 small Napa cabbage, cut in half and thinly sliced crosswise', '2 tablespoons coconut aminos', '2 teaspoon rice vinegar', '1 teaspoon fish sauce', '2 teaspoons toasted sesame oil', '3 scallions, thinly sliced', 'Butter lettuce leaves, to serve (optional)', 'Special equipment:', '12-inch skillet or large wok']",17,"['1 Cook the vegetables: In a 12-inch (or larger) skillet over medium heat, melt the ghee. Once it\\xe2\\x80\\x99s hot, toss in the carrots, shallots, and mushrooms.', 'Add a sprinkle of salt, and saut\\xc3\\xa9 for 3 to 5 minutes or until the shallots are soft and the \\xe2\\x80\\x99shrooms are pliable.', 'Toss in the garlic and ginger, and stir for 30 seconds or until fragrant.', '2 Add the ground pork and cook: Add the pork along with another sprinkle of salt, and break up the meat with a spatula or wooden spoon.', 'Crank up the heat to medium-high, and cook for about 5 minutes or until the pork is no longer pink.', '3 Transfer the cooked pork with a slotted spoon to another platter. Leave the cooking liquid in the pan.', '4 Cook the cabbage: Throw the cabbage into the pan with another sprinkle of salt, and saut\\xc3\\xa9 for 3 to 5 minutes or until wilted.', '5 Combine everything back in the skillet and season: Lower the heat to medium, and add the ground pork back into the skillet. Stir to combine.', 'Season with coconut aminos, rice vinegar, and fish sauce. Taste and adjust with more seasoning if needed.', '6 Serve and eat: Remove the skillet from the heat. Finish with a drizzle of sesame oil and a generous sprinkle of scallions. Serve the stir-fry on its own, or with butter lettuce to make lettuce cups (i.e. paleo ""tacos""!).']",10
445,Skillet Pork Chops with Cabbage Recipe,20,50,70,"['4 thick bone-in center-cut pork loin chops (2 1/2 pounds total)', '1 teaspoon salt', '1/2 teaspoon pepper', '3 tablespoons olive oil', '1 yellow onion, thinly sliced', '1 clove garlic, chopped', '1/2 large head green cabbage, cored and very thinly sliced with a mandoline or chef\\xe2\\x80\\x99s knife', '1 apple (any kind), peeled, cored, and cut into bite-sized chunks', '1 teaspoon caraway seeds, optional', '3 tablespoons chopped fresh parsley', 'Special equipment:', 'Mandoline (optional)', '10-inch oven-safe skillet']",13,"['1 Heat the oven to 400\\xc2\\xb0F.', '2 Sear the pork chops: Sprinkle the pork all over with 1/2 teaspoon of the salt and 1/4 teaspoon of the pepper. Heat a 10-inch oven-safe skillet over medium-high heat for 1 minute. Add 2 tablespoons of the oil and when it is hot, add the pork chops in one layer.', 'Sear for 3 minutes without disturbing. Turn and cook 2 minutes more. Transfer to a plate or bowl.', '3 Cook the cabbage: Add the remaining 1 tablespoon oil to the pan over medium heat. Add the onion, garlic, and cabbage, along with the remaining 1/2 teaspoon salt and 1/4 teaspoon pepper. Cook for about 3 minutes, stirring until the cabbage is completely coated with oil.', 'Continue cooking, stirring occasionally, for 15 minutes. Add the apples, caraway seeds (if using), and 2 tablespoons of the parsley. Cook, stirring occasionally, for 10 minutes more, or until the cabbage is very tender and wilted.', '4 Finish cooking the pork chops: Set the pork chops on the cabbage and tip any juices from the bowl into the pan with the cabbage.', 'Transfer to the oven. Cook the pork for 10 to 15 minutes, without turning the chops, or until a meat thermometer inserted into the thickest part of the meat registers at least 145\\xc2\\xb0F. Exact cooking time will depend on the thickness of your pork chops.', '5 Serve: Carefully remove the skillet from the oven (the handle will be very hot). Let the meat and cabbage sit for 5 minutes. Sprinkle with the remaining 1 tablespoon parsley. Serve immediately.']",8
446,Buttered Cabbage with Caraway Recipe,20,5,25,"['One 2-pound head of green cabbage', '4 Tbsp butter', '1 teaspoon caraway seeds', '1/2 teaspoon celery seeds', 'Salt', '1/2 teaspoon black pepper']",6,"['1 Put water on to boil: Heat a large (8-quart) pot of well salted water to a boil.', '2 Prep the cabbage: While the water is heating, prepare the cabbage. Peel away and discard and discolored or old outer leaves. Cut the head of cabbage into quarters, through the core, and cut away and discard the core. Use your hands to tear the cabbage into large (about 1 to 2 inch) pieces. (Or use a knife.)', '3 Boil leaves for 90 seconds: Once the water is at a rolling boil, add the torn cabbage leaves to the water. Submerge the leaves in the hot water. Cook for 90 seconds, then drain the pot of its water. Return the cabbage leaves to the pot.', '4 Melt butter, toss with cabbage, caraway, celery seeds, salt: Stir 4 tablespoons of butter into the cabbage. The cabbage and the pan are both hot, so the butter should melt quickly in the pan.', 'If you are using unsalted butter, you will want to add more salt to the cabbage. Start with half a teaspoon and add more if needed.', 'Sprinkle with caraway seeds, celery seeds, and black pepper, and toss to combine.', 'Serve immediately. Great with pork, veal, or frankfurters.']",7
447,Rabbit Cacciatore Recipe,15,50,65,"['One 2 1/4 pound rabbit, cut into 6 to 8 pieces', 'Salt and freshly ground pepper', '3 tablespoons fresh thyme leaves (or 1 Tbsp dried)', '1 teaspoon fresh rosemary leaves (or 1/2 teaspoon dried)', '1/4 cup all-purpose flour (Wondra flour works great)', '2 tablespoons extra virgin olive oil', '1/2 cup chopped onion', '2 cloves garlic, minced', '2/3 cup chopped mushrooms', '3 cups of chopped, very ripe tomatoes (or canned plum tomatoes)', '2 red bell peppers, seeded, cut into 1-inch cubes', '1 bay leaf', '16 salt-cured olives, black or green, pitted']",13,"['Before you start, cut the rabbit into pieces, or have your butcher do it for you. Hank Shaw has an excellent guide here: How to Cut up a Rabbit.', '1 Brown the rabbit pieces: Sprinkle the rabbit pieces generously with salt and pepper. Rub half of the thyme leaves into the pieces, then sprinkle with flour to lightly coat.', 'Heat olive oil in a large skillet on medium high. Place the rabbit pieces in the pan in a single layer. Do not stir.', 'Cook for 2-3 minutes on one side until lightly browned, then turn the pieces and brown on the other side for a minute or two more. Remove the rabbit pieces to a dish to set aside.', '2 Add onions, then garlic, bell pepper, mushrooms, rosemary, thyme: Reduce the heat to medium. Add onions to the pan, cook for 1 minute. Then add garlic, bell pepper, and mushrooms, cook for a couple minutes more. Add the rosemary and the remaining thyme.', '3 Add the rabbit back into the pan. Cover with chopped tomatoes and bay leaf.', 'Reduce heat to medium low; cover the pan and cook for 35 minutes.', '4 Uncover the pan, add the olives.', '5 Boil off excess liquid: Increase heat to high and cook for several minutes to boil off excess moisture and reduce the sauce.', 'When the liquid has reduced by half, check the seasoning, add salt or pepper to taste, remove from heat and serve.', 'Serve with rice, pasta, or potatoes.']",11
448,Nopalitos with Tomatoes and Onions Recipe,5,15,20,"['1 pound nopalitos, nopales prickly pear cactus paddles that have been stripped of spines, cleaned, and chopped', 'Extra virgin olive oil', '2 large cloves garlic, minced', '1/2 red onion, roughly chopped', '1 jalape\\xc3\\xb1o pepper, stem and seeds removed, chopped', '1 medium tomato, roughly chopped', 'Salt and pepper']",7,"['1 Saut\\xc3\\xa9 onions, garlic, jalape\\xc3\\xb1o: Heat a tablespoon of olive oil (enough to coat the bottom of the pan) in a large saut\\xc3\\xa9 pan on medium high heat. Add red onion, garlic, and jalape\\xc3\\xb1o. Cook for a minute, stirring occasionally.', '2 Add the nopalitos, then the tomatoes: Add the nopalitos. Cook for several more minutes. Then add the chopped tomato.', 'Continue to cook until all vegetables are cooked through. Season with salt and pepper to taste. Serve immediately.']",3
449,Cajun Chicken Salad Recipe,15,15,30,"['1 pound skinless, boneless chicken breasts', 'Salt', '1/2 cup mayonnaise', '2 Tbsp mustard', '1 Tbsp cider vinegar', '2 teaspoons paprika', '1 teaspoon Cajun or Creole seasoning', '1 teaspoon prepared horseradish', '2 hard-boiled eggs, chopped', '1/2 cup chopped celery', '1/2 cup chopped green pepper', '1/4 cup chopped green onion', 'Tabasco or other hot sauce to taste']",13,"['1 Poach the chicken: Set a 2-quart pot of well salted water over high heat. As the water heats to a boil, cut the chicken breasts into large (2 1/2-inch) chunks. When the water boils, add the chicken. Return to a simmer, then turn off the heat, and cover the pot. Let sit for 15 minutes (time it) or more while you prepare everything else.', '2 Make the dressing, mix in the eggs and vegetables: In a large bowl, mix the mayo, mustard, vinegar, paprika, Cajun seasoning and horseradish together. Mix in the eggs, celery, green pepper, green onion.', '3 Dice chicken, mix with salad: Using a slotted spoon, remove the chicken from the poaching water* and dice it. Mix it in with the remaining ingredients. Add salt and hot sauce to taste. Chill before serving.', 'Serve over butter lettuce or between two pieces of bread for a sandwich.', '*The resulting poaching liquid is a light, salted chicken broth. You can save it and pour it into a cup and drink it as a light soup if you want.']",5
450,Texas Sheet Cake Recipe,15,25,40,"['For the cake:', '2 cups (8.8 ounces) all-purpose flour', '2 cups (14 ounces) granulated sugar', '1/2 teaspoon kosher salt', '1 cup (8 ounces) unsalted butter', '1 cup water', '1/4 cup (1 ounce) natural unsweetened cocoa powder', '1/2 cup buttermilk', '2 large eggs', '2 teaspoons vanilla extract', '1/2 teaspoon baking soda', 'For the frosting:', '3/4 cup (6 ounces) unsalted butter', '5 tablespoons natural cocoa powder', '1/2 cup milk, whole or 2 percent', '1 teaspoon vanilla extract', 'Pinch of kosher salt', '3 cups (15 ounces) powdered sugar, sifted', '1 cup chopped pecans (4.5 ounces)', 'Special equipment:', 'Half-sheet pan']",21,"['1 Preheat the oven and prep the pan: Preheat the oven to 350\\xc2\\xb0F. Spray or butter a half-sheet pan (13x18 inches) and line the bottom with parchment.', '2 Combine the dry ingredients: Whisk the flour, sugar, and salt together in a large mixing bowl.', '3 Make the batter: In a saucepan over medium-low heat, combine the butter, water, and cocoa powder. Whisk until melted and smooth, and then bring to a simmer. Once simmering, remove from the heat.', 'Using a whisk or electric mixer, beat the hot cocoa mixture into the dry ingredients until combined. Beat in the buttermilk, eggs, and vanilla, followed by the baking soda, until combined.', '  4 Bake the cake: Spread the batter into the prepared pan and bake for 25 to 28 minutes, or until a toothpick inserted in the center comes out clean.', 'Remove from the oven and set the pan on a wire rack to cool briefly, about 5 to 10 minutes, while you make the frosting.', '5 Frost the cake: As soon as the cake is done baking and on the cooling rack, combine the butter, cocoa, and milk for the frosting together in a saucepan and bring to a boil. Remove from the heat and stir in the salt and vanilla. Beat in the powdered sugar with an electric mixer or by hand.', 'Pour the hot frosting over the still-warm cake and spread evenly. Sprinkle the top with chopped pecans or other topping.', 'Allow to set, then serve immediately or cool completely and cover to serve later. You can also wrap the cake well in foil or plastic wrap and freeze.']",9
451,Cranberry Upside Down Cake Recipe,20,70,90,"['Topping', '3/4 cup firmly packed brown sugar', '4 Tbsp (1/4 cup or 1/2 stick) unsalted butter', '12 ounces fresh or frozen cranberries', 'Cake', '1 3/4 cups all purpose flour', '2 teaspoons baking powder', '1/2 teaspoon salt', '1/2 teaspoon ground ginger', '1/4 teaspoon ground cinnamon', 'Scant pinch ground cloves', '1/2 cup (1 stick) butter, room temp (plus more for buttering the pan)', '1 1/2 cups white granulated sugar', '3 large eggs', '1 Tbsp orange zest', '1/2 cup sour cream (or greek yogurt)', '1/4 cup of milk', 'Equipment', 'A 9-inch cake pan with at least 2-inch high sides']",19,"['1 Butter a 9-inch cake pan: Generously butter the bottom and sides of a 9-inch diameter cake pan.', '2 Make caramel topping with brown sugar and butter: In a small saucepan, place the 1/4 cup of butter and the 3/4 cups of packed brown sugar. On medium high heat, stir the sugar as the butter melts. Once the butter is melted and mixed in well with the sugar, stop stirring and let the mixture simmer for 15 seconds or so.', '3 Pour brown sugar mixture into cake pan and top with cranberries: Pour the brown sugar butter mixture into the prepared cake pan. Spread the cranberries on top of the sugar butter mixture.', '4 Whisk together flour, baking powder, salt, cinnamon, ginger, cloves: Preheat oven to 350\\xc2\\xb0F. In a medium bowl vigorously whisk together the flour, baking powder, salt, cinnamon, ground ginger, and ground cloves.', '5 Beat butter, add sugar, add eggs, stir in zest: In a separate bowl, use an electric mixer to beat the butter until light. Add the sugar and beat together the sugar and butter until fluffy.', 'Add the eggs one at a time, beating after each addition. Stir in the orange zest.', '6 Alternate adding sour flour mixture and sour cream, then add milk: Mix a third of the dry ingredients into the mixture. Beat in half of the sour cream. Mix in another third of the dry ingredients.  Mix in the remaining sour cream. Beat in the remaining dry ingredients and then the milk.', '7 Pour batter into cake pan and bake: Pour batter over the cranberries in the cake pan, and smooth the surface.', 'Place in the preheated oven and lower the heat from 350\\xc2\\xb0F to 325\\xc2\\xb0F. Bake until a tester comes out with just a few moist crumbs, and pressing down on the surface bounces back, 55 minutes to an hour.', '8 Cool cake in pan, run knife around edge, turn over onto a serving plate: Cool cake in the pan on a rack for 10 minutes.', 'Run a blunt knife around the inside rim of the cake pan to loosen the cake from the sides of the pan. Then turn the cake out onto a platter.']",11
452,Pineapple Upside Down Cake Recipe,15,80,95,"['For the topping:', '1 cup (200g) of firmly packed dark brown sugar', '1/2 cup (1 stick) unsalted butter', '1 can (20 oz) of pineapple slices (Dole brand works best)', 'For the cake:', '1 1/2 cups (200g) all-purpose flour', '6 tablespoons (55 g) cake flour', '6 tablespoons ground almonds (from about 2 oz or 56g of blanched almonds)', '3/4 teaspoon baking powder', '1/2 teaspoon salt', '1 3/4 cups (350g) of sugar', '1 cup (2 sticks) unsalted butter at room temperature', '4 large eggs', '3/4 teaspoon vanilla extract', '3/4 cup sour cream', 'Optional:', '8 candied or maraschino cherries', 'Special equipment:', '10-inch non-stick cake pan']",19,"['1 Grease the pan with butter: Generously grease (with butter) a 10-inch diameter non-stick cake pan with at least 2-inch high sides.', ""2 Make caramel topping: Heat brown sugar and butter in a medium sized saucepan on medium heat until sugar dissolves and the mixture is bubbly,  several minutes. (After sugar melts, don't stir.)"", '3 Pour into pan, top with pineapple slices: Pour the caramel mixture into the pan. Arrange pineapple slices in a single layer on top of the caramel mixture.', '4 Preheat oven to 325\\xc2\\xb0 F.', '5 Make cake batter: Whisk the flours, ground almonds, baking powder, and salt in a large mixing bowl.', 'In a separate bowl, use an electric mixer to beat the sugar and butter together until light. Add eggs one at a time, beating after each addition. Beat in the vanilla.', 'Add dry ingredients alternately with sour cream in 2 additions each, beating well after each addition.', '6 Pour cake batter over caramel and pineapple in pan. Spread the cake batter over the pineapple and caramel so that it is smooth on top.', '7 Bake: Bake the cake at 325\\xc2\\xb0F until a tester inserted into the center comes out mostly clean (internal temperature of about 205\\xc2\\xb0F if you have an instant read thermometer), about 1 hour.', '8 Turn out cake: Cool cake in pan on a rack for 5 minutes. Turn the cake out onto a platter, after the cake has cooled for 5 minutes, and while the cake is still warm.', 'If some of the topping sticks to the cake pan (it often does), just scoop it out with a butter knife and patch the cake.', '9 (Optional) Add cherries: If you want to add candied or maraschino cherries for decoration, just put one in the center of each pineapple round.', 'Serve warm or at room temperature.']",13
453,Chocolate Chip Pumpkin Bread Recipe,15,0,15,"['For the topping:', '3 tablespoons sugar', '1/2 teaspoon ground cinnamon', 'For the bread:', '2 cups (280 g) all-purpose flour', '2 1/4 teaspoons baking powder', '3/4 teaspoon kosher salt', '1/2 teaspoon ground cinnamon', '1 cup (244 g) pumpkin pur\\xc3\\xa9e', '1 1/4 cups (250 grams) granulated sugar', '2 large eggs', '1/2 cup (125 ml) whole milk (2% is also fine)', '1/2 cup (113 g) unsalted butter, melted', '2 teaspoons vanilla extract', '1/2 cup mini chocolate chips, plus more for topping', 'Special equipment:', '9-x-5-inch loaf pan']",17,"['1 Preheat the oven to 350\\xc2\\xb0F. Butter or spray a 9-x-5-inch loaf pan.', '2 Mix the topping: Whisk 3 tablespoons of sugar and 1/2 teaspoon cinnamon together in a small bowl. Set aside', '3 Mix the dry ingredients: Combine the flour, baking powder, kosher salt, and cinnamon in a large mixing bowl.', '4 Make the batter: In a separate medium-sized mixing bowl, whisk together the pumpkin, sugar, eggs, milk, melted butter, and vanilla extract until well combined. Pour the pumpkin mixture into the flour mixture and fold to combine. Fold in the mini chocolate chips.', '5 Transfer the batter into the loaf pan. Tap the pan a few times on the counter to remove air bubbles, then smooth the top with a spatula. Sprinkle with cinnamon sugar and more mini chocolate chips.', '6 Bake the bread: Bake for 50 to 60 minutes, or until a toothpick inserted in the center of the bread comes out clean. Remove from the oven and cool in the pan on a cooling rack for 20 minutes before removing and cooling completely.', 'Wrap up any leftovers with foil or plastic wrap and store on the counter. The bread will keep for several days.']",7
454,Sour Cream Chocolate Cake Recipe,20,55,75,"['2 cups all purpose flour (250g)', '1 3/4 cups granulated sugar (360 g)', '3/4 cup dark cocoa powder (70 g)', '2 teaspoons baking soda', '1 teaspoon kosher salt', '2 large eggs', '1 cup sour cream', '3/4 cup canola oil', '2 teaspoons vanilla extract', '1 cup strong piping hot coffee', '1 batch chocolate or cream cheese frosting']",11,"['1 Preheat the oven to 300\\xc2\\xb0F. Butter and flour a 9x13 cake pan.  Set aside.', '2 Sift the dry ingredients: In a large bowl, sift together flour, sugar, cocoa powder, and baking soda. Whisk in the kosher salt.', '3 Whisk the wet ingredients: In a medium bowl, whisk together eggs, sour cream, canola oil and vanilla extract until it looks homogenous and creamy.', '4 Combine the wet and dry ingredients: Pour the wet ingredients into the dry ingredients. Stir together with a stiff spatula. The batter will be thick like frosting.', '5 Add the coffee: Pour in the piping hot coffee. The batter will look like mud pies in a muddy lake. Keep stirring until all the liquid is incorporated and it is a homogenized cake batter.', '6 Bake the cake: Pour the batter into the prepared pan. Place in the oven and bake for 50 to 55 minutes or until a toothpick poked in the center comes out clean.', '7 Cool the cake: Take the cake out of the oven and set it on a baking rack to cool. After about 30 minutes spread the frosting on top.', 'Cut and serve the cake straight from the pan like it\\xe2\\x80\\x99s 1983 and you\\xe2\\x80\\x99re rockin\\xe2\\x80\\x99 your favorite knee-high tube socks with the yellow stripe. Aw, yeah!']",8
455,Bittersweet Chocolate Cake Recipe,30,90,120,"['12 large eggs, separated (see how to separate eggs)', '2 cups (400 g) granulated sugar', '14 ounces (400 g) bittersweet or semisweet chocolate, grated or cut into small pieces', '4 Tbsp (60 ml) water (or more if needed)', 'A pinch of salt', '3 1/2 sticks (3/4 lb plus 4 Tbsp, or 400 g) unsalted butter, softened', '2 teaspoons orange zest', '1 cup (135 g) all purpose flour, sifted', 'Powdered sugar', 'Special equipment:', 'A 9-inch or 10-inch springform pan']",11,"['1 Preheat oven, prepare springform pan: Preheat oven to 325\\xc2\\xb0F. Prepare a rack in the center of the oven. Place a baking sheet in a rack below it (to catch any drippings or spill-overs).', 'Generously butter the sides and bottom of a 9-inch or 10-inch springform pan. Add a few tablespoons of sugar and gently shake so that all the sides and bottom of the pan are coated with sugar. Tap out excess sugar.', '2 Beat egg yolks with sugar: Beat egg yolks with the granulated sugar until they are thick and pale yellow and form a ribbon when they fall from the beater, about 2 to 3 minutes on medium speed of an electric hand mixer.', '3 Melt chocolate: Make a double boiler by heating an inch of water to a bare simmer in a saucepan, and place a metal bowl on top of it. Make sure that the bottom of the metal bowl is not touching the water below.', 'Place chocolate and 4 Tbsp of water together in the top metal bowl of the double boiler.', 'Slowly melt the chocolate over barely simmering water, whisking it until smooth. If the chocolate gets too thick, and looks like it will firm up, whisk in a tablespoon more of water.', 'Whisk in a pinch of salt.', 'Let cool until just warm to the touch.', '4 Make batter base: Slowly fold the warm chocolate into the egg mixture, gently stirring while you add the chocolate. Stir in the softened butter. Stir in the grated orange peel. Stir in the sifted flour. Mix thoroughly but gently.', '5 Incorporate beaten egg whites: Beat the egg whites until stiff. (See this wonderful explanation of whisking egg whites taken from La Bonne Cuisine de Madame Sant-Ange.)', 'Stir one third of the beaten egg whites in to the chocolate egg mixture to thin it. Gently fold in the remaining beaten egg whites, a third at a time until the egg whites are completely incorporated. Be careful at this stage not to over-mix.', '6 Bake: Pour the batter into your prepared springform pan. The batter will come close to the top of the pan. Set the pan on the middle rack of your oven and bake at 325\\xc2\\xb0F for 1 hour and 20 minutes, or until a cake tester comes out clean, or a digital thermometer inserted into the center reaches 200\\xc2\\xb0F (93\\xc2\\xb0C).', 'Do not worry if the top of your baked chocolate cake has cracks in it! As the cake cools the top will settle and the cracks will close.', '7 Cool: Cool on a rack for 15 minutes, then remove the outer rim. Allow the cake to cool completely before removing the bottom of the pan. Refrigerate.', '8 When ready to serve, sprinkle with powdered sugar.']",15
456,Spaghetti with Clams Recipe,0,30,30,"['1/2 pound (8 ounces) spaghetti pasta (can up to 3/4 pound of pasta if needed)', 'Salt for pasta water', '3 Tbsp extra virgin olive oil', '3 to 4 cloves garlic, minced (about a heaping tablespoon)', 'Pinch of red chili pepper flakes', '2 6-ounce cans minced clams (including the liquid)', '1/2 cup dry white wine', '1 teaspoon lemon zest', '2 Tbsp chopped fresh parsley', 'Freshly ground black pepper to taste']",10,"['1 Heat salted water, do prep: Bring a large pot of salted water to a boil (1 Tbsp of salt for every 2 quarts of water). While the water is heating, prep the garlic, lemon zest, and parsley.', '2 Cook the spaghetti: Add the spaghetti to the boiling water, set your timer for 2 minutes less than the recommended time (so you can be assured that you are cooking the pasta al dente).', 'Cook the spaghetti uncovered in vigorously boiling water. While the spaghetti cooks, prepare the clam sauce.', '3 Saut\\xc3\\xa9 garlic, chile flakes: Heat 3 Tbsp of olive oil in a saut\\xc3\\xa9 pan on medium heat. Add the minced garlic and the red chili pepper flakes. Cook for 30 seconds to a minute, until the garlic just is on the edge of browning.', '4 Add wine, clam juice, reduce: Add the white wine to the pan. Open the cans of clams and squeeze out the clam juice from the cans into the pan as well.', 'Raise the temperature to high and let boil sauce the sauce reduces as the spaghetti cooks. (Put pan on largest burner on high heat to help the sauce reduce more quickly.)', '5 Add chopped clams, parsley, lemon zest: About the same time the spaghetti is finishing its cooking, the sauce should be reduced by about two-thirds. There should be about 1/4 to 1/3 cup of liquid still in the pan.', 'Add the chopped clams, and return to a simmer. Then stir in the minced parsley and the lemon zest.', '6 Toss cooked spaghetti with the clam sauce: When the pasta is done to the point of al dente (cooked but still a little firm when you bite), drain it and place it in a serving bowl. Pour the sauce over the spaghetti and toss to combine. Sprinkle with freshly ground black pepper to taste.', 'Serve with a little more fresh parsley sprinkled over the top. Serve immediately.']",10
457,English Muffin Tuna Melts Recipe,15,15,30,"['DAD ADD: Quick Pickled Veggies:', '1 medium carrot', '5 radishes', '1/2 pickle', '3 to 4 tablespoons pickle juice', 'For the Tuna Melts:', '1 stalk celery, minced', '1/4 cup minced red onion', '2 tablespoons minced red pepper', 'Juice of 1/2 lemon', '2 cans (about 10 total ounces) albacore tuna, oil or water packed', '1/8 teaspoon salt', '1/8 teaspoon freshly ground black pepper', '1/3 cup mayonnaise', '4 whole English muffins', '8 slices Swiss cheese']",16,"['1 DAD ADD! Make the pickled veggies: Peel and slice the carrot in half down its length and then into thin half-coins. Slice the radishes in half and then slice into half-coins as well. Do the same with the pickle.', 'Stir the vegetables together with 3 tablespoons of pickle juice to coat. Set aside for a few minutes while you make the tuna melt muffins. Taste, and add more pickle juice if needed.', '2 Preheat oven to 400\\xc2\\xb0F.', '3 Make the tuna mixture:  In a medium bowl, stir together minced celery, onion, red pepper, salt, pepper, and tuna. Fold in the mayo last.', '3 Prep the tuna melts:  Spread out English muffin halves on a baking sheet. Add half a slice of Swiss cheese to the bottom of each muffin. Top each muffin with about two tablespoons of tuna salad mix. Top with second half of cheese.', '4 Bake: Bake the tuna melts for 12 to 15 minutes until muffins are browned around the edges and the cheese is melted.', '5 Serve: Serve while warm with pickled veggies on the side (optional).', 'Prepared tuna melts don\\xe2\\x80\\x99t keep well, but the tuna salad mix keeps well for a few days in the fridge, and you can make the muffins on demand.']",8
458,Mediterranean Tuna Pasta Recipe,15,15,30,"['2 5-ounce cans of albacore tuna (preferably packed in olive oil), drained*', '1 tomato, cored, cut in half crosswise and squeezed of excess juice, chopped (about 1 cup)', '1/4 cup pitted, kalamata olives, coarsely chopped', '1/4 cup chopped red onion', '2 Tbsp chopped parsley', '1 Tbsp capers, coarsely chopped', '2 teaspoons lemon juice', '2 Tbsp extra virgin olive oil (more if you are using tuna packed in water)', '1/2 teaspoon kosher salt', 'Pinch of freshly ground black pepper', '3/4 pound fusilli pasta, dry', '1 cup grated Mozzarella cheese', '*If you are using a good quality brand of canned tuna, packed in good quality olive oil, there is no need to drain. The oil is highly flavored. If you question the quality of the olive oil, drain it, and add back the same amount of your own good quality olive oil (about 2 Tbsp, listed in the ingredients).']",13,"['1 Put pasta water on to boil: Heat 2 quarts of salted water (1 Tbsp kosher salt), to a boil. While heating the pasta water, prep  the ingredients.', '2 Stir drained tuna with tomato, olives, onion, parsley, capers, lemon juice, olive oil, salt, pepper: Place drained tuna in a medium bowl. Stir with a fork to break up the largest chunks of tuna. Add the tomato, olives, red onion, parsley, capers, lemon juice, olive oil, salt and pepper. Stir to combine.', '3 Boil pasta until al dente: When the pasta water comes to a boil, add the pasta and boil, uncovered, on a rolling boil until al dente (cooked through, but still a little firm to the bite). Reserve 1/4 cup of the pasta water.', '4 Add pasta to tuna mixture, sprinkle with Mozz: Drain the pasta and immediately add the pasta to the tuna mixture.', 'Sprinkle with the grated Mozzarella cheese and stir until everything is well combined. If the pasta seems a little dry, add some of the reserved pasta water and/or some more olive oil.', 'Serve warm.']",6
459,Pasta with Tuna and Arugula Recipe,10,15,25,"['3/4 pound (12 ounces) dried fettuccine, spaghetti or linguine', '1/4 cup extra virgin olive oil', '2 cloves garlic, minced', '1/8 teaspoon hot red pepper flakes (more to taste)', '2 6-ounce cans tuna packed in olive oil, drained', 'Salt', '5 to 8 ounces baby arugula']",7,"['1 Cook pasta: Bring a large pot of salted water (1 Tbsp salt for every 2 quarts of water) to a rolling boil. Add the pasta, return to a rolling boil, and boil uncovered until the pasta is al dente, cooked, but still a little firm to the bite.', '2 Cook garlic and red pepper flakes in olive oil; add tuna, salt: While the pasta is cooking, heat the olive oil in a large skillet on medium-low heat. Add the garlic and hot pepper flakes and cook until garlic is fragrant.', 'Add the tuna and shred it into fine flakes with a fork. Season with salt. Keep warm over low heat.', ""3 Set aside a cup of pasta water: Just before the pasta is ready, set aside 1 cup of boiling water. You'll need this to add back to the pasta dish to keep it from getting too dry."", '4 Combine pasta with tuna mixture, arugula, and some pasta water: Drain the pasta and depending on the size of your pan, either add it to the skillet with the tuna, or return the pasta to the pasta pot and add the tuna mixture to the pasta.', 'Add the arugula and use tongs to toss together with the pasta and tuna. Add some of the hot reserved pasta water to help loosen the pasta.', 'The arugula will wilt as you toss the pasta and tuna with it. Add more pasta water as needed.']",7
460,Easy Tuscan Bean Soup Recipe,20,30,50,"['For the soup:', '3 tablespoons olive oil', '2 medium carrots, thickly sliced', '1 large onion, coarsely chopped', '1 stalk celery, coarsely chopped', '1 clove garlic, finely chopped', '3 sprigs fresh oregano', '1/4 teaspoon salt', 'Black pepper, to taste', '2 (15 -ounce) cans cannellini beans or other small white beans, drained and rinsed', '5 cups chicken stock or vegetable stock', '4 cups baby kale or baby spinach, stems removed if tough', '1 tablespoon chopped fresh oregano, for garnish', 'Olive oil, to serve', 'Extra grated Parmesan, to serve', 'For the parmesan toasts:', '1/2 baguette, thinly sliced', 'Olive oil', '1/2 cup grated Parmesan']",19,"['1 Cook the vegetables: In a soup pot, heat the olive oil. When it is hot, add the carrots, onion, celery, garlic, fresh oregano sprigs, salt, and pepper. Cook, stirring often, for 10 minutes until the vegetables look softened and the onions turn translucent.', '2 Prepare the beans: On a plate, mash 1/2 cup of the beans with a fork or potato masher. Add them to the vegetables in the pot. Cook, stirring, for 2 minutes.', '3 Simmer the soup: Add the remaining beans to the pot and stir well. Stir in the chicken stock and bring to a boil. Lower the heat, partially cover with the lid placed askew, and simmer for 20 minutes, or until the carrots are tender and the liquid is flavorful.', 'Discard the oregano sprigs; the leaves will have fallen into the soup. Add additional salt and pepper to taste.', '4 While the soup simmers, make the Parmesan toasts: Toast the bread until lightly golden on both sides. While the toast is still hot from the toaster, sprinkle with olive oil and cheese. If you have a toaster oven, return them to the toaster for 1 minute to melt the cheese; otherwise, arrange the toasts in a skillet over medium heat, cover, and warm for about 1 minute or until the cheese has melted.', '5 Add the greens to the soup: Add the kale or spinach to the pot and simmering for another 2 minutes, or just until the greens wilt.', ' 6 Serve the soup: Ladle the soup into bowls, sprinkle with oregano and more olive oil, if you like. Serve with Parmesan toasts and extra Parmesan for sprinkling.']",7
461,Creamy Tomato and White Bean Soup Recipe,10,35,45,"['For the soup:', '2 tablespoons olive oil', '1 large onion, chopped', '2 medium cloves garlic, thinly sliced', '3 pounds ripe plum (Roma) tomatoes, cut into 1-inch pieces (or 2 (28-ounce) cans whole tomatoes and their juices, crushed in a bowl)', '1 15-ounce can cannellini beans, drained and rinsed, or homemade', '1 sprig fresh rosemary', '1 1/2 cups water, plus more as needed', '1/2 cup freshly grated Parmesan', '1 teaspoon salt, plus more to taste', '1/8 teaspoon black pepper, plus more to taste', 'For the garnish:', '12 cherry tomatoes, sliced or quartered', '1 tablespoon olive oil', '1 teaspoon red wine vinegar', 'Salt and pepper, to taste', '12 basil leaves, thinly sliced', 'Special Equipment:', 'Blender or immersion blender']",19,"['1 Cook the onion and garlic: Heat the oil in a soup pot over medium heat. Add the onion and garlic. Cook, stirring occasionally, for 6 to 8 minutes, or until softened.', '2 Add the tomatoes and beans: Add the fresh or canned tomatoes, rosemary, beans, 1 1/2 cups of water, salt, and pepper to the pot. Bring to a simmer and cook, uncovered, for 20 minutes, or until the tomatoes are very soft. Remove the rosemary sprig. Stir in the Parmesan.', '3 Puree the soup: In 2- to 3-cup batches, puree the soup in a blender until smooth, or use an immersion blender. (Warning! The soup is hot! To puree hot liquid in a blender, only fill it 1/3 full. Cover the lid with a folded dishtowel and hold it down with your hand. Start on low speed, and increase the speed gradually.)', 'Transfer the soup to a pot and stir in enough additional water to bring the soup to your desired consistency (up to 2 1/2 cups of water). Taste and add salt and pepper, if you like. Reheat over low heat until hot.', '4 Make the garnish: In a bowl, stir together the tomatoes, oil, vinegar, salt, and pepper. Just before serving, stir in the basil.', '5 Serve the soup: Ladle the soup into bowls, and top each bowl with the fresh tomato garnish.']",6
462,Canned Tomato Salsa Recipe,30,45,75,"['5 pounds of tomatoes', '1 pound large Anaheim green chiles (5-6 chiles)', '3 jalape\\xc3\\xb1o chilies, seeded and stems removed, chopped', '1 1/2 cups chopped onion', '3 cloves garlic, minced', '1 cup apple cider vinegar', '1/2 cup loosely packed fresh chopped cilantro (including stems)', '2 teaspoons dried oregano', '1/2 teaspoon ground cumin', '2 teaspoons salt', '1 to 2 tablespoons sugar or more (to taste, depending on how sweet your tomatoes are)', 'Special equipment:', '5 to 6 pint-sized canning jars, with rings and new lids', 'A very large stockpot or canning pot (16-qt)', ""A flat steamer rack on which to place the filled jar for the water bath canning, so that they don\\'t touch the bottom of the pan and crack from excess heat"", 'Optional but recommended:', 'Jar lifter canning tongs to make it easy to lift the jars in and out of boiling water', 'Rubber or latex coated gardening gloves to make it easier on your hands for handling hot jars']",18,"['1 Sterilize jars and lids in water bath: Place steamer rack in the bottom of a large (16-qt) stock pot or canning pot. Place new or clean mason jars on the rack. Fill the jars with water and fill the pot with just enough water to come to the top of the jars. Heat water to a simmer. Simmer for 10 minutes. (Keep the jars warm while preparing the salsa.)', 'Have a kettle half filled with water ready to boil, to use to sterilize the jar lids a few minutes before canning.', ""2 Roast chile peppers: Roast the Anaheim green chile peppers until blackened all over. The best way to do this is directly over a gas flame on the stovetop (see how to roast chiles over a gas flame.) If you don\\'t have a gas cooktop you can broil the chiles, or blister them on a grill."", 'Note that it is not essential that the chile peppers be cooked through, only that the outer tough skin is blistered and blackened. This is what will help with flavor. Also it will make it easy to peel the chiles.', 'Just put the chiles near a heat source until blistered and blackened, and turn them so that they get blackened on all sides.', 'Then place the chiles in a brown paper bag (or in a covered bowl), close the bag and let the chiles steam in their own heat for a few minutes.', 'Then gently rub off the outer skin and discard. Cut away the stems and remove the seeds and any prominent veins.', 'Chop up the chiles and set aside; you should have 1 cup of chopped chiles. Do not use more than 1 1/2 cups of chopped chiles.', '3 Prepare the tomatoes: You want the tomatoes peeled, and there are several ways of doing that. Blanching them is easiest; grilling or broiling will result in more flavor.', 'To blanch them, score the ends of the tomatoes and place them in boiling water for a minute.', 'If you are going to grill or broil the tomatoes, I recommend coring them first. Grilling is best with whole plum tomatoes; grill them on high direct heat until blackened in parts and the peels are cracked.', 'Broiling works with any sized tomato. Just cut them in half and place the cut side down on a rimmed baking sheet or roasting pan. Broil until the peels are blackened in parts.', ""Remove the tomatoes (from water, grill or broiler) and let cool to the touch. Remove and discard the peels. Cut away any cores if you haven\\'t done so already. Chop the tomatoes taking care to save any juices that may come out of them."", 'Starting with 5 pounds of tomatoes you should end up with about 8 cups of chopped tomatoes and juices. (You must use at least 7 cups of tomatoes.) Place them in a bowl and set aside.', '4 Simmer all ingredients in a large pot: Put all of the ingredients into a large (8-qt) stainless steel pot. (Do not use aluminum or the acidity of the sauce will cause the aluminum to leach into the sauce.)', 'Bring to a boil, reduce to a simmer. Cook uncovered for about 10 minutes.', '5 Sterilize jar lids: While the salsa is cooking, place the jar lids in a bowl and cover with boiling water to sterilize.', '6 Blend salsa if you want it to be more smooth: If you want your salsa to be more smooth than chunky, use an immersion blender to pulse it a few times, or working in batches ladle about half of it into a blender and pur\\xc3\\xa9e.', '7 Adjust seasonings: If too acidic to taste, add more sugar to balance the vinegar! If too sweet, add a bit more vinegar.', '8 Ladle salsa into canning jars and seal: Ladle salsa into canning jars, leaving 1/2-inch head space. Wipe the rims with a clean, dampened paper towel so that there is no residual food on the rims.', 'Place canning lids on the jars. Screw on the lid rings. Do not over-tighten or you may not get a good seal. Air does need to escape from the jars during the next step, the water bath.', '9 Boil in a water bath: Place the filled and lidded jars back onto the rack in the large stock-pot of hot water you used to sterilize the jars in step one. You may need to remove some of the water from the pot to prevent it from overfilling.', 'Cover the jars with at least 1-inch of water. Bring to a rolling boil and process for 15 minutes (20 minutes for altitudes 1000 to 6000 ft, 25 minutes above 6000 ft). Then turn off heat and let the jars sit in the hot water for 5 minutes.', '10 Let jars cool, lids should pop: Remove jars from the water bath and let sit on a counter for several hours until completely cool. The lids should ""pop"" as the cooling salsa creates a vacuum under the lid and the jars are sealed.', 'If a lid has not sealed, either replace the lid and reprocess in a water bath for another 15 minutes, or store in the refrigerator and use within the next few days.', 'Remember to label the cans with the date processed. (I use a Sharpie on the lid.) Canned salsa should be eaten within a year.']",26
463,Meyer Lemon Marmalade Recipe,60,60,120,"['2 1/2 lbs of Meyer lemons (about 9 lemons)', '6 cups water', '6 cups granulated sugar', 'Special equipment:', '1 wide 6 or 8-quart pan (Stainless steel or copper with stainless steel lining, not aluminum which will leach)', ""A sharp chef\\'s knife"", 'A candy thermometer or instant-read thermometer (I use a thermapen or thermopop)', '6 half-pint (8-oz) canning jars', 'Cheesecloth, enough to double over and form a bag to hold the seeds for making pectin, or a Muslin jelly bag', 'Additional Equipment Recommended:', 'Flexible plastic cutting board surface (to curl up to catch the lemon juice from the lemons to add to the fruit)', 'Disposable latex or non-latex gloves to protect your hands from the acid from the lemons']",12,"['PREPARING THE FRUIT', '1 Scrub the lemons clean. Discard any that are moldy or damaged.', '2 Prepare the lemons: Cut 1/4 inch off from the ends of the lemons. Working one at a time, stand a lemon on end. Cut the lemon in half lengthwise. Cut each lemon half into several segments, lengthwise.', ""As you cut the lemons into segments, if you can, pull off any exposed membranes. Just get the ones that are easy to get to, ignore the rest. When you\\'ve cut down to the final segment, cut away the pithy core. Remove all seeds from the segments. Reserve the seeds and any removed membrane or pith. You will need them to make pectin."", 'Cut each lemon segment crosswise into even pieces to make little triangles of lemon peel and pulp.', '3 Put seeds, membranes, pith into cheesecloth or muslin bag: Put all of the seeds, membranes and pith you removed from the lemons into a bag fashioned out of two layers of cheesecloth or a muslin jelly bag.', '  FIRST STAGE OF COOKING', '4 Place the lemon segments and water into a large, wide pot.', '5 Secure pectin bag: Place the pectin bag in the pot with the fruit pulp and secure to the pot handle.', '6 Boil until peels are soft: Bring mixture to a strong boil on high heat. Let boil, uncovered, for about 25-35 minutes, until the peels are soft and cooked through. (If too much of the water evaporates from the boil and the peels start sticking to the bottom of the pan, add a little more water back in.)', 'Test one of the lemon peel pieces by eating it. It should be very soft. If it is still chewy, keep cooking until soft.', 'Remove from heat.', '7 Remove the pectin bag, place the pectin bag in a bowl and let cool until it is comfortable to touch.', 'ADD THE PECTIN AND SUGAR', '8 Squeeze pectin from pectin bag: Once your pectin bag has cooled to the point you can handle it, if you want, squeeze it like play-doh to extract any extra pectin. This is not necessary but will help ensure a good set. (I like to wear latex-type gloves for this part.) You should be able to get a teaspoon or two more from the bag. It has the consistency of sour cream. Return this pectin to the pan with the lemon mixture.', '9 Add sugar: Measure out your sugar and add it to the pan with the lemon mixture.', '  SECOND STAGE OF COOKING', '10 Boil and check temperature: Heat the jelly mixture on medium high and bring it to a rapid boil, stirring occasionally, making sure nothing is sticking to the bottom of the pan.', 'After the jelly first comes to a boil, it will foam up considerably. this is why you need need to use a large pot, and make sure you pay attention and keep your eyes on the whole process. Stir with a wooden spoon to bring the foam back down. If it gets too high, lower the temperature to keep it from overflowing the pot.', 'Secure a candy thermometer to the side of the pan, or check the jelly temperature with an instant read thermometer. The marmalade may take anywhere from 20 to 35 minutes or so to be ready to pour out. After about 15 minutes, start checking the temperature frequently.', '11 Test to see if the marmalade is at set point: There are two ways to test that the marmalade is ready to pour out into jars: the mixture reaching a temperature of 218-220\\xc2\\xb0F (6-8\\xc2\\xb0F above the boiling point at your altitude) OR putting a bit of it on a chilled plate ""wrinkling up"" when you push it with your finger tip. I steer off of the wrinkle test. If the sample of jelly wrinkles, it\\\'s ready. I use a thermometer just to help me gauge when to do the wrinkle test.', ""For the wrinkle test, place a small plate into the freezer. As the jelly temperature reaches 217\\xc2\\xb0F, start testing it by placing a small amount of the hot jelly on the chilled plate. If the jelly spreads out and thins immediately, it isn\\'t ready. If it holds its shape a bit, like an egg yolk, that\\'s a good sign. Push up against it with your finger tip. If the jelly sample wrinkles at all, it is time to take the jelly off the heat and pour it out into jars."", 'When you use a candy thermometer or an insta-read thermometer to test the temperature of your mixture, make sure the probe is NOT touching the bottom of the pan. Make sure that the indentation on the probe (with modern candy thermometers this is about an inch and a half from the bottom of the probe) is actually surrounded by the mixture. This may mean that you have to tilt the pan to one side, to cover the probe sufficiently to get a good reading.', '  CANNING', '12 Sterilize canning jars: While the marmalade is in its second cooking stage, rinse out your canning jars, dry them, and place them, without lids, in a 200\\xc2\\xb0F oven. They should be in the oven at least 10 minutes before using them. This not only sterilizes the jars, but it helps to keep them from cracking from the temperature differential when you add the hot jelly mixture to them.', '13 Sterilize lids: As the time approaches for the marmalade to be done, boil some water in a tea pot. Put the jar lids in a glass or ceramic bowl and pour the boiling water over them to sterilize.', '14 Ladle marmalade into sterilized jars: Once the jelly has reached 218-220\\xc2\\xb0F or its ""wrinkly"" stage, remove the jelly pot from the heat. Carefully ladle the jelly into the jars, leaving 1/4 inch head space at the top of the jars for a vacuum seal.', '15 Clean rims, secure with lids and jar ring: Wipe the rim clean with a clean, wet paper towel. Place the lid on the jar, securing with a jar ring. Work quickly.', '16 Allow jars to cool and seal: Allow the jars to sit overnight. You will hear them make a popping sound as a vacuum seal is created.', ""Even if the jelly is not firm as it goes into the jar (it shouldn\\'t be), it should firm up as it cools.""]",30
464,Jalapeno Pepper Jelly Recipe,15,80,95,"['4 lbs of tart apples (e.g. Granny Smith), unpeeled, chopped into big pieces, including the cores', '6 jalape\\xc3\\xb1o chili peppers, sliced in half lengthwise, the seeds and ribs removed from 3 of them (for mildly hot jelly. If you want a hotter jelly leave the seeds and ribs in all of them.)', '1 green bell pepper (or red if you want the color), seeds and ribs removed, chopped', '1 cup cranberries (optional but recommended, will help with color and with setting)', '3 cups water', '3 cups white vinegar', '3 1/2 cups sugar (7/8 cup for each cup of juice)', 'Special equipment:', 'One 6-quart pan (Stainless steel or copper with stainless steel)', 'A digital thermometer', 'A large fine mesh sieve (or several layers of cheesecloth, or a muslin cloth jelly bag)', '4-5 half-pint canning jars']",12,"['1 Boil and mash the apples, jalape\\xc3\\xb1os, bell pepper, and cranberries: Combine the apple pieces, apple cores (needed for their pectin content), jalape\\xc3\\xb1os, bell pepper, cranberries (if using), water and vinegar in a large pot.', 'Bring to a boil and then reduce heat to medium-low, simmering for about 20 minutes, or until the apples, cranberries, and peppers are soft. Stir occasionally to make sure nothing is sticking to the bottom of the pan where it might burn.', 'Use a potato masher to mash up the apple pieces to the consistency of slightly runny apple sauce. If the mash is too thick, add more water.', '2 Strain through a fine mesh sieve or cheesecloth: Spoon the mash into a fine mesh sieve, muslin cloth, or a couple layers of cheesecloth, suspended over a large bowl. Leave to strain for several hours (even overnight).', ""If you want a clear jelly, do not squeeze or force through the mesh. Just let it drip. If you want a fuller flavor jelly and don\\'t mind that the result won\\'t be clear, you can force some of the pulp through the mesh."", 'If your pulp is too thick, and nothing is coming out, you can add an extra 1/2 cup or cup of water to it. You want to end up with about 4 cups of juice.', ""3 Add sugar to juice, heat to dissolve: Measure the juice, then pour into a large, wide, thick-bottomed pot. Add the sugar (7/8 a cup for each cup of juice). Heat gently, stirring to make sure the sugar gets dissolved and doesn\\'t stick to the bottom of the pan and burn."", '4 Boil until setting point: Bring to a boil. Cook for 10-15 minutes, using a spoon to skim off the surface scum.', 'Continue to boil until a digital thermometer shows that the temperature has reached 220-222\\xc2\\xb0F (8-10\\xc2\\xb0F above the boiling point at your altitude).', 'Additional time needed for cooking can be anywhere from 10 minutes to an hour or longer, depending on the amount of water, sugar, and apple pectin in the mix.', '', ""Left: Jelly is too runny. Right: Jelly is wrinkling when pushed, which means it\\'s ready."", ""A thermometer reading isn\\'t always the most reliable indicator of whether or not a jelly is done. Another way to test is put a half teaspoonful of the jelly on a chilled (in the freezer) plate. Allow the jelly to cool a few seconds, then push it with your fingertip. If it wrinkles up, it\\'s ready."", '5 Can in jars: Pour jelly into sterilized jars* to within 1/4"" from the top and seal.', 'Makes approx. 4 half-pint jars.', 'Serve with cream cheese on crackers.', ""*There are several ways to sterilize your jars for canning jelly. You can run them through a short cycle on your dishwasher. You can place them in a large pot (12 quart) of water on top of a steaming rack (so they don\\'t touch the bottom of the pan), and bring the water to a boil for 10 minutes. Or you can rinse out the jars, dry them, and place them, without lids, in a 200\\xc2\\xb0F oven for 10 minutes.""]",17
465,Eggplant Caponata Pasta Recipe,20,40,60,"['2 medium eggplants (1 1/2 to 2 pounds total)', '1/2 red onion, cut into 1-inch pieces', '4 tablespoons olive oil', '1 clove garlic, finely chopped', '1 stalk celery, finely chopped', '1 28-ounce can whole tomatoes (I like an imported variety like San Marzano)', '1/2 cup golden raisins', '1/4 cup red wine vinegar, or more to taste', '2 tablespoons capers', '1/4 teaspoon sugar', '3/4 pound pasta shells, orecchiette, or any other curly pasta shape', '1/2 cup grated fresh Parmesan', '1/2 cup mixed green and black olives, pitted and coarsely chopped', '1/4 cup chopped fresh parsley']",14,"['1 Prepare the eggplant: Turn on the broiler and slide a rack 10-inches below the broiling element. Trim the stem and bottom from the eggplant and cut it into 1-inch pieces. Combine the eggplant and onion in a bowl and toss with salt, pepper, and 2 tablespoons of the olive oil.', '2 Broil the eggplant: Spread the eggplant and onions on a large rimmed baking sheet. Broil for 5 to 6 minutes, turning once, or until the eggplant begins to char at the edges.', '3 Roast the eggplant until tender: Place the eggplant and onion in the middle of the oven and turn the oven temperature to 450F. Continue roasting for 20 minutes, turning several times, or until the eggplant and onion are tender.', '4 Prepare the tomato sauce: In a large pot (big enough to hold the eggplant later), heat the remaining 2 tablespoons olive oil over medium-high heat. Add the garlic and celery and cook, stirring, for 1 minute.', 'Crush the whole tomatoes in a bowl using your hands or a potato masher until you have small, bite-sized pieces. Add both the tomatoes and the roasted eggplant mixture into the pan with the garlic and celery. Bring to a boil, then lower the heat, cover the pan, and simmer for 5 minutes.', '5 Stir the raisins, vinegar, capers, and sugar into the sauce. Continue cooking for 5 minutes, or until the eggplant is very soft. Taste for seasoning and add more salt and vinegar, if you like.', '6 Cook the pasta: Bring a large pot of salted water to a boil. Add the pasta and let it cook, stirring once or twice, for 8 minutes, or until it is tender but still has some bite. Before you drain the pasta, use a heatproof measuring cup to scoop out roughly 1 cup of the water; set aside. Drain the pasta and return it to its cooking pot. Sprinkle with olive oil and toss gently.', '7 Combine the pasta and sauce: Pour the eggplant sauce over the pasta, then add 1/2 cup of the pasta cooking water.. Place over low heat and stir until the sauce begins to coat the pasta. Add enough of the remaining cooking water to make a saucy mixture. Taste for seasoning and add more salt and vinegar, if you like.', '8 Serve the pasta: Spoon the pasta and sauce into 4 shallow bowls. Sprinkle with Parmesan, olives, and parsley.']",9
466,Sheet Pan Chicken with Roasted Eggplant Caponata Recipe,20,30,50,"['For the roasted eggplant caponata:', '1 large eggplant (about 2 pounds), cut in 1/2-inch cubes', '1/2 tablespoon salt', '2 tablespoons olive oil', '2 tablespoons balsamic vinegar', '1/2 teaspoon honey or sugar', '1 pint mixed cherry tomatoes, halved', '2 celery stalks, finely diced', '1/2 cup sliced green olives', '2 tablespoons capers', '1/4 cup parsley, finely chopped', '2 cloves garlic, minced', '1/4 cup toasted pine nuts', 'Additional chopped parsley, to garnish', 'For the chicken thighs:', '2 to 2 1/2 pounds chicken thighs, skin-on and bone-in', '1 teaspoon salt', '1/2 tablespoon sweet paprika', '1/2 teaspoon crushed red pepper (optional)', '1 teaspoon fennel seed (optional)', '1/4 teaspoon pepper', '2 tablespoons olive oil']",22,"['1 Prepare the eggplant: In a large bowl, combine diced eggplant with 1/2 tablespoon salt. Place the eggplant in a colander set inside a large bowl. Strain at least 15 minutes or up to 24 hours. The longer you strain the eggplant, the crispier it will get.', 'When ready to roast, press the eggplant firmly to squeeze out moisture.', '2 Place a large baking sheet on a middle rack in the oven and preheat to 450\\xc2\\xbaF for 15 to 20 minutes.', '3 Prepare the chicken: In a shallow bowl, combine chicken with paprika, red pepper, fennel, salt, pepper, and one tablespoon olive oil and toss to coat.', 'The chicken can also be prepared, covered, and refrigerated overnight.', '4 Roast the eggplant and chicken: When you\\xe2\\x80\\x99re ready to cook, toss the eggplant with 2 tablespoons olive oil. Working quickly, pull the baking sheet from the oven and place chicken skin side down. Add the eggplant in a single layer around the chicken.', 'Return the hot pan to the oven and immediately lower the heat to 425\\xc2\\xbaF. Roast for 15 minutes. Flip the chicken skin side up, and roast another 15 minutes, or until the thighs are cooked through and register 165\\xc2\\xbaF with an instant-read thermometer.', '5 Prepare the rest of the caponata: In a large bowl, whisk together the balsamic and the honey or sugar. Add the cherry tomatoes, celery, green olives, capers, parsley, and garlic. Toss to combine well.', '6 Finish and serve: When chicken is ready, transfer it to a plate and rest for 10 minutes.', 'Add the roasted eggplant and the pan juices to the bowl with the cherry tomato mixture, and stir well. Taste and add salt and pepper as needed. Mix pine nuts into the caponata just before serving so they retain their crunch.', 'Serve the chicken thighs and top with the caponata. Sprinkle with extra parsley.']",11
467,Caramel Walnuts Recipe,0,20,20,"['1/3 cup sour cream', '1/2 teaspoon salt', '2 Tbsp milk', '3/4 cup sugar', '2 cups of walnut halves', '1 teaspoon of vanilla extract']",6,"['1 Make the caramel base: In a small, thick-bottomed saucepan, mix together and heat the sour cream, salt, milk, and sugar. Heat until the temperature reads 240\\xc2\\xb0F on a candy thermometer or digital thermometer, stirring occasionally.', '2 Add walnuts, vanilla: Add the walnuts and a teaspoon of vanilla. Stir until the walnuts are creamy.', '3 Remove from pan and separate: Remove pan from heat and spread the walnuts out on parchment paper or Silpat. Separate using 2 forks if necessary. Let cool to harden.']",3
468,French Onion Soup Recipe,10,70,80,"['6 large red or yellow onions (about 3 pounds), peeled and thinly sliced root to stem (see How to Slice an Onion), about 10 cups of sliced onions total', '4 tablespoons extra virgin olive oil', '2 tablespoons butter', '1 teaspoon of sugar', 'Salt', '2 cloves garlic, minced', '8 cups of beef stock, chicken stock, or a combination of the two (traditionally the soup is made with beef stock)', '1/2 cup of dry vermouth or dry white wine', '2 bay leaves', '1 tablespoon (loose) of fresh thyme (can also use a few sprigs of fresh thyme) OR 1/2 teaspoon dried thyme (more to taste)', '1/2 teaspoon freshly ground black pepper', '2 tablespoons brandy (optional)', '8 slices French bread or baguette cut 1-inch thick', '1 1/2 cups of grated Swiss Gruyere and a sprinkling of Parmesan']",14,"['1 Caramelize the onions: In a 5 to 6 quart thick-bottomed pot, heat 3 tablespoons of olive oil on medium heat. Add the onions and toss to coat with the olive oil.', 'Cook the onions, stirring often, until they have softened, about 15 to 20 minutes.', 'Increase the heat to medium high. Add the remaining tablespoon of olive oil and the butter and cook, stirring often, until the onions start to brown, about 15 more minutes.', 'Then sprinkle with sugar (to help with the caramelization) and 1 teaspoon of salt and continue to cook until the onions are well browned, about 10 to 15 more minutes.', 'Add the minced garlic and cook for a minute more.', '2 Deglaze the pot with vermouth: Add the vermouth to the pot and scrape up the browned bits on the bottom and sides of the pot, deglazing the pot as you go.', '3 Add stock and seasonings: Add the stock, bay leaves, and thyme. Bring to a simmer, cover the pot and lower the heat to maintain a low simmer. Cook for about 30 minutes.', 'Season to taste with more salt and add freshly ground black pepper. Discard the bay leaves. Add brandy if using.', '4 Toast French bread slices: While the soup is simmering, line a sheet pan with parchment paper or foil and preheat the oven to 450\\xc2\\xb0F with a rack in the upper third of the oven.', ""Brush both sides of the French bread or baguette slices lightly with olive oil (you\\'ll end up using about a tablespoon and a half of olive oil for this)."", 'Put in the oven and toast until lightly browned, about 5 to 7 minutes. Remove from oven.', ""Turn the toasts over and sprinkle with the grated Gruyere cheese and Parmesan. Return to oven when it\\'s close to serving time and bake until the cheese is bubbly and lightly browned."", '5 Serve: To serve, ladle soup into a bowl and transfer one cheesy toast onto the top of each bowl of soup.', 'Alternatively, you can use individual oven-proof bowls or one large casserole dish. Ladle the soup into the bowls or casserole dish. Cover with the toast and sprinkle with cheese. Put into the broiler for 10 minutes at 350\\xc2\\xb0 F, or until the cheese bubbles and is slightly browned.']",14
469,Caramelized Fennel and Onions Recipe,10,60,70,"['2 large onions, halved then sliced lengthwise (root to tip) in 1/4-inch thick slices', '2 large fennel bulbs, sliced into 1/4-inch thick slices', '1/4 cup extra virgin olive oil', '1 Tbsp butter', 'Salt', '1/4 cup grated Parmesan', '2 tablespoons chopped fresh parsley', '1 teaspoon lemon zest', '2 teaspoons lemon juice']",9,"['1 Cook fennel and onions in olive oil and butter: Heat olive oil and butter in a large, uncovered, wide pan on medium high heat. Add the sliced fennel and onions and stir to coat. Stir occasionally.', 'After about 10 minutes, sprinkle the onions and fennel with salt. Lower the temperature to medium.', 'You want to strike a balance between allowing the pan to get hot enough so that some caramelization (when the natural sugars in the onion and fennel start to brown) and keeping the pot from getting so hot that the onions and fennel dry out.', 'If it becomes an issue, you can add a couple tablespoons of water to the pan to help the onions and fennel to keep from drying out too much.', '2 Scrape up browned bits: Stir occasionally, scraping up any browned bits from the bottom of the pan. Note that the browned bits are the tastiest parts.', ""Cook for another 30 minutes to an hour, depending on how much of a hurry you're in, and how caramelized you want your mixture to be. The longer you cook, the more caramelized and browned."", 'Taste test along the way to see if the cooking has been sufficient for your taste.', 'By the way, the onions and fennel will have plenty of flavor without having to be completely cooked down and browned all over.', '3 Toss with Parmesan, parsley, lemon: When ready to serve, remove from heat and toss in the freshly grated Parmesan cheese, the chopped parsley, lemon zest and lemon juice. Taste and add more lemon juice if necessary.', 'Serve alone as a side to chicken or seafood, or on crackers or thinly sliced toasted baguette for a crostini. You can also use it as a filling for a rustic tart.']",10
470,Caramelized Onion Dip Recipe,5,40,45,"['2 tablespoons extra virgin olive oil', '4 cups chopped yellow onions (from about 2-3 onions)', '1 teaspoon brown sugar', '2 tablespoons balsamic vinegar', '1/2 teaspoon kosher salt', '1/2 teaspoon black pepper', '1 cup sour cream', '1/2 cup mayonnaise', '1/4 teaspoon Worcestershire sauce', '1/4 teaspoon garlic powder']",10,"['1 Caramelize the onions: Heat olive oil in a large, thick-bottomed deep pot (I used a 5-quart Dutch oven) on medium high heat. Add the chopped onions and cook until translucent and starting to color, about 10 minutes.', 'If at any point during the cooking of the onions they start to dry out, add a tablespoon of water to the pot.', 'Stir in the brown sugar, balsamic, salt, and pepper. Lower the heat and cook gently, uncovered, for about 25 to 30 minutes, stirring occasionally, until the onions are nicely caramelized.', 'Then set aside. (You can caramelize the onions up to 2 days ahead and chill until you make the dip.) Let cool a bit before adding to the other ingredients.', '2 Combine with remaining ingredients: In a medium bowl, mix together the sour cream and mayonnaise (a rubber spatula works well for this). Stir in the caramelized onions. Sprinkle with garlic salt and stir to incorporate. Stir in the Worcestershire sauce.', 'Chill until ready to serve. Serve with potato chips.']",6
471,Roasted New Potatoes with Caramelized Onions and Truffle Oil Recipe,10,40,50,"['1 pound small, new potatoes, scrubbed, quartered', '1 large yellow onion, peeled, thinly sliced', '3 tablespoons extra virgin olive oil', 'Kosher salt and freshly ground black pepper', 'Several shakes of white truffle oil, about 1/2 teaspoon']",5,"['1 Preheat oven to 400\\xc2\\xb0F.', '2 Toss potatoes and onions with olive oil, salt, pepper: Put onions and potatoes in a sturdy roasting pan. Pour olive oil over them and toss well to coat. Liberally sprinkle salt and pepper over the potatoes and onions. Spread the potatoes out so they are in a single layer in the pan.', '3 Roast: Place in oven. Roast at 400\\xc2\\xb0F for 40 minutes or until the potatoes are lightly browned and cooked through.', '4 Sprinkle with truffle oil: Place potatoes and onions in a serving dish. Sprinkle well with truffle oil. Toss to coat.']",4
472,Rustic Onion Tart Recipe,20,100,120,"[""1 recipe for butter sour cream pastry dough* or 1 packaged, flat pie crust (Trader Joe's has one in their frozen section)"", '3 medium sized red and/or yellow onions (enough for 5 to 8 cups, sliced)', '2 tablespoons extra virgin olive oil', '1 tablespoon butter', 'Salt', '1 teaspoon balsamic vinegar', '1/2 teaspoon fresh thyme, chopped, or 1/4 teaspoon dried thyme', '3/4 cup (not packed) roughly grated Gruy\\xc3\\xa8re Swiss cheese', '*Sour cream pastry dough:', '1 1/4 cup (160 g) all purpose flour', '1 teaspoon salt', '5 ounces of butter (1 1/4 sticks, 10 Tbsp, 137g), cubed', '1/4 cup sour cream']",13,"['1 Prepare the dough: If you are making a crust from scratch, prepare the dough and let it chill in the refrigerator while you are cooking the onions.', 'To prepare the dough, whisk the flour and salt together in a large bowl. Cut the butter into the flour with your hands or with a pastry cutter, until the mixture resembles a coarse meal.', 'Add the sour cream and use a fork to incorporate it into the dough. Gather the dough into a ball and shape it into a disk. Wrap it with plastic wrap and chill for at least an hour.', '2 Peel and slice the onions, lengthwise from stem to root. (See How to Slice an Onion)', '3 Caramelize the onions: Heat olive oil and butter in a large, heavy-bottomed saut\\xc3\\xa9 pan on medium heat. Once the butter has melted, add the onions and sprinkle a little salt over them.', 'Cook, stirring occasionally for 10 minutes, until the onions have softened and are translucent.', 'Reduce the heat to medium low and cook for an additional 40 minutes, stirring occasionally, until the onions are well browned.', 'Add balsamic vinegar and cook for 10 minutes more, until onions are completely caramelized. Remove from heat.', '4 Roll out the dough: Preheat the oven to 450\\xc2\\xb0F. Remove the dough from the refrigerator and let stand for 5 minutes before rolling it out.', 'Roll out the dough on a lightly floured surface to a 13-inch diameter. Transfer the crust dough to a cookie sheet lined with parchment paper.', '5 Layer the cheese and onions onto the dough: Place all but a couple tablespoons of the cheese in the center of the dough. Spread to within 1 1/2 inches from the edges. Add the caramelized onions, layering them on top of the cheese. Sprinkle with thyme.', '6 Pleat the edges: Fold the edges of the crust dough over so that a small circle of onion is still showing in the centre of the tart. Sprinkle the remaining cheese over the top of the tart.', '7 Bake: Place in the oven on the middle rack. Bake for 10 minutes at 450\\xc2\\xb0F. Reduce the heat to 350\\xc2\\xb0F and bake for an additional 20-25 minutes, until the crust is golden brown.', 'Remove from oven and let sit for 10 minutes before serving.']",14
473,Purple Potatoes with Caramelized Onions and Shiitake Mushrooms Recipe,10,35,45,"['3 slices of thick style bacon', '1/2 pound new purple potatoes sliced in half and then in small wedges', '1 small yellow onion, thinly sliced lengthwise', '4 medium sized shiitake mushrooms, thinly sliced', 'Extra virgin olive oil', 'Kosher Salt', 'Freshly cracked pepper', '1 pinch red pepper flakes', '1 tablespoon chopped fresh tarragon', '1 tablespoon chopped capers', '1/2 tablespoons unsalted butter']",11,"['1 Start caramelizing the onions: In a small saut\\xc3\\xa9 pan heat one tablespoon of olive oil over a low heat. Add the sliced onions in one even layer, after five minutes add 1/2 tablespoon of butter, stir and add a pinch of kosher salt.', 'While rendering your bacon and cooking your mushrooms in the next steps, make sure to stir the onions every few minutes and remove once they are evenly browned. This should take around 30 minutes, remove from heat when finished and reserve.', '2 Cook the bacon: While the onions are slowly cooking slice the bacon in small batonettes (1/8-inch crosswise strips) on your cutting board. Heat up a larger saut\\xc3\\xa9 pan on medium and when your pan is hot add the sliced bacon.', 'Slowly saut\\xc3\\xa9 the bacon until slightly crispy and remove from the pan onto a paper towel-lined plate, reserve for later.', '3 Cook mushrooms in rendered bacon fat: Julienne the shiitake mushrooms and then add them to the pan which now has the rendered bacon fat.', 'Add a pinch of salt and fresh cracked pepper to the Shiitake mushrooms, don\\xe2\\x80\\x99t shake the pan but let the mushrooms brown evenly on one side.', 'Once browned, flip the mushrooms delicately and remove from pan onto a smaller plate, reserve.', '4 Brown the purple potatoes: Add 2 Tablespoons of olive oil in the pan and add the evenly sliced potatoes to the hot pan in a single layer; make sure not to crowd the pan. Add a pinch of red pepper flakes and a good pinch of salt to the potatoes.', 'Don\\xe2\\x80\\x99t move the pan, this is very important so that the potatoes can evenly brown.', 'After 3-5 minutes, when they are browned flip potatoes and brown the other side, turn down the heat to medium low to evenly cook the potatoes.', '5 Add capers, onions, mushrooms, bacon: Once the potatoes are thoroughly cooked, add the capers and let crisp up for a minute. Then combine the caramelized onions, mushrooms, and bacon to the large saut\\xc3\\xa9 pan with the browned potatoes.', 'Re-warm over low heat. When hot, turn the heat off and garnish with a sprinkle of fresh picked tarragon.']",12
474,Maple-Glazed Chicken with Caramelized Onions and Pears Recipe,15,45,60,"['4 skinless, boneless chicken breasts (1 1/2 to 2 pounds total)', '1 teaspoon salt, divided, plus more to taste', '1/2 teaspoon ground black pepper, divided, plus more to taste', '2 tablespoons olive oil', '2 tablespoons butter', '1 large Spanish or yellow onion, halved and thinly sliced', '2 large ripe firm-fleshed pears (like Bartlett), or 3 smaller pears', '2 tablespoons maple syrup', '1 tablespoon Dijon mustard', '3 tablespoons chopped fresh parsley', 'Special equipment:', '1 large cast iron skillet, or other oven-safe skillet']",12,"['1 Brown the chicken: Heat the oven at 450\\xc2\\xb0F. Sprinkle the chicken with 1/2 teaspoon salt and 1/4 teaspoon pepper.', 'Heat the olive oil in the skillet over medium-high heat. When it is hot, add the chicken and cook without disturbing for 3 to 5 minutes, until the underside is golden. Turn and cook the other sides for 3 to 5 minutes more, until the other side is golden. Transfer chicken to a large plate.', '2 Cook the onion: Melt the butter in the skillet over medium heat. Add the onion, 1/2 teaspoon of salt and 1/4 teaspoon pepper. Cook, stirring often, for 8 minutes, or until the onion starts to brown.', '3 Prep and cook the pears: While the onions cook, peel and core the pears. Cut into quarters (large pears can be cut into 6 pieces.)', 'Move the onions to the center of the pan. Add the pears, cut sides down, around the edge. Cook for 4 minutes or until the pears brown on the bottom. Stir the onions occasionally.', 'Turn the pears and cook the other cut sides for 3 minutes more. Stir the onions occasionally.', '4 Return the chicken to the skillet and glaze: Gently stir the pears and onions together and flatten them slightly to create a bed for the chicken. Place the chicken on top of the pears and onions. Tip in any pan juices from the plate into the skillet.', 'In a small bowl, stir together the maple syrup and mustard. Spread the glaze over the chicken breasts with a spoon.', '5 Bake the chicken: Transfer the skillet to the oven and cook for 20 to 25 minutes, or until the glaze is browned, the pears are tender when pierced, and the chicken is cooked through. A meat thermometer inserted into the thickest part of the breasts should register 165\\xc2\\xb0F.', '6 Serve the chicken: Divide the pears and onions between plates, add a chicken breast, and sprinkle with parsley.']",10
475,Caramelized Onion English Muffin Pizzas Recipe,10,25,35,"['6 English muffin halves', '1 cup grated Mozzarella cheese, packed', '1 tablespoon butter', '1 medium onion, thinly sliced', '3/4 cup diced ham', 'A pinch of chopped fresh sage', '1/4 teaspoon stoneground mustard', 'Optional: A few slices of fresh tomato']",8,"['1 Preheat oven to 425\\xc2\\xb0F.', '2 Cook the onions and ham: Melt butter in a medium skillet on medium high heat. Add the onions and cook until translucent, about 5 minutes. Add the diced ham, cook 5 minutes more. Mix in the sage and mustard. Remove from heat.', '3 Assemble the muffin pizzas: Put muffin halves, open side up on a sturdy baking pan. Distribute the cheese evenly, sprinkling over the muffin halves. Put the onion ham mixture on top of the cheese. If you want to use tomato slices, layer them between the cheese and onion mixture.', '4 Bake: Bake at 425\\xc2\\xb0F for 8-9 minutes, until the muffins and toppings are nicely browned, but not burnt. Cut into quarters for appetizers or just leave whole for a meal or snack.']",4
476,Saut\xc3\xa9ed Chard and Onions with Caraway Recipe,15,20,35,"['3 tablespoons extra virgin olive oil', '2 large onions, sliced 1/4-inch to 1/2-inch wide slices, root to stem', 'Salt', '1 pound chard, center ribs removed, leaves roughly chopped', '1 tablespoon honey', '1 teaspoon caraway seeds', '1/4 teaspoon celery seed', '1/2 teaspoon black pepper', '2 teaspoons sherry or red wine vinegar']",9,"['1 Saut\\xc3\\xa9 onions: Heat the olive oil in a large saut\\xc3\\xa9 pan over high heat until the oil is almost smoking. Add the onions and toss to coat with oil. Saut\\xc3\\xa9 for 10-12 minutes stirring often, until the onions are soft and browned on the edges. Sprinkle with salt while the onions are cooking.', '2 Add chard, once wilted add honey and seasonings: Add the chard to the onions and mix well with tongs.', 'Once the chard wilts, 2 to 4 minutes, add the honey, caraway seeds, celery seeds, and black pepper. Toss well to combine and cook for another 2-3 minutes, stirring often.', 'Add the vinegar right before serving.']",4
477,Cardamom Honey Chicken Recipe,10,75,85,"['Marinade', '4 tablespoons honey', '2 tablespoons sherry', '1 teaspoon cardamom seeds, ground', '1 teaspoon peppercorns, ground', 'Chicken', '4 chicken breasts, skin-on, bone-in (cut in half if large), or one whole chicken, cut into parts', '2 tablespoons extra virgin olive oil', '1 lemon, thinly sliced', 'Salt and pepper']",10,"['1 Marinate the chicken: Warm the honey slightly (in microwave or on stovetop), stir in the sherry, cardamom and peppercorns.', 'Place marinade and chicken in a large bowl, coat chicken with marinade. Cover with plastic wrap and let sit at room temperature for 30 minutes.', '2 Preheat oven to 390\\xc2\\xb0F (200\\xc2\\xb0C).', '3 Sear the chicken pieces: Heat olive oil in a large frying pan at medium heat. Sear the chicken for 20 to 30 seconds, skin side down, until golden. Watch carefully, since the chicken skin goes from browned to charred quickly.', '4 Bake in oven: Place lemon slices in a roasting pan. Lay the chicken pieces on top. Brush with the marinade. Season generously with salt and pepper. Cover loosely with foil.', 'Place in the oven and bake for 25 minutes. Remove foil and continue to bake for 10 to 15 minutes longer or until a thermometer registers 165\\xc2\\xb0F (75\\xc2\\xb0C) when inserted into the thickest part of the chicken.', 'Check often. If the chicken starts to get too dark (this can happen when using honey), tent with foil.', '5 Let rest: Remove from oven and let rest for 10 minutes before serving. Pour out drippings from the pan into a gravy boat for gravy.', '6 Serve with rice, mashed potatoes, or couscous.']",9
478,Pork Roast with Cardamom Mushroom Sauce Recipe,15,1470,1485,"['Brine:', '3/4 cup coarse kosher salt', '3/4 cup sugar', '1 gallon cold water', '1 tablespoon pepper', 'Roast:', '1 1/2 cups chopped onion (about 2 medium sized onions), divided into 3 x 1/2 cups', '6 tablespoons extra virgin olive oil', '2 1/4 teaspoons ground cardamom, divided, 2 and 1/4 teaspoons', '1 large garlic clove', '1 4-pound center-cut boneless pork loin roast', 'Salt and pepper', '1 1/2 pounds mushrooms, sliced', '2 cups chicken broth, divided, 1 cup and 1 cup', '1/2 cup whipping cream', '1 tablespoons all purpose flour', '1 tablespoons butter, room temperature']",17,"['1 Brine the pork roast: Whisk together the salt, sugar, and water until the salt and sugar have completely dissolved. Add the pepper.', 'Submerge pork in the brine solution and chill for 1 to 2 days. Note that thick, gallon-sized freezer bag is great for brining; if you use one, you probably only need half as much brine solution. Even if you are using a bag, place in a bowl just in case the bag leaks.', 'Rinse the roast thoroughly of the brine solution before cooking, pat dry.', '2 Preheat oven to 350\\xc2\\xb0F.', '3 Make onion garlic cardamom rub: Pur\\xc3\\xa9e 1/2 cup chopped onion, 2 Tbsp olive oil, 2 teaspoons ground cardamom, and garlic in a food processor or blender.', '4 Rub roast with onion pur\\xc3\\xa9e, surround with mushrooms and onions in roasting pan: Toss remaining 1 cup of chopped onion with mushrooms and 4 Tbsp olive oil in a bowl. Place pork roast in the center of the roasting pan. Sprinkle the roast with salt and pepper. Rub roast with onion garlic pur\\xc3\\xa9e. Surround the roast with mushrooms and onions.', '5 Roast pork, remove mushrooms, add broth and water: Roast pork 1 hour at 350\\xc2\\xb0F. Remove from oven after one hour and remove the mushrooms, placing them into a large saucepan.', 'Add 1 cup broth and 1/2 cup water to roasting pan.', 'Return roast to oven and roast pork until thermometer inserted into thickest part registers 140\\xc2\\xb0F-145\\xc2\\xb0F, about 15-20 minutes longer. Transfer pork to platter; tent with foil.', '6 Make mushroom cream sauce with pan drippings: Scrape the drippings from the roasting pan into the pan with the mushrooms. Add the cream, remaining cup of broth, and 1/4 teaspoon cardamom to pan; bring to boil. Blend flour and butter in small cup; mix into mushroom sauce.', 'Cook the sauce, stirring often, until reduced enough to coat spoon. Season sauce with salt and pepper; serve with pork.']",11
479,Roasted Baby Carrots Recipe,10,35,45,"['1 1/2 pounds of 5 inch long young carrots, rinsed and scrubbed clean, patted dry, carrot greens cut to 1 inch above top of carrot', '1 medium red onion, halved lengthwise (root to top) then cut into 8-12 wedges (see How to Slice an Onion)', '2 tablespoons extra virgin olive oil', '1 tablespoon fresh chopped rosemary', '2 cloves garlic, peeled and crushed', 'Salt', 'Freshly ground black pepper']",7,"['1 Preheat oven to 400\\xc2\\xb0F. Line a roasting pan with aluminum foil.', '2 Arrange vegetables on pan, coat with olive oil, salt, pepper: Place the carrots, red onion wedges, and crushed garlic cloves on the pan and sprinkle with chopped rosemary. Drizzle with olive oil and toss to combine so that the carrots and onions are lightly coated. Sprinkle with salt and pepper.', '3 Roast: Roast at 400\\xc2\\xb0F for 30 to 40 minutes until well browned and caramelized around the edges.', 'Remove from pan and place in a serving dish to serve.']",4
480,Carrot Cake Cupcakes Recipe,20,20,40,"['1 cup (100 g) chopped walnuts', '1 pound (450 g) carrots (about 3 1/2 cups, grated)', '3 large eggs', '1/2 cup (120 ml) of buttermilk (or add a teaspoon of lemon juice to regular milk and allow to stand for 10 minutes)', '1 teaspoon vanilla extract', '2 cups (400 g) sugar', '1 cup (240 ml) vegetable oil', '1 tablespoon orange zest', '3 cups (400 g) all-purpose flour', '1 teaspoon baking soda', '2 teaspoons baking powder', '1 teaspoon kosher salt', '1/2 teaspoon ground cardamom', '1 teaspoon ground cinnamon', 'Cream Cheese Frosting:', '1 cup unsalted butter, softened', '16 ounces Philadelphia cream cheese', '2 cups powdered sugar, sifted']",18,"['1 Toast the walnuts: Preheat the oven to 350\\xc2\\xb0F. Toast the walnuts in the oven for 5 minutes. Remove from the oven and set aside to cool.', '2 Line 2 standard (12-well) cupcake pans with cupcake liners.', '3 Mix wet ingredients and carrots: Place the buttermilk, oil, sugar, eggs, vanilla extract, and orange zest together in a bowl and whisk thoroughly. Then stir in the grated carrots.', '4 Mix dry ingredients: In another bowl whisk the flour, baking soda, baking powder, salt, cardamom, and cinnamon.', '5 Fold dry ingredients into wet, add walnuts: Fold the flour mixture into the carrot mixture, being sure not to over-mix. Fold in the toasted walnuts until evenly incorporated.', '6 Bake: Scoop the batter into cupcake papers, filling them about 1/2 to 3/4 full. Bake for 19-21 minutes at 350\\xc2\\xb0F, rotating the pan after the first 15 minutes of baking.', 'Cool for 5 minutes before taking the cupcakes out of the cupcake tin and allowing them to fully cool on a wire rack.', '7 Make the frosting: Beat the cream cheese and butter on medium speed until well combined. Sift in the powdered sugar and mix. Spread or pipe onto cooled cupcakes.']",8
481,Classic Corned Beef and Cabbage Recipe,10,240,250,"['For the corned beef', '1 flat-cut corned beef brisket (about 4 pounds)', '1/4 teaspoon mustard seed', '1/4 teaspoon coriander seed', '1/8 teaspoon whole cloves', '1/8 teaspoon whole peppercorns', '2 to 3 bay leaves', '1 large onion, peeled and quartered', '6 Yukon gold potatoes (about 1 pound), halved, or quartered, if large', '1 small head of cabbage (about 1 3/4 pounds), outer tough leaves removed and cut into 6 wedges', '12 slender carrots (about 1 pound), peeled and left whole', '2 teaspoons kosher salt', '2 tablespoons chopped fresh parsley (for garnish)', 'Dijon or grainy mustard (for serving)', 'For the horseradish sauce (Optional)', '1 cup sour cream', '3 tablespoons whole milk', '1 tablespoon lemon juice, or more, to taste', '1 tablespoon prepared horseradish in brine, or more, to taste', '1/2 teaspoon Dijon mustard', '1/4 teaspoon salt', '1/8 teaspoon ground black pepper', '1/4 cup chopped fresh parsley']",23,"['1 Make the horseradish sauce (optional): In a bowl, stir the sour cream and milk together until blended. Stir in the lemon juice, horseradish, and mustard. Add the salt, pepper, and parsley, and taste. Add more horseradish or lemon juice, if you like. Cover and set in the refrigerator until ready to serve.', '2 Preheat the oven: Preheat the oven to 325\\xc2\\xbaF.', '3 Prepare the meat for braising: Discard the spice packet that came with the beef. In a Dutch oven or other large, heavy-bottomed pot, place the brisket, mustard seed, coriander seed, cloves, peppercorns, bay leaves, and onion quarters. Add enough cold water to just cover the meat.', '4 Braise the meat: Over medium heat on the stovetop, bring the water to a boil. Cover the pot and place in the oven for 3 1/2 hours, or until the beef is very tender when pierced with a fork. Remove the meat from the broth with tongs and transfer it to a shallow baking dish or baking sheet.', '5 Brown the meat: Increase the oven temperature to 425\\xc2\\xb0F. Place the corned beef in the oven with a ladle of stock, and bake for 10 to 15 minutes, or until the top browns. Transfer the meat to a cutting board, cover with foil to keep warm, and let rest while you cook the vegetables. Turn off the oven.', '6 Strain the stock, cook the vegetables, and slice the meat: In a fine mesh strainer, strain the stock and return it to the pot. Add the salt. With a ladle, skim the fat that rises to the top. Bring it to a boil.', 'Add the potatoes and adjust the heat to a simmer. Cook for 5 minutes. Add the cabbage wedges and carrots, cover and bring to a simmer again. Cook for 15 to 20 minutes, or until the potatoes, carrots, and cabbage are tender.', 'Transfer them to a deep platter, cover with foil, and keep them warm in the turned-off oven.', '7 Slice and serve the corned beef: Slice the beef across the grain into 1/4-inch thick slices. Transfer them to the platter with the vegetables, and spoon a few ladles of stock over the meat and vegetables. Sprinkle with chopped parsley. Serve with mustard and/or horseradish sauce.']",9
482,"Skillet Chicken Thighs with Potatoes, Carrots, and Greens Recipe",15,45,60,"['8 (3 pounds) bone-in, skin-on, chicken thighs', '1/2 teaspoon salt', '1/8 teaspoon pepper', '2 tablespoons olive oil', '1 1/2 pounds (about 4 medium) Yukon Gold potatoes, cut into 1-inch chunks', '12 ounces baby carrots', '3 whole, unpeeled cloves garlic, smashed with the flat of a knife to break the skin', '1 bunch Swiss chard', '1 1/2 cups chicken stock', '1 tablespoon Dijon mustard', 'Finely grated zest of 1 lemon', '1/2 teaspoon dried thyme', 'Juice of 1/2 lemon', '1/4 cup chopped parsley', 'Special equipment:', 'Large (12- to 13-inch) oven-proof skillet or Dutch oven']",16,"['1 Preheat the oven: Preheat the oven to 400\\xcb\\x9aF.', '2 Trim and season the chicken thighs: With scissors or a sharp knife, cut off excess flaps of skin and fat from the thighs. Sprinkle with salt and pepper on both sides.', '3 Prep the chard stalks and leaves: Tear or cut the stalks from the leaves. Cut the stalks into 1-inch pieces. Slice the leaves into 2-inch-wide strips. Keep the stalks and leaves separate.', '4 Brown the chicken and par-cook the potatoes and carrots: In a large (12- to 13-inch) ovenproof skillet set over medium-high heat, add the oil. Once the oil shimmers, add the chicken with the skin side down. Cook on the skin side only for about 5 minutes without disturbing it, or until the skin lightly browns.', 'Transfer to a plate. (If the chicken doesn\\xe2\\x80\\x99t fit in one skillet, cook in batches or use two smaller skillets and divide the ingredients between them.)', 'Add the potatoes and carrots to the skillet and cook for 5 minutes, or until they brown lightly.', '5 Prep the braising liquid: In a bowl or measuring cup, whisk the chicken stock, mustard, and lemon zest to combine.', '6 Braise the chicken: Add the chard stalks, smashed garlic and braising liquid to the skillet with the vegetables. Set the chicken pieces on top and sprinkle with the thyme.', '7 Transfer to the oven: Transfer the pan to the oven. Roast, uncovered, for 30 minutes, or until the chicken is cooked through and the vegetables are tender. Remove the pan from the oven.', '8 Add the chard leaves: Transfer the chicken thighs to a plate. Taste the broth and add more salt, if you like. Set the skillet over high heat and bring the liquid to a boil. Stir the chard leaves into the skillet and cook for 2 to 3 minutes, or just until wilted. Remove the garlic cloves.', '9 Serve: Set the chicken on top of the vegetables. Squeeze the lemon over the chicken and sprinkle with the parsley. Serve from the skillet, or transfer to a large serving platter. Serve as is, or with a salad.']",11
483,Easy Breakfast Casserole with Prosciutto Recipe,25,45,70,"['1 tablespoon extra-virgin olive oil', '1 medium yellow onion, chopped', '2 big handfuls tender greens, such as arugula, dandelion greens, baby kale, or spinach (tough stems removed)', '1 1/2 cups asparagus, cut into 3/4-inch pieces', '1 teaspoon kosher salt, divided', '3 ounces thinly sliced prosciutto', '2 packed cups cubed crusty bread, such as levain, baguette, or Italian bread (slightly stale is ok)', '8 large eggs', '1 cup low fat cottage cheese', '1 cup 2% milk (or whatever kind you have in the fridge)', 'Freshly ground black pepper', '1 1/2 cups (3 oz) grated cheddar, divided']",12,"['1 Preheat the oven to 350\\xc2\\xb0F.', '2 Saut\\xc3\\xa9 the vegetables: Add oil to a 12-inch ovenproof skillet set over medium heat. I use cast iron, but any ovenproof skillet will do.', 'Add the onion and saut\\xc3\\xa9 until tender, about 5 minutes. Add the greens, asparagus, and 1/2 teaspoon salt and saut\\xc3\\xa9 until the greens wilt, about 2 minutes. Remove from heat.', '3 Add the prosciutto and bread: Tear the prosciutto slices into smaller pieces and distribute over the vegetables. Add the bread and stir everything together. Leave that to cool while you whisk the eggs.', '4 Whisk the eggs: In a large bowl, whisk together the eggs, cottage cheese, milk, the remaining 3/4 teaspoon salt, and several generous grinds of black pepper. Add 1/2 cup of the cheese and stir again. Pour the eggs over the vegetables and scatter the remaining cheese on top.', '5 Bake the casserole: Place the casserole in the oven and bake until it is just set with no obvious liquid remaining, about 35 minutes. It should be a little jiggly. Keep in mind that it will continue to cook a bit once it\\xe2\\x80\\x99s out of the oven.', '6 Serve: Cool for 10 minutes. Cut into wedges and serve.']",7
484,Mexican Lasagna Recipe,45,45,90,"['Extra virgin olive oil', '1 1/4 pounds ground beef or ground turkey', '1 teaspoon salt', '1 tablespoon chili powder', '1 tablespoon ground cumin', '1 tablespoon ground coriander seeds', '1/4 teaspoon cayenne', '1 14-oz can refried pinto beans (or you can make your own refried beans)', '2 medium onions, chopped (about 2 1/2 cups)', '1 red bell pepper, stem and seeds removed, chopped (about 1 cup)', '3 garlic cloves, peeled and minced', '1 28-oz can crushed or diced tomatoes, preferably ""Fire Roasted""', '1 7-oz can diced green Anaheim chiles', '1/2 teaspoon dried oregano', '12 (6-inch) corn tortillas (choose sturdy tortillas mad with yellow corn)', '2 cups coarsely grated Monterey Jack cheese (about 8 oz)', '2 cups coarsely grated mild cheddar cheese (about 8 oz)', 'To serve:', 'Sour cream', 'Avocado', 'Cilantro', 'Iceberg lettuce']",22,"['1 Brown the ground beef: Heat 2 tablespoons olive oil in a large saut\\xc3\\xa9 pan or cast iron frying pan on medium high heat. Add the ground meat, breaking it up as you add it.', 'Sprinkle with salt. Sprinkle on the chile powder, cayenne, cumin, and coriander. Increase the heat to high. Add another 2 tablespoons of olive oil.', 'Do not stir the meat unnecessarily. Allow the meat to brown on one side, and then stir it so the other side can be browned.', 'As soon as the meat is browned, remove the pan from the burner. The meat will continue to cook in the heat of the pan.', 'Once you are sure that the meat is cooked through, use a slotted spoon to remove the meat from the pan to a bowl. Set aside.', '2 Saut\\xc3\\xa9 onions, bell peppers, garlic, add tomatoes, chiles, oregano: Add another tablespoon of olive oil to the empty pan used to cook the meat and set over medium heat.', 'Add the onions and chopped bell peppers. Cook until onions have softened, about 5 minutes. Add the garlic, cook for an additional 1 minute.', 'Add the diced tomatoes, green chiles and oregano. Bring to a simmer. Simmer gently for 15-20 minutes while you prepare the tortillas.', '3 Cook the tortillas: While the sauce is simmering, soften the tortillas by frying them in a little oil. In a 9-inch skillet, heat 1/2 cup olive oil on medium high heat until it is sizzling hot, but not smoking.', ""Cook the tortillas one at a time, for 5 seconds on each side, so that they soften, but don\\'t get crisp."", 'Remove the tortillas with a metal spatula or tongs and place on a plate lined with paper towels to soak up the excess oil.', '4 Preheat oven: Preheat oven to 350\\xc2\\xb0F and lightly oil a 9x13-inch glass or ceramic baking dish.', '5 Assemble the casserole: In baking dish, arrange 4 tortillas in one layer, overlapping slightly (tortillas will not cover bottom completely).', ""(If you don\\'t have time to pre-soften the tortillas, coat the bottom of the pan with some olive oil and spread a little sauce over the bottom before adding the tortillas.)"", 'Spread half of bean mixture evenly over tortillas in dish and top with half of meat mixture. Sprinkle one third cheese over the meat and spread half of the sauce over the cheese.', 'Repeat layering of tortillas, beans, meat, cheese, and sauce and top with remaining 4 tortillas. Sprinkle remaining cheese over tortillas.', '6 Bake: Bake casserole on the middle rack in the oven at 350\\xc2\\xb0F for 35 minutes, until the casserole is heated through and the cheese is completely melted and bubbling.', '7 Cool and serve: Let the casserole stand for 10-15 minutes before serving.', 'Serve with sour cream, chopped avocado, chopped cilantro, and thinly sliced iceberg lettuce on which has been sprinkled vinegar and salt.']",19
485,Sweet Potato Casserole with Marshmallows Recipe,15,45,60,"['8 sweet potatoes (about 4 pounds)', '1/4 cup plus 1 tablespoon unsalted butter, softened at room temperature', 'Finely grated zest of 1 orange', '1/2 cup fresh-squeezed orange juice', '1/2 teaspoon salt', '1/8 teaspoon pepper', '4 cups large marshmallows (about 12 ounces), cut in half with scissors']",7,"['1 Roast the sweet potatoes: Preheat the oven to 425\\xc2\\xbaF. Line a baking sheet with parchment and spray it with vegetable oil spray.', 'Scrub clean and dry the sweet potatoes. Slice them in half lengthwise.', 'Place the potato halves, cut side down, on the baking sheet. Prick each in several places with a fork and bake for 40 to 45 minutes, or until soft. Remove and let rest until potatoes are cool enough to handle.', '2 Lower the oven temperature to 375\\xc2\\xbaF. Butter or coat with cooking spray a 3-quart or 9-x13-inch baking dish.', '3 Remove the sweet potato skins: As soon as the potatoes are cool enough to handle, pull off the skins and discard. Transfer the inner flesh to the bowl of a stand mixer bowl fitted with the paddle attachment, or a large bowl.', '4 Mash the potatoes: Add 1/4 cup of the butter, orange zest, orange juice, salt and pepper. Mix on low speed in the stand mixer until the potatoes are creamy, but not necessarily perfectly smooth. Taste and add more salt and pepper, if you like. Transfer the potatoes to the buttered baking dish.', 'Alternatively, mash with a potato masher and beat until creamy with a wooden spoon, then transfer to the baking dish.', '4 Bake the casserole: Dot the top of the casserole with the remaining 1 tablespoon of butter. Cover loosely with foil and bake for 30 to 35 minutes, or until hot.', '5 Add the marshmallows: Place the marshmallows close together in a random pattern over the potatoes. Return the casserole to the oven and bake for 5 to 7 minutes, or until the marshmallows melt and brown.', '6 Serve: Cool the casserole briefly and serve while hot. Leftovers can be refrigerated for up to 5 days.']",10
486,Creamy Baked Mac and Cheese Recipe,20,25,45,"['For the topping:', '2 tablespoons melted unsalted butter', '2/3 cup plain panko breadcrumbs', '1/4 cup shredded Parmesan', '1/4 teaspoon salt', '1/8 teaspoon smoked paprika', 'Pinch cayenne pepper', 'For the macaroni:', '10 ounces elbow macaroni pasta or cavatappi', '1 tablespoon kosher salt', '1 tablespoon unsalted butter', 'For the sauce:', '4 ounces cream cheese', '10-ounce brick of cheddar cheese, shredded (about 3 cups thickly shredded cheddar cheese)', '2 1/2 cups whole milk', '1/2 teaspoon white pepper', '1/2 teaspoon kosher salt', '1/2 teaspoon mustard powder', '1/4 teaspoon turmeric powder', 'Garnish:', 'Minced parsley or chives (optional)']",21,"['1 Prepare the pan and heat the oven: Butter an 8x8 pan and set aside. Preheat the oven to 350\\xc2\\xb0F.', '2 Make the topping: In a small bowl, melt 2 tablespoons of butter. Add panko, Parmesan, salt, smoked paprika, and cayenne pepper. Set aside.', '3 Boil the pasta: Bring a pot of water to a boil over medium high heat. Add the macaroni and salt. Cook until the pasta is firm-tender, or al dente. Usually, this takes about a minute or two less than the cook time recommended on the box.', '4 Drain and butter the pasta: Drain the pasta into a colander. Add 1 tablespoon butter to the same pot you boiled the pasta in. Add the drained pasta back to the pan and stir to coat. Remove from heat. You\\xe2\\x80\\x99ll get back to it later.', '5 Make the sauce: In a large, high sided skillet set over medium heat, add the cream cheese, 1 cup of milk, and all of the spices. Break apart and smash the cream cheese with a spatula as it begins to soften and melt. Once the cream cheese is in pieces the size of a nickel or smaller, whisk the mixture until it\\xe2\\x80\\x99s homogeneous and thickened, about 4 to 5 minutes.', '6 Add the remaining milk and cheddar cheese: Whisk the remaining 1 1/2 cups of milk into the sauce. Add the cheddar cheese one cup at a time, whisking continuously. Make sure each cup is incorporated before adding the next.', '7 Add the pasta to the sauce: Once the sauce is thick like heavy whipping cream and homogeneous, add the pasta. Stir to coat. It will look soupy. That\\xe2\\x80\\x99s what you want. Transfer the mixture to the buttered 8x8 pan. Smooth the top.', '8 Top with panko and bake: Sprinkle the panko mixture over the top of the mac and cheese. Place in oven for 20 to 25 minutes until the top is golden brown and the cheese sauce is bubbling around the edges. Cool briefly before serving.']",8
487,Turkey Tetrazzini Recipe,20,75,95,"['12 ounces mushrooms, sliced (about 4-5 cups)', '8 Tbsp unsalted butter, divided 3 Tbsp, 4 Tbsp, and 1 Tbsp', '1/4 cup all-purpose flour', '12 oz egg noodles, spaghetti, linguini or other pasta', '1 1/2 cups of milk', '1/4 cup whipping cream', '2 cups chicken broth', '1/4 cup dry sherry (or vermouth or dry white wine)', '3 cups coarsely chopped cooked turkey', '1 cup peas', '2/3 cup freshly grated Parmesan (divided into 1/3 and 1/3 cups)', '1/3 cup shredded Swiss cheese', '2 Tbsp lemon juice', 'Salt and Pepper', 'Ground nutmeg (optional)', '1/3 cup fine fresh bread crumbs (or panko)', 'Freshly chopped parsley for garnish (optional)']",17,"['1 Preheat oven and heat water for pasta: Preheat oven to 375\\xc2\\xb0F. Start heating 2 to 3 quarts of water for the pasta. Add 1 teaspoon of salt for each quart of water.', '2 Saut\\xc3\\xa9 mushrooms: Cook the mushrooms in 3 Tbsp of the butter over medium-high heat, stirring, until all of the liquid the mushrooms give off has evaporated, 5-7 minutes. Set aside.', '3 Make a roux with flour and butter: In a large, heavy saucepan, melt 4 Tbsp of butter. Stir in the flour, and cook the mixture over low heat, stirring, for 3 minutes.', ""4 Add pasta to boiling water: About now, put the pasta into the boiling water you've heated. Follow the package directions and cook until al dente. While the pasta is cooking continue on with the recipe."", '5 Make the sauce: Into the saucepan with the butter and flour, slowly whisk in the milk, cream, chicken broth, and the sherry. Bring to a simmer and cook over medium-low heat, stirring constantly, for about 5 to 8 minutes.', '6 Assemble the casserole: When the pasta is ready, drain it. In a large bowl combine the pasta, the sauce, the mushrooms, the turkey, and the peas. Stir in 1/3 cup of the Parmesan and the 1/3 cup of Swiss cheese. Stir in the lemon juice. Add salt and pepper to taste.', 'Note that if you have been using unsalted butter, and/or unsalted or low sodium stock, you will need to add more salt than you might expect. Just keep sprinkling it in until it is seasoned to your taste.', 'Add a pinch of ground nutmeg if using, again to taste. Transfer the mixture to a buttered 3-quart casserole.', '7 Make breadcrumb Parmesan topping: In a small bowl combine well the remaining 1/3 cup Parmesan and the breadcrumbs. Sprinkle the mixture evenly over the tetrazzini, and dot the top with the remaining 1 tablespoon butter, cut into bits.', '8 Bake: Bake the Tetrazzini at 375\\xc2\\xb0F in the middle rack of the oven for 30 to 40 minutes, or until it is bubbling and the top is golden.', 'Garnish individual servings with chopped parsley.']",11
488,Vegetarian Spinach and Mushroom Lasagna Recipe,20,105,125,"['For the sauce:', '1 1/2 pound cremini mushrooms, roughly chopped', '1/2 pound shiitake mushrooms, roughly chopped', 'Salt', '1 generous cup chopped onions', '1/4 cup extra virgin olive oil plus more for keeping the noodles from sticking to each other', '4 cloves garlic, chopped (about 4 teaspoons)', '1 (6-ounce) can tomato paste', '2 cups tomato sauce', '1 (28-ounce) can crushed tomatoes (such as Muir Glen with basil)', '1 cup water', '1 tablespoon dried thyme', '1/2 teaspoon red pepper flakes', '1 tablespoon sugar', 'For the lasagna:', '2 (10-ounce) boxes frozen chopped spinach, thawed and squeezed in clean towel of excess moisture', '1 pound lasagna noodles (16 to 20 noodles)', '1 (15-or-16-ounce) container of ricotta cheese', '1/4 cup chopped fresh basil', '1/4 pound pecorino cheese (or Parmesan), grated (about 1 cup)', '1 pound shredded mozzarella cheese (about 4 cups)', 'Special equipment:', ' 1 large casserole pan, preferably 10x15-inches']",23,"['Once the mushrooms start to release water into the pan, stir in the chopped onions. Cook until the mushrooms are no longer releasing moisture and the mushroom water has boiled away, about 5 minutes more.', '2 Make the sauce: Add the olive oil to the mushrooms and stir to coat. Saut\\xc3\\xa9 the mushrooms and onions for about a minute. Add the garlic and cook for another minute.', 'Stir in the tomato paste, cook for a minute longer. Reserve 1 cup of the tomato sauce (it will go in the bottom of the casserole dish), and put the remaining cup of tomato sauce into the pot with the mushrooms.  Add the large can of crushed tomatoes and one cup of water.', 'Stir in the thyme, sugar, and red pepper flakes. (If you are using dried basil instead of fresh, add it now.) Bring to a simmer, then lower the heat and simmer on a low simmer, for 20 minutes.', '3 Boil and drain the lasagna noodles: Once the sauce is simmering, salt the boiling pasta water, and add the dry lasagna noodles to the boiling water.  (The water should be at a vigorous, rolling boil.) Stir gently, making sure that the noodles are not sticking to each other. Set the timer for 8 minutes, or however long is indicated on the package of the noodles. Cook uncovered on a high boil.', ""When the noodles are ready (al dente, cooked through but still firm to the bite), drain the noodles in a colander, and rinse them to cool them with cold water.  As you rinse them, gently separate them with your fingers so they don\\'t stick to each other."", 'Prepare a couple large cookie sheets or baking sheets by spreading a tablespoon of olive oil over the baking sheets.', 'Place the lasagna noodles on the sheets, gently coating them with a bit of that olive oil, and spreading them out. This will help keep them from sticking to each other while you finish the sauce and prepare the layered casserole.', '4 Assemble the lasagna: Turn off the heat on the stovetop for the sauce. Preheat the oven to 350\\xc2\\xb0F.', 'Spread the one cup of reserved tomato sauce over the bottom of a large (preferably 10x15-inch) casserole dish. (If your casserole dish is smaller, you may need to add another layer as you go through this step.)', 'Place a layer of lasagna noodles down over the tomato sauce, slightly overlapping. (For our 10x15-inch dish, we ultimately fit 3 layers of 6 noodles each, with 2 extra noodles on which to nosh.)', 'Sprinkle half of the ricotta cheese over the noodles, and half of the defrosted, drained, and squeezed out spinach over the ricotta.', 'Sprinkle half of the mozzarella cheese over the spinach, and just a quarter of the pecorino cheese.', 'Then spoon 1/3 of your mushroom sauce over the mozzarella. Sprinkle half of the fresh basil over the sauce.', '5 Repeat layers: Repeat the layering process. Place a second layer of noodles over the sauce. Spread the remaining ricotta, spinach, and mozzarella over the noodles. Sprinkle another quarter of the pecorino along with the mozzarella. Top with another third of the mushroom sauce and the remaining fresh basil.', 'Layer your final layer of lasagna noodles over the sauce. Spread the remaining sauce over the lasagna noodles, and sprinkle with the remaining pecorino or parmesan cheese.', '6 Cover with foil and bake: Pull out a sheet of aluminum foil large enough to cover the casserole dish. Spread a little olive oil over the inside of the piece of foil (the side that will have contact with the lasagna). Place the foil over the casserole dish and crimp the edges.', 'Bake at 350\\xc2\\xb0F for 25 minutes, then remove the foil and bake uncovered for an additional 25 minutes.', 'Take the lasagna out of the oven when done and let it rest 10 minutes before cutting to serve. Once made, the lasagna will last a week in the fridge.']",19
489,Pastel\xc3\xb3n (Puerto Rican Plantain \xe2\x80\x9cLasagna\xe2\x80\x9d) Recipe,30,30,60,"['4 ripe plantains, about 3 to 3 1/4 pounds', '1/2 cup vegetable oil', '1 pound ground beef (preferably ground round) or ground turkey', '1 teaspoon adobo seasoning blend', '1 1/2 teaspoons saz\\xc3\\xb3n flavoring blend, store-bought or homemade, optional', '1 small white onion, minced (about 1 cup)', '1 green bell pepper, minced (about 1 cup)', '1 tablespoon recaito flavoring base (store-bought or homemade), or 2 tablespoons chopped cilantro', '6 pimento-stuffed green olives, sliced', '1 teaspoon capers', '1 teaspoon dried oregano', '1 cup tomato sauce', '2 cups Monterey jack, cheddar, or mozzarella cheese, divided', '2 large eggs', '1/2 teaspoon baking soda']",15,"['1 Preheat the oven to 350\\xc2\\xb0F. Lightly grease a 10x10 casserole dish (for a thicker pastel\\xc3\\xb3n) or 9x13 casserole dish (for a thinner pastel\\xc3\\xb3n) with nonstick cooking spray or butter.', '2 Prepare the plantains: Cut off both ends from the plantain, then use the tip of your knife to cut a slit down the back. Using your two thumbs, remove the peel from the plantain and discard the peel.', 'Once you\\xe2\\x80\\x99ve peeled all the plantains, slice each one in half down the length. Separate the two halves and flip them onto their flat sides to create a stable base. Place your palm flat on top of the plantain, and use a sharp knife to slice parallel to the cutting board and cut the plantains into very thin slices (about 1/4-inch thick). Set aside.', '(Alternatively, you can use a mandoline to slice the plantains thinly, but be careful because the plantains are soft and the mandoline is sharp!)', '  3 Fry the plantains: In a large skillet, heat the vegetable oil to 300\\xc2\\xb0F over medium heat (check the temperature with a candy thermometer or instant-read thermometer). Line a plate with paper towels to drain the plantains after frying, and set next to the stove.', 'Place four or five slices of plantains into the oil and fry for about 1 1/2 minutes on each side, or until the plantains have a browned slightly. Remove from the skillet to the paper-lined plate to drain. Continue frying the remaining plantains.', '4 Cook the beef: Drain all but 1 tablespoon of oil from the pan you used to fry the plantains. Return the pan to the stove and heat over medium-high heat. Add the ground beef and season with the adobo and saz\\xc3\\xb3n.', 'Continue to cook the meat, breaking it up into crumbles, for 6 minutes or until browned. Drain the meat by pouring it into a colander, but leave a bit of the grease in the pan to cook the vegetables.', '5 Cook the vegetables: Return the empty pan to the heat and cook the onions, bell pepper, and recaito for 3 minutes or until glossy. Add the olives, capers, and dried oregano, and cook for 2 more minutes.', '6 Finish the filling: Return the ground beef to the pan with the vegetables, along with the tomato sauce, and then stir to combine. Bring the mixture to a simmer, then remove the pan from the heat.', '7 Assemble the pastel\\xc3\\xb3n: Cover the bottom of the casserole dish with a single layer of the fried plantain strips. Spoon a 1-inch layer of the ground beef mixture onto the plantains. Top with 1/2 cup of shredded cheese. Repeat with another layer of plantains, meat, and cheese (reserve the remaining 1 cup of cheese). Top with a final layer of plantains.', '   8 Add the egg layer: In a small bowl, whisk together the eggs and baking soda until frothy. Pour this mixture over the plantains.', '9 Bake the pastel\\xc3\\xb3n, uncovered, for 25 minutes. Remove from the oven and top with the remaining cup of cheese. Return the dish to the oven and cook for an additional five minutes, until the cheese has melted.', '10 Cool and serve: Remove the pastel\\xc3\\xb3n from the oven. Allow it to cool for at least fifteen minutes before slicing and serving, which helps it maintain its shape when sliced.', 'Leftovers can be stored, covered, in the refrigerator for up to three days. To reheat, cut a portion and place either in the microwave or the oven until warmed through.']",15
490,Green Bean Casserole from Scratch Recipe,45,20,65,"['For the fried onions:', '1 red onion, thinly sliced', '1 1/2 cup buttermilk', '1 cup all-purpose flour', '1 cup Panko crumbs', '2 tablespoon mixed dried herbs - parsley, dill, thyme, whatever you want!', 'Salt, for seasoning', 'Vegetable oil, for frying', 'For the casserole:', '2 pounds green beans, trimmed and cut into 2-inch lengths', '1/4 cup (1/2 stick) regular salted butter', '1 pound crimini or button mushrooms, trimmed and sliced', '3 cloves garlic, minced', '2 teaspoons fresh thyme (or 1 teaspoon dried thyme)', '2 to 3 tablespoons all-purpose flour', '1 1/4 cup half-and-half', '1 1/4 cup low sodium chicken broth', '1/2 cup grated Parmesan cheese']",18,"['1 Prepare the onions for frying: In a bowl, combine the sliced red onions and the buttermilk. Toss to coat the onions, then place them in the fridge for at least 15 minutes.', 'In another small bowl, whisk together flour, panko, and dried mixed herbs.', '2 Heat the oil for deep-frying: Fill a Dutch oven or other deep pot with about 2 inches of vegetable oil, and heat to 375F, or until shimmering but not smoking (lower the heat if you start to see wisps of smoke). To check that the oil is hot enough, toss in a pinch of panko mixture; if it starts to bubble and fry, you\\xe2\\x80\\x99re ready to go.', 'Set a baking sheet lined with paper towels near the stove to drain the fried onions.', '3 Deep-fry the onions: Working in handfuls, lift the onions from the buttermilk and toss them in the flour/panko mixture.', 'Gently lower the coated onions into the hot oil and fry until deep golden brown. Lift the onions from the oil with a heat-proof slotted spoon or tongs, and place on the paper towels to drain.', '4 Preheat the oven to 375F. Set a strainer over your sink and prepare a bowl with ice water.', '5 Blanch the green beans: Bring a large pot of salted water to a boil. Add the green beans and boil for 5 to 6 minutes until just tender, but still slightly crisp.', 'Drain and then shock the green beans in the bowl of cold water to stop the cooking process. When cool, drain again and set aside.', '6 Cook the mushrooms: Melt the butter in a large skillet and add in the mushrooms. Season with salt and cook until softened and tender. Add in the garlic and thyme.', '7 Make the creamy sauce: Sprinkle the flour over the mushrooms and stir until the mushrooms are coated. Stir in the half-and-half and the chicken broth.', 'Bring the mixture to a simmer and allow the sauce to thicken. Stir in the Parmesan cheese and green beans.', '8 Assemble and bake the casserole: Transfer the creamy green bean and mushroom mixture to a 3-quart or 9x13 casserole dish. Scatter the fried onions over top, and bake in the oven for 15 to 20 minutes, until the casserole is bubbling. Serve hot.']",13
491,Cheesy Funeral Potatoes From Scratch Recipe,35,45,80,"['1 1/2 pounds Russet potatoes (about 3 large or 4 small potatoes)', '8 tablespoons of butter, divided', '1/2 large onion, finely chopped (about a cup)', '1/3 red bell pepper, finely chopped (about a 1/2 cup)', '2 cups homemade cream of chicken soup (store-bought will also work)', '2 cups shredded mild cheddar cheese', '1 cup sour cream', '1 1/4 teaspoon salt, divided', '1 teaspoon fresh ground black pepper', '1 1/2  cups panko bread crumbs']",10,"['1 Preheat the oven to 350\\xc2\\xb0F. Butter an 8x8 baking dish.', '2 Parboil the potatoes: Scrub the potatoes clean, but leave the skins on. Place them in a large pot and cover with water. Bring to a boil. Allow to boil for about 10 minutes.', 'Turn off heat and let the potatoes sit in the hot water for another 10 minutes. When ready, you should be able to pierce the potatoes with a fork, but still feel slight resistance. Drain the potatoes and set aside until cool enough to handle.', 'If making the potatoes ahead, cool to room temp, cover, and store in fridge for up to 3 days.', '3 Meanwhile, cook the onions and peppers: In a medium skillet, melt 5 tablespoons butter, cook the onions and bell pepper until the onions are soft and translucent, about 6 minutes. Set aside.', '4 Peel and shred the potatoes: Once the potatoes are cool enough to handle, score them along their equator with a paring knife. Twist each side in opposite directions to remove skin. The skin should pull off easily. If any bits of skin remain, trim them off with a knife.', 'Shred the potatoes using a food processor fitted with the shredder disk, or shred them by hand using the large holes on a cheese grater.', '5 Assemble the casserole: Transfer shredded potatoes to a large bowl, and mix with the cooked onions, pepper, cream of chicken soup, cheddar cheese, sour cream, 1 teaspoon of salt, and pepper.', 'Stir until thoroughly combined. Spread into casserole dish.', '6 Toast the breadcrumbs: In the same pan where you cooked the onions, melt remaining 3 tablespoons of butter over medium heat. Add the panko and remaining 1/4 teaspoon of salt. Stir to coat.', 'Toast panko, stirring frequently, until it takes on a golden hue, about 5 minutes. Sprinkle evenly over the top of the potatoes.', '7 Bake at 350\\xc2\\xb0F for 45 minutes. When done, the potatoes should be bubbling around the edges, and the panko top will be golden.  ', '8 Cool for 10 minutes, then spoon onto plates.  ']",13
492,Salsa Verde Chicken Bake Recipe,5,30,35,"['1 1/4 to 1 1/2 pounds boneless skinless chicken breasts', '1 3/4 cups (1 15-ounce jar) tomatillo salsa verde', '4 ounces grated Monterey jack and/or pepper jack cheese', '1/2 cup chopped fresh cilantro (optional)']",4,"['1 Preheat oven to 350\\xc2\\xb0F.', '2 Cut chicken breasts and line baking dish with them: Cut the chicken breasts into halves.', 'Line a 1 1/2 to 2 quart casserole baking dish with the chicken pieces. Try to cover the bottom as completely as you can with the chicken.', '3 Cover the chicken pieces with the salsa verde. Cover completely, there should be no exposed chicken or it will dry out.', '4 Bake in a 350\\xc2\\xb0F oven for 25-30 minutes. If you have a meat thermometer, use it. The chicken should be removed from the oven when the internal temperature of the breast meat reaches 150\\xc2\\xb0F.', '5 Sprinkle cheese over the chicken, increase the oven heat to 400\\xc2\\xb0F and return to the oven for another 5-10 minutes, enough time for the cheese to melt and the sauce to get bubbly.', 'Remove from oven. Serve immediately. Spoon over cooked rice or quinoa. Sprinkle with chopped fresh cilantro. Serve with tortilla chips for crunch if you would like.']",7
493,Chicken with Creamy Cassis Sauce Recipe,5,20,25,"['4 boneless, skinless chicken breast halves or cutlets (about 1 1/4 pounds)', '1/3 cup flour', 'Salt', 'Freshly ground black pepper', '2 tablespoons extra virgin olive oil', '1/3 cup dry white wine', '1/4 cup cr\\xc3\\xa8me de cassis (or a teaspoon of Dijon)', '1/4 cup heavy cream', '2 tablespoons unsalted butter']",9,"['1 Dredge chicken: Rinse the chicken breasts and pat dry with paper towels. Dredge them in flour, shake off the excess flour and season with salt and pepper.', '2 Brown chicken on both sides: Heat oil in a large skillet on medium high. Place the chicken breasts in the skillet and cook, turning once, until both sides are golden brown and the chicken is just cooked through, about 10 minutes.', 'Transfer the chicken to a platter, cover with foil to keep warm.', '3 Make sauce: Discard excess fat in the skillet. Add the wine and deglaze, scraping up the browned bits. Boil the wine down for half a minute, add the cr\\xc3\\xa8me de cassis and the cream.', 'Continue to boil down the mixture until it is reduced by a third. Whisk in the butter. Add salt and pepper and spoon over chicken breasts to serve.']",5
494,Roasted Cauliflower Recipe,10,30,40,"['1 head cauliflower, cut into florets', '2 to 3 cloves garlic, peeled and chopped', '1 tablespoon lemon juice (or about half a lemon)', 'Extra virgin olive oil', 'Coarse salt and freshly ground black pepper', 'Freshly grated Parmesan cheese']",6,"['1 Preheat oven, prepare pan: Preheat oven to 400\\xc2\\xb0F (205\\xc2\\xb0C). Lightly oil a large roasting pan or baking sheet, or line with aluminum foil.', '2 Prep the cauliflower:  Place the cauliflower florets in a bowl. Toss with minced garlic. Sprinkle with lemon juice. Drizzle with olive oil and toss so that the florets are lightly coated with oil.', '3 Spread on roasting pan and sprinkle with salt and pepper: Spread the florets out into a single layer on the roasting pan. Sprinkle with salt and pepper.', '4 Roast until lightly browned: Roast the cauliflower at 400\\xc2\\xb0F (205\\xc2\\xb0C), uncovered, for 25 to 30 minutes, or until the tops are lightly brown. Use a fork to test for doneness; the tines should easily pierce the cauliflower when done.', '5 Sprinkle with Parmesan: Remove the cauliflower from the oven and sprinkle generously with Parmesan cheese. Serve immediately.']",5
495,Simple Cauliflower Soup Recipe,10,15,25,"['Florets from one head of cauliflower (See How to Cut and Core Cauliflower)', '1 quart of water', 'Salt', 'Unsalted butter', 'Chives', 'Extra virgin olive oil']",6,"['1 Cook cauliflower florets in salted water: Bring 1 quart of water to a rolling boil in a medium-sized pot. Add 2 teaspoons of salt to the water.', 'Add the cauliflower florets, and cook until cooked through, about 4 minutes. Use a slotted spoon to remove florets to a bowl. Reserve cooking water.', '2 Pur\\xc3\\xa9e cooked cauliflower: Working in batches, fill a blender half-way with cooked cauliflower, add enough cooking water to the blender bowl so that it comes up a quarter of the way. Pur\\xc3\\xa9e until smooth. You want the consistency to be that of soup, so if you need to add more water, do so.', '3 Add salt and butter: or each blender batch, add salt and butter to taste (about 1/2 teaspoon of salt, and about a tablespoon or more of butter for each blender batch). Since you are using only lightly salted cooking water for a base, not stock, you will need to salt this more than you would otherwise.', '4 Serve: Serve immediately into bowls. Drizzle olive oil over the top and sprinkle with chopped chives.']",5
496,Cauliflower Pasta Bake Recipe,20,60,80,"['For the pasta:', '1 large head cauliflower', '3 tablespoons olive oil', '1 medium yellow onion', '3/4 teaspoon salt', '1/4 teaspoon ground black pepper', '1/2 pound pasta, such as shells, pipe rigate, or rigatoni', '1/2 cup (1 1/2 ounces) finely grated Parmesan', '1 cup milk, whole or 2%', 'Zest from one lemon (about 1 tablespoon zest)', '2 tablespoons chopped thyme leaves', '3 cups (8 ounces) grated Gouda', 'For the cracker topping:', '14 (1 small sleeve) Ritz crackers, or similar buttery crackers', '2 tablespoons finely grated Parmesan', '2 tablespoons melted butter', '2 tablespoons chopped fresh parsley', 'Special equipment:', '3-quart or 4-quart baking dish (a 9x13 baking dish works great)']",19,"['1 Preheat the oven to 425\\xc2\\xbaF. Place one rack in the top third of the oven and one rack in the lower third.', '2 Prepare the cauliflower and the onions: Trim away the outer leaves and cut the cauliflower into slices roughly 1/4-inch thick. Some smaller florets will fall away; this is fine.', 'Spread the cauliflower slices and any florets that have fallen off on a rimmed baking sheet. Drizzle with 2 tablespoons of the oil. Using your hands, rub the oil into the cauliflower, coating both sides. Sprinkle with 1/2 teaspoon salt and 1/4 teaspoon pepper.', 'Roughly chop the onion. On a second baking sheet or in an ovenproof skillet, toss the onions with the remaining 1 tablespoon of the oil and sprinkle with 1/4 teaspoon salt.', '(Roasting the cauliflower and onions on separate pans will give them more space and help them roast better.)', '3 Roast the cauliflower and onions: Place the cauliflower on the lower rack of the oven and the onions on the top rack. Roast for 25 to 30 minutes, until both are tender and golden. Flip the cauliflower once during roasting; stir the onions occasionally. Remove the onions from the oven if they finish before the cauliflower or start to burn.', 'Let the vegetables cool slightly in their pans. Break the cauliflower into smaller florets.', '4 Lower the oven temperature to 375\\xc2\\xbaF for baking the pasta.', '5 While the vegetables roast, cook the pasta: Bring a large pot of salted water to a boil. Add the pasta to the boiling water and cook for 8 to 10 minutes, or until al dente (do not overcook or the pasta will become mushy after baking). Scoop out and reserve 1 cup of the pasta cooking water.', 'Drain the pasta in a colander.', '6 Assemble the casserole: Return the drained pasta to the pot and immediately stir in 1/2 cup of Parmesan while the pasta is still hot. Once the cheese has melted and absorbed into the pasta a little, stir in the milk.', 'Add the roasted cauliflower and onion, lemon zest, thyme and Gouda, and stir well. Taste and add more salt and pepper, if you like. If the mixture seems dry, add a little pasta cooking water, a tablespoon at a time.', 'Transfer to a 3- or 4-quart baking dish.', '7 Top with the crispy cracker crumbs: Place the crackers in a zip-top bag and crush with a rolling pin until coarsely crumbled.', 'In a bowl, mix the crushed crackers with 2 tablespoons Parmesan, the melted butter and parsley. Sprinkle this evenly over the pasta.', '8 Bake the pasta: Bake for 35 to 40 minutes, or until the pasta is hot and the top is golden.', '9 Cool briefly and serve. Leftovers can be refrigerated for up to 5 days and reheated in a microwave or a warm oven.']",17
497,Turmeric Cauliflower Curry Recipe,15,20,35,"['1 head cauliflower (about 1 3/4 pounds)', '3 medium Yukon gold potatoes (about 1 1/4 pounds)', '1 1/2 cups water', '1 medium onion, coarsely chopped', '1 poblano chili pepper, seeded and coarsely chopped', '1 2-inch piece fresh ginger, sliced', '1 teaspoon ground turmeric', '2 teaspoons garam masala', '1/2 teaspoon salt, or to taste', '2 tablespoons olive oil', '1 cup frozen green peas', '12 cherry tomatoes, halved', '1 cup plain yogurt', '3 tablespoons chopped fresh cilantro', '2 limes, quartered, for garnish', 'Special equipment:', 'Blender or food processor']",17,"['1 Bring a large pot of salted water to a boil.', ""2 While waiting for the water to boil, prepare the cauliflower and potatoes: Cut the potatoes into 1 1/2-inch cubes. To prepare the cauliflower, use a chef's knife to cut a deep cross into the base of the cauliflower. Place your thumbs into the crevice and pull the head apart into 4 quarters Stand each quarter upright, and slice off and discard the core and outer leaves. Break or cut the cauliflower into bite-size florets."", '3 Cook the potatoes and cauliflower: Carefully transfer the potatoes into the boiling water and cook for 4 minutes. Add the cauliflower and cook for 10 minutes longer, or until the vegetables are tender. (Total cooking time is 14 to 15 minutes) Drain into a colander.', '3 Make the curry sauce: In a blender or food processor, combine the water, onion, chili pepper, ginger, turmeric, garam masala, and salt. Puree until smooth.', '4 Cook the curry sauce: Warm the olive oil in a large pot over medium heat. Add the sauce and cook for 2 minutes. Stir in the cooked cauliflower and potatoes. Taste and add more salt and garam masala, if you like.', '5 Finish the dish: Stir the peas and tomatoes into the pot. Heat for 2 to 3 minutes, or until hot. Just before serving, stir in the yogurt and reheat gently (do not let it boil, or the yogurt may curdle.)', 'Transfer to a serving dish and sprinkle with cilantro. Serve with lime wedges.']",7
498,Braised Lamb Shanks with Celery Root and Rosemary Recipe,10,140,150,"['2 tablespoons extra virgin olive oil', '2 lamb shanks (3 to 3 1/2 pounds total), trimmed of excess fat', 'Salt', '1 medium onion, chopped (about 1 1/2 cups)', '8 cloves garlic, peeled and crushed', '2 sprigs rosemary', '2 sprigs fresh thyme', '2 bay leaves', '1 cup chicken stock', '2 large celery roots (about 3 pounds total)', '1/2 head of green cabbage', '1 tablespoon balsamic vinegar', 'Freshly ground black pepper', '2 tablespoons chopped fresh parsley']",14,"['1 Salt the lamb shanks: Sprinkle shanks with salt and let sit while you prep the ingredients.', '2 Brown the shanks: Heat oil in a large (6 quart), thick-bottomed pot on medium high heat. Pat shanks dry with paper towels, add them to the pot and sear to brown on all sides.', 'When sufficiently browned, remove shanks to a bowl, set aside.', '3 Saut\\xc3\\xa9 onions and garlic: Add chopped onions to the pot and cook until translucent and beginning to color, about 5 minutes. Add garlic cloves and cook a minute more.', '4 Add rosemary, thyme, bay, shanks, stock, then simmer: Place sprigs of rosemary, thyme, the bay leaves on top of the onions.', 'Place the seared lamb shanks on top. Sprinkle with a teaspoon of salt. Add the chicken stock. Bring the stock to a simmer, lower the heat to the lowest setting to maintain a simmer, and cover. Let simmer for 1 hour.', '5 Prep celery root and cabbage: While the shanks are cooking prepare the celery root and cabbage. Cut off the knobby end of the celery root. Place the celery root cut side down on cutting board to stabilize it. Use a strong knife to cut away the outside peel. Once peeled, cut the celery root into 1 1/2-inch cubes.', 'Core the cabbage and slice the cabbage into 1 1/2-inch thick slices.', '5 Add celery root and cabbage to pot: After an hour, remove the shanks from the pot. Add the sliced cabbage and chunks of celery root. Sprinkle with balsamic vinegar.', 'Return the shanks to the pot, nestling them in the celery root and cabbage.', '6 Simmer until celery root is cooked and shanks are tender: Increase heat to return the pot to a simmer, lower the heat to maintain a simmer, cover and cook for another 45 minutes to an hour, until the celery root is cooked through and the shanks are tender.', '7 Cut meat away from bones, chop, return meat to pot: Remove the shanks from the pot. Cut the meat away from the bones. Roughly chop the meat and return to the pot.', 'Add salt and pepper to taste. Sprinkle with parsley to serve.']",13
499,Champagne Sorbet Recipe,5,195,200,"['1 1/2 cups sparkling wine or champagne', '1 cup white granulated sugar', '1 Tbsp light corn syrup', '1 teaspoon of lemon and or grapefruit zest', '1 1/2 cups fresh grapefruit juice', '1/4 cup fresh squeezed lemon juice (Meyer if you have access to them)']",6,"['1 Boil champagne, sugar, corn syrup, zest: Put champagne, sugar, corn syrup, and zest into a saucepan. Bring to a vigorous boil so that the sugar completely dissolves, remove from heat.', '2 Strain: Strain into a stainless steel bowl (will help cool down faster), add the grapefruit juice and lemon juice.', '3 Chill: Chill completely. To do this, either place bowl in a larger bowl half-filled with ice water, and stir until champagne solution is completely cold, refreshing the ice in the outer bowl if necessary.', 'Or you can cover with plastic wrap and chill in your refrigerator overnight.', 'I put the bowl in the ice compartment of our freezer for a couple hours, because it fits, chills quickly, and is far enough away from the other food in the freezer.', '4 Process in ice cream maker: Process the mixture in your ice cream maker (Amazon sells a good one) according to the ice cream maker directions.', '5 Freeze until firm: Transfer mixture to a storage container and freezer in your freezer until firm, at least 6 hours.']",7
500,Champagne Mushroom Sauce Recipe,5,25,30,"['1/2 ounce dried porcini mushrooms (other dried mushrooms will work if dried porcini are not available)', '1 cup chicken or vegetable stock', '2 cups Champagne or other sparkling wine', '1/3 cup shallots, minced', 'Unsalted butter, 1/4 cup to add to the sparkling wine, 3 Tbsp for the roux', '3 Tbsp all-purpose flour', 'Salt']",7,"['1 Rehydrate dried mushrooms: Add the stock and dried mushrooms into a medium sized pot. Cover and bring to a boil, then reduce heat to its lowest setting.', '2 Reduce champagne with shallots, whisk in butter: In separate medium sized pot, add the sparkling wine and shallots. Bring to a rolling boil, and boil until the wine has reduced to 3/4 of a cup.', 'Turn off the heat and wait until the wine stops simmering, then whisk in 1/4 cup of butter, a little at a time.', '3 Make roux with butter and flour: Heat 3 Tbsp butter in a saucepan over medium-high heat. When the butter stops foaming, add the flour and stir well to combine. Stirring often, cook this roux for 5 minutes, or until it turns the color of coffee-with-cream.', '4 Slowly add hot stock to roux: Working with two hands, slowly add the hot stock (along with the mushrooms) to the roux. It will sputter and spit at first, but keep pouring in the stock and stirring. It will turn into a silky sauce.', '5 Whisk in butter shallot champagne mixture, pour through sieve: To finish, turn the heat off and whisk in the butter-shallot-sparkling wine mixture.', 'Pour the mixture through a fine mesh sieve into a bowl, to strain out the mushroom and shallots. Add salt to taste and keep warm until you need it.', 'Do not let it boil or the sauce may separate.']",8
501,Turkey Mushroom Risotto Recipe,15,40,55,"['2 Tbsp butter', '1 large shallot, chopped', '1/3 pound chanterelles or other fresh mushrooms, chopped', '2 garlic cloves, chopped', '1 Tbsp fresh sage, chopped', '1 1/2 cups Arborio, Carnaroli, Vialone Nano, or other risotto rice', 'Salt', '3 cups turkey stock', '2 ounces Chevre or other fresh goat cheese', 'Black pepper to taste']",10,"['1 Simmer turkey stock and water: Bring the turkey stock, plus an additional 2 cups of water, to a simmer.', '2 Cook shallots and mushrooms: Heat the butter in a medium-sized pot over medium-high heat for 1-2 minutes, until it begins to brown. Add the shallots and mushrooms and toss to combine. Salt them well and saut\\xc3\\xa9 until the shallots are translucent, about 3 minutes.', '3 Add the garlic, sage and rice and stir well. Saut\\xc3\\xa9 for another 1-2 minutes, stirring often.', '4 Start adding stock: Add 1 cup of the simmering stock. Stirring constantly, let the stock evaporate before adding another 1/2 cup. Repeat, stirring almost constantly, until the rice is al dente, cooked through but still a little firm. This will take about 20-30 minutes.', '5 When the rice is al dente, add the goat cheese and stir well to combine. Add the black pepper and stir again. Serve at once.']",5
502,Saut\xc3\xa9ed Swiss Chard with Shiitake Mushrooms Recipe,10,10,20,"['2 Tbsp unsalted butter', '6 ounces of shiitake mushrooms, sliced 1/4-inch thick', '1/4 teaspoon Kosher salt', '2 large bunches of Swiss chard (about 1 1/2 pounds total), rinsed, patted dry, large ribs removed, leaves roughly chopped', 'Sprinkling of grated Parmesan cheese']",5,"['1 Saut\\xc3\\xa9 mushrooms in butter: In a large stick-free saut\\xc3\\xa9 pan melt the butter on medium-high heat. Stir in the sliced mushrooms. Sprinkle with salt (skip added salt if using salted butter).', '2 Add chopped chard: Once the mushrooms are beginning to brown and have given off some water, add the chopped chard leaves to the pan and toss with the mushrooms. (You may have to stagger in the adding of the chard leaves, as not to overwhelm the pan.)', 'Once the chard leaves have wilted, remove from heat and cover the pan. Let the chard leaves steam in their residual heat for a couple minutes.', '3 Sprinkle with Parmesan: Place chard and mushrooms in a serving dish. Sprinkle generously with grated Parmesan cheese.', 'Serve immediately.']",5
503,Chayote with Tomato and Green Chile Recipe,10,35,45,"['1 pound chayotes', '6 ounces of roasted tomatoes (can use canned fire roasted tomatoes, or roast whole tomatoes on stovetop or under broiler until skin begins to blacken, do not remove skin but process whole)', '1 clove garlic, chopped', '2 tablespoons extra virgin olive oil', '2 tablespoons chopped onion', '1 large green Anaheim chile (stem and seeds removed and discarded), chopped', 'Pinch red chile pepper flakes', '1/4 cup water', 'Salt to taste', '1/4 cup roughly chopped cilantro', '1/4 cup finely grated Monterey Jack cheese']",11,"['1 Peel and cut the chayotes: The peel is tough and inedible when cooked, so peel the chayotes completely. (This may take a little doing, as the folds in the chayotes can make it difficult.) Cut the chayotes into 1/4-inch wide, 2 inch long julienned strips, including the core.', '2 Pur\\xc3\\xa9e the roasted tomatoes and the garlic in a blender, set aside.', '3 Saut\\xc3\\xa9 onions and green chiles, add tomato and chili flakes: Heat oil in a large skillet on medium heat. Add the chopped onion and green chiles. Cook on medium heat until just soft, about 3-4 minutes.', 'Add the tomato mixture, red chile flakes, and continue to cook 3 minutes more.', '5 Add chayote, water, salt: Add the chayote, water, and salt to taste. Cover and cook, stirring occasionally for 15 minutes.', 'Add the chopped cilantro and cook for 5 minutes more. The chayote should be just tender, moist but not watery.', '5 Serve: Sprinkle with grated cheese to serve.']",7
504,Cheesy Zucchini Bites Recipe,35,30,65,"['2 pounds of zucchini, grated (large holes of a box grater)', '1/2 teaspoon salt', '1/4 cup mayonnaise', '3 eggs', '3/4 cup diced fresh bread (without crust)', '1/2 cup minced green onions (including green parts)', '2 cloves garlic, minced, about 2 teaspoons', '1 1/2 teaspoons grated lemon zest', '1/4 teaspoon minced fresh rosemary', '1/2 cup grated cheddar cheese', '1/4 cup grated Parmesan cheese', '1/4 teaspoon black pepper', '2 teaspoons of olive oil to coat mini muffin tins', 'Special equipment:', '2 12-well mini-muffin tins']",15,"['1 Salt and drain the zucchini: Toss the grated zucchini with 1/2 teaspoon of salt and place in a colander to drain (in a sink or over a bowl). Let drain for 30 minutes to an hour.', 'After at least 30 minutes, use your (clean) hands to press and squeeze the grated zucchini against the colander to release more moisture.', 'Then use double layered sturdy paper towels or a clean tea towel to wrap up the zucchini and squeeze out even more moisture.', '2 Whisk together the mayo and eggs, then whisk in the bread, green onions, garlic, zest, rosemary, cheeses, pepper: While the zucchini is draining in step 1, whisk together in a large bowl the mayonnaise and eggs until smooth.', 'Then add the bread, green onions, garlic, lemon zest, rosemary, grated cheddar, Parmesan, and black pepper. Let that sit while the zucchini is draining so that the bread breaks down in the mixture.', '3 Prepare pans, preheat oven: Grease the wells of 2 mini-muffin tins with olive oil. Preheat the oven to 350\\xc2\\xb0F.', '4 Stir zucchini into batter, spoon into mini-muffin tins: Stir the drained, squeezed zucchini into the egg mixture until evenly distributed. Spoon the mixture into the wells of the mini-muffin tins, about a heaping tablespoon each.', '5 Bake for 25 minutes at 350\\xc2\\xb0F.', '6 Cool and release zucchini bites from pan: Let cool for 5 minutes, then run a knife around the edges of the zucchini bites to loosen them from the pan. Remove from the pan to a rack to cool further.', 'Eat warm or cool to room temp, then chill or freeze to reheat later.']",10
505,Sous Vide Cheesecake in Jars Recipe,10,90,100,"['For the cheesecake:', '2 (8-ounce) packages cream cheese, softened', '2/3 cup sugar', '3 large eggs', '2/3 cup buttermilk', '2 teaspoons vanilla extract', 'Pinch of salt', 'For the topping:', '2 cups chopped fresh or frozen strawberries, hulled and roughly chopped', '2 tablespoons sugar', '1 tablespoon lemon juice', 'Pinch of salt', '1 cup crumbled graham crackers', 'Special equipment:', '6 (8-ounce) jars with lids', 'Canning jar lifter']",16,"['1 Heat the water: Fill a pot with water and place your immersion circulator inside. Set the temperature to 176\\xc2\\xb0F and let the water come up to temperature. Make sure there is enough water in the pot to completely cover the jars.', '2 Beat together the cream cheese, sugar, and eggs: In a stand mixer with the paddle attachment or with a hand mixer, beat together cream cheese and sugar at medium speed until it\\xe2\\x80\\x99s light and fluffy. Then add in the eggs, one at a time, and beat until combined.', '3 Add the buttermilk: Slowly add the buttermilk to the cream cheese mixture, mixing on low until it\\xe2\\x80\\x99s combined. Then add the vanilla and salt, and mix until the cheesecake mixture has no lumps and is an even consistency.', 'Stop the mixer a couple times and scrape down the sides of the bowl to make sure everything is evenly incorporated.', '4 Fill the jars: Transfer the mixture to a large measuring cup or bowl with a spout. Divide the cheesecake mixture among 6 jars, leaving about 1 1/2 inches of room at the top of each jar. Seal jars tightly with lids and bands, but don\\xe2\\x80\\x99t overtighten them.', '5 Cook the cheesecakes sous vide: Once the water has come to temperature, add the jars and cook for 90 minutes. Then remove the jars carefully and allow to cool. Refrigerate the jars to set the cheesecake completely before serving, although they can be served at room temperature as well.', '6 Make the strawberry topping: Put the strawberries in a small pot over low heat with the sugar, lemon juice, and salt. Bring to a low simmer. Cook for 2 to 3 minutes until the strawberries just start to break down but are still spoonable. You aren\\xe2\\x80\\x99t making jam, so don\\xe2\\x80\\x99t overcook it. Allow topping to cool to room temperature.', '7 Serve the cheesecake: Place a big spoonful of the strawberry topping over each jar along with a few spoonfuls of crumbled graham crackers.']",8
506,Chocolate Chip Cheesecake Bars Recipe,30,265,295,"['For the cookie crust:', '30 original-size vanilla wafer cookies', '2 tablespoons granulated sugar', '1/4 teaspoon kosher salt', '3 tablespoons (43 g) unsalted butter, melted', '2 tablespoons (10 g) mini chocolate chips', 'For the cheesecake filling:', '16 ounces softened cream cheese', '3 large eggs', '1/2 cup (3 1/2 ounces) granulated sugar', '1 teaspoon vanilla extract', '1/4 cup (2 ounces) sour cream', '1/2 cup (3 ounces) mini chocolate chips', '  Special equipment:', 'Food processor']",15,"['1 Preheat oven: Heat oven to 350\\xc2\\xb0F. Grease and line an 8x8 baking dish with parchment paper, leaving an overhang of parchment on two sides. This will help you lift the bars out of the pan after they\\xe2\\x80\\x99ve been baked.', '2 Make the crust: Pulse vanilla wafers in a food processor until fine crumbs the size of sand are formed. You should end up with 1 cup of crumbs. Add sugar and salt to the food processor and pulse 5 times to combine. Pour in melted butter and pulse until the mixture starts to clump together, 5-10 seconds. The crust will look like wet sand and stick together when squeezed. Remove blade and use a small rubber spatula to stir in 2 tablespoons mini chocolate chips.', '3 Form the crust to the pan: Dump the cookie crumb mixture into the prepared baking dish. Firmly, press crust into the bottom of the dish in an even layer. You can use the bottom of a measuring cup for this. It should be firm enough to not move when gently touched. Bake for 10 minutes. The crust will be slightly golden brown around the edges.', 'Remove from oven to cool on a cooling rack while you make the filling.', 'Turn the oven down to 325\\xc2\\xb0F.', '4 Make the filling: Beat the cream cheese in a mixing bowl (or in the bowl of a stand mixer) until smooth. Beat in the eggs one at a time until combined, scraping the bowl after each addition.', 'Beat in the sugar, followed by the vanilla extract and sour cream, until just combined. Do not overmix. The mixture should be smooth and thick like yogurt.', 'Turn off the mixer and fold in the mini chocolate chips with a spatula.', '5 Fill the crust: Spread the cheesecake filling over the prepared crust and rap the pan on the counter a few times to release any bubbles.', '6 Bake the bars: Bake for 20 to 25 minutes or until the filling is just set and slightly jiggly in the center. Turn off the oven, crack open the door (use a wooden spoon wedged between the door to keep it from closing if yours won\\xe2\\x80\\x99t stay open) and cool in the oven for 30 minutes.', '7 Chill the bars: Remove from the oven and cool to room temperature on a rack, about 30 minutes. Transfer to the fridge and chill for at least 3 hours or overnight before serving.', 'Leftovers! These bars will keep in a covered container in the fridge for about a week.']",12
507,Raspberry Cheesecake in a Mason Jar Recipe,0,180,180,"['1 12-ounce package frozen raspberries', '3/4 cup sugar, divided 1/2 cup and 1/4 cup', '1/3 cup water', '10 Oreo cookies, without the filling, or 20 chocolate wafer cookies', '2 Tbsp melted butter', '8 ounces cream cheese, room temperature', 'Pinch salt', '1 egg', '1/3 cup sour cream', 'Whipped cream for topping', 'Fresh raspberries for garnish', '  4 Wide-mouthed 8-ounce mason jars']",12,"['1 Make the raspberry sauce: Set aside 1/2 a cup of the frozen raspberries from the package. With the remaining raspberries, place them in a medium saucepan. Add 1/2 cup sugar and 1/3 cup of water. Bring to a simmer on medium high heat, then lower the heat to maintain the simmer, and gently cook, whisking frequently, until the raspberries have completely broken down, about 10 minutes.', 'If you want, strain the raspberry sauce through a sieve to remove the seeds, and then return the sauce to the pan and continue to gently simmer until the the sauce is syrupy. Set aside to cool.', '2 Make the Oreo cookie crust: Grind the chocolate cookie wafers (Oreo or other brand) in a food processor, mini chopper, or by placing in a plastic bag and crushing with a rolling pin, until finely ground.', 'Place in a medium bowl and stir in the melted butter. Divide evenly among the mason jars, packing the chocolate ""crust"" at the bottom of each mason jar in a layer about 1/4 to 1/3-inch thick.', ""At this point you can put in a 350\\xc2\\xb0F oven for 10 minutes to bake the crust in, which will make it easier to pour in the cheesecake filling without it mixing in with the crust. (Or if you don\\'t care if the bottom is a little messy, you can skip this part.)"", '3 Make the cream cheese filling: In a mixer, beat the cream cheese on medium speed for 4 minutes, until smooth and light. Add 1/4 cup of sugar and beat 4 minutes more. Add a pinch of salt and the egg, and beat another minute.', 'Add the sour cream and beat another minute, until smooth. Add 1/4 cup of the cooled raspberry syrup from step one, and beat until incorporated.', '4 Layer raspberries and filling on top of crusts in mason jars: Place the reserved raspberries on top of the chocolate crusts in the mason jars in a single layer. Pour the raspberry cheesecake filling over the raspberries in the jars.', '5 Bake in water bath: Place in a roasting pan and add about an inch of boiling water to the pan to create a water bath, which will help the cheesecakes cook more evenly. Bake at 325\\xc2\\xb0F for 40 minutes. Then turn off the heat in the oven and let the cheesecakes continue to gently cook in the residual heat of the oven for another 30 minutes.', ""6 Chill and top with whipped cream and raspberry sauce: Remove from oven and let cool to room temp. Chill for at least a half hour before eating. Don\\'t worry if there are cracks on the surface of the cheesecakes. Top with the remaining raspberry sauce, whipped cream, and fresh raspberries.""]",10
508,Triple Chocolate Cheesecake Recipe,60,780,840,"['For the crust:', '8 chocolate graham crackers, crushed (about 1 1/4 cups)', '1/3 cup (66 g) sugar', '1 tablespoon cocoa powder', 'Pinch of kosher salt', '4 tablespoons unsalted butter, melted', 'For the filling:', '8 ounces semi-sweet chocolate, chopped', '1/3 cup heavy whipping cream', '4 large eggs, room temperature', '2 teaspoons vanilla extract', '1/4 teaspoon kosher salt', '3 (8 ounce) packages cream cheese, room temperature', '1 1/4 cup (250 g) sugar', '2 tablespoons cocoa powder', 'For the ganache topping:', '3/4 cup heavy whipping cream', '1 tablespoon corn syrup (optional)', 'Pinch of kosher salt', '8 oz semi-sweet chocolate, finely chopped', '1 teaspoon vanilla extract', 'Special equipment:', '9-inch springform pan', 'Heavy-duty, extra-long aluminum foil', 'Roasting pan']",25,"['1 Preheat the oven to 350\\xc2\\xb0F.', '2 Make the crust: In the bowl of a food processor fitted with the metal s-blade attachment, add the graham crackers. Pulse until they are ground fine like sand.', 'Add the sugar, cocoa powder, and salt. Pulse 2 or 3 times until just combined. Pour melted butter around the bowl in a circle, pulse 4 or 5 times combine it. The mixture should clump a little bit, but may still look a little dry.', 'Dump the mixture into the bottom of your ungreased springform pan. Use your fingers or the underside of a cup to press the mixture into the bottom of the pan, making it as even as possible.', 'Place the crust in the oven and bake for about 8 to 10 minutes. Remove from oven to cool.', '3 Reduce the oven temp and melt the chocolate: Once the crust has baked, reduce the oven to 300\\xc2\\xb0F.', 'In a medium-sized, heavy-bottom saucepan set over low heat, combine the chopped chocolate and 1/3 cup heavy cream. Stir continuously, for about 10 minutes. Once melted, remove from heat, and set aside. You will fold it into your filling later.', '4 Make the cheesecake filling: In a small bowl or Pyrex measuring cup, gently beat the eggs, vanilla extract, and salt together with a fork. Set it aside.', 'Using a stand mixer fitted with a paddle attachment (or a hand mixer set to low and a large bowl), add the cream cheese. Beat the cream cheese on low or stir speed until creamy, about 2 minutes. Scrape down the sides and bottom of the bowl.', 'Beat again on low for about 1 minute. With the stand mixer still on low, slowly add the sugar and two tablespoons cocoa powder. Stop the mixer. Scrape down the bottom and sides of the bowl. Beat for another minute or two until light and fluffy.', 'With the mixture still on low, add the egg mixture, 1/3 at a time, scraping down the sides of the bowl after each addition.', 'Pour the cooled, melted chocolate into the bowl of the stand mixer and (you guessed it!) beat on low for about a minute. Scrape down the sides and bottom of the bowl. Beat on low again for about 30 seconds, or until the chocolate is fully incorporated. Alternatively, you can fold in the chocolate in using a spatula.', '5 Prepare the water bath and add the filling: Wrap the outside of the your springform pan in 3 layers of aluminum foil. Be careful not to tear or puncture the foil. Bring the foil all the way up the sides. Set it inside a roasting pan or a large Dutch oven.', 'Pour the filling into springform pan.', 'Fill the roasting pan with warm water about halfway up the sides of the springform pan. (I usually just heat it in a tea kettle.) Be careful not to splash any water into the cheesecake pan or inside the foil.', '6 Bake the cheesecake: Put the pan in the oven and bake until the cheesecake is just barely set in the center, 55-65 minutes. It will still jiggle slightly, but shouldn\\xe2\\x80\\x99t slosh in the center when moved.', '7 Let it cool, then chill: Remove the roasting pan from the oven. Let the cake cool in the water bath for about an hour. Then remove it from the water bath and transfer it to a cooling rack on the counter for another hour. Finally, keep the cake in the springform pan, and let it chill, uncovered overnight in the fridge.', '8 Make the ganache: Place chopped chocolate in a medium-sized bowl. In a small saucepan set over medium heat, add the heavy cream, corn syrup, and salt. Stir to combine and bring to a simmer.', 'Pour the heated cream over the chopped chocolate. Don\\xe2\\x80\\x99t stir. Let sit for 5 minutes, then add the vanilla. Use a spatula and stir gently to combine. Let the ganache cool at room temperature for 2 hours. Cover with plastic wrap and keep it in the fridge until you\\xe2\\x80\\x99re ready to serve the cheesecake.', '9 Finish the cake: The ganache is probably too thick to pour. Simply warm it in the microwave for 15-second intervals (or more depending on how powerful your microwave is) until it\\xe2\\x80\\x99s pourable. (Be careful, though \\xe2\\x80\\x93 chocolate can burn quickly in a microwave.) Stir it gently.', 'Remove the cheesecake from the springform pan. Pour about half of the ganache over the top, just until it drips down a little on the sides. You probably won\\xe2\\x80\\x99t use all of the ganache. Save the rest to add to hot milk for the most luxurious hot cocoa or freeze it in scoopfuls for when you need a little chocolate fix.', '10 Serve the cake: Serve the cake with sliced strawberries (if you wish), slice, and enjoy!']",22
509,Savory Cherry Compote Recipe,10,20,30,"['3 tablespoons extra virgin olive oil', '2 tablespoons minced shallots (can sub red onion)', '2 1/2 cups pitted sweet cherries, quartered', '1 cup walnuts, chopped', '1 teaspoon minced fresh rosemary', 'Salt and pepper to taste', '1/4 cup Port, red wine, kirsch, cassis, or cherry juice (or water)', '1 tablespoon honey', 'Special equipment:', 'Cherry pitter']",10,"['1 Cook the shallots: Heat the olive oil in a pan in a frying pan on medium heat. Add the shallots and cook them until they just begin to color on the edges, about 2-3 minutes. Stir a few times while they\\xe2\\x80\\x99re cooking.', '2 Add the walnuts, rosemary and cherries and stir everything to combine. Turn the heat down to medium and cook until the cherries are soft, about 4-5 minutes, stirring occasionally. Add a little black pepper and taste for salt.', '3 Pour in the Port, wine, kirsch or cassis and the honey, and stir again. Boil this down slowly until the softening cherries and the liquid cook down to a syrupy texture.']",3
510,Sweet Cherry Cobbler Recipe,15,40,55,"['For the filling:', '2 1/2 pounds pitted fresh or frozen sweet cherries', '1/2 cup (70 grams) granulated sugar', '1 tablespoon lemon juice', '1 tablespoon cornstarch (use 1 1/2 tablespoons if using frozen cherries)', '1/8 teaspoon kosher salt', 'For the topping:', '2 cups (250 grams)  all-purpose flour', '2 teaspoons baking powder', '1/4 cup (35 grams) granulated sugar, plus additional for sprinkling over top', '1 tablespoon lemon zest', '1/2 teaspoon kosher salt', '6 tablespoons (85 grams) unsalted butter cut into small pieces', '1 cup whole milk', '1 teaspoon vanilla extract', 'Special equipment:', '9x13 baking pan', 'Ice cream scoop, optional']",18,"['1 Preheat the oven to 375\\xc2\\xb0F.', '2 Make the filling: In a large mixing bowl, combine the whole pitted cherries, sugar, lemon juice, cornstarch, and salt, and stir to coat. Spread the cherries into a 9x13 inch baking dish and set aside.', 'If you are using frozen cherries, you can put the dish in the preheating oven to defrost them a bit while you make the cobbler topping.', '3 Make the topping: In a medium mixing bowl, combine the flour, baking powder, sugar, lemon zest, and salt and whisk with a fork. Using your hands or a pastry blender, work the butter into the dry mixture until it becomes coarse, sandy, and well incorporated.', 'Whisk the milk and vanilla together in a measuring cup, and using a fork, work the liquid into the dry mixture until you get a thick batter--it should resemble something between biscuit dough and pancake batter.', '   4 Top the cobbler: Using a levered ice cream scoop or a large spoon, drop large scoops of the batter on top of the cherries. Make about 9 mounds of batter over the top of the cherries; they won\\xe2\\x80\\x99t completely cover the cherries but that\\xe2\\x80\\x99s okay. As it bakes, the dough will puff and spread out. Sprinkle about 2 tablespoons of sugar over the top of the batter.', '5 Bake the cobbler: Bake the cobbler in the preheated oven for about 40 minutes, or until the topping is golden brown and the cherry juices are bubbling throughout. (If you are using frozen fruit, expect to bake an additional 15 minutes).', '6 Serve: Serve the cobbler warm with vanilla ice cream. This cobbler is best the day it is made, but leftover servings can be reheated in the microwave for about 1 minute. Store any leftover cobbler in the pan covered with plastic or in an airtight container in the refrigerator.']",8
511,Cherry Frozen Yogurt Recipe,15,105,120,"['3 cups pitted fresh or frozen cherries', '2 Tbsp lemon juice', '3/4 cup sugar (more or less depending on how sweet the cherries and how sweet you want your frozen yogurt to be)', '1/4 cup whole milk (can substitute half-and-half or cream for creamier version)', '1 1/2 cups full fat yogurt (if you are using non or low-fat yogurt, add 2 Tbsp heavy cream)', '2 Tbsp almond liqueuer such as Amaretto (optional)', 'Special equipment:', 'Cherry pitter']",8,"['1 Cook the cherries with lemon juice and sugar: Place the pitted cherries, lemon juice, and sugar in a medium saucepan and bring to a simmer, stirring until the sugar is completely dissolved.', 'While the mixture is heating, use a potato masher to mash up the berries in the pot which will release some of their moisture.', 'When all of the sugar has dissolved, remove from heat and let cool for 10 minutes.', '2 Place the cherry mixture in a blender and pulse until smooth.', '3 Make and chill yogurt base: Mix cherry pur\\xc3\\xa9e, milk, and yogurt together in a bowl. Chill in the refrigerator for at least an hour; the longer the mixture chills the better (can chill overnight).', '4 Process in ice cream maker: Right before processing in an ice cream maker, add the almond liqueur if using. The alcohol in the liqueur will help keep the frozen yogurt smooth, but it is not necessary.', 'Process the mixture in your ice cream maker for 25 minutes.', 'You can eat it right away (it will be rather soft) or put it in the freezer for a few hours to harden up a bit.']",8
512,Grilled Pork Chops with Cherry Salsa Recipe,15,10,25,"['1/2 cup chopped red onion', '2 tablespoons lemon juice', '1 1/2 pounds cherries, about 4 cups', '4 pork chops, about 3/4-inch thick', 'Salt', 'Extra virgin olive oil', '2 Tbsp chopped fresh basil', '1 tablespoon balsamic vinegar', '1/2 teaspoon salt', '1 heaping teaspoon sugar']",10,"['1 Mix onion with lemon juice: Mix the chopped onion with the lemon juice in a small bowl and set aside. The lemon juice will help take the edge off the onions.', '2 Coat the pork chops in olive oil and sprinkle salt over them. Set aside at room temperature.', ""3 Pit and de-stem the cherries. A cherry pitter is magical for this task, but if you don't have one, use a small knife. Double check for stray pits, they always seem to find their way into dishes that call for fresh cherries."", '4 Process cherries, onions, basil for salsa: Put the cherries, onions and chopped basil into a food processor. Pulse a few times until you have a chunky salsa, with differing textures of cherry. Alternately, you can chop everything by hand.', '5 Add balsamic vinegar, salt, sugar to salsa: Mix in the balsamic vinegar, the 1/2 teaspoon salt and sugar. Add more of any of these ingredients to taste. Set aside at room temperature. You can make this salsa up to 8 hours in advance.', '6 Grill pork chops: Prepare your grill for high direct heat. Grill the pork chops over high heat with the grill cover closed for 3 minutes. Turn them 45 degrees on the same side to get a pretty cross-hatch pattern, then close the grill cover and cook another 3 minutes.', 'Turn the pork chops over, but this time keep the grill cover open and cook for a final 2-3 minutes. Allow to rest for 5-10 minutes before serving.', 'Serve the pork chops with the cherry salsa.']",8
513,Tomato Galette With Parmesan Whole Wheat Crust Recipe,25,80,105,"['For the whole wheat crust:', '1 cup (135g) whole wheat flour', '1 cup (120g) all-purpose flour', '1/3 cup (50g) coarse cornmeal', '1/4 cup (20g) shredded Parmesan', '3/4 teaspoon salt', '8 ounces (2 sticks) cold unsalted butter, cut into cubes', '1/2 cup ice water, more as needed', 'For the tomato filling:', '4 cups (about 1 3/4 pounds) cherry tomatoes, halved', 'Salt (for the tomatoes)', '1/2 cup (40g) shredded Parmesan', '2 tablespoons chopped fresh thyme leaves', '1 large egg, well beaten with 1 tablespoon water', '1 tablespoon chopped parsley, to garnish']",15,"['1 Chill the crust ingredients: In a bowl, combine the whole-wheat flour, all-purpose flour, cornmeal, Parmesan and salt. Add the butter pieces and toss with your hands to separate and coat them with flour. Place the bowl in the freezer for 30 minutes.', '2 Make the dough: Pour the flour and butter mixture into the bowl of a food processor. Process in 4 to 5 long pulses, or until the butter is cut into small pieces (a few larger pieces are okay.)', 'Open the top of the machine and drizzle the ice water over the flour and butter. Close and pulse in a series of short bursts, until the mixture looks like wet sandy gravel.', 'Press a small amount of the dough together in your hand. It should form a clump that holds together firmly and without cracking at the edges. If it feels crumbly or dry, put it back in the food processor, sprinkle the mixture with an additional tablespoon or two of the ice water, and pulse briefly to mix.', 'To mix by hand: Follow step one, and use a pastry cutter or wire whisk to break up the butter into small pieces. Drizzle the ice water over the mixture and toss it together with your hands as if you were tossing a salad. If it still feels dry, add water, one tablespoon at a time. When the dough starts to come together, shape it as directed in the next step.', '3 Shape and chill the dough: Empty the dough onto the countertop. Quickly press the dough together to form a disk about an inch or so thick. Resist the temptation to knead or squish the dough. The idea is to firmly compress all the little bits of dough together into a disk shape without overworking the dough.', 'Wrap the dough in plastic wrap and refrigerate for 30 minutes.', '4 Salt the tomatoes: Line a baking sheet with paper towels. Spread the tomatoes on the baking sheet and sprinkle evenly with about a teaspoon of salt. (This might seem like too much at first, but the saltiness mellows out perfectly once the tomatoes have rested for a little while.)', 'Let stand while the dough chills (about 30 minutes). The tomatoes will start to release their juices as they sit. Before assembling the galette, blot the tomatoes dry with paper towels until much of the liquid is absorbed.', '5 Preheat the oven to 425\\xc2\\xbaF. Line a baking sheet with parchment.', '6 Roll and fill the galette: On a lightly floured surface, roll the dough into a 15-inch circle. Transfer to the baking sheet (it will drape over the sides, but that\\xe2\\x80\\x99s okay).', 'Sprinkle the Parmesan for the filling in a rough 11-inch circle over the bottom of the dough, leaving the edges clear. Arrange two-thirds of the tomatoes, cut-side up, over the cheese (reserve the remaining third). Sprinkle with the thyme.', 'Fold the edges over the tomatoes, pleating as necessary. Brush the edges of the crust with beaten egg.', '7 Bake the galette: Bake for 30 minutes, or until the crust is golden. Scatter the reserved tomatoes over the top of the galette and sprinkle with parsley. Serve warm or at room temperature.', 'This galette is best served the day it is made. Leftovers will keep for several days, refrigerated.']",15
514,"Make-Ahead Frittata Squares with Spinach, Tomatoes, and Feta Recipe",15,45,60,"['Butter (for the baking dish)', '2 tablespoons olive oil', '1 pint cherry tomatoes', '1 bunch scallions, thinly sliced', '5 ounces (about 3 1/2 packed cups) baby spinach leaves', '1/2 cup whole milk', '1/2 cup sour cream', '12 large eggs', '3/4 teaspoon salt, divided', '1/8 teaspoon freshly ground black pepper', '1 cup (about 5 ounces) crumbled feta cheese', '3 tablespoons chopped fresh parsley', 'Special equipment:', '2-quart glass or ceramic baking dish (8x8 square or 7x11 rectangular)']",14,"['1 Preheat the oven to 350F. Butter a 2-quart baking dish.', '2 Cook the vegetables: In a large skillet over medium heat, heat the olive oil. Add the tomatoes and cook, stirring often, for 2 minutes, or until just starting to soften but not yet falling apart. Transfer to a separate dish and set aside.', 'Add the the scallions to the pan and cook for about 1 minute, or until softened. Stir in the spinach and 1/4 teaspoon of salt. Cook, stirring often, until the spinach wilts. Remove the pan from the heat and cool for a few minutes.', 'Stir in the crumbled feta cheese.', '3 Whisk egg mixture: In a large bowl, gradually whisk the milk into the sour cream until smooth. Whisk in the eggs, 1/2 teaspoon of salt and pepper.', '5 Assemble and bake the frittata: Transfer the spinach filling from the pan into the baking dish and pour the egg mixture over top. Scatter the tomatoes on top of the eggs so they peek out, and sprinkle with the parsley.', 'Bake for 40 to 45 minutes, or until the eggs are set. You can check with a paring knife inserted in the middle; the eggs should be set and no longer be runny.', '6 Serve: Cool the frittata for at least 10 minutes, and cut into 9 servings. Store leftovers in the refrigerator for up to a week, and reheat in the microwave.']",8
515,"Spaghetti with Tomatoes, Bacon, and Eggs Recipe",5,15,20,"['2 tablespoons white vinegar, for poaching the eggs', '12 ounces (3/4 box) spaghetti', '6 slices (about 5 ounces) thick cut bacon, cut into 1/2-inch dice', '2 cloves garlic, thinly sliced', '7 to 8 (12 ounces) small (1 1/2-inch) tomatoes, quartered', '4 large eggs', '1/2 cup freshly grated Parmesan', '1/2 cup packed basil leaves, torn into pieces', 'Freshly ground black pepper, to taste', 'Olive oil, for garnish']",10,"['1 Bring two pans of water to a boil: For the pasta, bring a large pot of salted water to a boil (at least 4 quarts of water and 2 tablespoons of salt). For the eggs, fill a wide saucepan with 2 inches of salted water and bring to a boil. Add the vinegar to the saucepan for the eggs.', '2 Cook the bacon, garlic, and tomatoes while the water heats: In a large (12-inch) skillet over medium-high heat, cook the bacon until browned. Transfer to plate.', 'Add the garlic and the tomatoes, and cook, stirring often, for 2 minutes, or just until the garlic turns pale golden and the tomatoes soften slightly. Remove the pan from the heat.', '3 Cook the spaghetti: Add the spaghetti to the large pot of boiling water, and cook for 8 to 9 minutes, or until al dente. Remove 1 cup of the pasta water with a measuring cup.', '4 Poach the eggs while the pasta cooks: Line a tray or plate with a paper towel. Adjust the heat under the saucepan so that the poaching water barely simmers.', 'Crack 1 egg into a small bowl or cup and, holding the rim as close to the surface of the water as possible, drop the egg into the water.', 'Rapidly repeat with the remaining eggs.', 'Drag a wooden spoon around the edge of the pot to stir the water and gently release the eggs from the bottom.', 'After 2 minutes, lift 1 egg from the water with a slotted spoon and test for doneness by pressing on the egg. The white should feel firm and the yolk should still be soft. Return to the water if necessary to complete the cooking. With a slotted spoon, transfer the eggs to the paper towel lined plate to drain the water.', '5 Assemble the pasta: Set the skillet with the garlic and tomatoes back over low heat. With tongs, add the cooked spaghetti. Add the cooked bacon, Parmesan, basil, salt, and pepper and toss together. If the spaghetti looks dry, add some of the reserved pasta water a few tablespoons at a time.', '6 To serve: Divide the spaghetti among 4 plates or shallow bowls and top each with a poached egg. Drizzle with olive oil and sprinkle with freshly ground pepper, if you like.']",11
516,Mixed Berry Chia Seed Jam Recipe,5,12,17,"['1 cup blueberries', '3/4 cup chopped strawberries (stems removed)', '3/4 cup raspberries', '2 tablespoons sugar, plus more to taste', '2 tablespoons lemon juice (from about 1/2 a lemon), plus more to taste', '1 1/2 tablespoons chia seeds']",6,"['1 Combine the blueberries, strawberries, raspberries, sugar, and lemon juice in a medium saucepan. Give everything a quick stir to distribute the sugar.', '2 Cook the fruits over medium heat for about 10 to 12 minutes, stirring occasionally, until the fruit breaks down. The fruit should look like a syrupy, runny sauce. (If you want a smooth jam without chunks, use the back of a wooden spoon or a fork to mash large chunks of fruit.', '3 Remove the saucepan from heat. Mix in the chia seeds and let the jam sit for 10 minutes to thicken. Taste and add additional sugar or lemon juice to taste.', '4 Cool to room temperature, then transfer to a jar and refrigerate. The jam will continue to thicken in the refrigerator. Store for up to 3 to 4 weeks.']",4
517,Grilled BBQ Chicken Sandwiches Recipe,10,20,30,"['Pickle Slaw:', '1/2 cup mayonnaise', '1/4 cup dill pickle juice', '1 tablespoon sugar', '1/2 green cabbage, thin shredded (about 4 cups)', '2 medium carrots, grated (about 1 cup)', '1/4 cup chopped dill pickles', 'Chicken Filling:', '2 pounds boneless skinless chicken breasts, butterflied', '2 tablespoons olive oil', '1/2 teaspoon kosher salt', '1/2 teaspoon black pepper', '1 \\xe2\\x80\\x93 1 1/2 cups Hank\\xe2\\x80\\x99s Kansas City BBQ Sauce or store-bought', '8 hamburger buns', 'DAD ADD! Serrano Mayo:', '2-3 grilled serrano peppers, seeds removed', '1 cup mayonnaise', 'Juice from 1/2 lime', 'Pinch of salt']",19,"['1 Make the slaw: Whisk together mayo, pickle juice, and sugar. Stir in shredded cabbage, carrots, and pickles. Stir together and taste. Season to your liking. Slaw can be made a day or two in advance with no problem.', '', '2 Heat the grill and prepare the chicken: Preheat grill to medium-high heat. To butterfly the chicken, use a sharp knife to slice the chicken horizontally \\xe2\\x80\\x93 leaving the edge connected so you can open the chicken breast \\xe2\\x80\\x93 making it thinner and therefore faster-cooking. Then drizzle with olive oil, salt, and pepper.', 'Pour 1/2 cup of BBQ sauce into a bowl and set it aside. You will add it to the cooked chicken later.', '3 Grill the chicken and chiles (if using): Add chicken to grill and spoon BBQ sauce over each piece of chicken. You will use 1/3 to 1/2 cup of BBQ sauce for this part of cooking.', 'Grill for 5 to 6 minutes on the first side. Flip and add BBQ sauce to the second side. Grill for another 5 to 6 minutes on the second side or until the chicken breasts reach 165\\xcb\\x9aF. Remove from the grill.', 'As the chicken grills, add 2 to 3 serrano peppers to the grill. Grill them for 2 to 3 minutes per side. Remove and let cool.', 'NOTE: If you do not butterfly your chicken breasts, you will need to grill them for 8 to 10 minutes longer than this.', '4 Shred the chicken: When chicken comes off the grill, let it cool briefly and then use two forks to shred or roughly chop the chicken. Stir the 1/2 cup of BBQ sauce you set aside in step 1 into the shredded chicken.', '5 Making the serrano mayo: Split grilled peppers in half and remove seeds. Add to a small food processor with mayo, lime juice, and salt. Pulse until combined.', '6 Make your sandwich: Toast your sandwich buns (if you want to) and smear with serrano mayo if you\\xe2\\x80\\x99re using it. Top with a heap of pickle slaw and shredded BBQ chicken. Serve with chips and pickles on the side.', 'Leftover chicken will keep in the fridge for 3 to 4 days or freeze in an airtight container for up to three months.']",12
518,Instant Pot Paella with Chicken and Sausage Recipe,10,40,50,"['1 1/2 cups low sodium chicken broth', 'Big pinch of saffron threads (roughly equal to 1/4 teaspoon)', '1 cup frozen peas', '1 tablespoon olive oil', '3 cloves garlic, chopped', '1 medium yellow onion, chopped', '1 red bell pepper, chopped', '1 pound (3 to 4) boneless skinless chicken thighs, cut into 1 inch pieces', '6 ounces (about 2 links) chorizo or other spicy sausage, sliced', '1 teaspoon smoked paprika', '1 teaspoon salt', '1 1/2 cups (325 grams) short or medium grain rice', '2 tablespoons chopped parsley', 'Special equipment:', '6-quart Instant Pot or other electric pressure cooker']",15,"['1 Heat the saffron with the chicken broth and defrost the peas: In a small saucepan, heat the broth to a simmer, then and add the peas and saffron. Reduce the heat to low to keep the broth warm and give the saffron a chance to infuse the broth while you get everything else ready.', '(You can also heat the broth in a microwave safe bowl or liquid measuring cup for about three minutes. Add the peas and saffron after microwaving and cover to keep warm until needed.)', '2 Cook the vegetables, chicken, and sausage in the pressure cooker: Select the \\xe2\\x80\\x9cSaut\\xc3\\xa9\\xe2\\x80\\x9d setting on your electric pressure cooker and add the oil and garlic. Saut\\xc3\\xa9 until little bubbles of oil form around the garlic and it becomes aromatic, 1 to 2 minutes.', 'Stir in the onion and bell pepper. Saut\\xc3\\xa9 until they have softened a little bit, 3 to 4 more minutes. Stir in the paprika and salt, and saut\\xc3\\xa9 for one more minute.', ""Add the chicken and sausage and stir to combine. Saut\\xc3\\xa9 for 5 to 6 minutes, until the chicken has turned opaque. It\\'s ok if the chicken is still a little pink in the middle."", ""3 Scrape the bottom of the pan: Add a splash of the hot broth to the pan and use it to scrape up any browned bits that have developed on the bottom of the pan. These browned bits add a lot of flavor to the dish, so don\\'t skip this step. (This also helps prevent the dish from burning on the bottom during cooking!)"", '4 Add the remaining ingredients and the broth: Stir in the rice, then pour in the rest of the hot broth with the peas and saffron. Push down any grains of rice from the sides of the pot, making sure that everything is submerged in the cooking liquid.', '5 Pressure cook the paella: Secure the lid on the pressure cooker, and make sure the pressure regulator is in its \\xe2\\x80\\x9cSealing\\xe2\\x80\\x9d position. Cancel the \\xe2\\x80\\x9cSaut\\xc3\\xa9\\xe2\\x80\\x9d cooking program, then select the \\xe2\\x80\\x9cManual\\xe2\\x80\\x9d or \\xe2\\x80\\x9cPressure Cook\\xe2\\x80\\x9d program and set the cooking time to 5 minutes at high pressure.', 'The pot will take 5 to 10 minutes to come up to pressure, and then the cooking program will begin counting down.', '6 Release the pressure: When the cooking program ends, let the pressure release naturally for 10 minutes, then release the remaining pressure by moving the pressure regulator to its \\xe2\\x80\\x9cVenting\\xe2\\x80\\x9d position.', '7 Serve: When the pressure has fully released, open the pot. Scoop onto plates, garnish with chopped parsley, and serve it piping hot. Leftovers will keep for about a week.', 'You may get a crust of dark caramelization and crunchy rice at the bottom of the pan -- this is ok! This is called ""socarrat"" and is traditional for paella. Just mix it in and enjoy!']",12
519,Tandoori Chicken Recipe,15,400,415,"['3 Tbsp vegetable oil', '1 teaspoon ground coriander', '1 teaspoon ground cumin', '1 teaspoon ground turmeric', '1 teaspoon cayenne', '1 Tbsp garam masala', '1 Tbsp sweet (not hot) paprika', '1 cup plain yogurt (can sub buttermilk)', '2 Tbsp lemon juice', '4 minced garlic cloves', '2 Tbsp minced fresh ginger', '1 teaspoon salt', '4 whole chicken legs (drumsticks and thighs), or its equivalent, skinless, bone-in']",13,"['1 Heat the spices in oil: Heat the oil in a small pan over medium heat, then cook the coriander, cumin, turmeric, cayenne, garam masala and paprika, stirring often, until fragrant (approximately 2-3 minutes). Let cool completely.', '2 Whisk spices into yogurt, add lemon juice, garlic, salt, ginger: Whisk the cooled spice-oil mixture into the yogurt, then mix in the lemon juice, garlic, salt and ginger.', '3 Cut deep slashes into chicken, coat with marinade, chill: Cut deep slashes (to the bone) in 3-4 places on the leg/thigh pieces. Just make 2-3 cuts if you are using separate drumsticks and thighs. Coat the chicken in the marinade, cover and chill for at least an hour (preferably 6 hours), no more than 8 hours.', '4 Prepare grill: Prepare your grill so that one side is quite hot over direct heat, the other side cooler, not over direct heat. If using charcoal, leave one side of the grill without coals, so you have a hot side and a cooler side. If you are using a gas grill, just turn on one-half of the burners.', 'Use tongs to wipe the grill grates with a paper towel soaked in vegetable oil.', '5 Shake off excess marinade, place chicken on hot side of grill: Take the chicken out of the marinade and shake off the excess. You want the chicken coated, but not gloppy.', 'Put the chicken pieces on the hot side of the grill and cover. Cook 2-3 minutes before checking.', 'Turn the chicken so it is brown (even a little bit charred) on all sides', '6 Move to cool side of grill, cover and cook: Move chicken to the cool side of the grill. Cover and cook for at least 20 minutes, up to 40 minutes (or longer) depending on the size of the chicken and the temperature of the grill. The chicken is done when its juices run clear.', 'Let it rest for at least 5 minutes before serving. It\\xe2\\x80\\x99s also great at room temperature or even cold the next day.', 'Serve with naan, and Indian flatbread, or with Indian style rice, with yogurt-based raita on the side.']",11
520,Pressure Cooker White Chicken Chili Recipe,10,45,55,"['2 tablespoons olive oil', '4 cloves garlic, minced', '1 large green bell pepper, seeded and chopped', '2 jalapen\\xcc\\x83o peppers, seeded and chopped (leave the seeds in if you like it spicy)', '3 celery stalks, chopped', '1 medium yellow onion, chopped', '2 teaspoons ground cumin', '2 teaspoons dried oregano', '1 teaspoon ground coriander', '1/4 teaspoon cayenne pepper (optional)', '2 teaspoons salt', '2 (15-ounce) cans cannellini beans, rinsed and drained (or 3 cups homemade beans)', '1 1/2 pounds boneless, skinless chicken breasts, tenders, or thighs', '1 cup chicken broth', '1 cup sour cream', '1/2 cup chopped fresh cilantro', 'Special equipment:', '6-quart electric pressure cooker, like the Instant Pot']",18,"['1 Saut\\xc3\\xa9 the garlic and vegetables: Select the saut\\xc3\\xa9 setting on your pressure cooker and heat the olive oil and garlic for 2 minutes, until the garlic is bubbling.', 'Add the bell pepper, jalapen\\xcc\\x83os, celery, and onion, and saute\\xcc\\x81 for about 5 minutes, until the vegetables are softened.', '2 Add the spices, beans, and chicken: Add the cumin, oregano, coriander, cayenne, and salt and saute\\xcc\\x81 for about 1 minute more, until aromatic.', 'Pour the beans over the vegetables, layer the chicken pieces on top, and pour in the broth. Do not stir. ', '3 Pressure cook the chicken: Secure the lid on your pressure cooker in its sealing position. Cancel the saut\\xc3\\xa9 program, then select the manual setting and set the cooking time for 15 minutes at high pressure. (The pot will take about 10 minutes to come up to pressure before the cooking program begins.) ', '4 Release the pressure: Perform a quick pressure release by moving the pressure cooker\\xe2\\x80\\x99s lid to its vented position, or let the pressure release naturally.', 'At this point, you can also leave the chili on your pressure cooker\\xe2\\x80\\x99s Keep Warm setting for up to 10 hours, then continue with the recipe when you\\xe2\\x80\\x99re ready to serve.', ' 5 Shred and season the chicken: When the pressure has fully released, open the pot and use a pair of tongs to remove the chicken to a carving board or dish. Using a pair of forks, break up the chicken into shreds.', 'Add the shredded chicken back to the pot along with the sour cream and cilantro and stir to combine. Taste for seasoning and add more salt if needed.', '6 Serve the chili: Ladle the chili into bowls. Serve hot, with tortillas or cornbread on the side.']",10
521,Air Fryer Fried Chicken Recipe,15,105,120,"['For the chicken: ', '1 4-pound fryer chicken, cut into 10 pieces (2 breasts cut in half, 2 wings, 2 legs, 2 thighs)', '1 teaspoon kosher salt', '1 teaspoon ground black pepper', '2 cups buttermilk', 'For the coating:', '2 cups all-purpose flour', '1 tablespoon seasoned salt', '1 teaspoon kosher salt', '1 teaspoon ground black pepper', '1 tablespoon garlic powder', '1 tablespoon paprika', 'Spray olive oil for cooking', 'Special equipment:', 'Krups Air Fryer', 'Thermapen Instant Read Thermometer']",16,"['During the air frying process, if you pull out the chicken and notice any dry flour spots on the chicken, spray those spots lightly with oil. The breading will never crisp up if it doesn\\xe2\\x80\\x99t have a tiny bit of oil to hydrate it. It will just burn.', '4 Serve: When the fried chicken is ready, let it rest on a plate for a few minutes before serving. Serve immediately with salad, coleslaw, mashed potatoes, or your favorite fried chicken sides!', 'Cooked fried chicken can be stored in the fridge for 5 days and reheated in a 300\\xc2\\xb0F oven for 8 to 10 minutes.']",3
522,Char Siu Chicken Recipe,5,60,65,"['1 large garlic clove, put through a garlic press or minced and mashed', '1/4 teaspoon Chinese five-spice powder', '2 tablespoons honey, preferably amber colored', 'Brimming 2 tablespoons hoisin sauce', '1 1/2 tablespoons soy sauce', '1 tablespoon ketchup', 'Scant 2 teaspoons toasted sesame oil', '1 3/4 pounds boneless, skinless chicken thighs (See Recipe Note)', 'Special equipment:', 'Cast iron grill pan or grill']",10,"['1 Marinate the chicken: In a large bowl, stir together the garlic, five-spice powder, honey, hoisin, soy sauce, ketchup, and sesame oil. Remove 3 tablespoons and set aside for glazing the chicken.', 'Add the chicken to the bowl, coating the pieces well. Cover with plastic wrap and marinate at room temperature for 30 minutes, or refrigerate up to 24 hours (return to room temperature before cooking).', '2 Grill the chicken: Lightly oil a cast-iron stovetop grill pan and set over medium-high heat. Add the chicken and cook for 6 to 10 minutes, turning several times.', 'To test for doneness, pierce the flesh with the tip of a knife: The chicken is cooked when clear juices flow out.', 'During the last 2 minutes of cooking, when the chicken feels firm-ish, baste with the reserved marinade to freshen flavor and add sheen.', 'Alternatively, prepare a medium charcoal fire or preheat a gas grill to medium and cook the chicken for 10 to 12 minutes, basting during the last 3 minutes.', '3 Serve: Transfer to a platter and let rest for 5 to 10 minutes before serving.']",7
523,Quick Chicken Pho Recipe,10,30,40,"['3/4-inch (2 cm) section ginger', '2 medium-large green onions', '1 very small (.5 oz | 15 g) bunch cilantro sprigs', '1 1/2 teaspoons coriander seeds', '1 whole clove', '3 1/2 to 4 cups (840 ml to 1 l) low-sodium chicken broth', '2 cups (480 ml) water', '6 to 8 ounces (180 to 225 g) boneless, skinless chicken breast or thighs', 'About 1/2 teaspoon fine sea salt', '5 ounces (150 g) dried narrow flat rice noodles', '2 to 3 teaspoons fish sauce', 'About 1/2 teaspoon organic sugar, or 1 teaspoon maple syrup (optional)', 'Pepper (optional)', 'Optional extras: Bean sprouts, mint sprigs, Thai basil, cilantro leaves, lime wedges, thinly-sliced chili peppers']",14,"['1 Prepare the broth ingredients: Peel then slice the ginger into 4 or 5 coins. Smack with the flat side of a knife or meat mallet; set aside. Thinly slice the green parts of the green onion to yield 2 to 3 tablespoons; set aside for garnish. Cut the leftover sections into pinkie-finger lengths, bruise, then add to the ginger.', 'Coarsely chop the leafy tops of the cilantro to yield 2 tablespoons; set aside for garnish. Set the remaining cilantro sprigs aside.', '2 Toast the broth ingredients: In a 3- to 4-quart (3 to 4 l) pot, toast the coriander seeds and clove over medium heat until fragrant, 1 to 2 minutes. Add the ginger and green onion sections. Stir for about 30 seconds, until aromatic.', '3 Add the broth and bring to a simmer: Slide the pot off heat, wait 15 seconds or so to briefly cool, then pour in the broth.', 'Return the pot to the burner, then add the water, cilantro sprigs, chicken, and salt. Bring to a boil over high heat, then lower the heat to gently simmer.', '4 Remove the chicken from the broth once cooked: After 5 to 10 minutes of simmering, the chicken should be firm and cooked through (press on it and it should slightly yield).', '5 Continue to simmer the broth without the chicken for another 15 to 20 minutes (for a total of 30 minutes simmering time).', '6 Shred the chicken: Transfer the chicken to a bowl, flush with cold water to arrest the cooking, then drain. Let cool, then cut or shred into bite-size pieces. Cover loosely to prevent drying.', ""[Emma\\'s note: If the chicken isn\\'t quite cooked through when you begin to shred it, just split it into a few pieces and put it back in the broth for another few minutes until cooked through. The split pieces will quickly cook through.]"", '7 Soak the rice noodles in hot water until pliable and opaque. Drain, rinse, and set aside.', '8 Strain the broth: When the broth is done, pour it through a fine-mesh strainer positioned over a 2-quart (2-liter) pot; line the strainer with muslin for superclear broth. Discard the solids. You should have about 4 cups.', 'Season with fish sauce and sugar (or maple syrup), if needed, to create a strong savory-sweet note.', ""9 Finish the pho: Bring the strained broth to a boil over high heat. Put the noodles in a noodle strainer or mesh sieve and dunk in the hot broth to heat and soften, 5 to 60 seconds. Lift the noodles from the pot and divide between the 2 bowls. [Emma\\'s note: I didn\\'t find it necessary to soften my noodles any further. I just added them to the bowls and poured the hot broth over top. However, dunking them in the broth would make them more flavorful!]"", 'Lower the heat to keep the broth hot while you arrange the chicken on top of the noodles and garnish with the chopped green onion, cilantro, and a sprinkling of pepper. Taste and adjust the broth\\xe2\\x80\\x99s saltiness one last time. Return the broth to a boil and ladle into the bowls. Enjoy with any extras, if you like.', ""[Emma\\'s note: I just left the broth at a low simmer during this last step, rather than bringing it to a boil again. I thought it was plenty hot!]""]",15
524,Easy Chicken Parmesan Recipe,10,40,50,"['For the sauce:', ""1/2 large yellow onion, grated (don't cut onion in half, just grate half of a whole onion), about 3/4 cup of grated onion"", '1/4 cup extra virgin olive oil', '2 medium garlic cloves, minced', '1 (28-ounce) can crushed tomatoes', '1 teaspoon dried oregano', 'Pinch red pepper flakes', 'Pinch sugar', 'For the chicken:', '4 chicken breast cutlets (1 1/4 to 1 1/2 pounds)', 'Salt', '2 large eggs', '1 cup breadcrumbs, Panko or homemade', '1 cup freshly grated Parmesan cheese', '1/4 cup extra virgin olive oil', '2 tablespoons fresh basil leaves, thinly sliced', '8 ounces mozzarella cheese, sliced', 'To serve:', 'Cooked spaghetti, or sub rolls']",19,"['1 Start the sauce: Heat the olive oil in a saucepan on medium-high heat. Add the onions and saut\\xc3\\xa9 for 2 to 3 minutes. Add the minced garlic. Cook until fragrant, about a minute more.', 'Then add the crushed tomatoes, oregano, red pepper flakes, and sugar. Bring to a simmer; reduce the heat to maintain the simmer. Cook, uncovered while you prepare the chicken (about 10 to 12 minutes).', '2 Preheat oven to 400\\xc2\\xb0F.', '3 Pound cutlets thin: Place the chicken cutlets one at a time between two layers of plastic wrap or wax paper. Use a meat hammer, mallet, rolling pin, or even a heavy empty wine bottle to pound or roll the chicken pieces to an even thickness of 1/4 to 1/2-inch. Sprinkle salt on both sides of the cutlets.', '4 Prepare breadcrumbs and eggs for dredging: In a shallow bowl (large enough to dredge the cutlets), mix together the breadcrumbs, 1/2 cup Parmesan, and pinch of salt. In separate shallow bowl, whisk together the eggs.', '5 Dredge cutlets and brown them: Heat 1/4 cup olive oil in a large saut\\xc3\\xa9 pan on medium-high heat until the oil is shimmering (not smoking) and a piece of breading dropped into it sizzles.', 'Working one cutlet at a time, dip the chicken cutlet into the egg mixture and then into the breadcrumbs. Working in batches as to not crowd the pan, place the dredged cutlets into the pan.', 'Lower the heat to medium and gently fry the chicken cutlets until they are golden brown on each side, about 3 to 4 minutes per side.', '6 Prep the chicken for the oven: Spread enough tomato sauce to thickly coat the bottom of a 9x13 casserole pan or baking dish. Once the cutlets are browned on both sides, arrange them on top of the tomato sauce in the baking dish.', 'Spoon tomato sauce over each of the cutlets. Sprinkle the tops with sliced basil. Then lay slices of mozzarella over each cutlet and sprinkle with the remaining 1/2 cup of Parmesan cheese.', '7 Bake: Bake in the oven at 400\\xc2\\xb0F for 10 to 12 minutes, or until the mozzarella begins to brown.', '8 Serve: Serve with pasta and the remaining sauce, or in a large roll.']",12
525,Avgolemono Soup Recipe,10,25,35,"['2 tablespoons extra virgin olive oil', '1 cup chopped onion', '5 cups chicken stock, plus 1 cup water', '1/2 cup orzo or rice', '1 pound skinless chicken breast, diced', 'Salt', '3 tablespoons lemon juice', '3 eggs', 'Fresh parsley for garnish']",9,"['1 Saut\\xc3\\xa9 onions: Heat the olive oil in a medium pot and saut\\xc3\\xa9 the onions over medium-high heat until they are soft and translucent, 4-5 minutes.', '2 Cook orzo or rice: While the onions are cooking, bring another pot of salted water to a boil and add the orzo or rice.', '3 Add chicken stock to onions: When the onions are ready, add the chicken stock and water and bring to a bare simmer.', '4 Drain orzo or rice, add to stock and onions: When the orzo or rice is nearly done \\xe2\\x80\\x94 firm, but mostly cooked \\xe2\\x80\\x94 drain the boiling water and add the pasta or rice to the chicken broth.', '5 Add the diced chicken breast to the pot. Let this cook 5-8 minutes, then taste the soup for salt.', '6 Temper eggs: Beat the eggs in a bowl. Whisking constantly, add the lemon juice to the eggs. You will need to temper the eggs before you add the egg-lemon mixture to the soup. It takes both hands to do this.', ""With one hand, whisk the egg-lemon mixture vigorously. With the other, slowly pour in a ladle's worth of hot broth."", ""Do this at least twice, and you can add as many ladle's worth of broth as you want to the mixture."", '7 Whisk tempered eggs into soup and serve: Turn the heat off the soup. Whisk the soup with one hand while you pour the hot egg-lemon mixture in with the other.', 'Serve at once, garnished with parsley.']",10
526,"How to Poach Chicken, the Quick and Easy Way",0,15,15,"['1 to 4 boneless, skinless chicken breasts (roughly 12 ounces each)', '1 teaspoon salt', 'Optional seasonings: smashed garlic, bay leaf, peppercorns, sliced ginger, sliced lemons or oranges, sliced onions or celery, fresh rosemary, fresh thyme']",3,"[""1 Place the chicken in a single layer in the bottom of a pan. It's ok if the pieces overlap a little."", ""2 Cover with an inch of water. Add the salt and any seasonings you'd like to use."", ""3 Bring to a boil over medium-high heat. As the water comes to a boil, foam will start to collect on the surface. If you're planning to use the cooking liquid for something else, you can skim the foam off the surface. Otherwise, it's fine to just leave it."", ""4 Cover and simmer for 8 to 15 minutes: Once boiling, reduce the heat to low and cover the pan. Cook for 8 minutes, then begin checking the chicken to see if it's done. Thin cutlets will cook in about 8 minutes; large chicken breasts will need up to 15 minutes."", ""The chicken is done when it registers 165F in the thickest part of the meat with an instant read thermometer. You can also cut into the chicken to see if it's cooked through. Continue cooking and checking the chicken every minute or so until the chicken is cooked."", '5 Cool briefly, then shred or slice: Remove the chicken from the broth and place on a plate or cutting board. When cool enough to handle, shred or slice the chicken, as needed. Use immediately, or cool completely and refrigerate for up to 5 days. Shredded or sliced chicken can also be frozen for up to 3 months.']",6
527,Creamy Dijon Mustard Chicken Recipe,15,20,35,"['1 to 1 1/4 pound boneless, skinless chicken breasts', 'Salt', '2 tablespoons extra virgin olive oil + more for lightly coating chicken', '1 tablespoon butter', '1 cup sliced shallots', '1/2 cup dry white wine (can sub chicken stock)', '1/2 cup water', '4 tablespoons Dijon mustard, smooth, whole grain, or a mixture of both', '1 teaspoon dried thyme', '1/4 cup heavy cream']",10,"['1 Cut chicken breasts and pound thin: Remove chicken breasts from package and sprinkle with salt. Remove the tenderloin from each breast and set aside. Cut each chicken breast into 3 pieces, approximately the same size. Coat with just a little olive oil.', 'Place the breast pieces between two pieces of plastic wrap or parchment paper and use a mallet, empty wine bottle, or rolling pin to pound the chicken pieces to an even thinness of about 1/4 inch. Repeat with the tenderloin pieces.', '2 Lightly brown the chicken cutlets: In a large, heavy-bottomed saut\\xc3\\xa9 pan, heat the olive oil on medium high to high heat. Stir in the butter. When the butter is foamy, add the chicken pieces to the pan. Do not crowd the pan, if necessary work in batches.', 'Lightly brown chicken on one side, turn over and brown the other side. Do not overcook the chicken. The pieces are thin and they will cook quickly. Remove the chicken pieces from the pan and set aside while you make the sauce.', '3 Cook the shallots: Add sliced shallots to the pan. Lower the heat to medium. Stir to coat with the remaining fat in the pan. Cook until softened, about 5 to 6 minutes.', '4 Make the sauce: Add white wine to the pan and increase the heat to high. When most of the wine has evaporated, add the water, the mustard, and the dried thyme. Simmer until reduced by half.', '5 Add chicken back to pan, drizzle in cream: Reduce the heat to low. Add the chicken back to the pan and coat with the sauce. Remove the pan from heat and drizzle in the cream. Taste and adjust seasonings, adding more salt if necessary.', '6 Serve: Serve with egg noodles, rice, mashed potatoes, pur\\xc3\\xa9ed celery root or parsnips, or serve alone or with vegetables for low carb version.']",8
528,Grilled Cilantro Lime Chicken Recipe,5,40,45,"['2 pounds skinless, boneless chicken breasts', '2 tablespoons extra virgin olive oil for the marinade, plus more for grilling', 'Grated zest from 2 limes', 'Juice from 2 limes (about 1/4 cup)', '3 tablespoons chopped cilantro', '1/2 teaspoon sugar', '1/2 teaspoon salt', '1/4 teaspoon black pepper', 'Lime wedges, fresh sprigs of cilantro, and slices of avocado, to serve']",9,"['1 Pound chicken breasts to even thickness: Place the chicken breasts between two piece of plastic wrap or wax paper and pound to an even thickness with a meat mallet or rolling pin.', '2 Marinate the chicken: Mix the olive oil, lime zest, lime juice, cilantro, sugar, salt, and pepper together in a large bowl. Add the chicken and massage the marinade into the chicken. Cover and chill for at least 30 minutes, and up to 4 hours or overnight.', '3 Preheat Grill: Preheat a gas or charcoal grill for medium-high heat grilling, or until you can hold your hand about an inch over the grates for 1 second.', '4 Grill the chicken: Remove the chicken breasts from the refrigerator. Remove them from the marinade and pat them dry with paper towels. Coat the chicken breasts with some olive oil.', 'Soak a paper towel in a little more oil and use tongs to wipe the grill grates.', 'When the grill is hot, place the chicken breasts on the grill. Grill for a few minutes on each side, until just cooked through.']",6
529,Instant Pot Chicken Adobo and Rice Recipe,10,45,55,"['3 to 3 1/2 pounds bone-in, skin-on chicken legs and thighs (or 1 1/2 to 2 pounds boneless skinless chicken thighs)', '1 medium yellow onion, sliced', '4 garlic cloves, chopped', '1/3 cup soy sauce (use low sodium soy sauce for less salt, or tamari for gluten-free)', '3 tablespoons white vinegar (or rice vinegar for a milder flavor)', '1 tablespoon brown sugar', '1 teaspoon black peppercorns', '3 dried bay leaves', '1 1/2 cups long grain white rice', '1 1/2 cups water', 'Thinly sliced green onions, to garnish the rice (optional)', '  Special equipment:', '6-quart pressure cooker (I use an Instant Pot)', 'Raised steam rack', 'Wire strainer', 'Small stainless steel bowl']",16,"['1 Combine the chicken and sauce ingredients in the pressure cooker. Stir or use your hands to evenly coat the chicken pieces in the sauce.', 'Nestle a raised steam rack in with the chicken pieces, making sure all of its legs are touching the bottom of the pot.', '2 Rinse the rice: Rinse the rice in a wire mesh strainer, let it drain for a minute or so, then combine it with the 1 1/2 cups of water in a small (1 \\xc2\\xbd-quart) stainless steel mixing bowl.', 'Place the bowl of rice and water on top of the steam rack in the pot. It should just fit inside the pot, so it will not touch the lid when the pot is closed.', '3 Cook the chicken and rice. Place the lid on the pressure cooker. Make sure the pressure regulator is set to the \\xe2\\x80\\x9cSealing\\xe2\\x80\\x9d position. If you are using an Instant Pot, select the \\xe2\\x80\\x9cPoultry\\xe2\\x80\\x9d or \\xe2\\x80\\x9cManual\\xe2\\x80\\x9d program, then adjust the time to 15 minutes. If your pressure cooker does not have a \\xe2\\x80\\x9cPoultry\\xe2\\x80\\x9d program, set it manually to \\xe2\\x80\\x9cHigh Pressure\\xe2\\x80\\x9d for 15 minutes. For stovetop pressure cookers, cook for 12 minutes at high pressure.', 'It will take about 20 minutes for your pressure cooker to come up to pressure, and then the actual cooking will begin. Total time from the time you seal the pressure cooker to the finished dish is about 45 minutes (including a 10-minute natural pressure release).', '4 Release the pressure: When the cooking program ends, let the pressure release naturally for at least 10 minutes, then perform a quick pressure release by moving the pressure release knob from \\xe2\\x80\\x9cSealing\\xe2\\x80\\x9d to \\xe2\\x80\\x9cVenting.\\xe2\\x80\\x9d', '5 Fluff the rice: Wearing a pair of heat-proof mitts, remove the bowl of rice and the steam rack from the pot. Fluff the rice with a fork.', '6 Check the temperature of the chicken: Use an instant read thermometer to take the temperature of a piece of chicken at its thickest part. It should read at least 165\\xc2\\xbaF.', 'If the chicken isn\\\'t 165\\xc2\\xbaF yet, reset the pressure cooker and select the ""Poultry"" or ""Manual"" setting for another minute or two. It will take much less time to come up to pressure the second time since the food is already hot.', '7 Finish the sauce and serve: Transfer the chicken to a serving dish.', ""If you\\'d like, you can reduce the sauce to concentrate the flavor using your pressure cooker\\xe2\\x80\\x99s \\xe2\\x80\\x9cSaut\\xc3\\xa9\\xe2\\x80\\x9d setting for 15 minutes."", 'Strain the sauce to catch the bay leaves, peppercorns, and any bones that might have fallen from the chicken. If you prefer a less fatty sauce, use a fat separator to separate the sauce and the fat, or wait for the fat to float to the top and then skim it off.', 'Drizzle some of the sauce over the chicken and serve the rest alongside.']",14
530,Chicken Florentine Pesto Pasta Recipe,10,20,30,"['12 ounces dried short pasta (bowties, penne, gemelli, etc)', '4 chicken breast cutlets (1 to 1 1/2 pounds total)', 'Salt', '2 tablespoons extra virgin olive oil', '1 medium onion, chopped, about 1 cup', '3 garlic cloves, minced', '1/2 cup white wine or stock', '8-16 ounces of fresh spinach*, washed, long stems removed and chopped', 'Black pepper', '1/4 cup heavy whipping cream', '1/4 cup (or more) pesto', '*To wash spinach, fill up a clean sink basin with cold water and let the spinach soak in the water. Move it around a bit to loosen any dirt. Fresh spinach is usually pretty dirty, so you may need to do a couple of soakings. Remove the spinach and shake off excess water. Lay the spinach leaves down on a clean towel and pat dry.']",12,"['1 Start cooking the pasta: Bring a large pot of salted water (add enough salt so that the water tastes salty) to a boil. Add the dried pasta and cook until al dente.', ""2 Cook the chicken: While preparing the pasta, cook the chicken. Sprinkle the chicken breasts with salt, heat the olive oil in a saut\\xc3\\xa9 pan and brown the chicken breasts on both sides over medium-high heat. They don't need to be cooked all the way through, just browned. Remove the chicken from the pan and set aside."", '3 Saut\\xc3\\xa9 onions: Add the chopped onion to the pan and saut\\xc3\\xa9 2-3 minutes, stirring occasionally. While the onions cook, slice the chicken into strips. Put any pieces that are cooked all the way through in one pile, and put the ones that still need a little cooking in another pile.', '4 Add garlic, then white wine or stock: When the onions are just beginning to brown, add the garlic and cook another minute. Add the white wine or stock and boil vigorously until the liquid is reduced by half.', '5 Add spinach, chicken: Add the spinach and the undercooked pieces of chicken to the pan. Using tongs, turn them over to coat them with the juices in the pan. Continue to cook, turning and stirring often, until the spinach is wilted and the chicken cooked through, about 2 minutes.', '6 Combine chicken, spinach, pesto, pasta, cream: Turn off the heat and add some black pepper, the pile of cooked chicken pieces and the pesto. Stir to combine. Drain the pasta put it in a large bowl. Add the cream to the saut\\xc3\\xa9 pan and stir well to combine. Add the contents of the pan to the bowl with the pasta and mix well. Serve at once.']",6
531,Chicken Milanese Recipe,30,15,45,"['4 large skinless boneless chicken breasts (1 1/2 pounds, 680 g)', '1 1/2 cups (190 g) all-purpose flour', '1 teaspoon salt', '1/2 teaspoon ground pepper', '3 large eggs', '2 cups (144 g) Panko breadcrumbs', '8 tablespoons (120 ml) olive oil, or more if needed', '1 lemon, cut into wedges, for serving']",8,"['1 Prepare the chicken: Set aside any smaller breasts or cutlets that are 1/2-inch thick. Set larger breasts on a cutting board. Hold the top of the chicken steady with one hand and hold a sharp knife parallel to the table in the other hand, then butterfly the breast in half like opening a book (watch your fingers!). Cut all the way through to make two thin pieces.', 'Continue with the remaining large breasts. Pat them dry with paper towels. Set them on a rimmed baking sheet.', '2 Pound the chicken: Set one of the chicken breast slices between 2 sheets of plastic wrap. Use a meat mallet or small heavy pan to pound the breast to flatten it \\xe2\\x80\\x93 six or so good whacks should do it.  Continue with the remaining breasts, returning them to the baking sheet.', '2 Set up an assembly line for coating the chicken: In a pie pan or shallow bowl, place the flour, 1/2 teaspoon of the salt, and pepper. Stir thoroughly. In another pie pan or shallow bowl, beat the eggs with the remaining 1/2 teaspoon salt. In a third pie pan or bowl, place the Panko.', 'Set the pan of chicken on the counter. Set the flour next to it on the right. Set the egg to the right, then the Panko as the last thing in the row.', '3 Coat the chicken: With tongs, dip one slice of chicken in flour, making sure both sides are coated and shaking the excess into the bowl. Next, coat the chicken in egg and lift it up so the excess falls back into the bowl. Finally, transfer to the Panko and coat both sides.', 'Return the chicken to the baking sheet. Continue with the remaining breasts until they are all coated.', '3 Cook the chicken in batches: Heat the oven to 250F with a baking sheet on a middle rack. Set a heavy 12-inch skillet over medium-high heat.', 'Add enough of the olive to the pan to make a 1/4-inch layer (about 4 tablespoons). Heat until the oil shimmers and flows; when hot, a piece of Panko thrown in the oil should sizzle.', 'Add 3 pieces of chicken in a single layer and cook without moving for 4 minutes, or until the bottoms are golden. Turn and brown the other sides for another 4 minutes, or until the chicken is cooked through.', '4 Keep the chicken warm: Transfer the finished chicken to the oven so they stay warm while you cook the remaining breasts. Cook the remaining breasts, adding more oil to the pan as needed to keep it coated.', '5 To serve: Serve right away with lemon and a green salad.', ""If making ahead, let the cooked chicken cool completely on a parchment-lined baking sheet, then store in the fridge. If you're planning on reheating in a few hours, you can leave them on the baking sheet. Otherwise, layer them in an airtight container with parchment between the layers, and refrigerate for 1 to 3 days."", 'To reheat, let the chicken cutlets sit out for half an hour to lose their chill, then warm in a 400F oven for 8 to 10 minutes or until piping hot and crispy.']",14
532,Firecracker Chicken Recipe,5,45,50,"['For the sauce:', ""1/2 cup buffalo sauce, like Frank's"", '3/4 cup brown sugar', '2 teaspoons apple cider vinegar', '1/4 teaspoon salt', '1/4 teaspoon red pepper flakes', 'For the chicken:', '2/3 cup cornstarch', '1 teaspoon salt', '1 teaspoon black pepper', '1 1/2 pounds boneless skinless chicken breasts or thighs, cut into 1-inch cubes', '3 large eggs', '1/2 cup vegetable oil', 'To serve:', 'Cooked rice', 'Fresh scallions, just the green ends, chopped']",16,"['1 Preheat the oven to 400\\xc2\\xb0F and prep the sauce. Stir together the sauce ingredients in a medium bowl and set aside.', '2 Prep the chicken: In a bowl or large plastic bag, combine the cornstarch, salt, and pepper. Add chicken and toss to coat well.', 'Whisk together the eggs in a medium mixing bowl. Line a plate with paper towels. Arrange everything near your stove.', '3 Fry the chicken on the stovetop: In a large, deep skillet or wok, warm the vegetable oil over medium-high heat until a flick of water sizzles on contact.', 'As soon as the oil is hot, transfer the coated chicken to the bowl with the eggs and toss to coat well. Scoop out the chicken pieces with a slotted spoon, allowing any excess egg to drain off, and transfer the chicken to the skillet in an even layer.', 'Cook for about 3 minutes per side until a crust forms and the chicken is a light tan color. The chicken will not be cooked through at this point.', '4 Sauce the chicken: When chicken is done, remove it from the skillet with a slotted spoon and transfer it to the plate lined with paper towels to drain off any excess oil.', 'Transfer to a 9x13 baking dish. Add sauce and toss to combine.', '5 Bake the chicken: Bake chicken for 25 to 30 minutes, stirring halfway through to ensure even cooking. When the chicken is done, it should be cooked through and the sauce will thicken and turn into a glaze coating the chicken.', '6 Serve: Serve chicken with cooked rice garnished with scallions.']",10
533,Greek Lemon Chicken Skewers with Tzatziki Sauce Recipe,25,37,62,"['1 1/4 pound boneless, skinless chicken breasts, trimmed of excess fat', '1 teaspoon salt', '2 tablespoons plain yogurt', '2 cloves garlic, minced (about 2 teaspoons)', '1 tablespoon minced fresh oregano (or 1 1/2 teaspoons dried oregano)', '1/8 teaspoon freshly ground black pepper', '1 teaspoon lemon juice', '1 tablespoon extra virgin olive oil plus more for the grill', '2 lemons, thinly sliced', 'Tzatziki:', '1 cup plain yogurt', '2 cloves of garlic, minced (about 2 teaspoons)', '1/2 teaspoon kosher salt', '1/8 teaspoon black pepper', '1 tablespoon lemon juice', '1 cucumber, peeled']",16,"[""1 Soak the skewers: If using bamboo or wooden skewers, place them in water to soak while you prepare the recipe. You'll need either 4 flat skewers or 8 regular round skewers."", '2 Cut chicken breasts, marinate: Cut the chicken breasts into 1 1/2 to 2 inch chunks. Place in a bowl and sprinkle with salt. Add the yogurt, minced garlic, oregano, pepper, lemon juice, and olive oil to the bowl with the chicken, stir to combine. Marinate for 30 minutes to an hour.', '3 Make yogurt tzatziki sauce: While the chicken is marinating, make the tzatziki. In a medium bowl stir to combine the yogurt, minced garlic, salt, pepper, and lemon juice.', 'Grate the cucumber with the large holes of a box grater. Place in a strainer and press with your hands to squeeze out excess moisture. Add the grated cucumber to the yogurt mixture.', '4 Thread skewers with chicken and lemon slices: Prepare your grill for direct high heat. While the grill is heating, prepare the skewers. Use either flat bamboo or metal skewers or double up regular bamboo skewers so that the chicken is easier to turn on the grill. Thread the chicken pieces onto the skewers with a lemon slice folded over like a taco between each piece of chicken.', '5 Grill: When the grill is ready brush the grill grates with a little olive oil (use a paper towel folded over several times and dipped in olive oil, hold with tongs). Brush some olive oil over the chicken skewers as well. Place the chicken skewers directly over the hottest part of the grill and cover the grill.', 'Allow to sear on one side (about 2 to 3 minutes), then turn the chicken skewers over to the other side, cover and cook 2 to 3 minutes more, until the chicken is browned and just cooked through.', 'Remove from grill and serve immediately with tzatziki sauce.']",8
534,Chicken with Creamy Mushroom Sage Sauce Recipe,10,20,30,"['3 tablespoons butter', '1/2 cup chopped shallots', '8-10 ounces cremini or button mushrooms, thickly sliced', 'A couple shiitake mushrooms, thinly sliced', '1 teaspoon chopped fresh parsley', '1 cup dry vermouth or dry white wine (such as Sauvignon Blanc)', '2/3 cup heavy whipping cream (light cream may curdle, so use heavy cream)', '3 tablespoons chopped fresh sage', '1 tablespoon extra virgin olive oil', '1 1/4 to 1 1/2 pounds chicken breast cutlets, or skinless, boneless chicken breasts pounded to an even 1/4 inch to 1/3 inch thickness', 'Salt and freshly ground black pepper']",11,"['1 Cook the shallots and mushrooms: Melt the butter in a large saut\\xc3\\xa9 pan on medium high heat. Add the shallots and saut\\xc3\\xa9 for one minute.', 'Add the mushrooms and parsley and saut\\xc3\\xa9 for 7-10 more minutes, or until the mushrooms have browned. If you are using unsalted butter, sprinkle on a pinch of salt.', '2 Make the sauce: Add the vermouth and deglaze the pan, scraping up any bits that may be sticking to the bottom of the pan.', 'Stir in the cream. Bring to a simmer and cook for 3 to 5 minutes, or until the sauce is thick enough to coat the back of a wooden spoon.', '3 Cook the chicken cutlets: While the sauce is simmering, heat the olive oil in another large saut\\xc3\\xa9 pan on medium high heat. Sprinkle salt and pepper over both sides of the chicken breast cutlets.', 'Add cutlets to pan and cook for about 3 minutes on each side, until browned and cooked through.', '4 Finish the sauce and serve: Stir the sage into the sauce, and season to taste with salt and pepper. Pour the sauce over the chicken.', 'Serve alone or with a vegetable (for low carb version) or with rice, mashed potatoes, or pasta (use gluten-free pasta for gluten-free version). Garnish with chopped fresh parsley.']",8
535,Chicken and Apples in Honey Mustard Sauce Recipe,5,25,30,"['1/2 cup sweet apple cider', '1 1/2 teaspoons cornstarch', 'Salt', 'Freshly ground black pepper', '1 tablespoon honey', '2 tablespoons Dijon mustard', '1/2 cup flour, for dredging', '1 pound boneless, skinless chicken breasts', '2 tablespoons extra virgin olive oil', '2 small unpeeled apples, cored and cut into eighths (use Fuji, Granny Smith, Jonathan, Jonagold, Pippin, or McIntosh apples, good cooking apples)', '1/2 cup chicken broth', 'Fresh parsley for garnish']",12,"['1 Whisk apple cider, cornstarch, mustard, honey, salt and pepper (to taste) in a bowl. Set aside.', '2 Salt the chicken well and dust in flour. Shake off the excess.', '3 Brown the chicken breasts and apple slices: In a large non-stick skillet, heat the oil on medium to medium high heat. Once the oil is hot add the chicken breasts to the pan. Cook until well browned on one side, about 3-4 minutes.', 'Turn chicken, add apples, and cook until the chicken has browned on the other side.', '4 Add broth cider mixture, cover and simmer: Add chicken broth and cider mixture to the pan and bring to a boil. Turn the heat down to low, cover the pot and simmer until chicken is tender, about 15 minutes.', '5 Reduce sauce: With slotted spoon, remove chicken and apples to serving plates. Increase the heat of the pan to high and simmer the sauce for a minute or two until it thickens.', 'Spoon sauce over chicken and apples and sprinkle with parsley.', 'Serve with rice or noodles.']",8
536,Skillet Chicken with Cheesy Orzo and Zucchini Recipe,15,30,45,"['1 to 2 tablespoons olive oil, as needed', '2 pounds boneless, skinless chicken breasts (4 to 6 pieces)', '1 medium yellow onion, chopped (about 1 cup chopped)', '1 1/2 cups dried orzo', '2 medium zucchini, cubed (about 2 cups cubed)', '2 teaspoons minced fresh thyme', '1/2 teaspoon salt', '3 cups chicken broth', '1 cup half-and-half (or whole milk)', '1/2 cup grated cheddar', '1/2 cup grated fontina or Havarti']",11,"['1 Sear the chicken: In a very large skillet, heat 1 tablespoon of the olive oil over medium-high heat. Season the chicken on both sides with salt and pepper.', 'Sear the chicken for about 4 minutes on each side, or until browned but not cooked through. (It should still be just barely pink in the center, if you want to cut into one of the pieces to test.) Transfer the chicken to a plate and set aside.', '2 Cook the onions and add the orzo: Reduce the heat to medium and add the remaining tablespoon of olive oil if needed (if there is still about a tablespoon of oil left in the pan, skip it).', 'Add the onions and saut\\xc3\\xa9 for 2 minutes until they start to become tender. Add the orzo and stir for another minute to coat it with the oil and onions.', '3 Add the zucchini and stock, and simmer: Stir in the zucchini, thyme, and 1/2 teaspoon of salt. Add the chicken broth, raise the heat to medium-high and allow the liquid to come to a simmer, about 3 minutes, scraping up any browned bits from the bottom.', 'Stir in the half-and half and bring it to a simmer, about 2 minutes. Cover the pan, lower the heat and simmer gently for about 8 minutes, stirring occasionally, until the orzo is almost tender. Much of the liquid will be absorbed, but it should still be fairly runny at this point.', '4  Add the cheese and chicken: Sprinkle in the cheeses in batches, stirring after each addition until the cheese is all melted. Taste the orzo after all the cheese is added and add additional salt if needed.', 'Tuck the browned chicken into the top of orzo mixture, and drizzle over top any juices that accumulated from the chicken as it rested.', 'Cover the pan and simmer for another 3 to 5 minutes, until the chicken is cooked through (165\\xc2\\xb0F with a digital thermometer) and the orzo and zucchini are tender. The orzo mixture will have thickened slightly, but should still be quite saucy, like a very loose risotto.', '5 Serve immediately: Serve the chicken and orzo hot from the pan.']",10
537,Chicken Minestrone with Basil Pesto Recipe,20,25,45,"['2 tablespoons olive oil', '1 large yellow onion, diced small', '3 ribs celery, diced small', '3 medium carrots, diced small', '2 small (12 ounces) zucchini, diced small', '1/2 teaspoon salt, plus more to taste', 'Black pepper, to taste', '1 can (15 ounces) cannellini beans, drained and rinsed, or 1 1/2 cups cooked white beans', '1 can (28 ounces) whole San Marzano tomatoes, with juices', '6 cups chicken stock or water', '1/2 cup small pasta, such as small shells, ditalini, or ancini di pepe,', '2 handfuls (8 ounces) green beans, trimmed and cut into 1-inch lengths', '3 cups cooked, shredded chicken', '1 cup pesto, homemade or store-bought']",14,"['1 Cook the vegetables: In a large soup pot over medium heat, heat the oil. Add the onion, celery, carrots, zucchini, and 1/2 teaspoon salt. Cook, stirring occasionally, for 5 minutes, or until the vegetables begin to soften.', '2 Crush the tomatoes in a bowl: Pour the tomatoes and their juices into a bowl. Using your hands, a dinner fork, or a potato masher, crush the tomatoes into small pieces.', '3 Simmer the soup: Add the beans, crushed tomatoes and stock or water to the pot and bring to a simmer.  Cook for about 8 minutes. Add the green beans and the pasta and continue to cook for 8 to 10 minutes, or until the pasta is tender. Stir in the shredded chicken and cook for another minute, or until the soup is hot all the way through.', 'Taste the soup and add more salt and black pepper to taste.', ""If you haven't already done so, make your pesto while the soup simmers."", '4 Serve the soup: Ladle the soup into bowls and garnish with a few spoonfuls of pesto.']",6
538,Teriyaki Chicken Breasts Recipe,0,30,30,"['3/4 cup soy sauce* (or mix tamari** and water in equal proportions to make 3/4 cup)', '3/4 cup sake', '3/4 cup mirin', '4 Tbsp sugar', 'A 1-inch piece of ginger, grated fine', '4 skinless, boneless chicken breasts, about 1 1/4 to 1 1/2 pounds total (set out for 30 minutes to come to room temp)', '2-3 Tbsp sesame seeds', '*Use gluten-free soy sauce for gluten-free version.', '**If you are using tamari instead of soy sauce, use half as much, as tamari is more concentrated than soy sauce.']",9,"['1 Gently simmer chicken in sauce made with sake, mirin, soy sauce, sugar, ginger: Mix the grated ginger, sugar, soy sauce, sake and mirin in a pot and bring to a boil. Add the chicken breasts, return to a simmer, then lower the heat to the lowest possible setting (warm if you can), on your smallest burner, and cover.', 'The idea is to cook the chicken as gently as possible, below a simmer. Cook for 20 minutes.', 'If you are working with somewhat large chicken breasts, you may need to cook them longer, or cut them in half before cooking.', '2 Toast sesame seeds: While the chicken is poaching, toast the sesame seeds in a dry pan until they begin to brown. Move to a small bowl and set aside.', '3 Set aside chicken, cover with foil: Remove the chicken breasts from the teriyaki sauce, set on a plate and wrap with foil.', '4 Reduce sauce: Bring the sauce back to a boil and boil vigorously until the sauce is reduced to a syrup, about 8-10 minutes. Keep an eye on the sauce, stirring it occasionally.', '5 Slice chicken, cover with sauce, sprinkle with sesame seeds and serve: To serve, slice the chicken breasts, cover with the teriyaki sauce and sprinkle sesame seeds on them. Serve with plain white rice.']",7
539,Mediterranean Chicken Salad Recipe,10,25,35,"['1/2 cup minced red onion', '2 tablespoons red wine vinegar', '1 pound boneless, skinless chicken breasts', 'Salt', '2 tablespoons extra virgin olive oil', '1 tablespoon capers', '3/4 cup mixed pitted deli olives, sliced', '1 pinch of red chile flakes', '1 tablespoon chopped fresh oregano or basil (or both!)', '2 tablespoons chopped fresh parsley', 'Black pepper to taste', 'Optional:', 'Endive lettuce for appetizer boats, or chopped to add to the salad', 'Butter lettuce for lettuce cups', 'Fusilli pasta, about 1/4 pound dry for one batch of the salad (use gluten-free pasta for gluten-free option)']",15,"['1 Marinate the onion in vinegar: Mix the minced onion with the vinegar in a bowl and set aside. This quick pickling will take the edge off of the onions.', '2 Poach the chicken: Bring 1 1/2 quarts of water to a boil and add about 2 tablespoons of salt. Cut the chicken breasts in half crosswise and place them in the water. Reduce the heat to low and let the chicken cook very gently, at barely a simmer, for 10-15 minutes, until just cooked through.', '3 Combine the other salad ingredients: While the chicken is cooking, mix the olive oil, capers, olives, chile flakes, and oregano in a large bowl.', '4 Dice or shred the chicken: When the chicken is done, place it on a cutting board to cool. Add the onions to the bowl with the olives. Once the chicken has cooled enough to handle, cut it into dice or shred it.', '5 Combine chicken, parsley, with other salad ingredients: Gently mix the chicken and parsley in with the olives. Add salt and black pepper to taste. Serve warm, at room temperature, or chilled.']",5
540,Grilled Chicken Nachos Recipe,15,10,25,"['Nachos:', '8 ounces tortilla chips', '2 cups finely grated cheddar cheese', '1 cup chopped cooked chicken meat (a rotisserie chicken is great for this)', '1/4 cup BBQ Sauce', 'Sour Cream BBQ Sauce:', '1/2 cup sour cream', '1/4 cup BBQ Sauce', 'Extras (all optional):', '1 tomato, chopped', '1/4 red onion, chopped', '1 jalapeno, thinly sliced', '1/2 bunch cilantro, chopped', '1/2 avocado, chopped', ""You\\'ll need:"", '2 15x12-inch sheets of heavy duty aluminum foil']",16,"['1 Preheat grill and prep ingredients: Preheat your grill for high direct heat. While the grill is heating, prep the ingredients.', '2 Mix BBQ sauce with chicken: Mix the cooked chicken with the BBQ sauce and set aside.', '3 Make sour cream BBQ sauce: Mix the sour cream with BBQ sauce and set aside.', '4 Make foil boats: Take the sheets of aluminum foil and crimp the sides so that you have ""boats"".', ""5 Assemble nachos: Arrange a layer of tortilla chips over the bottom of the foil. It\\'s okay if some of the chips overlap, but all chips should have some exposure at the top. Sprinkle with most of the cheese (reserve some to go on top of the chicken)."", 'Sprinkle the BBQ sauce coated cooked chopped chicken over the chips. Sprinkle with remaining cheese.', '6 Grill: Place nacho boats on pre-heated grill, cover and cook for 5 to 10 minutes, until the cheese is melted and the chips are lightly browned at the edges.', ""If your grill doesn\\'t have a cover (as in a campfire), either make a large foil packet to put the nachos in, or tent the foil boats with another piece of foil. Some of the nachos prepared this way may not be as crispy, but they\\'ll still be great."", '7 Serve: To serve, drizzle with sour cream BBQ sauce and sprinkle with extras such as chopped tomato, red onion, jalape\\xc3\\xb1o, and/or cilantro.']",9
541,Chipotle Salsa Baked Chicken Recipe,10,35,45,"['1 15-ounce can fire roasted tomatoes (or canned whole or crushed tomatoes if fire roasted are not available)', '1/4 cup chopped red onion', '1 clove garlic, chopped', '1/2 cup, packed, chopped fresh cilantro', '2 chipotle chili peppers in adobo, plus 1 teaspoon adobo sauce (less or more to taste)', '1 teaspoon lime juice', '1 teaspoon kosher salt', '1 1/2 pound boneless, skinless chicken breasts (or thighs), trimmed of excess fat, cut into 3-inch wide pieces', '4 ounces grated or sliced Monterey jack cheese', 'Serve with or over', 'Avocados', 'More chopped cilantro', 'Sour cream', 'Corn or flour tortillas', 'Rice', 'Pasta']",16,"['1 Make the salsa: Place tomatoes, onion, garlic, cilantro, chipotle peppers and adobo, lime juice and salt in a blender or food processor. Pulse a few times so there are no more large chunks of anything, but not so much so that the salsa is completely smooth.', '2 Spread salsa over chicken: Preheat the oven to 350\\xc2\\xb0F. Place the chicken pieces in a casserole dish, just large enough to fit them all in a single layer (about 8x10-inches).  Spread the chipotle salsa over the chicken pieces, turning the chicken pieces to coat them all over with the salsa.', '3 Bake, layer with cheese, bake again: Cover with aluminum foil and bake for 25 minutes (30 minutes for thighs). Remove the foil, and sprinkle or layer the cheese over the chicken. Bake uncovered for 10 minutes more.', 'Serve over rice, pasta, or with tortillas on the side, along with chopped avocado, more cilantro, crema fresca or sour cream.', 'Variation: This is a bake-in-the-oven recipe. You could easily adapt the recipe to the stovetop this way:  sear the chicken pieces first in a little olive oil, remove the chicken, add the onions to the pan, cook them till soft, add the garlic and chiles, cook a little longer, add the tomatoes, lime juice, cilantro, and salt, then add the chicken, coat the chicken with the sauce, bring to a low simmer, cover, cook for 25 minutes, sprinkle with cheese, cover and cook for a few more minutes until the cheese is melted.']",5
542,Chicken with Goat Cheese and Arugula Recipe,15,15,30,"['4 chicken breasts (about 1 1/2 lbs total), tenders removed, breasts pounded thin', 'Salt', 'Ground black pepper', '1 large bunch arugula (about 4 ounces, trimmed)', '4 oz of soft goat cheese (chevre) broken into small pieces', '1-2 tablespoons butter or extra virgin olive oil', 'Wooden Toothpicks']",7,"['1 Pound chicken breasts thin: Preheat oven to 425\\xc2\\xb0F. Pound the breasts thin to make them thin enough for rolling. To do this place a piece of plastic wrap over the chicken breast. Use the smooth side of the meat pounder to pound the piece thin.', '2 Layer arugula and cheese on cutlets: Season the chicken pieces with salt and pepper. On a clean work surface lay cutlets flat, smooth side down. Layer with arugula leaves and pieces of goat cheese in the center.', '3 Roll up and secure with toothpicks: Starting with the narrowest ends, roll up the chicken cutlets into a tight roulade and seal with toothpicks to keep from unrolling.', '4 Brown chicken roulades on all sides Heat the oil on medium high in a large cast iron pan (or other non-stick oven-proof skillet). Place the chicken roulades in the pan and brown on all sides.', '5 Finish in oven: Place the skillet in the oven and cook until the chicken is cooked through, about 10 to 12 minutes. Remove pan from oven (take care to not touch pan handle with bare hands!) and remove the chicken from the pan.', '6 Cover with foil and let rest for 5 minutes. Remove the toothpicks from the chicken and slice the roulades into rounds to serve.']",6
543,Chicken Curry Salad Recipe,10,15,25,"['2 tablespoons extra virgin olive oil', '1 1/2 pound skinless chicken breast, cut into 1 inch cubes', 'Salt', '1 yellow onion, roughly chopped', '2 heaping tablespoons yellow curry powder', '1 cup raisins (soak in water while you prep)', '1 apple (tart or sweet, your preference), peeled, cored, and diced', '1/2 cup chopped fresh cilantro (just lightly packed)', '2 green onions, sliced', '1 tablespoon mayonnaise optional']",10,"['1 Saut\\xc3\\xa9 cubed chicken breast: Heat olive oil on medium/medium-high heat in a thick-bottomed saut\\xc3\\xa9 pan. Add chicken breast cubes and cook, stirring frequently until just cooked through, about 5 minutes. Sprinkle some salt on the chicken pieces while cooking.', 'Check doneness by removing the thickest piece and cutting it in half. If it is still pink in the middle, keep cooking. Try not to overcook the chicken or it will be dry.', 'Remove chicken pieces with a slotted spoon, set aside in a bowl.', '2 Saut\\xc3\\xa9 onion, curry, raisins: Add chopped yellow onion and cook. After a few minutes, when the onions are beginning to get translucent, add 2 heaping tablespoons of yellow curry powder. Cook a few minutes more, stirring frequently.', 'If the curry sticks to the bottom or the mixture gets dry, add a bit more olive oil to the pan. As you stir, scrape up the stuck curry bits.', 'Add drained raisins, and cook, stirring another minute. (If adding optional mayonnaise, remove curry from heat and mix in mayo.)', '3 Add raisin onion mixture to chicken: Add raisin and onion mixture to chicken and mix well, coating the chicken pieces with the curry infused olive oil. Refrigerate until cool. At this point you can make the salad a day a head of time.', '4 Mix in apple, green onions, cilantro to serve: When you are ready to serve the salad, mix in the apple, green onions, and cilantro.']",8
544,Quick Green Curry Chicken with Zucchini Noodles Recipe,20,15,35,"['1 1/4 pounds boneless skinless chicken thighs', '2 cloves garlic, minced', '2 teaspoons minced ginger', '1 1/4 teaspoons kosher salt, divided', '1 1/4 pounds zucchini', '1/2 medium yellow onion (about 2/3 cup sliced)', '1 large red bell pepper', '1 large carrot', '1 1/2 tablespoons canola oil (or any high heat oil), divided', '1 1/2 tablespoons green curry paste (like Thai Kitchen or Maesri)', '3/4 cup full-fat coconut milk', '1/2 cup water', '1 1/2 tablespoons lime juice', '3 tablespoons chopped Thai basil, divided', 'Special equipment:', 'Spiralizer']",16,"['1 Prepare and marinate the chicken: Cut the chicken thighs into 1/2-inch to 1-inch pieces. Transfer the chicken to a bowl. Add the garlic, ginger and 3/4 teaspoon salt to the bowl and mix to combine the ingredients. Set the chicken aside while you prep the vegetables.', '2 Spiralize the zucchinis: Rinse the zucchini and trim off the tops and ends. If you have any zucchini that is slightly curved, slice those in half. Make thin zucchini noodles using a spiralizer.', 'Once you have spiralized all the zucchini, give the noodles several rough chops to shorten them. Set the zucchini aside.', '3 Prepare the vegetables: Cut the onion into thin slices. Peel the carrot, cut it into thirds, and then cut each third into thin matchsticks. Remove the seeds from the red pepper, cut it into thick 1-inch slices, and then cut each crosswise into thin matchsticks.', '4 Make and simmer the curry: Heat a large skillet or saut\\xc3\\xa9 pan with 1 tablespoon of oil over medium-high heat. Once the pan is hot, add the sliced onions and cook for about 2 minutes, until they start to soften.', 'Transfer the chicken to the pan and spread it around. Cook the chicken for about 3 to 4 minutes, stirring occasionally. The chicken does not need to be fully cooked.', 'Add green curry paste and stir to coat with the chicken. Add the remaining vegetables and toss with the chicken. Add the coconut milk and water.', 'Reduce the heat to medium-low, cover, and let everything simmer while you cook the zucchini.', '5 Cook the zucchini noodles: Heat another large skillet or pan with 1/2 tablespoon of oil over medium-high heat. Once the pan is hot, add the zucchini noodles and cook for about 3 minutes. The noodles should be softened but not mushy.', 'Season with a pinch of salt and 1 1/2 tablespoons chopped basil, if using. Turn off the heat.', '6 Finish and serve: Uncover the chicken curry and mix in the remaining chopped basil, lime juice and 1/2 teaspoon salt. Taste the chicken curry and add more salt, if necessary. Serve the chicken with zucchini noodles, spooning extra curry sauce over top.']",11
545,Chicken Curry with Sweet Potato and Lemongrass Recipe,15,40,55,"['1/2 cup coarsely chopped lemongrass, from 2 medium stalks', '2 tablespoons coarsely chopped peeled ginger', '1 medium yellow onion, coarsely chopped', '2 tablespoons Madras-style curry powder, preferably Sun brand', '1/2 teaspoon freshly ground black pepper', '1/4 teaspoon cayenne pepper, optional', '1 (13.5-ounce) can full-fat, unsweetened coconut milk, not shaken', '2 tablespoons virgin coconut oil or neutral oil, such as canola', '4 large boneless, skinless chicken thighs (about 1 3/4 pounds total), each cut into 3 pieces', '1/2 teaspoon fine sea salt', '1 1/4 pounds sweet potatoes (white or orange flesh), peeled and cut into 1-inch chunks', '3 to 5 fresh cilantro sprigs, coarsely chopped']",12,"['1 Make the curry paste: In a food processor, whirl the lemongrass into a fine texture, about 3 minutes, pausing occasionally to scrape down the bowl. Add the ginger and pulse to finely chop. Add the onion and pulse again to chop.', 'Add the curry powder, black pepper, and cayenne (if using) and whirl until you have a fragrant yellow paste, about 30 seconds.', '2 Prep the coconut milk: Do not shake the can of coconut milk. Open the can and remove 1/3 cup of the thick cream at the top of the coconut milk. Stir the remaining lighter milk, and set both aside.', '3 Begin cooking the curry: In a 3- to 4-quart pot over medium-high heat, melt the coconut oil. Add the lemongrass paste and cook for 3 to 5 minutes, stirring frequently, until fragrant and no longer raw and harsh smelling. Lower the heat as needed to avoid scorching.', 'Add the chicken and 1/2 teaspoon salt, stir to combine, and cook for 1 minute to meld the flavors. Add the coconut milk and a little water to cover the chicken. Bring to a simmer over medium-high heat, cover, and adjust the heat to gently simmer for 15 minutes, stirring occasionally.', '4 Add the sweet potatoes: Uncover the pot, add the sweet potatoes, and return the curry to a simmer. Continue cooking for 10 to 12 minutes, uncovered and stirring occasionally, until the potatoes are tender.', '5 Finish the curry: Turn off the heat, stir the coconut cream into the sauce, and let rest on the burner\\xe2\\x80\\x99s receding heat for 10 minutes, uncovered, to blend and mature flavors. Taste and season with salt (unsalted curry powder may require an additional teaspoon), and splash in a bit of water if the flavors are too strong.', 'Serve immediately, garnished with the cilantro.']",8
546,Chicken Cordon Bleu Recipe,45,30,75,"['1 1/2 teaspoons kosher salt', '1/2 teaspoon granulated garlic powder', '1/4 teaspoon ground black pepper', '3/4 cup all-purpose flour', '1 1/2 cups panko or regular breadcrumbs', '1 tablespoon chopped fresh parsley', '2 large eggs, beaten', '4 boneless, skinless chicken breasts (2 1/2 pounds), trimmed of excess fat', '1 1/2 tablespoons Dijon mustard', '8 slices (about 4 ounces) prosciutto or sliced ham', '4 ounces Gruyere or Swiss cheese, cut into 1/2-inch thick sticks', '3 cups vegetable oil, for frying', 'To Serve:', '1 lemon, sliced into wedges', 'Special equipment:', 'Cocktail toothpicks for securing the chicken bundles', 'Meat pounder']",17,"['1 Mix the spices: In a small mixing bowl, combine the salt, garlic powder, and black pepper. You will use this spice blend later to season the breadcrumbs, flour, and chicken.', '2 Prepare the breading station and baking sheet: Prepare your breading station by arranging three shallow dishes in the following order: flour, beaten eggs, breadcrumbs. The breadcrumbs should be closest to your frying pan as that will be the final step in the process before frying. Add the chopped parsley to the dish with the breadcrumbs and stir to mix well.', 'Season both the flour with a 1/2 teaspoon of the spice mixture. Season the breadcrumbs with 1/2 teaspoon of the spice mixture and the chopped fresh parsley. Set these aside while you prepare the chicken breasts.', 'Place a cooling rack on top of a baking sheet and set it aside. This will allow hot air to circulate under the chicken, letting it bake on all sides without the risk of getting soggy.', '3 Pound the chicken breasts: Place the chicken breasts between two pieces of parchment paper and use a meat mallet to flatten them to a 1/4-inch thickness.', '4 Season and fill the chicken: Slather a teaspoon of mustard onto the flattened chicken breast, then season the meat with a pinch of the spice mixture. Slightly overlap two slices of the prosciutto in the center of the chicken. Place a baton (stick) of Gruyere on top of the prosciutto at one of the longer sides of the chicken.', '5 Roll and secure the filling: Starting with the cheese side, roll the chicken over the cheese until the meat and cheese are fully encased in the chicken. If you can, try to fold the chicken over the ends of the cheese to prevent the cheese from oozing out during cooking. Use one or two toothpicks to secure the chicken bundle.', '6 Heat the frying oil and the oven: In a 12-inch skillet set over medium-high heat, bring the oil to 350\\xc2\\xb0F. Heat your oven to 350\\xc2\\xb0F.', '7 Bread the chicken: Lightly dredge the chicken bundles in the flour. Pat off any excess flour, and coat the floured chicken in the egg, allowing excess egg to drip off, then press the chicken bundle into the breadcrumbs to coat it completely.', '8 Fry the cordon bleu; then finish it in the oven: Once your oil is hot, add the chicken to the pan. Fry the chicken for 5 minutes on each side. (You may have to do this in batches. Crowding the pan can reduce the oil\\xe2\\x80\\x99s temperature and leave you with a soggy crust.)', 'Once the chicken breasts have finished frying, drain them on paper towels before transferring them to the cooling rack topped baking sheet, and place them in the oven for an additional 10 minutes.', '9 Serve and slice: Remove the chicken from the oven and allow it to rest for 5 minutes before serving. The thrill of a chicken cordon bleu is cutting into the bundle, separating the pieces, and watching that glorious cheese ooze out.', 'Serve the cordon bleu while hot with lemon wedges, mashed potatoes, and a simple green salad.']",13
547,Spicy Chicken Drumsticks Recipe,10,30,40,"['10 green onions (scallions), white and green parts, chopped', '1/2 habanero or Scotch Bonnet chile (or 3 serrano chilies), seeded and chopped', '2 tablespoons white wine vinegar', '1 tablespoon fresh thyme', '3 cloves garlic, chopped', '1 1/4 teaspoon ground allspice', '1 teaspoon kosher salt, plus more for additional seasoning', '1/2 teaspoon freshly ground pepper', '10 chicken dumsticks (3 1/2 lbs)', 'Extra virgin olive oil']",10,"['1 Make the chili paste: In a food processor, pur\\xc3\\xa9e the green onions, chilies, vinegar, garlic, thyme, allspice, salt and pepper into a thick paste.', '2 Coat the chicken drumsticks with the chili paste: Put the drumsticks in a large bowl and coat with the chili paste. Let stand for 10 minutes.', '3 Prepare oven and chicken for broiling: Position the oven rack in the center of the oven and set the broiler to high.', 'Coat the bottom of a broiler pan (under the perforated top part of the pan) with oil. (Note that a broiler pan really works best here. A regular baking pan may warp under the high heat of the broiler.)', 'Arrange the drumsticks on the pan and sprinkle generously with salt.', '4 Broil the chicken: Broil chicken, turning once after about 10 minutes. Continue broiling until cooked through (juices run clear when poked with a knife tip) and nicely browned, about 20 minutes total.', 'Note that some pieces may cook faster than others, in which case remove the pieces that are done and continue to cook the rest until cooked through.']",7
548,Paleo Chicken Adobo Recipe,10,45,55,"['4 chicken thighs, bone-in and skin on (about 1 1/2 pounds)', '4 chicken drumsticks (about 1 1/2 pounds)', ""3/4 cup tamari or coconut aminos (or low-sodium soy sauce, if you don't need this to be gluten-free!)"", '3/4 cup white wine vinegar', '1 tablespoon fish sauce', '1 tablespoon coconut sugar, honey, or dark brown sugar', '1/2 tablespoon coconut oil', '2 tablespoons fresh grated ginger', '2 bay leaves (dried, not fresh)', '1 tablespoon whole peppercorns', '3 cloves garlic', '1/4 teaspoons salt (optional)', '1/2 teaspoon fine ground pepper', 'Coconut rice or plain steamed rice, to serve']",14,"['1 Prepare the chicken: Pat chicken thighs and legs dry with paper towels and season very lightly with salt and pepper.', '2 Prepare the sauce: Whisk together the tamari, vinegar, fish sauce, and sugar or honey in a measuring cup or bowl and set aside.', '3 Saut\\xc3\\xa9 the ginger and other seasoning ingredients: In a heavy-bottom, high-sided skillet, melt coconut oil over medium heat. Add the ginger, bay leaf, and peppercorns. Saut\\xc3\\xa9 for 5 minutes until fragrant. Add the garlic and saut\\xc3\\xa9 for 1 minute, stirring constantly so that garlic doesn\\xe2\\x80\\x99t burn. Scoop the solids from the pan with a slotted spoon and set them aside on a plate, leaving the flavor-infused oil behind.', '4 Sear the chicken: Turn the heat up to medium high, and brown the chicken on all sides to crisp up the skin. Once skin is nice and golden, pour the sauce over the chicken. Add the ginger and other seasoning ingredients you saut\\xc3\\xa9ed in the last step. Bring the sauce to a rolling boil.', '5 Reduce the heat to low, cover the pot, and cook for 25 minutes.', '6 Pull the chicken from the pan and allow to rest at room temperature.', '7 Reduce the sauce while the chicken rests. Raise heat to high and boil the sauce for about 10 minutes or until the volume is reduced by about half and the sauce looks nice and thick.', '8 Serve the chicken over rice and cover with the adobo sauce.']",8
549,Chicken Liver P\xc3\xa2t\xc3\xa9 Recipe,15,15,30,"['6 Tbsp unsalted butter, divided', '1/3 cup minced shallot', '1 pound chicken livers', 'Salt', '1 clove garlic, minced', '2 Tbsp capers', '1 teaspoon dried thyme', '1 teaspoon anchovy paste (optional)', '1/4 cup brandy', '1/4 cup cream']",10,"['1 Trim connective tissue and fat: Trim any fat or connective tissue from the livers and discard.', '2 Brown the butter: Heat 2 tablespoons of the butter in a large saut\\xc3\\xa9 pan on medium heat and let the butter brown, about 3-5 minutes. Do not let it burn.', '3 Saut\\xc3\\xa9 shallots and livers: Add the shallots and saut\\xc3\\xa9 for 1 minute. Add the livers. Be sure to space them well in the pan so they can brown more easily. Sprinkle salt over the livers. Flip the livers when one side browns, about 2 minutes.', '4 Add capers, thyme, garlic, anchovy paste: Once the livers have browned, add the capers, thyme, garlic, and anchovy paste if using, and saut\\xc3\\xa9 another minute.', '5 Deglaze with brandy: Take the pan off the heat and add the brandy. (Be careful when you return it to the heat, as it could flame up, especially if you are using a gas range. If it does, cover the pan for a moment.) Increase the heat to high and let the brandy boil and reduce to the consistency of syrup, about 1-2 minutes. Turn off heat and allow the mixture to cool.', '\\x016 Pulse in food processor, add butter, cream: Put the mixture into a food processor or blender and pulse a few times to combine. Add the remaining butter and the cream and pur\\xc3\\xa9e. The mixture will look a little loose, but it will firm up in the fridge.', '7 Place into ramekins and chill: Pack the p\\xc3\\xa2t\\xc3\\xa9 into ramekins or a small bowl, cover and refrigerate for at least an hour before using.', 'The p\\xc3\\xa2t\\xc3\\xa9 will last a week or so in the fridge. If you want to preserve it for up to a month, pour a little melted lard or clarified putter on top to seal. Each time you dip into the p\\xc3\\xa2t\\xc3\\xa9, you will need to reseal the top to preserve it.', 'Serve spread on crackers or baguette slices.']",9
550,Circassian Chicken Salad Recipe,15,10,25,"['1 pound skinless chicken breasts', '4 tablespoons extra virgin olive oil or walnut oil', '4 teaspoons paprika', '1 \\xc2\\xbd cups chopped walnuts, divided', '3 chopped garlic cloves', '2 tablespoons chopped green onions', '1 teaspoon cayenne, or to taste', '2 tablespoons chopped parsley, divided', '2 slices of bread, crusts removed', '1 quart chicken stock', 'Salt and black pepper', 'The juice of a lemon']",12,"['1 Poach the chicken breasts: Bring the chicken stock to a simmer and add the chicken breasts. Add some water if there is not enough liquid to cover the meat. Simmer gently for 10 minutes, then turn off the heat.', '2 Heat paprika in olive or walnut oil: Meanwhile, heat the olive or walnut oil in a small pot over low heat and add the paprika. Stir well to combine. Heat until you can smell the aroma of the paprika, then turn off the heat.', '3 Soak bread in broth: Tear the bread into chunks and put into a bowl. Ladle out about a cup or two of the chicken broth and pour it over the bread.', '4 Make walnut paste: Put one cup of the walnuts into a food processor. Add the garlic, the cayenne, about a teaspoon of salt, 1 Tbsp of the parsley and the soaked bread. Pulse to make a thick, relatively chunky paste.', 'If it needs a bit more chicken broth to loosen up, add some a tablespoon at a time.', 'Stir the paprika-oil, then pour it into the food processor and buzz to combine. Add salt to taste.', '5 Assemble the salad: Tear the chicken breasts into shreds. Put it in the bowl with the remaining 1/2 cup walnuts, the green onions and 1 Tbsp of parsley.', 'Add the walnut-paprika paste from the food processor to the bowl and stir gently to combine everything thoroughly. Add black pepper and lemon juice to taste.']",8
551,Chicken Salad with Roasted Bell Peppers and Toasted Almonds Recipe,0,40,40,"['4 skinless chicken breasts (about 2 pounds total)', '4 bay leaves', '1 quart chicken stock', '2 garlic cloves, finely chopped', '1 cup unsalted, toasted almonds, finely chopped', '1/2 large red onion, chopped', '1/2 cup parsley, chopped', '1 8-ounce jar roasted red peppers (or one or two large red peppers, roasted, blackened skin removed, stems and seeds removed)', '3 Tbsp sherry vinegar (can sub apple cider vinegar)', '1/2 cup extra virgin olive oil', 'Salt and pepper to taste']",11,"['1 Simmer chicken breasts in stock: Put the bay leaves and the chicken stock in a pot with a lid and bring the stock to a simmer. Add the chicken breasts to the pot. Return the stock to a simmer. Simmer for one minute. Cover the pot. Turn off the heat. Let the chicken steep in the stock for 30 minutes to an hour.', '2 Prep other ingredients, toss with oil and vinegar: While the chicken is cooking, chop the other ingredients\\xe2\\x80\\x94garlic, almonds, onion, parsley, roasted red bell peppers\\xe2\\x80\\x94and add to a large bowl.', 'Sprinkle a little salt over the mixture and add the oil and vinegar. Toss to combine.', '3 Shred chicken, mix with the rest of the ingredients: When the chicken breasts are cooked, remove them from the stock (which you can reuse if you bring it to a boil again) and let them cool.', 'When they are cool enough to handle, shred the chicken breasts into bite-sized pieces by hand. Mix the chicken pieces in with the rest of the ingredients and served chilled or at room temperature.']",5
552,Chicken Salad with Miso Dressing Recipe,25,16,41,"['For the salad', '1 pound boneless skinless chicken breasts', 'Kosher salt', 'Freshly ground black pepper', '1 head butter lettuce, washed and dried', '1 large handful arugula or watercress, washed and dried', '1 small or 1/2 large bulb fennel, very thinly sliced', '3 seedless mandarins, peeled, cut into wheels, and pulled into pieces', '1 small avocado, diced', 'For the miso dressing', '1/4 cup plus 2 teaspoons extra-virgin olive oil', '1 tablespoon white miso paste', '1 tablespoon plus 2 teaspoons apple cider vinegar', '1 teaspoon honey', '2 scallions, white and light green parts only, finely chopped', '1/2 teaspoon ground cumin', 'Special equipment:', 'Meat pounder or rolling pin']",18,"['1 Pound the chicken: Lay the chicken breasts on a cutting board. Use a mallet or the side of a rolling pin to pound the thicker end of the breasts, so they\\xe2\\x80\\x99re about the same thickness along the whole breast. Season on both sides with salt and freshly ground pepper.', '2 Cook the chicken: Heat 2 teaspoons of the olive oil over medium in a large cast-iron or non-stick skillet. Cook the chicken until nicely browned on one side and opaque halfway up the side, about 8 minutes.', 'Flip and cook on the second side until no longer pink in the center, another 8 minutes or so. Transfer to a cutting board to rest for at least 5 minutes. Cut across the grain in 1/3-inch-thick slices.', '3 Make the miso dressing: In a small bowl, whisk together the miso, apple cider vinegar, honey, scallions, and cumin until smooth. Continue to whisk as you drizzle in the remaining olive oil.', '4 Assemble the salad: Toss the lettuce, arugula, and fennel in a large bowl with just enough dressing to lightly coat. Transfer to 4 serving bowls. Tuck the avocado, mandarins, and chicken slices into the bowls and dribble a little more dressing over them. Serve immediately.']",5
553,Homemade Chicken Noodle Soup Recipe,15,120,135,"['One 3 1/2-pound chicken, cut into parts\\xe2\\x80\\x94breast, thighs, backs, wings and neck (if available)', '5 carrots (2 carrots scrubbed clean, but not peeled, cut into 2 inch chunks for the stock, 3 carrots peeled and cut into 1/4-inch rounds for the soup)', '5 ribs celery (2 ribs cut into 2 inch pieces for the stock, 3 ribs cut into 1/4-inch thick slices for the soup), including celery tops for the stock', '1 onion, quartered (for stock, peel on is okay)', '3 cloves of garlic, peel on, cut in half', '2 to 3 sprigs fresh thyme (or a teaspoon of dried)', '1 bunch parsley', '5 whole peppercorns', 'Salt', '4 to 8 ounces egg noodles (depending on how noodle-y you want your soup)', 'Freshly ground black pepper']",11,"['1 Separate breast and thigh meat from bones: Remove the breast meat from the breast bones, and the thigh meat from the thigh bone, place in a bowl, cover and chill in the refrigerator until needed towards the end of preparing the soup.', 'Remove and discard the largest pieces of breast and thigh skin. Cut away and discard excess fat from chicken pieces.', '2 Parboil bones for 3 minutes: Place breast and thigh bones, the back, leg, neck, and wings in a large (8 quart) pot. Cover with water. Bring to a full rolling boil. Boil for 3 minutes. After 3 minutes, remove from heat, drain off the water, rinse the bones and the pot.', '3 Make stock with parboiled bones, celery, carrots, onion, garlic, thyme, parsley, peppercorns: Return the now parboiled bones to the clean pot.  Add a couple carrots and a couple celery ribs, each cut into 2 inch chunks, and some celery tops if you have them, to the pot with the chicken. (Fennel tops or leek greens can be added too, if you have them.)', 'Add the quartered onion, garlic cloves, thyme, one-half of the parsley, and the peppercorns to the pot.', 'Cover with an inch or two of water (about 3 quarts).  Bring to a low simmer (about 185\\xc2\\xb0F) and let simmer (the stock should be just barely bubbling), partially covered, for 1 1/2 hours.', '4 Strain bones and solids from the stock: At the end of 1 1/2 hours strain out the bones and vegetables, reserving the stock. If you want, set aside and strip the bones of any remaining meat. After parboiling and 1 1/2 hours of cooking the meat will be rather dry and tasteless, though you could use it in a chicken salad.  Rinse out the pot and return the stock to the pot.', ' 5 Salt the stock: Taste the stock. It should be rather bland because up to now, no salt has been added. Add salt to taste. As a guideline, for each quart of stock, add 2 teaspoons of salt.', '6 Add carrots, celery: Add the sliced carrots and celery to the stock, bring to a simmer.', '7 Cut raw chicken breast and thigh meat, add to stock: Cut the chicken breast and thigh meat into bite-sized pieces.  Add to the pot with the carrots, celery, and stock. Return to a low simmer.', '8 Add noodles, bring to simmer: Add the egg noodles and return to a simmer. Note that the noodles will expand substantially in the soup broth as they cook.', 'Simmer for until the egg noodles are just barely cooked through, al dente (about 5 minutes or so, depending on your package of noodles), and the chicken is just cooked through.', '9 Add parsley, salt, pepper, thyme to serve: Stir in a handful of chopped fresh parsley. Add freshly ground black pepper, more thyme, and more salt to taste.']",13
554,One-Pot Chicken and Rice Soup Recipe,15,30,45,"['2 bone-in chicken breasts, skin removed (1 to 1 1/2 pounds)', '1 cup long-grain white rice, like basmati', '2 celery ribs, diced small', '2 medium carrots, peeled and diced small', '1 onion, diced small', '2 cloves garlic, peeled but left whole', '1 teaspoon salt, plus more to taste (see Recipe Note)', '1/2 teaspoon ground black pepper', '2 quarts unsalted or low-sodium chicken stock', 'Juice of 1/2 lemon (about 3 tablespoons)', 'Chopped fresh parsley, for serving']",11,"['1 Assemble the soup and bring to a simmer: Combine the chicken, white rice, celery, carrots, onions, garlic, salt, and pepper in a large pot. Add the chicken stock and bring to a boil over high heat.', 'Once the soup is boiling, reduce the heat to keep the soup at a gentle simmer.', '2 Simmer for about 25 minutes: As the soup simmers, skim off any foam that collects on the surface with a spoon. Continue to simmer until the rice and vegetables are tender, about 25 minutes. Remove the soup from heat.', '3 Shred the chicken and make the garlic paste: Remove the chicken and garlic cloves using a slotted spoon or tongs. Transfer the chicken breasts to a bowl and shred with two forks. Discard the bones. Return the shredded chicken to the pot.', 'Smash the garlic cloves into a paste against a cutting board using a fork or the flat of your knife. Stir the paste back into the soup.', '4 Season and serve: Stir the lemon juice into to the soup, and taste. The soup should taste rich, barely salty, and with just a hint of lemon. Add more salt or lemon juice as needed until it tastes good to you.', 'Divide among bowls and sprinkle with some parsley for serving.', 'Leftovers will keep for about a week refrigerated, or up to 3 months frozen.']",8
555,Mom\xe2\x80\x99s Cold-Season Chicken Soup Recipe,10,20,30,"['4 cups of homemade chicken stock', 'Fat from the homemade chicken stock', '1 yellow onion, peeled and chopped', '2 carrots, sliced in 1/4-inch slices (about the same amount as onion)', '2 celery stalks, sliced in 1/4-inch slices (about the same amount as the onion)', '1 Tbsp fresh parsley leaves', '1 Tbsp of chopped greens from a green onion (green part of the green onion) or chives', '1/4 teaspoon poultry seasoning (ground sage and thyme)', '1/8 teaspoon (a pinch) of crushed red pepper flakes (or a small pinch of cayenne)', 'Salt and freshly ground black pepper to taste']",10,"[""1 Saut\\xc3\\xa9 onion, carrots, and celery: In a 4 qt saucepan, heat a tablespoon of chicken fat (that has risen to the surface and solidified from your homemade stock) on medium high heat. If you don't have enough chicken fat, you can add some olive oil. Saut\\xc3\\xa9 the vegetables in the fat until the carrots are almost done."", '2 Add seasonings: While you are saut\\xc3\\xa9ing the vegetables, add the seasoning - the poultry seasoning, the crushed red pepper flakes, a pinch of salt and a pinch of pepper. Seasoning like this during the cooking of the vegetables brings out their flavor. According to my mother, crushed red pepper flakes or cayenne is very helpful for a cold, which is why it is part of this recipe.', '3 Add stock and simmer: Add the 4 cups of chicken stock. Bring to a low simmer. Cook until the carrots are just cooked through (about 5 to 10 minutes).', '4 Add the fresh parsley and green onion greens. Check seasonings (you will likely need to add more salt) and adjust to taste.', 'Serve with (at least) day old crusty French bread.']",5
556,Rotisserie Chicken Noodle Soup Recipe,10,20,30,"['For the soup:', '8 ounces egg noodles', '2 tablespoons olive oil', '1 cup white onion, diced (1 medium)', '1 cup celery, diced (about 2 stalks)', '1 cup carrots, diced (2 medium carrots)', '2 cloves garlic, minced', '4 cups chicken stock, homemade or store bought', '2 cups shredded chicken, from a store-bought rotisserie chicken', '1 tablespoon melted butter', 'Salt and pepper, to taste', 'Fresh parsley, garnish', 'Crackers, for serving', 'DAD ADD: Soft-boiled eggs', '2 large eggs']",15,"['1 Cook the noodles: Bring a large pot of lightly salted water to a boil and cook the egg noodles according to package directions. Strain and toss with butter.', '2 Meanwhile, cook the veggies: In a large pot, warm the olive oil over medium heat. Add onions, celery, and carrot. Cook for 4 to 5 minutes until vegetables soften. Then add garlic and season with salt and pepper. Cook for another minute.', '3 Simmer the stock and chicken: Add chicken stock and bring soup to a simmer. Stir in shredded chicken and simmer for a few minutes to combine flavors. Taste soup and season with salt and pepper.', '4 Make the soft-boiled eggs (if using): Add 1/2-inch of water to a medium pot over high heat. Cover and bring to a rapid boil. Add the eggs and cover. The water will not completely cover the eggs. That\\xe2\\x80\\x99s okay. Return water to a rapid boil and cook eggs for 6 1/2 minutes.', 'Immediately remove the pot from the heat and remove lid. Run the pot under cold water for 30 seconds to stop the cooking.', '5 Assemble the soup: Divide the egg noodles among the bowls and spoon in the soup. Once the eggs are cool enough to handle, peel them carefully and slide them into the bowl on top of the soup. Garnish with fresh parsley and serve with crackers.']",6
557,Chicken Soup with Ginger and Shiitake Mushrooms Recipe,20,25,45,"['1 ounce dried shiitake mushrooms (dried is much preferable to fresh in this recipe)', '3 cups boiling water', '1 to 1 1/2 pounds chicken thighs, preferably bone-in, cut into chunks', 'A 1-inch piece of fresh ginger, peeled and sliced very thin', '2 tablespoons soy sauce (use gluten-free soy sauce for gluten-free version)', '2 teaspoons sugar', 'A pinch of salt', '1 teaspoon cornstarch']",8,"['1 Soak dried mushrooms: Soak the dried mushrooms in the hot water for 20 minutes. Use a bowl or a smaller pot to keep the mushrooms submerged in the water.', '2 Marinate chicken: While the mushrooms are soaking, mix the soy, sugar, salt and cornstarch in a large bowl. Make sure there are no cornstarch lumps. Add the chicken and ginger to the bowl, toss to coat with the marinade, and set aside.', '3 Slice mushrooms, add to chicken: When the mushrooms have softened, remove from the water (saving the soaking liquid) and slice thin. Add the mushrooms into the bowl with the chicken. If the soaking water has grit in it, pour the soaking water though a fine-meshed sieve lined with a paper towel into another bowl.', '4 Cook chicken, mushrooms with mushroom soaking water: Put the chicken mushroom mixture, and the mushroom soaking liquid into a pot and bring to a boil. Lower the heat to a bare simmer, cover the pot and cook gently for 25 minutes. Serve hot.']",4
558,Mexican Chicken Lime Soup (Sopa de Lima) Recipe,10,75,85,"['1 to 1 1/2 cups extra virgin olive oil, peanut oil, canola oil, or corn oil', '6 corn tortillas', '1 1/4 cup chopped white onion', '3 cloves of garlic, minced', '1 habanero chile, seeded and minced', '1/4 teaspoon ground cinnamon', 'Pinch of ground cloves', '1 pound tomatoes (2 large), cored, peeled, and chopped (or 1 cup of canned crushed tomatoes)', '2 quarts of chicken stock (homemade is best)', '1 teaspoon of dried oregano (preferably Mexican oregano if you have it)', '1 teaspoon salt (more to taste)', '1 1/2 pounds of skinless, boneless chicken thighs (or breasts if you prefer, we like the stronger taste of thighs), trimmed of excess fat, and cut in half crosswise', '1/3 cup lime juice (from 2 to 4 limes, depending on the size)', '1 bunch of cilantro, roughly chopped (stems included) for garnish', '2 avocados, pitted, peeled, and roughly chopped for garnish']",15,"['1 Dry tortillas in oven, cut into strips: Heat oven to 350\\xc2\\xb0F. Place tortillas in a single layer on a baking sheet and heat in the oven for 10 to 12 minutes, flipping over after the first 5 minutes. (This will help dry out the tortillas a bit before frying.) Remove from oven. Cut the tortillas into 1/4-inch wide strips.', '2 Fry tortilla strips in hot oil: Pour oil into a large, thick-bottomed pot to 1/4-inch deep, about 1 to 1 1/2 cups. Heat the pot on medium high heat until the oil temperature reaches about 350\\xc2\\xb0F or a small piece of tortilla place in the oil sizzles. If a small tester piece of tortilla burns or browns too fast, move the pan from heat to let the oil cool a bit before continuing.', 'Working in batches, gently scatter a handful of tortilla strips in the hot oil. Turn with metal tongs so that the tortilla strips are separated.  Cook for a few minutes or until the strips just begin to color. Remove them to a paper towel lined plate.', 'When I make these after I add the tortilla strips I increase the heat of the burner to compensate for the tortilla strips lowering the temperature of the oil. Once the tortilla strips start to color I lower the temperature to keep the oil from getting too hot.', '3 Saut\\xc3\\xa9 onions, add garlic, habanero, cinnamon, ground cloves: Remove all but two tablespoons of the tortilla frying oil. Heat on medium high. Add the onions and cook until translucent, about 5 minutes.  Add the garlic, minced habanero, cinnamon, and ground cloves and cook a few minutes longer.', '4 Add tomatoes, stock, oregano, chicken, salt, then simmer: Add the peeled chopped tomatoes to the onions.  Add the stock, oregano, and chicken. Add one teaspoon of salt.', 'Bring to a simmer and reduce the heat to maintain a low simmer.', 'Cover and cook for 20 to 25 minutes, until the chicken is just cooked through.', '5 Remove chicken from pot, shred: Remove pot from the heat. Remove the chicken from the pot. Using two forks, shred the chicken.', '6 Return shredded chicken to pot, add lime juice: Return the chicken to the soup.  Stir in the lime juice. Add more salt, if needed, to taste.', 'Serve garnished with fried tortilla strips, chopped avocado, and cilantro.']",11
559,Lemon Chicken Chickpea Soup Recipe,15,60,75,"['1 1/4 pound boneless skinless chicken thighs, cut into 1-inch pieces', '1 teaspoon salt', '1 teaspoon ground turmeric', '1 teaspoon ground cumin', '1/2 teaspoon ground black pepper', '2 tablespoons extra virgin olive oil', '1 onion, chopped (about 1 1/2 cups)', '1 celery rib, chopped (about 1/3 cup)', '4 cloves garlic, minced (about 1 1/2 Tbsp)', '1 teaspoon grated fresh ginger (or powdered ginger)', '2 bay leaves', '6 cups chicken stock', '2-3 strips of lemon zest from one lemon', '2 tablespoons lemon juice', '1/3 cup basmati rice', '1 15-ounce can chickpeas, drained, or 1 1/2 cups cooked chickpeas', 'Cilantro or parsley for garnish']",17,"['1 Coat the chicken pieces with the spices: Whisk the salt, turmeric, cumin, and black pepper together in a medium bowl. Add the chicken pieces and toss with the spices to coat.', '2 Brown the chicken in olive oil: Heat olive oil in a large, thick-bottomed soup pot on medium high. Add the chicken pieces and brown lightly on all sides, 5-7 minutes total. Remove chicken to a bowl and set aside.', '3 Saut\\xc3\\xa9 onions, celery, garlic, ginger: Add the chopped onion and celery to the pot. Saut\\xc3\\xa9 until lightly browned, about 5 to 6 minutes. Add the garlic and ginger and cook a minute more.', '4 Add chicken, stock, bay leaves, lemon zest strips, then simmer: Add the chicken pieces back to the pot. Add the stock, bay leaves, lemon zest strips. Bring to a simmer and simmer for 15 minutes.', '5 Add rice, chickpeas, lemon juice, simmer: Add the rice, chickpeas, and lemon juice. Bring to a simmer and cook for 20 minutes, until the rice is cooked through.', '6 Add salt pepper to taste: Remove bay leaves and lemon peel strips. Add salt and pepper to taste. Garnish with cilantro or parsley to serve.']",6
560,Homemade Condensed Cream of Chicken Soup,0,45,45,"['4 chicken thighs, skin-on and bone-in (about 1 1/2 pounds)', '2 tablespoons olive oil', '1/3 cup finely chopped onion', '2 large cloves garlic, minced', '3 cups water', '1 bay leaf', '1/4 cup all-purpose flour', '1/2 teaspoons salt', '1/4 teaspoon freshly ground black pepper', '1/4 cup heavy cream']",10,"['1 Render the fat from the chicken: Sprinkle the four chicken thighs with salt and freshly ground pepper over and under the skin. Heat the oil in a medium pan with deep sides over medium high heat. When the oil begins to shimmer, add the thighs skin side down.', 'Cook at medium high for about 5 minutes, until the skin has a nice golden brown color. A few bits of skin may even stick to the pan. That\\xe2\\x80\\x99s ok.', 'Reduce the heat to medium. Let the chicken cook for another 15 minutes untouched. If the skin seems like it\\xe2\\x80\\x99s starting to burn, turn down the heat a little more. Flip and cook on the other side for about 5 minutes.', 'When done, the skin should be crisp and golden and the chicken should have rendered about a 1/4 cup of fat (just eyeball it; you\\xe2\\x80\\x99ll be fine!). If you have more than 1/4 cup, reserve the extra for another purpose or discard.', 'It\\xe2\\x80\\x99s ok if the chicken isn\\xe2\\x80\\x99t entirely cooked through at this point -- your goal in this step is to render the fat from the chicken skin, and develop the browning in the pan and not necessarily cook the meat through.', '2 Meanwhile, bring 3 cups of water, bay leaf and good pinch of salt to a boil in medium sauce pan over medium high heat.', '3 Make the soup stock: Once you\\xe2\\x80\\x99ve finished rendering the fat from the chicken thighs, remove the pan from heat and transfer the thighs to the pot of boiling water. If your chicken isn\\xe2\\x80\\x99t completely covered with water, add more so it is. Leave the pot uncovered.', 'Reduce heat under the pan of water so it comes down to a gentle simmer. Cook the chicken for 9-11  minutes, until the chicken is cooked all the way through. Skim any foam from the top of the water.', '4 Strain the soup stock: Remove the chicken from the pot of water. Put on plate and set aside to cool.', 'Strain stock through fine mesh strainer into a liquid measuring cup. You should have somewhere between 2 to 4 cups of chicken stock. Measure out 2 1/4 cups of the stock and set aside (add water if needed to make this amount; if you have more stock than needed, save the leftover for another recipe.)', '5 Make the roux: Return the pan with the rendered chicken fat to medium heat. While whisking constantly, sprinkle flour a little at a time over the fat until all the flour is mixed in and you have a white paste.', 'Keep whisking continuously until the roux turns a golden color, about 5 minutes. Add the chopped onion and the minced garlic \\xe2\\x80\\x93 the roux will get crumbly when you add the vegetables, and that\\xe2\\x80\\x99s ok. Keep whisking for about 5 more minutes until the onions are cooked through. It will smooth out again when you add the stock.', '6 Make the creamy soup base: While whisking continuously, slowly pour the 2 1/4 cups of stock into the pan with the roux. At first, it will have the consistency of paste with clumps of onion in it. Just keep whisking and slowing adding the stock. At this point your soup may look a little watery, and you could even see fat around the edges of the pan. That\\xe2\\x80\\x99s ok.', 'Once all the stock is added, increase the heat to medium high and whisk for about 8 minutes until the liquid is noticeably thicker than syrup, but thinner than ketchup.', 'Reduce the heat to medium. Keep an eye on the soup while you do the next step (shredding the chicken) so that it stays warm but doesn\\xe2\\x80\\x99t boil. Whisk the soup occasionally.', '7 Add the chicken: Pull the meat off two of the chicken thighs, and chop it finely; you should have 3/4 to 1 cup of chicken meat. Save the remaining two chicken thighs for another meal.', '8 Finish the soup: Slowly whisk in the heavy cream. Taste and add additional salt and pepper as needed, to taste.', 'The soup can be used immediately. Alternatively, cool and store in fridge for up to four days.']",18
561,Persian Pomegranate Chicken (Fesenjan) Recipe,10,120,130,"['1 to 2 large yellow onions, chopped, (3 cups)', '2 tablespoons unsalted butter', '3 tablespoons extra virgin olive oil', '5 tablespoons pomegranate molasses', '1/2 pound walnut halves (about 2 cups)', '2 pounds boneless skinless chicken thighs and/or breasts, trimmed of excess fat, cut into medium size pieces, patted dry and salted', '2 cups chicken stock', '2 tablespoons plus 2 teaspoons of sugar', '1/2 teaspoon turmeric', '1/4 teaspoon cinnamon', '1/4 teaspoon ground nutmeg', '1/4 teaspoon ground black pepper', 'Salt', '1/2 cup fresh pomegranate arils for garnish (optional)']",14,"['1 Toast and grind the walnuts: You can toast the walnuts in one of two ways. You can either spread them out in a single layer in a large skillet, and toast them on medium high heat, stirring frequently until lightly toasted, OR you can spread them out in a single layer in a baking rimmed baking sheet, and toast at 350\\xc2\\xb0F in the oven for 8 to 10 minutes.', 'In either case, once toasted, remove from heat and allow to cool. Once cool enough to handle, pulse in a food processor or blender until finely ground.', '2 Brown the chicken pieces on all sides: In a large pan, heat 1 tablespoon of butter and 2 tablespoon of olive oil over medium-high heat.', 'When the butter has melted, pat the chicken pieces dry again and place the chicken pieces in the pan, working in batches if necessary to not crowd the pan, and cook until golden brown on all sides. Sprinkle the chicken with salt while they are cooking.', '3 Saut\\xc3\\xa9 the onions: Use a slotted spoon or tongs to remove the chicken from the pan, set aside. Add a tablespoon of butter and a tablespoon of oil to the pan. Lower the heat to medium low. Add chopped onions to the pan and saut\\xc3\\xa9 until translucent, stirring on occasion to release the browned bits from the bottom of the pan.', '4 Add chicken and stock: Return the chicken pieces to the pan with the onions. Pour 2 cups of chicken stock over the chicken and onions. Bring to a boil, reduce to a simmer, cover and simmer gently for 30 minutes.', '5 Add ground walnuts, pomegranate molasses, sugar, spices, cover and cook: Stir in the ground walnuts, pomegranate molasses, sugar, and spices. Cover and cook on very low heat for 1 hour, stirring every 20 minutes or so to prevent the walnuts from sticking to the bottom of the pan.', 'Remove from heat and adjust sugar/salt to taste. At this point the chicken should be fall apart tender.', 'Garnish with pomegranate seeds. Serve over parsi pulao or other favorite rice.']",9
562,Moroccan Chicken with Lemon and Olives Recipe,65,60,125,"['2 teaspoons paprika', '1 teaspoon ground cumin', '1 teaspoon ground ginger', '1 teaspoon turmeric', '1/2 teaspoon cinnamon', '1/4 teaspoon freshly ground black pepper', '2 tablespoons extra virgin olive oil', '1 chicken, 3-4 lbs, cut into 8 pieces (or 3-4 lbs of just chicken thighs and legs, the dark meat is more flavorful)', 'Salt', '3 cloves garlic, minced', '1 onion, chopped', ""The rind from 1 preserved lemon, rinsed in cold water, pulp discarded, rind cut into thin strips (if you don't have preserved lemon, use whole thin slices of regular lemon)"", '1 cup green olives, pitted', '1/2 cup raisins', '1/2 cup water', '1/4 cup chopped fresh cilantro', '1/4 cup chopped fresh flat-leaf parsley']",17,"['1 Marinate chicken in spice rub: Combine all the spices\\xe2\\x80\\x94paprika, cumin, ginger, turmeric, cinnamon, black pepper\\xe2\\x80\\x94in a large bowl.', 'Pat dry the chicken pieces and put in the bowl, coat well with the spice mixture. Let the chicken stand for one hour in the spices.', '2 Brown chicken pieces in tagine or skillet: If you are using a clay tagine (if you have one, you must soak the bottom in water overnight before using), place it on a heat diffuser on the heating element to prevent the tagine from cracking, and place the olive oil in the tagine and heat it on medium heat.', 'If you do not have a tagine, you can use a thick-bottomed, large skillet with a cover. Heat the olive oil in the skillet on medium high heat.', 'In either case, sprinkle the chicken pieces very lightly with salt (go easy on the salt, the olives and preserved lemons are salty) and place skin side down in the tagine or skillet for 5 minutes, until lightly browned.', '3 Add garlic and onions, cover and cook: Lower the heat to medium-low, add the garlic and onions over the chicken. Cover and let cook for 15 minutes.', '4 Add lemon, olives, raisins, water, then cover and simmer: Turn chicken pieces over. Add the lemon slices, olives, raisins, and 1/2 cup water.', 'Bring to a simmer on medium heat, then lower the heat to low, cover, and cook for an additional 30 minutes, until the chicken is cooked through and quite tender.', '5 Stir in parsley, cilantro: Mix in fresh parsley and cilantro right before serving. Adjust seasonings to taste.', 'Serve with couscous, rice, or rice pilaf.']",10
563,Chicken Cacciatore (Hunter Style Chicken) Recipe,10,70,80,"['One 4 pound chicken, cut into serving pieces, trimmed of excess fat (or 3 1/2 to 4 pounds of chicken thighs, bone in, skin on)', 'Salt', '2 Tbsp extra virgin olive oil', '1 medium onion, thinly sliced root to tip, about 1 1/2 cups', '1 red or green bell pepper, seeded, sliced into 1/4-inch wide slices', '8 ounces cremini mushrooms, thickly sliced', '2 garlic cloves, thinly sliced', '1/3 cup white or red wine', '2 1/2 to 3 cups peeled and chopped, firm ripe tomatoes, with their juices,  or 1 28 ounce can of plum tomatoes in their juice', '1/2 teaspoon freshly ground black pepper', '1 teaspoon dry thyme (or 2 teaspoons fresh, chopped)', '1 teaspoon dry oregano (or 2 teaspoons fresh, chopped)']",12,"['1 Brown the chicken: Rinse chicken and pat dry. Season the chicken pieces on all sides with salt. Heat olive oil in a large skillet on medium heat.', ""Working in batches so that you don't crowd the pan, place the chicken pieces skin side down in the pan.  Cook until nicely browned, about 5 minutes, then turn over and lightly brown the other side."", 'Remove chicken to a bowl, set aside. Drain off all but 2 tablespoons of the rendered fat. If you have less than 2 Tbsp of fat in the pan, add more olive oil until you have about that much oil coating the pan.', '2 Saut\\xc3\\xa9 the onions, bell peppers, mushrooms, garlic: Add the sliced onions, bell peppers, and mushrooms to the pan. Increase the heat to medium high.', 'Cook until the onions are translucent, and the mushrooms have given up most of their moisture, stirring frequently, about 10 minutes.', 'Add the garlic to the pan and cook a minute more.', '3 Deglaze pan with wine, add tomatoes, spices: Add the wine and scrape up any browned bits at the bottom of the pan. Simmer until the wine is reduced by half. Add the tomatoes.', 'Stir in the pepper, thyme, oregano, and about a teaspoon of salt. Test and taste to adjust. Simmer uncovered for another 5 minutes.', '4 Add chicken back to pan, partially cover, cook until tender: Place the chicken pieces on top of the tomatoes and onions, skin side up. Lower the heat and cover the skillet with the lid slightly ajar.', 'Cook the chicken on a low simmer, turning and basting from time to time. Cook until the thighs are tender, about 30 to 40 minutes.']",10
564,"Chicken Stew with Onions, Tomatoes, and Dijon Recipe",5,80,85,"['1 whole head garlic', 'Extra virgin olive oil', 'Salt and freshly ground pepper', 'One 3-4 pound whole chicken, cut into 8 serving pieces (2 breasts, wings, thighs, legs)', '6 medium red onions (about 2 pounds)', 'One 28 to 32 ounce can good quality whole peeled tomatoes, drained', '1 tablespoon fresh thyme or 1 1/2 teaspoons dried thyme', '2 bay leaves', 'A pinch of chile powder', '1/3 cup dry white wine', '3 tablespoons old-fashioned whole seed Dijon mustard (or 1/4 cup regular Dijon mustard)']",11,"['1 Preheat oven to 400\\xc2\\xb0F.', '2 Roast garlic: Remove the papery outer layers of the garlic bulb, leaving intact the skins of the individual cloves. Cut 1/4 to a 1/2 inch off the tops of cloves, exposing the individual garlic cloves.', 'Place the head of garlic on a piece of aluminum foil. Drizzle some olive oil over the garlic, and sprinkle it with salt and pepper.', 'Wrap the head of garlic with the aluminum foil and place in the oven. Bake for 45 minutes, or until the flesh of the cloves are light brown and feel quite soft when pressed. Set aside to cool. (See how to roast garlic.)', '3 Brown the chicken pieces: While the garlic is roasting, heat a tablespoon of olive oil in a large, heavy-bottomed pot (with lid) or Dutch oven, on medium high heat. Rinse the chicken pieces in cold water then pat dry with paper towels. Season liberally with salt and pepper.', ""Brown the chicken pieces, starting them skin-side down, cooking them a few minutes on each side, working in batches so that you don't crowd the pan."", '4 Cook onions until soft: While the chicken is browning, peel and quarter the onions. Remove chicken from pan when nicely golden with tongs or a slotted spoon and set aside on a plate. Discard any fat and oil beyond about 1 Tbsp left in the pan.', 'Put the onions in the pot and cook them until softened, stirring frequently, about 5 minutes.', '5 Add tomatoes, herbs, chili powder, chicken, wine, then simmer: Add the tomatoes to the pot, the thyme, bay leaves, and ground chile powder. Put the chicken pieces on top of the tomatoes. Pour in the wine and bring to a simmer.', ""Cover and cook on medium-low heat for 40 minutes, stirring from time to time so that the vegetables don't stick."", '6 Crush roasted garlic: After the garlic has cooled enough to handle, squeeze out the roasted garlic from the cloves into a small bowl and crush with a fork.', 'Sprinkle with salt and pepper to taste. Set aside to serve with the chicken stew.', '7 Add mustard, thicken sauce: When the chicken has cooked, add the mustard to the pot and stir to blend. Increase the heat to medium-high and cook uncovered for 10 more minutes, or until the sauce is thick enough to cling to the meat. Remove bay leaves. Salt and pepper to taste.', 'Serve stew over rice or pasta, with the garlic paste on the side.']",14
565,Chicken Stew with Tomatillo Sauce Recipe,15,45,60,"['For the tomatillo sauce:', '12 tomatillos (about 1 1/2 pounds)', '1 large or 2 small poblano chiles', '2 cloves garlic, peeled', '1/4 large white onion, sliced', '1 cup loosely packed cilantro leaves', 'Salt to taste', 'For the chicken:', '8 bone-in, skin-on chicken thighs (about 3 pounds)', 'Salt and pepper, to taste', '2 tablespoons olive oil', '1 pound small creamer potatoes (small Yukon gold or red potatoes), halved', '1 red bell pepper, seeded and cut into thin strips', '1/4 cup or more water', '2 cups corn kernels, fresh or frozen', '1/2 cup chicken stock or broth', 'Cilantro, for garnish', '1 lime, quartered, for garnish', 'Tortillas or rice, for serving', 'Special Equipment:', 'Blender or food processor']",21,"['1 Turn on the broiler: Set an oven rack about 4 inches from the broiler element. Turn on the broiler.', '2 Broil the tomatillos, poblano chile(s), and garlic: Remove the husks from the tomatillos and rinse them under cool running water to remove the sticky residue. Lightly oil a rimmed baking sheet, then place the tomatillos, chile(s), and garlic on top. Broil for 4 to 5 minutes on a side, or until the skins are splotchy with black spots and the tomatoes are soft. Cool briefly.', '3 Make the sauce: Scrape away any loose blackened skin from the chile(s). (Don\\xe2\\x80\\x99t worry if you can\\xe2\\x80\\x99t scrape off all of it.) Cut in half and remove the seeds. Combine the broiled tomatillos, chiles, garlic, onion, cilantro, salt, and the accumulated juices from the baking sheet in a blender. Pulse until you obtain a coarse puree. Set aside. (Sauce can also be prepared a few days ahead and kept refrigerated.)', '4 Prepare the chicken: Preheat the oven to 375\\xc2\\xb0F. Sprinkle the chicken thighs on both sides with salt and pepper.', '5 Brown the chicken: In a large ovenproof skillet over medium-high heat, heat the olive oil. Add the chicken thighs with the skin side down. Cook for 6 to 8 minutes, or until the skin is golden brown and crisp. Transfer to a plate.', '6 Begin cooking the peppers and potatoes: Pour off all but a thin layer of fat from the pan. Return the pan to the heat and add the potatoes, peppers, and 1/4 cup of the water. Cook, stirring occasionally, for 8 minutes, or until the potatoes are almost tender. If the vegetables start to stick to the bottom of the pan, add more water, 2 tablespoons at a time.', ""7 Add the sauce and chicken to the pan: Stir the tomatillo sauce, corn, and stock into the skillet. (If you're using fresh corn, you can reserve some of it for garnish, if you like!) Bring to a simmer and taste. Add more salt and pepper, if you like. Nestle the chicken into the skillet with the skin side up. The chicken should be partially submerged, with the skin rising above the sauce."", '8 Bake the chicken: Bake for 20 minutes, or until a thermometer inserted into the thickest part of a thigh registers 165F. Remove from the oven.', '9 To serve: Spoon the vegetables and sauce into 4 shallow bowls and top each with 2 chicken thighs. Sprinkle with cilantro. Garnish with lime wedges and serve with rice or tortillas, if you like.']",9
566,Sesame Chicken Fingers with Spicy Orange Dipping Sauce Recipe,30,15,45,"['1 1/4 to 1 1/2 pounds chicken tenders', '1/2 cup buttermilk (can sub a scant half cup of milk that has been mixed with 1 1/2 teaspoons of vinegar or lemon juice)', '1 tablespoon orange marmalade', '1 teaspoon soy sauce', 'Breading:', '1 1/4 cups panko breadcrumbs', '1/4 cup raw sesame seeds', '1 tablespoon extra virgin olive oil', '1/2 teaspoon kosher salt', 'Dipping sauce:', '1/2 cup sweet orange marmalade', '1 tablespoon soy sauce', '1 teaspoon sriracha hot sauce', '1 teaspoon seasoned rice vinegar']",14,"['1 Marinate the chicken: Mix marinade ingredients (buttermilk, marmalade, soy sauce) in a medium bowl. Add the chicken tenders to the marinade and stir to coat completely with the marinade. Cover with plastic wrap and chill in the refrigerator for 30 minutes to an hour (or longer).', '2 Prepare the breading: While the chicken is marinating, prepare the breading. Heat a medium sized thick-bottomed skillet on medium high heat. Add the panko breadcrumbs to the dry hot pan and spread the breadcrumbs so they are in an even layer in the pan. Lower the heat to medium and stir frequently until the breadcrumbs begin to brown.', 'Once you can see visible browning, stir in the raw sesame seeds. Continue to cook in the pan, stirring frequently until the mixture is a deep golden color. Remove from heat.', 'Stir in the olive oil and the salt and stir until all of the breadcrumbs and sesame seeds are lightly coated with the oil.', '3 Dredge chicken in breading: Pre-heat oven to 400\\xc2\\xb0F. Line a roasting with aluminum foil and place a baking rack on top. Brush or spray the rack with a little cooking oil. Place the toasted breadcrumb mixture in a shallow bowl for dredging.', 'Remove the chicken tenders one at a time from the marinade  (do not wipe off the marinade) and dredge them in the bread crumb mixture. Place them on the prepared rack on the roasting pan.', '4 Bake: Bake chicken tenders at 400\\xc2\\xb0F for 15 minutes. Remove from oven and let cool for 5 minutes before serving.', '5 Make dipping sauce: While the chicken tenders are baking, prepare the dipping sauce. In a small bowl stir together the orange marmalade, soy sauce, sriracha hot sauce, and seasoned rice vinegar.', 'Serve sesame chicken fingers with the spicy orange dipping sauce.']",9
567,Slow Cooker Chicken Tacos Recipe,10,180,190,"['For the spice rub:', '2 tablespoons chili powder', '2 teaspoons ground cumin', '1 teaspoon kosher salt', '1 1/2 teaspoons dried oregano, crumbled fine between your hands', '1 teaspoon onion powder', '1 teaspoon garlic powder', '1/4 teaspoon ground cinnamon', '1/4 teaspoon allspice (can sub a scant pinch of ground cloves)', '1/4 teaspoon cayenne (optional, add more or less depending on how much heat you want)', 'The chicken:', '2 pounds boneless skinless chicken thighs (do not remove excess fat)', '6 ounces (3/4 cup) pineapple juice', '2 tablespoons tomato paste', 'To assemble the tacos:', 'Corn tortillas', 'Finely shredded cabbage', 'Thinly sliced radishes', 'Chopped avocado', 'Cilantro', 'Lime wedges']",21,"['1 Coat chicken with rub, place in slow cooker: Whisk the rub ingredients together in a bowl. Dredge the boneless skinless chicken thighs in the rub. Place the chicken thighs in a slow cooker.', '2 Add pineapple juice, tomato paste: Pour the pineapple juice over the chicken. Add the tomato paste to the juice.', '3 Cover and slow cook: Cover and cook in the slow cooker for 3 hours on high setting or 6 hours on low.', '4 Shred chicken meat with forks: When the chicken is done, it should be fork tender. Use two forks to shred the meat completely in the slow cooker bowl.', '5 Serve: Use the taco meat with heated and softened corn tortillas, sprinkle with lime juice, adding garnishes of finely shredded cabbage, thinly sliced radishes, avocado, and cilantro.']",5
568,Chicken and Rice Casserole Recipe,10,70,80,"['2 1/2 pounds boneless, skinless chicken thighs, cut into 1 to 1 1/2 inch pieces, patted dry', 'Salt and pepper', '4 tablespoons extra virgin olive oil', '1 medium onion, chopped', '2 cloves garlic, minced', '1/2 pound cremini or button mushrooms, sliced', '1/4 cup dry sherry or white wine', '1 1/3 cups chicken stock (See Recipe Note)', '1/2 cup sour cream', '1/4 cup cream', '1 cup uncooked white rice, medium or long grain', '1 1/2 teaspoon salt', '1 teaspoon each of Italian seasoning and poultry seasoning (or 2 teaspoons of one of these herb mixes, or 2 tablespoons chopped fresh herbs such as rosemary, sage, thyme, and basil)', '1/2 teaspoon paprika', '2 tablespoons chopped fresh parsley', 'Special equipment:', '9 x 13-inch casserole dish']",17,"['1 Preheat oven to 375\\xc2\\xb0F.', '2 Brown the chicken: Heat 2 tablespoons of olive oil in a large saut\\xc3\\xa9 pan on medium high or high heat (hot enough to brown but not burn). Season the chicken pieces all over with salt and pepper.', 'Working in batches, brown the chicken pieces on both sides, about 1 to 2 minutes per batch. Add a little more olive oil if needed with every batch.', 'Remove chicken pieces and set aside in a bowl. The chicken does not have to be cooked through, only browned.', '3 Saut\\xc3\\xa9 the onions and garlic: In the same saut\\xc3\\xa9 pan add 1 tablespoon olive oil. Lower the heat to medium, add the onions, and cook until translucent, about 3 minutes.', 'Add the garlic; cook 30 seconds more. Remove onions and garlic to a shallow 9x13 casserole dish.', ""4 Saut\\xc3\\xa9 the mushrooms: Raise heat to medium high and add the sliced mushrooms. Dry saut\\xc3\\xa9 the mushrooms (don't add butter or oil), allowing them to brown lightly and release some of their moisture. Add the mushrooms to the casserole dish."", '5 Make the sauce: Add 1/4 cup dry sherry or dry white wine to the pan to deglaze it, scraping off the browned bits from the bottom.', '(At this point, if you are making ahead, reduce the sherry to 1 tablespoon and pour off into the casserole dish. Refrigerate cooked onions, garlic, mushrooms, and browned chicken pieces until you are ready to make the casserole.)', 'Let the sherry reduce to about 1 tablespoon, then add the chicken stock, and remove from heat. Stir in 1 1/2 teaspoons salt, the cream, and the sour cream.', '6 Assemble the casserole: Add the uncooked rice to the casserole dish. Then pour the stock, sherry, cream, and sour cream mixture over the rice.', 'Add the Italian and poultry seasonings (or fresh herbs) and paprika to the dish.', 'Stir the rice, onion, mushroom, and herb mixture so that they are evenly distributed in the casserole dish.', 'Place the chicken pieces on top of the rice mixture (in a single layer if you can, they will be crowded).', '7 Bake:  Cover the casserole dish tightly with aluminum foil. Bake in a 375\\xc2\\xb0F oven for 45 minutes and then remove foil.', 'If the casserole still has too much liquid, let it cook a few minutes more, uncovered, until the excess liquid has evaporated away.', '8 Serve: Sprinkle with fresh parsley before serving.']",17
569,Basil Chicken Coconut Curry Recipe,15,25,40,"['1 teaspoon salt', '1/2 teaspoon ground coriander', '1/2 teaspoon cumin', 'A small pinch of ground cloves', '1/4 teaspoon cinnamon', '1/4 teaspoon ground cardamom', '1/2 teaspoon freshly ground black pepper', '1/4 to 1/2 teaspoon cayenne, or more to taste', '1/2 teaspoon turmeric', '1 lb skinless, boneless chicken thighs, cut into 1 1/2-inch chunks', '1 large onion, sliced root to tip', '5 cloves garlic, minced', '1 Tbsp finely chopped fresh ginger', '1-2 jalape\\xc3\\xb1o peppers, seeded and minced', '2 Tbsp canola oil, rice bran oil or ghee', '1 14-oz can coconut milk', '1 Tbsp lime juice, or to taste', '12-20 fresh basil leaves, torn roughly', 'Hot cooked rice for serving']",19,"['1 Mix the spices: In a small bowl, mix together the salt, ground coriander, cumin, ground cloves, cinnamon, ground cardamom, black pepper, cayenne and turmeric. Set aside.', '2 Saut\\xc3\\xa9 onions, jalape\\xc3\\xb1os, ginger, garlic, spices: In a wok or deep saut\\xc3\\xa9 pan, heat the oil over high heat. The moment the oil begins to smoke, add the onions and jalape\\xc3\\xb1os and toss to coat in oil. Sear the vegetables for 3 minutes, stirring only enough to keep them from burning, but still allowing the onions to sear.', 'Add the ginger, garlic and spice mixture and toss to combine, cook for 1 minute.', '3 Add coconut milk, chicken, simmer:  Add the coconut milk and chicken. Stir the mixture so that the chicken pieces are coated in the coconut milk. Bring to a simmer, reduce the heat, cover and cook for 20 minutes.', '4 Add basil, lime juice: When the chicken is tender, turn off the heat and add the basil and lime juice. Add more lime juice and salt to taste and serve over rice.']",5
570,Instant Pot Chicken and Rice Recipe,20,25,45,"['For the sauce:', '1/4 cup dry sherry', '3/4 cup chicken broth', '1/2 cup sour cream', '1/4 cup heavy cream', '1 1/2 teaspoons Italian seasoning', '1 1/4 teaspoons salt', '1/2 teaspoon ground pepper', '1/2 teaspoon paprika', 'For the casserole:', '1 tablespoon olive oil', '1 medium onion, diced', '1/2 pound crimini mushrooms, sliced', '2 cloves garlic, minced', '1 1/2 pounds (5 to 6) boneless skinless chicken thighs, cut into 1 1/2-inch pieces', '1 1/2 cups long grain white rice', 'To serve:', '1/4 cup chopped parsley', 'Special equipment:', '6-quart electric pressure cooker, such as the Instant Pot']",20,"['1 Whisk together the sauce: In a mixing bowl or large liquid measuring cup, whisk together the sherry, chicken broth, sour cream, cream, Italian seasoning, salt, pepper, and paprika. Set aside.', '2 Saut\\xc3\\xa9 the vegetables in the pressure cooker: Select the \\xe2\\x80\\x9cSaut\\xc3\\xa9\\xe2\\x80\\x9d setting on the pressure cooker and heat the oil in the pressure cooker. (If you are using a stovetop pressure cooker, heat the oil over medium heat.)', 'Add the onion and cook for 4 minutes, until a bit softened but not browned. Add the mushrooms and cook until they begin to wilt and give up their liquid, about 3 more minutes. Stir in the garlic and saut\\xc3\\xa9 for 1 more minute.', '3 Add the chicken: Stir in the chicken thighs and let them cook for 5 to 6 minutes, stirring often, until opaque and mostly cooked through (it\\xe2\\x80\\x99s fine if they\\xe2\\x80\\x99re still a little pink in the middle).', '4 Add the rice and the sauce: Use your spatula to pat the chicken and vegetables down into a fairly even layer. Sprinkle the rice over the top of the chicken in an even layer.', 'Slowly pour the sauce over the rice, taking care not to disturb the layer. Use a spoon to nudge down any grains of rice that are clinging to the sides of the pot, so everything is covered with the cooking liquid.', '5 Pressure cook the chicken and rice: Secure the lid on the pressure cooker. Make sure that the pressure regulator is set to the \\xe2\\x80\\x9cSealing\\xe2\\x80\\x9d position. Cancel the \\xe2\\x80\\x9cSaut\\xc3\\xa9\\xe2\\x80\\x9d program on the pressure cooker, then select the \\xe2\\x80\\x9cManual\\xe2\\x80\\x9d or \\xe2\\x80\\x9cPressure Cook\\xe2\\x80\\x9d setting. Set the cooking time to 5 minutes at high pressure. (If using a stovetop pressure cooker, the cooking time is the same.)', 'The pressure cooker will take 5 to 10 minutes to come up to pressure before the cooking time begins.', '6 Let the pressure release naturally for at least 10 minutes, then quick-release the pressure by immediately moving the vent from \\xe2\\x80\\x9cSealing\\xe2\\x80\\x9d to \\xe2\\x80\\x9cVenting."" Be careful of the steam! Alternatively, you can let the pot continue to depressurize naturally, which takes about 20 minutes total.', 'The sauce may look a little bit separated when you initially open the pot. Don\\xe2\\x80\\x99t worry, it\\xe2\\x80\\x99s fine! Just use a fork to gently fluff the rice and incorporate the creamy layer back into the casserole.', '7 Serve the casserole: Spoon the casserole into shallow bowls or onto plates, digging all the way down to the bottom so you get both rice and chicken in each scoop. Sprinkle generously with chopped parsley and serve hot.', 'Leftovers will keep for about a week and can be warmed in the microwave.']",12
571,Old Bay Chicken Wings Recipe,15,30,45,"['3 pounds chicken wings, separated tips from drummettes', '8 Tbsp (1/2 cup or 1 stick) unsalted butter', '1 Tbsp Old Bay seasoning, plus more for dusting', '1 Tbsp lemon juice', 'Cocktail sauce for dipping']",5,"['1 Preheat the oven to 425\\xc2\\xb0F. Allow the wings to come to room temperature (or else the sauce will be more difficult to spread on them). Pat the chicken wings dry.', '2 Make Old Bay sauce: Melt the butter in a small pot and whisk in the Old Bay and lemon juice. Let it cool enough to feel lukewarm.', '3 Mix the sauce again and toss the chicken wings in half the sauce.', '4 Bake: Arrange the wings in one layer on a baking sheet lined with parchment paper, aluminum foil, or Silpat and bake at 425\\xc2\\xb0F for 25 minutes.', '5 Broil: Take the wings out of the oven and turn on the broiler. Set a rack about 6 inches under the broiler. Turn the wings over on the baking sheet and put under the broiler for 3-4 minutes, or until they are nicely browned.', '6 To serve, toss in the remaining sauce and set on a plate. Dust with more Old Bay and serve with your favorite cocktail sauce.']",6
572,Miso Glazed Chicken Wings Recipe,10,30,40,"['1 to 1 1/2 pounds chicken wings', '2 tablespoons red or white miso paste', '2 tablespoon teriyaki sauce', '2 tablespoon rice wine vinegar', '1/2 to 1 tablespoon Korean gochujang or Sriracha', 'Green onions, sliced (optional)']",6,"['1 Preheat oven to 425F. Line a baking sheet with aluminum foil and spray with non-stick spray.', '2 Prepare the wings: Pat each chicken wing dry with paper towels. Arrange in a single layer on the baking sheet and season with salt and pepper.', '3 Bake the wings for 20 to 22 minutes: Roast until the wings begin to brown on the ends and the skin begins to turn crispy.', '4 Prepare the miso glaze: While the wings are roasting, whisk together the miso paste, teriyaki sauce, rice wine vinegar, and Korean spicy sauce (to taste) into a small bowl.', '5 Brush the roasted wings with glaze: Using a brush, liberally smear the chicken wings with sauce. Return to the oven and roast for an additional 8 minutes.', '6 To serve: Remove the wings from the oven and transfer to a serving platter. Sprinkle with sliced green onions, if desired.']",6
573,Slow Cooker Chickpea Curry with Sweet Potatoes and Red Peppers Recipe,15,480,495,"['1 tablespoon olive oil', '1 medium yellow onion, diced', '1 pound dried chickpeas, rinsed', '2 tablespoons curry powder', '1 large white-fleshed sweet potato, peeled and diced (See Recipe Note)', '1 large or two small sweet bell peppers, diced (red or yellow, about 1/2 pound)', '1 (28-ounce) can diced tomatoes', '1 (15.5 ounce) can coconut milk', '1 1/4 cups water', '3 cloves garlic, minced', '1 diced serrano, jalape\\xc3\\xb1o, or fresno chili (optional)', '1 teaspoon salt', '6 cups spinach, roughly chopped, to serve', 'Cooked rice, to serve (optional)', 'Chopped cilantro, to serve', 'Lime or lemon wedges, to serve', 'Special equipment:', '6-quart or larger slow cooker']",18,"['1 Combine the ingredients in the slow cooker: Drizzle olive oil in the bottom of a 6-quart or larger slow cooker then add onion and stir to coat. Pour dried chickpeas on top, then sprinkle the curry powder evenly over the beans.', 'Follow with sweet potato, bell pepper, tomatoes, coconut milk, water, garlic, chili pepper (if using), and salt. Do not stir (leaving the chickpeas on the bottom and the sweet potatoes on top helps everything cook more evenly).', ""2 Cook on low for 6 to 8 hours: If you\\'re around, stir the curry after about 4 hours and give it a check. At this point, the curry should seem soupy and the chickpeas will likely be edible, but still crunchy. If the slow cooker seems dry, add another half cup of water. (The curry will also be fine if you\\'re not around to stir it.)"", 'Total cooking time will depend on your slow cooker and your chickpeas. The curry can be served any time after the chickpeas are soft and tender.', 'It\\\'s also fine to if the curry cooks a little longer, or if you leave it on the ""warm"" setting for a while. The recipe is very forgiving! The curry will get thicker and creamier the longer it cooks.', ""3 Serve with spinach: Stir the curry well. Taste and add additional salt if needed. Serve the curry over bowls of chopped spinach, stirring to wilt the spinach. (You can also stir the spinach directly into the curry if that\\'s more convenient for you.)"", 'Garnish with cilantro and a squeeze of lemon or lime.', 'Leftovers will keep for about a week or can be frozen for up to three months.']",8
574,Kale Sausage Soup with Tomatoes and Chickpeas Recipe,15,60,75,"['1/2 pound mild Italian bulk sausage', 'Olive oil (if needed)', '3 cups sliced onions', '5 cloves garlic minced (about 5 teaspoons)', '1 28-ounce whole peeled tomatoes, roughly chopped', '6 cups sliced kale (about 2 bunches lacinato kale, stems removed, leaves sliced into 1/2-inch wide slices)', '1 15-ounce can of chickpeas, drained', '2 bay leaves', '2 sprigs of oregano (or 1/2 teaspoon dried oregano)', '8 cups chicken stock', '1/2 teaspoon black pepper', 'Salt to taste', '1/2 cup grated Parmesan cheese for garnish']",13,"['1 Lightly brown the sausage: Put the sausage in a large (5-qt) thick-bottomed pot and heat on medium or medium low heat.', ""Break up the large clumps of sausage and gently cook until lightly browned, rendering out the fat from the sausage. If the sausage is relatively lean and doesn't produce much fat when you cook it, add a tablespoon of olive oil to the pot. Note that you are just trying to lightly brown the sausage, not cook it through."", '  Remove sausage with a slotted spoon and set aside. You should have at least one tablespoon of fat or oil left in the pot, if not, add more.', '2 Cook the onions and garlic: Add the sliced onions to the pot and cook on medium heat until translucent, about 7 to 8 minutes. Add the minced garlic and cook a minute more.', '3 Add the chopped tomatoes, stock, bay leaves, oregano, and pepper. Bring to a simmer on high heat, reduce the heat to low and maintain a simmer for about 15 minutes.', '4 Add the chopped kale, chickpeas, and sausage to the soup. Cook for another 15 to 20 minutes, until the kale is tender. Add salt to taste.', 'Garnish with grated Parmesan to serve.']",7
575,Curry Chickpea-Loaded Baked Potatoes Recipe,15,40,55,"['For the potatoes:', '2 large russet potatoes (1 pound each)', '2 teaspoons extra virgin olive oil', 'Sea salt for sprinkling and to taste', '2 tablespoons olive oil', '4 cloves garlic, minced', '3 1/2 cups cooked chickpeas, or 2 (15-ounce) can of chickpeas, drained and rinsed', '1 cup full-fat coconut milk', '2 tablespoons curry powder', 'To serve:', 'Chopped fresh cilantro', 'Coconut flakes']",12,"['1 Roast the potatoes: Preheat the oven to 400\\xc2\\xb0F. Slice the potatoes in half lengthwise, and coat them with the olive oil using a brush or your hands. Add a sprinkle of sea salt. Place the potatoes cut-side down a baking sheet.', 'Bake until the potatoes are tender when pierced with a fork, 30 to 40 minutes, depending on the size of the potato.', '2 Make the chickpea topping: Heat a medium saucepan over medium-low heat. Add the olive oil followed by the minced garlic. Cook the garlic for a minute, just until fragrant. Stir in the chickpeas, coconut milk, curry powder, and a pinch of sea salt.', 'Simmer the chickpeas until hot and the coconut milk has reduced slightly, 4 to 5 minutes. If the sauce is too thick, add another splash of coconut milk or water, as needed.', '3 Assemble the chickpea-loaded potatoes: Place half a potato on a plate and mash slightly to create room for the chickpeas to rest inside. Top with the chickpeas and sprinkle with the cilantro and toasted coconut flakes.']",5
576,Chickpea Potato Curry Recipe,10,45,55,"['2 1/2 cups vegetable broth', 'Two 15-ounce cans chickpeas (garbanzo beans), drained and rinsed, or about 3 cups cooked', ""One 14 1/2-ounce can fire-roasted or stewed tomatoes with chiles (See Muir Glen. If you can't find canned tomatoes with chiles you can add half a 4-ounce can of diced green Anaheim chiles to a 14.5 ounce can of tomatoes.)"", '6 baby (new) Yukon Gold potatoes (about 12 ounces), quartered', '1 medium onion, diced (about 2 cups)', '2 tablespoons unsalted butter (or ghee if you have it, or you can sub extra virgin olive oil)', '2 teaspoons minced ginger', '1-2 teaspoons salt', '1 teaspoon ground cumin', '1 teaspoon ground coriander', '1/8 to 1/2 teaspoon cayenne pepper (to taste)']",11,"['1 Saut\\xc3\\xa9 onions and ginger: In a large pot, heat the butter over medium-high heat and saut\\xc3\\xa9 the onions and ginger until the onion begins to brown, about 4-5 minutes.', '2 Add the seasonings: Add the salt, cumin, coriander and cayenne, stir to combine and cook for another minute or two.', '3 Add the remaining ingredients, stir to mix and simmer, partially covered, for about 35 minutes, or until the potatoes are tender. Add more salt to taste.', 'Serve the curry in bowls over rice. Great accompanied with plain yogurt.']",4
577,Moroccan-Spiced Sweet Potato and Chickpea Stew Recipe,10,30,40,"['For the Ras el Hanout spice mix (or substitute a store-bought mix):', '1 1/2 tablespoons ground cumin', '3/4 tablespoons coriander', '3/4 tablespoons ground ginger', '2 teaspoons cinnamon', '2 teaspoons turmeric', '1 teaspoon crushed red chili (for a spicy stew), or 1 teaspoon mild paprika', 'For the stew:', '2 tablespoons olive oil', '1 large onion, diced (6 to 8 ounces)', '3 tablespoons grated fresh ginger', '2 tablespoons ras el hanout', '4 to 5 medium carrots, sliced (about 1lb)', '1 medium parsnip diced (about 3/4 lb)', '2 medium sweet potatoes, peeled and cubed (about 1 lb)', '2 roasted red peppers (from a jar or homemade), diced', '1 tablespoon grated lemon zest', '1/2 cup dried apricots, roughly chopped', '4 cups water or broth', '1 can (15 ounces) chickpeas, rinsed and drained', '6 to 8 cups baby kale or baby spinach', 'Lemon wedges, to garnish (optional)', 'Sliced jalapeno peppers, to garnish (optional)', 'Chopped cilantro, to garnish (optional)', 'Vegan or regular yogurt, to serve (optional)']",25,"['1 Mix the ras el hanout (or substitute store-bought): Whisk all the spices together until well-combined. This will make a little more than 1/4 cup of spice mix. Use 2 tablespoons for this recipe, then store the remaining in an air tight container for up to a year.', '2 Cook the onions: Saut\\xc3\\xa9 the onions in olive oil over medium-low heat for about 5 minutes, until the onions begin to turn translucent. Stir often to avoid browning too much.', 'Add in the ginger and 2 tablespoons of ras el hanout and saut\\xc3\\xa9 for another minute, stirring often.', '3 Add the remaining ingredients and bring to a simmer: Add in the carrots, parsnips, sweet potatoes, peppers, lemon zest, apricots, and broth or water, and stir well. Turn heat to medium to medium-high, and cover.', '4 Cook for 10 minutes. The stew should be bubbling at a low boil during this time. Adjust the heat as needed to maintain a low boil.', '5 Remove lid, add chickpeas, and cook for another 10 to 15 minutes, or until parsnips and sweet potatoes are quite soft and just starting to break down. Taste the stew, and add salt, pepper, and more ras el hanout to your taste.', '6 Just before serving, stir in the fresh greens. Stir gently until the greens are wilted.', '7 Serve: Serve with fresh cilantro, a spoon full of yogurt (either vegan or dairy), sliced chili, and lemon wedges.']",8
578,"Spicy Turkey Soup with Yogurt, Chickpeas, and Mint Recipe",10,35,45,"['1 cup water', '1/2 teaspoon salt', '1/2 cup raw basmati rice (rinsed if package directs you to rinse)', '4 cups turkey stock (or chicken stock)', '2-3 cups cooked leftover turkey meat, dark or light, cut into 1-inch pieces', '1 cup full-fat plain yogurt', '1 large egg yolk', '2 tablespoons flour', '1 15-ounce can chickpeas (garbanzo beans), drained and rinsed, or about 1 1/2 cups cooked', 'Salt and freshly ground pepper', '2 tablespoons unsalted butter', '2 cloves garlic, minced (about 2 teaspoons)', '2 teaspoons sweet paprika (can also use smoked paprika for a smokey added touch)', '1/8 teaspoon cayenne pepper (more or less to taste)', '3 tablespoons finely chopped mint', 'Lemon wedges, for serving']",16,"['1 Cook the rice: Bring water, 1/2 teaspoon of salt, and rice to a boil in a small saucepan. Reduce heat to a low simmer, cover, and cook for 15 minutes. Remove from heat and let sit for 10 minutes.', '2 Heat the turkey stock: In a medium saucepan, add the turkey stock and bring to a simmer, remove from heat. (If you are like us, and make your own homemade turkey stock and store it in glass jars, you can remove the lid from the jar and heat the stock in the microwave. You are just trying to warm up the stock in this step.)', '3 Add stock to yogurt, egg yolk, flour: Whisk together the yogurt, egg yolk, and flour in a large pot. Slowly add the heated stock, whisking after each small addition to incorporate. Heat to a simmer.', '4 Add the chickpeas, cooked turkey, and cooked rice. Add salt and pepper to taste.', '5 Make paprika butter sauce: Melt the butter on medium heat in a small skillet. Stir in the garlic, paprika, and cayenne pepper. Cook for a couple minutes, until fragrant, then remove from heat.', '6 Serve: Serve soup with a small amount of paprika butter sauce swirled on the surface. Sprinkle with chopped mint. Serve with lemon wedges. Squeeze lemon juice from the wedges onto the soup before eating.']",6
579,Vegan Chickpea Minestrone Recipe,15,30,45,"['2 tablespoons olive oil', '1 large yellow onion, minced', '2 stalks celery, minced (about 1/2 cup)', '1 large carrot, diced (about 1/2 cup)', '2 cloves garlic, minced', '3 tablespoons tomato paste', 'About 1 1/2 pounds Yukon Gold potatoes, diced (about 1 1/2 cups)', '1 cup fresh or frozen green beans', '3 cups vegetable broth', '2 cups water', '4 ounces small pasta, such as orzo, cavatelli, small macaroni, or pearl couscous', '1 teaspoon dried oregano', '2 teaspoons dried thyme', '1 bay leaf', '2 teaspoons dried basil', '1 (15-ounce can) crushed tomatoes', '1 (15-ounce) can chickpeas, drained and rinsed', '1 1/2 teaspoons salt', '3/4 teaspoon black pepper', '2 cups baby spinach', '1/4 cup unsweetened almond creamer']",21,"['1 Cook the vegetables: Heat a large stock pot over medium-low heat. Add the olive oil followed by the minced onion, celery, and carrot. Cook for 8 to 10 minutes until everything starts to soften and the onions are fragrant.', 'Stir in the garlic and tomato paste and cook for another minute. Add the diced potatoes and cook for another 2 to 3 minutes.', '2 Simmer the soup: Add the green beans, broth, water, pasta, and herbs. Bring to a boil, reduce to a simmer, and cook until the potatoes are just about tender and the pasta is al dente, 8 to 10 minutes.', '3 Add the remaining ingredients: Add the crushed tomatoes and their juices, along with the chickpeas, salt, and pepper and cook for another few minutes to warm everything through. Finally, stir in the spinach and cook for another minute or two until the spinach is wilted.', 'Turn off the heat. Remove the bay leaf and stir in the almond creamer just before serving.']",5
580,Turmeric Fried Rice with Eggs and Kale Recipe,15,15,30,"['For the rice:', '1/2 bunch Lacinato or dino kale', '2 tablespoons olive oil', '1/2 onion, finely chopped', '2-inch piece of ginger root, peeled and finely chopped', '1 clove garlic, finely chopped', '1 teaspoon ground cumin', '1 teaspoon ground turmeric', '1/2 teaspoon table salt', '1 cup rinsed and drained chickpeas (about half of a 15-ounce can)', '10 cherry tomatoes, halved', '1 to 2 cups cooked basmati rice', '1 tablespoon lemon juice', 'For the eggs:', '2 teaspoons butter or olive oil', '2 large eggs', 'Pinch of salt', 'Pinch of ground black pepper']",18,"['1 Finely slice the kale: On a cutting board, stack the kale leaves and cut across them to finely shred them, including the thinner stems. Set aside.', '2 Saut\\xc3\\xa9 the onions and spices: In a large skillet over medium heat, add the oil. Once the oil shimmers, add the chopped onions and cook for 2 to 3 minutes or until they begin to soften. Add the ginger, garlic, cumin, and turmeric. Cook, stirring, for about 1 minute, or until aromatic.', '3 Cook the kale: Add 1/4 cup water, kale, and the salt to the skillet. Cook, stirring often, for 3 to 4 minutes, or until the kale wilts.', '4 Stir in the rice: Add the chickpeas, tomatoes, cooked rice, and lemon juice to the skillet. Cook, stirring, until hot. Taste and add more salt, if you\\xe2\\x80\\x99d like. Remove the pan from the heat, cover, and set aside while you fry the eggs.', '5 Cook the eggs: In a non-stick skillet with a lid, over low heat, melt the butter or heat the oil. Break the eggs into the skillet and cover the pan with a lid. Cook for 1 1/2 to 2 minutes, or until all but a thin rim of egg white around each yolk is opaque. Remove the pan from the heat, keep covered, and let sit for about 30 seconds to finish cooking. (See here for more details.)', '6 Serve: Divide the fried rice between 2 bowls. Top each with a fried egg if desired, and sprinkle with salt and pepper.']",6
581,Mexican Red Chili Sauce Recipe,5,25,30,"['3 dried Ancho (sometimes called pasilla in the US*) chiles OR 2 Ancho and 2 Guajillo chiles', 'Water', '1 large clove garlic', '2 black peppercorns, crushed', 'A pinch of ground cloves', '1/2 teaspoon of salt, more to taste', 'Extra virgin olive oil', '* According to Diana Kennedy, Pasilla chilies are a long and skinny variety of chile, while Ancho chilies (dried poblanos) are shorter and wider. However, in certain parts of Michoacan, Mexico, the Ancho chile is called Pasilla, and because of immigration, is commonly known as Pasilla in many parts of the US.']",8,"['1 Cut the chiles open and remove stem and seeds: Working on one chile at a time, use a paring knife to cut a slit all the way down one side of a chile. Open up the chile and remove the stem and seeds. Remove as much of the veins as you can.', 'Reserve a few of the seeds or veins for adding later if you want added heat.', 'Note when working with chilies, either wear protective gloves or wash your hands very thoroughly with soap and warm water after handling the chilies. Do not touch or rub your eyes if you have been handling chili peppers.', '2 Heat the chiles on a skillet: Heat a large skillet on medium heat. Flatten out the dried chilies as well as you can and place on the skillet to heat.', 'Press down on the opened chilies and leave for a few seconds. Turn the chilies over and heat a few seconds more.', ""You do not want to toast or burn the chilies! If they burn, they'll turn bitter. Just heat them enough to draw out more of their flavor."", '3 Soften the chiles in hot water: Add the chilies to a small saucepan and add enough water so that they are just covered. Bring to a boil. Remove from heat and let sit for 10 minutes, until the chilies have softened and plumped up.', '(OR pour place the chilies in a small saucepan and pour boiling water over them to cover. Let sit for 15 minutes, until softened.)', '4 Pur\\xc3\\xa9e with garlic, seasonings, water or poaching liquid: Reserving the soaking water, remove the chilies from the pan and place in a blender. Add the garlic, salt, crushed peppercorns, ground cloves, and 1 1/2 cups of the soaking liquid (taste the soaking water first, if it seems bitter, use plain water instead).', 'Pur\\xc3\\xa9e for 2 minutes, until the sauce is completely smooth. Taste the sauce and adjust the seasoning. If you want more heat, add in a few of the seeds or veins and pur\\xc3\\xa9e some more. Add more salt if needed.', '5 Strain through sieve into a skillet, simmer: Pour the sauce through a sieve into a skillet. Add a tablespoon of olive oil to the sauce.', 'Bring to a simmer and reduce heat to maintain the simmer, cook for 10 minutes. Skim off the foam.', 'Remove from heat. Use immediately or pour into a glass jar (plastic will get stained) and refrigerate.']",13
582,Blistered Shishito Peppers Recipe,3,6,9,"['1 teaspoon extra virgin olive oil', '20 or so shishito peppers (about 4 or 5 ounces, 1 small basket)', 'Sprinkle of kosher salt', '2 tablespoons balsamic vinegar (optional)']",4,"['1 Toss peppers with oil: Toss shishito peppers with extra virgin olive oil in a bowl, so the peppers are well coated.', '2 Sear in frying pan: Heat a well seasoned cast iron (or a pan that can take high heat) on high heat. When the pan is hot, add the peppers to the pan in a single layer. Let the peppers sear and blister on one side, then use tongs to turn them over individually to sear on the other side.', '3 Salt: Remove to a bowl and sprinkle the shishito peppers with salt.', '4 Make balsamic glaze (Optional):  Add a couple tablespoons of balsamic vinegar* to the pan. Remove from heat, and let bubble until the vinegar reduces to a glaze, which should be very quickly. Pour over the blistered shishito peppers.', '*Balsamic vinegar can be syrupy and sweet, or thin and acidic. Use the syrupy kind. If what you have is thin and very acidic, stir with a half teaspoon of sugar or honey before adding to the hot pan.']",5
583,Roasted Poblanos in Cream Sauce (Rajas con Crema) Recipe,5,25,30,"['6 fresh poblano chiles', '1 Tbsp butter', '1/2 white onion, sliced lengthwise (root to tip), 1/4-inch slices', '1/2 teaspoon salt', '1/2 cup Mexcian crema (Mexican sour cream) or cr\\xc3\\xa8me fra\\xc3\\xaeche', '1/2 cup milk', '1/2 cup grated Monterey Jack cheese']",7,"['1 Char the whole poblano chiles: Char the whole poblano chile peppers on all sides. The best way to do this is over an open flame of a gas stove. Just place the raw whole chile peppers directly on the grate covering the flame and let the flame blacken the outside skin of the peppers. When one side has blackened, use tongs to turn the chile over a little so the flame can blacken another side.', 'You can also use a broiler to blacken the chile peppers, but direct flame is the best way. Sometimes with a broiler the chiles end up cooking too much before they blacken. They should still be a little firm. This is easier to control when you cook them directly over flame.', '2 Place the chiles in a bowl, cover: Once the peppers are blackened all over (you can still have a few green spots), place them in a glass bowl and cover them with a plate. Let the chiles steam in their own heat for a few minutes.', '3 Wipe away the charred bits: When the chiles are cool to touch, remove them from the bowl. Working over a sink (this part is messy) use your fingers or a damp towel to strip off the blackened parts. Try to avoid running the chiles themselves under water, as that may wash away some good flavor. But you may find it easier to rinse your hands with water as you are stripping the blackened bits off.', '4 Open the chiles, remove stems, seeds, inner veins, then cut the chiles into strips: Once the blackened outer skin is removed, open up the chiles and cut out and discard the stems, seeds, and inner veins. Cut the chiles into long strips, about an inch wide. Many recipes call for thin strips, about a half inch wide, which you can do if you want. I just like them with thicker strips. Set aside.', '5 Cook onions in butter: Heat the butter (can use vegetable oil instead if you want) in a large cast iron skillet on medium heat. Add the onions and cook until translucent, about 3 to 4 minutes.', '6 Add the chiles, crema, milk: Add the poblano chiles to the onions. Sprinkle the chiles with salt. Add the Mexican crema and the milk. Gently stir to coat the chiles. Let cook for several minutes, until the chiles are completely cooked through and the sauce is bubbly and a little reduced.', '7 Stir in the grated cheese: Sprinkle in the grated jack cheese. Stir with the hot crema sauce until the cheese has melted and mixed in with the crema sauce.', 'Serve with warmed corn or flour tortillas.']",9
584,How to Roast Green Chiles on a Gas Stove,0,0,0,"['Raw chile peppers - anaheim, Hatch, poblano, or jalape\\xc3\\xb1o']",1,"['At this point you can freeze the blackened roasted chiles by letting them cool to room temp, placing them in a freezer bag, squeezing out the air and freezing them. When you defrost them, the blackened skins will peel right off! If you need to use the chiles right away, continue with the instructions.', '3 Place chile in covered dish to steam: Place the chile in a bowl and cover with a plate (or put the chile in a brown paper bag and close the bag).', 'Let the chiles sit for 5 or 10 minutes. The steam from the hot chile will help the peel come off more easily.', ""4 Remove charred peel: Remove the chile from the bowl. Use your fingers or a damp towel or damp paper towel to rub off the charred peel. You may find it easier to do this over a sink, because it can get rather messy. Try to avoid running water over the chile itself, as doing so may wash away some of the chile's flavor."", '5 Prep and store the chile: Make a slice into the side of the chile and cut away and discard the stem, seeds, and veins.', 'Place in a covered container and refrigerate.', 'The chile will keep for several days in the fridge. Or you can place in a freezer bag, press out the air, and freeze. Frozen chiles will last for several months.']",7
585,Easy Green Chicken Chili Recipe,15,25,40,"['2 tablespoons olive oil', '1 yellow onion, diced', '1 green bell pepper, diced', '1 cup sweet corn', '3 cloves garlic, minced', '2 cups mild roasted Hatch green chiles, chopped or diced', '2 teaspoons ground cumin', '1 teaspoon paprika', '1/2 teaspoon salt', '1/2 teaspoon black pepper', '1 quart chicken stock', '3 cups cooked shredded chicken', '1 15-ounce can cannellini beans, drained', '1/2 cup cilantro', '1/4 cup water', '1 lime, juice only', 'Cilantro, for garnish', 'Avocado slices, for garnish', 'Hot sauce, optional, for garnish', 'For the Crispy Corn Chips (Dad Add)', '10 small corn tortillas, sliced into 1/4 inch strips', '2 tablespoons olive oil', '1 teaspoon kosher salt', '1 teaspoon sugar', '1 teaspoon chili powder']",25,"['1 Make the corn chips (optional Dad Add): Preheat oven to 400\\xcb\\x9aF. Spread out the corn tortilla slices on a baking sheet lined with aluminum foil or parchment paper. Drizzle with olive oil and sprinkle with salt, sugar, and chili powder. Toss well to combine spices.', 'Bake for 15 minutes, stirring once or twice to make sure the strips are baking evenly. Remove and let cool. Strips will get crispy as they cool.', '2 Make the soup: In a large pot or Dutch oven, heat olive oil over medium heat. Add onions, green peppers, corn, and garlic. Saut\\xc3\\xa9 for 5-6 minutes until vegetables soften.', 'Add roasted green chiles to the pot along with the cumin, paprika, salt, and pepper. Stir together and cook for a 3-4 minutes .', 'Add shredded chicken and chicken stock and bring chili to a low simmer.', '3 Simmer the soup: Turn heat down to low and simmer for five minutes.', '4 Blend the beans: In a blender or food processor, add drained and rinsed cannellini beans, water, and cilantro. Blend until the mixture has become a green paste. Add to the chili and stir until the soup has thickened slightly.', '5 Adjust seasonings, then serve with toppings: Add lime juice to the chili, taste, and adjust for seasoning. Serve garnished with avocado, cilantro, hot sauce (optional), and crispy corn chips.', 'Leftover green chili can be stored in the fridge for five days, or frozen for up to three months. Reheat gently on the stove.']",9
586,Instant Pot Beef Chili Recipe,10,30,40,"['1 tablespoon olive or vegetable oil', '1 medium green bell pepper, chopped', '1 medium yellow onion, chopped', '2 ribs celery, chopped', '1 clove garlic, finely chopped', '1 pound ground beef (85% lean)', '2 tablespoons chili powder', '1 1/2 teaspoons salt', '1/2 teaspoon oregano', '3 tablespoons tomato paste', '1 (14-ounce) can diced tomatoes', 'Water or broth, as needed to make 1 cup liquid with the tomato juices', '1 (15.5-ounce) can kidney beans, drained and rinsed', '1 cup shredded cheese, any favorite mix, to serve', '2 green onions, sliced thinly, to serve', 'Rice, cornbread, or garlic knots, to serve', 'Special equipment:', '6-quart Instant Pot, or other pressure cooker']",18,"['1 Cook the vegetables: Select the \\xe2\\x80\\x9cSaut\\xc3\\xa9\\xe2\\x80\\x9d program on your pressure cooker and add the oil to the pot. (If you are using a stovetop pressure cooker, heat the oil over medium heat.) Add the bell pepper, onion, celery, and garlic. Saut\\xc3\\xa9 until the onions are softened and translucent, about five minutes.', '2 Cook the ground beef: Add the ground beef to the pot, breaking it up in small pieces. Cook until no longer pink, about five minutes.', '3 Stir in the spices and tomato paste. Add the chili powder, salt, oregano, and tomato paste to the pot. Stir until the tomato paste is evenly mixed into the other ingredients and no clumps remain.', '4 Add the tomatoes and beans: Strain the tomatoes, then add enough water or broth to make 1 cup total liquid. Add the liquid, the strained tomatoes, and the beans to the pressure cooker.', '5 Cook the chili: Place the lid on the pressure cooker. Make sure the pressure regulator is set to the \\xe2\\x80\\x9cSealing\\xe2\\x80\\x9d position. If you are using an Instant Pot, select the \\xe2\\x80\\x9cChili\\xe2\\x80\\x9d program, then adjust the time to 20 minutes. If your pressure cooker does not have a \\xe2\\x80\\x9cChili\\xe2\\x80\\x9d program, set it manually to \\xe2\\x80\\x9cHigh Pressure\\xe2\\x80\\x9d for 20 minutes. For stovetop pressure cookers, cook for 17 minutes at high pressure.', 'It will take about 10 minutes for your pressure cooker to come up to pressure, and then the actual cooking will begin. Total time from the time you seal the pressure cooker to the finished dish is about 30 minutes.', '6 Release the pressure after cooking: When the timer goes off, you may either perform a quick pressure release by moving the pressure release knob from \\xe2\\x80\\x9cSealing\\xe2\\x80\\x9d to \\xe2\\x80\\x9cVenting,\\xe2\\x80\\x9d or let the pot depressurize naturally on its own (this takes about 20 minutes; open the vent to ""Venting"" when you\\xe2\\x80\\x99re ready to serve the chili.) For stovetop pressure cookers, perform a quick pressure release.', '7 To serve: Top bowls of chili with shredded cheese and green onions, if desired. Serve alone, over rice, or with cornbread.']",8
587,Black Bean Turkey Chili Recipe,15,75,90,"['3 tablespoons extra virgin olive oil', '1 medium onion, chopped (about 1 cup)', '1 carrot, chopped (about 1/2 cup)', '2 to 3 red bell peppers, chopped (about 2 cups)', 'Salt', '2 cloves garlic, minced (about 2 teaspoons)', '2 tablespoons chili powder (more to taste)', '1 teaspoon ground cumin', '1 pound ground turkey (I use ground turkey thighs for more flavor)', '3 cups chicken stock', '1 teaspoon dried oregano', '1 bay leaf', '1 tablespoon tomato paste', '1 tablespoon cider or white vinegar', '2 (15-ounce) cans black beans, drained', 'Freshly ground black pepper']",16,"['1 Saut\\xc3\\xa9 carrots, onions, bell peppers: Heat the oil in a large, thick bottomed pot (6- to 8-quart) on medium heat. Add the chopped onion, carrot, and bell peppers, and sprinkle with salt. Cook until softened, 6 to 8 minutes.', '2 Add the minced garlic, chili powder, and cumin and cook for a minute more.', '3 Add the ground turkey and break it up with a wooden spoon. Increase the heat to medium high. Stir and cook until the turkey is no longer pink, about 5 minutes.', '4 Add the chicken stock, oregano, bay leaf, vinegar, and tomato paste. Use a straight edge spatula or wooden spoon to scrape up any browned bits from the bottom of the pan.', '5 Simmer the chili: Add the black beans. Bring the chili to a boil, lower to a simmer. Cover and cook for half an hour.', 'Uncover and cook for another half hour, or until the the liquid thickens.', '6 Serve: Remove the bay leaf. Taste the chili and adjust seasonings, adding salt and pepper to taste.', 'Serve with rice or heated corn tortillas.']",8
588,Chili Beans with Rice Recipe,5,170,175,"['2 cups (1 pound) dry pinto beans OR 4 15-ounce cans pinto beans, drained', '1 pound ground beef or ground turkey', '2 cups uncooked white rice', '1 yellow onion, chopped (about 1 1/2 cups)', '2 tablespoons extra virgin olive oil', '2 cloves garlic, chopped (about 1 teaspoon)', '1 to 2 tablespoons chili powder', '1 tablespoon chopped parsley', '1 (14-ounce) can crushed or whole peeled tomatoes', '1 jalape\\xc3\\xb1o pepper (cooked, canned), sliced (Note concerning the tomatoes and jalape\\xc3\\xb1o pepper: my mother will substitute these on occasion with a cup of Pace brand salsa - works fine)', '1 teaspoon salt', '1 teaspoon sugar', '1/2 cup of fresh cilantro leaves']",13,"[""2 Cook the rice: When you're ready to begin making the chili beans (after the dried beans are cooked), cook the rice. Put 2 cups of rice in a medium thick-bottomed pot. Add 3 cups of water (less or more depending on package instructions), a tablespoon of butter (for flavor), and a teaspoon of salt. Bring to a boil, lower the heat to a low simmer, cover the pot and let cook for 15 minutes (again check your package instructions)."", 'Remove from heat, keep covered, and let steam for 10 minutes.', '3 Saut\\xc3\\xa9 the onions: In a large skillet, saut\\xc3\\xa9 onions in 2 Tbsp of olive oil until translucent on medium high heat, about 4 minutes. Add the garlic and chili powder and cook for a minute more.', 'Remove the onions to a bowl.', '4 Brown the meat: Increase the heat to high, and add the meat to the same pan used to cook the onions. Let cook for a minute or two without moving so that the meat gets browned, then turn to brown on the other sides.', '5 Combine meat and onions, add tomatoes and jalape\\xc3\\xb1o: Add the onions and garlic back to the pan. Taste for spiciness and add more chili powder if desired.', 'Add one can of tomatoes, the sliced jalapeno pepper, the chopped parsley, 1 teaspoon of salt, and 1 teaspoon of sugar to counteract the acidity of the tomatoes. Stir to combine.', '6 Add the cooked beans and simmer: Once the beans are cooked, drain them. Add the beans to the meat and onions, adding another teaspoon of salt as the beans go in.', 'Simmer for 5 to 10 minutes, tasting and adding more salt if needed to taste.', '7 Serve: Stir in cilantro leaves right before serving, or sprinkle on top. Serve over rice or with warm corn tortillas.']",10
589,Red Chile Marinated Grilled Chicken Recipe,10,120,130,"['3 pounds bone-in, skin-on chicken parts, preferably thighs, trimmed of excess skin and fat', 'Salt', '1 1/4 cup Mexican red chili sauce, either homemade* or canned (if you are gluten intolerant and are using canned chili sauce, make sure to read the ingredients on the can, some makers put wheat products in their sauce)', '1 tablespoon extra virgin olive oil', '2 tablespoons white or cider vinegar', '1/2 teaspoon ground cloves', '1/2 teaspoon ground allspice', '1 teaspoon cinnamon', '1/4 teaspoon ground cumin', 'A couple of turns on a black pepper grinder', 'A pinch of dried oregano, crushed', '1 teaspoon minced garlic', 'Garnish', 'Avocado slices', 'Thinly sliced lettuce or cabbage', 'Thinly sliced radishes', 'Cilantro', ""* To make your own homemade sauce, take 2 ancho and 2 guajillo chiles, open them up, remove the stems, seeds, and ribs. Lightly toast the chiles on a medium griddle or cast iron pan for a minute or two, flattening them down with a metal spatula. Place the chiles in a saucepan, cover with water, bring to a boil, remove from heat and let soak for 10-15 minutes, until chiles are softened. Place chiles, 1 1/4 cup of the soaking water, 1 clove of garlic, a pinch of salt, in a blender. Blend until completely smooth. Put mixture through a strainer to strain out any solids. Proceed with the recipe, but don\\'t add any more garlic to the sauce.""]",18,"[""1 Simmer chili sauce and spices to make the marinade: Heat oil in a medium sized saucepan on medium heat. Add the chili sauce. Add vinegar (2 Tbsp if using canned sauce, 4 Tbsp in you\\'ve made your own sauce), cloves, allspice, cinnamon, cumin, black pepper, oregano and garlic."", 'Bring to a simmer and let simmer for 5 minutes. Remove pan from heat and let cool.', '2 Marinate chicken: Sprinkle salt over all the chicken pieces on all sides. Put chicken pieces in a non-reactive bowl or a large freezer bag. Add the marinade, make sure all pieces are coated well with the marinade.', 'Marinate in the refrigerator at least one hour, preferably overnight.', '3 Grilling Instructions: Remove the chicken from the refrigerator before starting up the grill. Preheat your grill, allowing for a space on the grill for cooking the chicken with indirect heat. (If using coals, move all the coals to one side of the grill, if using gas, after the grill is hot, turn off one of the burners.)', 'Brush the grill grates with olive oil. Make sure the chicken pieces are well coated on all sides with the paste-like marinade.', 'Place the chicken pieces on the indirect heat part of the grill (not over a flame or coals). Cook, covered, for 25-30 minutes, turning the pieces over after the first 15 minutes. Try to keep the temperature in the grill around 350\\xc2\\xb0F. Chicken is done when juices run clear, breasts have an internal temperature of 165\\xc2\\xb0F and thighs 175\\xc2\\xb0F.', ""3a Roasting Instructions: If you aren\\'t in a grilling mood, you can roast the chicken pieces in the oven. Preheat the oven to 350\\xc2\\xb0F. Place the chicken pieces in a roasting pan, skin-side up. Cook for about 45-50 minutes, until breasts have an internal temperature of 165\\xc2\\xb0F and thighs 175\\xc2\\xb0F."", '4 Serve with garnishes: Serve garnished with sliced avocado, sliced lettuce or cabbage dressed with a little vinegar and oil, sliced radishes and cilantro.', 'Makes for great leftover chicken to cut up and put into tacos.']",10
590,Easy Vegetarian Chili Recipe,10,40,50,"['For the chili:', '1 tablespoon olive oil', '8 ounces baby portabella mushrooms, cleaned and quartered', '1 teaspoon kosher salt', '3/4 teaspoon freshly cracked black pepper', '1 medium yellow onion, peeled and quartered', '1 medium green bell pepper, chopped', '1 jalape\\xc3\\xb1o, seeded and minced', '3 large cloves garlic, minced', '1 1/2 tablespoons mild chili powder', '1 1/4 teaspoons oregano', '1 1/4 teaspoons ground cumin', '1/4 teaspoon smoked paprika', 'Pinch of cinnamon', '1 tablespoon plus 1 teaspoon brown sugar', '1 (15-ounce) can fire-roasted tomatoes, undrained', '1 (15-ounce) can tomato sauce', '3 cups vegetable stock or water', '1/2 cup bulgur wheat', '1/2 teaspoon liquid smoke, optional', '2 (15-ounce) cans kidney beans (light or dark or a combination), drained', 'For the toppings:', '1 handful cilantro, minced', '1/2 small red onion, minced', '1 avocado, diced', 'Lime wedges']",26,"['1 Prep and begin cooking the mushrooms: Put the mushrooms in a food processor fitted with the blade attachment. Pulse for about 30 seconds until they are smaller than a pea.', 'Heat 1 tablespoon of olive oil in a large Dutch oven over medium heat. Add mushrooms to the pot with 1 teaspoon kosher salt and 3/4 teaspoon freshly cracked pepper.', 'Cook for about 7 minutes until the mushrooms release some of their liquid and turn a darker color.', '2 Cook the veggies and spices: Add the onion to the food processor (no need to clean) and pulse about 6 to 8 times until the onions are the size of a small dice. Add the onion, along with the chopped green bell pepper, minced jalape\\xc3\\xb1o pepper, garlic, chili powder, oregano, cumin, smoked paprika, and cinnamon to the pot.', 'Cook for about 8 minutes until the onions are translucent and the green peppers just begin to soften. Stir in the brown sugar. Cook for about 1 minute just to incorporate it.', '3 Simmer the chili: Add the fire roasted tomatoes (and all their juices), tomato sauce, and three cups of stock or water. Stir to combine.', 'Cover the pot and bring the chili up to a boil. This should take about 4 to 5 minutes.', 'Once the chili is boiling, stir in the bulgur, then reduce the heat to medium low. Let the chili simmer for about 12 minutes until the bulgur is cooked through. It should be chewy and tender.', 'Add the drained beans to the beans and liquid smoke to the pot. Stir to combine. Let it simmer on the stove for about 10 minutes.', '4 Season and serve: Stir. Taste, and add salt or pepper as you see fit. Ladle into bowls, and top with the cilantro, red onion and avocado. Serve the lime wedges alongside the bowl.']",10
591,Easy No-Bean Chili Recipe,20,30,50,"['For the chili:', '1 tablespoon olive oil', '2 pounds lean ground beef', '1 white onion, diced', '1 green pepper, diced', '1 jalape\\xc3\\xb1o, seeded and diced', '4 cloves garlic, minced', '2 teaspoons cumin', '1 teaspoon paprika', '2 tablespoons mild chili powder', '1 teaspoon salt', '1 teaspoon black pepper', '6 ounces tomato paste', '2 tablespoons cornmeal', '1 (28-ounce) can chunky tomato puree (or diced tomatoes)', '2 cups beef stock', 'For the toppings:', 'Sliced scallions', 'Sour cream', 'Grated cheddar cheese', 'Tortilla chips', 'Diced avocado', 'Diced onion', 'Special equipment:', 'Dutch Oven or heavy-bottomed pot']",25,"['1 Brown the beef: In a Dutch oven or heavy-bottomed pot over medium-high heat, add a drizzle of olive oil and then the ground beef. Brown the beef well, breaking it up with a wooden spoon while it cooks.', 'Let the beef cook for 5 to 6 minutes, until it\\xe2\\x80\\x99s lightly browned. There shouldn\\xe2\\x80\\x99t be any visible pink spots on the beef.', '2 Add the onions through cornmeal: Add the onions, green peppers, jalape\\xc3\\xb1o, and garlic to the chili and stir. Let the vegetables cook for a few minutes until they soften. Add the cumin, paprika, chili powder, salt and pepper, and stir together.', 'Finally, add the tomato paste and cornmeal and stir into the mixture. It will seem very dry at this point, but let it cook for a few minutes like that, stirring constantly, to develop some color.', '3 Add the tomatoes and beef stock to the chili. Use the liquid to scrape up any bits stuck to the pan.', '4 Simmer the chili: Bring the chili to a simmer and turn heat down to low. Let the chili simmer for at least 10 minutes, but it could simmer for hours at this point if you wanted to. Just keep an eye on it to make sure it has enough liquid and add water if it seems dry.', '5 Serve! Serve the no bean chili with grated cheddar cheese, sour cream, and fresh scallions.', 'Leftovers can be kept in the fridge for a few days or frozen for up to two months. Reheat chili slowly on the stovetop.']",8
592,Buffalo Chicken Chili Recipe,10,30,40,"['2 boneless, skinless chicken breasts (1 1/2 pounds)', '2 14.5-ounce cans diced fire-roasted tomatoes', '1 7-ounce can diced fire-roasted green chiles', '1 cup unsalted or low-sodium chicken stock', '3/4 cup buffalo wing sauce, plus more for serving', '1 tablespoon chili powder', '2 teaspoons ground cumin', '2 15.5-ounce cans cannellini beans, drained and rinsed', 'Salt and ground black pepper', 'Sour cream, crumbled blue cheese, diced green onion, and tortilla chips, for serving']",10,"['1 Cook the soup: Add the chicken, tomatoes, chiles, chicken stock, buffalo wing sauce, chili powder, and cumin to a large pot or Dutch oven. Bring to a boil; reduce to a gentle simmer over medium heat, and cook until the chicken is cooked all the way through, about 25 minutes.', '2 Shred the chicken and add the beans: Remove the chicken breasts from the pot and shred with two forks. Return the shredded chicken along with the beans to the pot, and cook until the beans are warmed through, about 5 minutes.', '3 Season and serve: Taste the chili and season with salt, pepper, and more buffalo wing sauce as desired. (Note: buffalo wing sauce tends to be high in sodium, so you might not need to add very much, if any, additional salt.)', 'Ladle the chili into bowls and serve topped with sour cream, crumbled blue cheese, diced green onion, tortilla chips, or whatever other ingredients you enjoy.']",4
593,Simple Cooked Tomato Salsa Recipe,5,18,23,"['2 medium sized fresh tomatoes, cored and cut in half', '1 whole jalape\\xc3\\xb1o chili pepper (or a serrano), stem removed, chopped', '5 large garlic cloves, peeled', '1 1/2 teaspoons salt', '1/4 cup water', '2 teaspoons olive oil']",6,"['1 Pur\\xc3\\xa9e ingredients: Put tomatoes, jalape\\xc3\\xb1o, garlic, salt, and water into a blender. Pur\\xc3\\xa9e for 20 seconds, until completely liquified.', '2 Simmer for 15 minutes: Heat olive oil in a sauce pan on medium high. Pour pur\\xc3\\xa9e into pan. Bring to a low simmer and cook, stirring occasionally, until the mixture completely changes color from light red to a much darker red, about 15 minutes. Remove from heat.', 'Keep refrigerated when not using.']",3
594,Skirt Steak with Avocado Chimichurri Recipe,25,8,33,"['For the avocado chimichurri sauce:', '1 cup cilantro leaves, packed', '1 cup parsley leaves, packed', '1 tablespoon roughly chopped garlic', '1/2 teaspoon kosher salt', '1/2 teaspoon ground cumin', '1/2 teaspoon red pepper flakes', '1/4 cup red wine vinegar', '1/2 cup extra-virgin olive oil', '1 medium avocado, diced about 1 cup', 'For the skirt steak:', '1 pound skirt steak', '1 teaspoon Kosher salt, as needed for seasoning', '1/2 teaspoon black pepper, as needed for seasoning', '2 tablespoons olive oil']",15,"['1 Prepare the chimichurri sauce: Add the cilantro, parsley, garlic, salt, cumin, and red pepper flakes to a food processor. Pulse until the leaves are coarsely chopped, about 5 pulses. Add the red wine vinegar, pulse 5 times. Add the olive oil, pulse 5 times. The chimichurri sauce should be emulsified and the herbs coarsely chopped.', '2 Add the avocado: Transfer the chimichurri sauce to a medium bowl. Cut the avocado into 1/2-inch dice. Add the avocado to the chimichurri and gently stir to combine. Cover and refrigerate until ready to use.', '3 Cut the steak: If the skirt steak comes in a long strip, cut across the grain into 2 to 3 smaller pieces, about 5 to 7 inches in length. This will allow the steak to fit better in the pan.', '4 Dry and season the steak: Thoroughly pat dry each steak with paper towels on each side. The surface should be very dry to help brown the surface of the meat. Generously season each side of the steaks with salt and pepper.', '5 Heat the pan: Heat a large 12-inch cast-iron skillet over high heat for 3 minutes. Once hot add the olive oil.', '6 Cook the steak: Use tongs to carefully add the steak to the pan, then press down on the surface a few times for more contact. Sear the first side until browned, about 2 to 4 minutes depending on the thickness of the meat. Flip and cook another 2 to 4 minutes.', 'For medium-rare doneness, cook steak until it reaches an internal temperature of 130\\xc2\\xbaF. Work in two batches if needed.', '7 Rest the steak: Transfer steak to a cutting board, loosely cover with foil and rest for 10 minutes before slicing.', '8 Slice and serve the steak: Hold the carving knife at a 45-degree angle and then slice the steak against the grain, about 1/4-inch thick slices. Transfer skirt steak to a serving plate and either top with avocado chimichurri sauce or put the sauce on the side.']",9
595,Easy Chinese Chicken Salad with Chow Mein Noodles Recipe,15,15,30,"['1 pound boneless, skinless chicken breast, sliced into short strips', 'Salt', '1 tablespoon dark sesame oil', '1 tablespoon canola or peanut oil', '1/2 teaspoon red pepper flakes', '1 head iceberg lettuce or Napa cabbage, thinly sliced', '1/2 sweet bell pepper, thinly sliced', '3-4 scallions, sliced', '1 carrot, julienned', '1/2 cup loosely packed cilantro leaves, chopped', '1/2 cup roasted peanuts', 'Chow mein noodles, to taste', 'For the dressing:', '1 tablespoon soy sauce (use gluten-free soy sauce for gluten-free option)', '2 tablespoons unseasoned rice vinegar', '1 teaspoon mustard powder', '1 teaspoon fresh grated ginger', '1 clove garlic, minced', '1/2 teaspoon chili pepper flakes', '2 teaspoons sugar', '1 tablespoon dark sesame oil', '1/4 cup peanut or canola oil']",22,"['1 Saut\\xc3\\xa9 the chicken: Heat both oils over high heat in a large saut\\xc3\\xa9 pan for 1 minute, then add the red pepper flakes and cook for 30 seconds.', 'Pat dry the chicken strips, sprinkle them with a little salt, and add them to the pan. Stir-fry the chicken over high heat until cooked through, 3-6 minutes depending on how hot your burner gets. Remove and set aside to cool.', '2 Make dressing: In a small bowl, whisk together the dressing ingredients. Adjust seasonings to taste.', '3 Toss salad to serve: In a large bowl, toss the chicken and salad ingredients together. Just before serving, toss with dressing and top with the chow mein noodles.']",4
596,Vegetable Lo Mein Recipe,15,20,35,"['For the sauce:', '1/4 cup soy sauce', '1/4 cup hot water', '2 tablespoons hoisin sauce', '1 tablespoon sesame oil', 'For the lo mein:', '10 ounces lo mein noodles, fresh or dry', '2 teaspoons salt', '1 teaspoon sesame oil', '2 tablespoons olive oil', '8 ounces cremini mushrooms, sliced', '1 red pepper, sliced', '1 carrot, grated', '1 small head napa cabbage, chopped', 'To garnish:', 'Fresh scallion, chopped', 'Sesame seeds', 'Wasabi edamame (Dad Add)']",18,"['1 Combine the sauce ingredients: In a small bowl, stir together soy sauce, hot water, hoisin sauce, and sesame oil.', '2 Cook the lo mein noodles: Fill a large pot with water and set it over medium heat. Add the salt and bring the water to a boil. Add the noodles and cook until tender, usually around 4 minutes, but check the package directions for the noodles you are using.', 'Drain the noodles, transfer to a bowl, and toss with sesame oil to prevent sticking.', '3 Cook the vegetables: Set a wok or large skillet over medium-high heat. Once hot, add olive oil along with the sliced mushrooms, and stir fry for 2-3 minutes until the mushrooms lose their water and start to brown slightly. Then add the red pepper, carrot, and cabbage. Continue to cook for about 3 minutes, stirring regularly until the vegetables are wilted.', '4 Add the noodles and sauce: Add noodles along with the sauce and stir with the vegetables to combine. The sauce should coat the noodles and vegetables. If the noodles seem dry, add more water, a tablespoon at a time.', 'Taste and adjust the flavor to your liking. It might need another dash of soy sauce, for example.', '5 Serve: Serve the Veggie Lo Mein topped with scallions, sesame seeds, and wasabi edamame (if you like it hot) for some nice spicy crunch.', 'Leftovers! You can store leftovers in the fridge for 3-4 days. They will reheat beautifully in the microwave.']",8
597,Pork Stir Fry with Green Onion Recipe,20,5,25,"['1 pound pork loin or boneless pork chops', '2 tablespoons soy sauce (use gluten-free soy sauce if cooking gluten-free)', '1 teaspoon sugar', '1 teaspoon cornstarch', '4 tablespoons peanut oil or canola oil', '5 cloves garlic, thinly sliced', '8-12 scallions/green onions, sliced diagonally into 1 to 2-inch pieces, green and white parts included', '1/2 teaspoon sesame oil (optional)', 'Cooked rice, to serve']",9,"['1 Prepare the pork: Pork chops tend to come in thicknesses either around 1/2 inch thick or an inch thick. If you are working with a thick boneless pork chop, start by slicing it into two thin layers, horizontally.  If starting with pork loin, cut slices 1/2 inch thick.', 'Put the slices under some plastic wrap or wax paper and pound them thin with a rubber mallet, meat mallet or even an empty wine bottle. This will help tenderize the meat. The slices should be about 1/4 inch thick.', 'Cut the pork across the grain into thin strips, about 1 1/2 inches long.', '2 Marinate the pork: Put the soy sauce, sugar, and cornstarch into a large bowl and whisk to combine. Add the pork strips to the bowl with the marinade and toss to coat completely. Set aside for at least 10 minutes.', '3 Stir fry pork on high heat: Heat the peanut oil in a wok or large saut\\xc3\\xa9 pan on high heat. When the oil is hot (shimmering but not smoking) add the garlic slices and stir-fry until they begin to turn brown at the edges, about 30 seconds.', 'Add the pork strips and stir-fry until the pork changes color, about 90 seconds, stirring constantly.', '4 Add in green onions and sesame oil: Add the sliced green onions and continue to stir-fry for another minute, or until the green onions wilt. Turn off the heat and stir in the sesame oil, if using.', '5 Serve! Serve immediately. Serve alone (paleo and low carb), or with rice.']",8
598,Chinese Orange Chicken Recipe,20,15,35,"['For the orange sauce:', 'Zest from 1 orange', '1/4 cup orange juice', '1/4 cup soy sauce', '1/4 cup water', '1/3 cup rice vinegar', '1 tablespoon cornstarch', '1 tablespoon sesame oil', '1/2 cup sugar', 'For the chicken:', '1 1/2 pounds boneless skinless chicken thighs', '2 large eggs', '1 teaspoon salt', '1/4 teaspoon black pepper', '1/2 cup cornstarch', '1/2 cup all-purpose flour', '2 cups vegetable oil, for frying', '2 cloves garlic, chopped', '1 large shallot, chopped', 'To garnish and serve:', 'Sliced scallions, garnish', 'Sesame seeds, garnish', 'Cooked white rice, to serve']",23,"['1 Make the orange sauce: Whisk together sauce ingredients in a medium bowl. Set aside.', '2 Prep the chicken: Cut chicken into about 1-inch cubes. Whisk eggs with salt and black pepper in a bowl and add chicken. Stir together.', 'In a separate bowl, whisk together flour and cornstarch. Remove chicken from eggs with a slotted spoon or tongs, letting excess egg drain off, then transfer to cornstarch mixture and coat well.', '2 Fry the chicken: Add oil to a large 10- to 12-inch skillet. Heat over medium-high heat until it reaches 350\\xcb\\x9aF. If you don\\xe2\\x80\\x99t have a thermometer, you can also test the temperature by sprinkling in some flour and it should fizzle immediately.', 'Once oil is hot, fry the chicken in two batches. The oil might not completely cover the chicken\\xe2\\x80\\x94that\\xe2\\x80\\x99s okay. Cook for 3-4 minutes. Flip the chicken pieces and cook until the chicken is cooked through, about 3 to 4 more minutes. Total cook time is about 6-8 minutes.', 'Remove fried chicken cubes and transfer to a plate lined with paper towels, so the chicken can drain. Repeat until all the chicken is cooked.', '3 Simmer the chicken in the sauce: Once chicken is done, pour out hot oil and wipe pan clean. Add a fresh tablespoon of oil along with chopped garlic and shallot. Cook for a minute and then add the sauce. Simmer the sauce until it starts to thicken.', 'Once the sauce is lightly bubbling, add fried chicken and toss together to coat. The sauce should continue to thicken and stick to the chicken. Let simmer for a minute or two more. Serve orange chicken over cooked white rice, garnished with sesame seeds and fresh scallions.', 'LEFTOVERS! The orange chicken keeps well in the fridge for 5 days. Reheat in a skillet with a splash of water over low heat. Freeze the orange chicken for up to 3 months, but be sure to thaw it before reheating so the chicken doesn\\xe2\\x80\\x99t clump together.']",9
599,Ginger Beef Stir Fry Recipe,15,40,55,"['Marinade', '2 Tbsp unseasoned rice vinegar', '5 Tbsp soy sauce (use gluten-free soy sauce if cooking gluten-free)', '1 Tbsp honey', '1 Tbsp peeled, grated fresh ginger', '1 teaspoon chile pepper flakes', '1 teaspoon ground cumin', 'Beef and stir-fry', '1 1 1/4 to 1 1/2 lb top sirloin steak', '1 Tbsp cornstarch', '2 Tbsp vegetable oil (preferably peanut)', '1 Tbsp dark toasted sesame oil (optional)', '3-4 green onions, cut on a diagonal, 1/2-inch apart, including the greens', '2 cloves garlic, thinly sliced', '2-3 hot chilis, preferably red serranos, seeded, sliced', '1-inch knob of ginger, peeled, cut lengthwise into matchstick shapes', '1/2 cup loosely packed, chopped cilantro']",17,"['1 Chill steak, slice into strips: Chill the steak in the freezer for 30 minutes before you slice it, this will make it easier to cut in thin slices. Slice the steak first crosswise in 1/2-inch thick slices. The cut each slice lengthwise into strips.', '  2 Marinate the beef: In a medium bowl, whisk together the marinade ingredients; the soy sauce, vinegar, grated ginger, honey, red chile flakes, and cumin. Mix the beef in with the marinade to coat and let it sit for at least 30 minutes, and up to 4 hours, in the fridge.', '3 Make cornstarch slurry: In a small bowl, mix the cornstarch with 2 tablespoons of cold water to make a slurry.', '4 Brown the beef strips: Heat the oil in a wok (vegetable oil plus dark sesame oil if using), or a large saut\\xc3\\xa9 pan, over high heat until it is nearly smoking. As the oil is heating up, pat the beef dry and separate it into small batches no larger than what can fit into the palm of your hand. Working in batches, saut\\xc3\\xa9 beef until just brown outside but rare inside, no more than 1 minute. Transfer beef to a bowl.', '5 Stir fry chiles, garlic, ginger: When all of the beef is cooked, put the chiles and garlic into the pan and stir-fry 30-45 seconds. Add the julienned ginger and cook for 30-45 seconds more.', '6 Add beef, cornstarch slurry, scallions: Add the beef back to the pan. Add the cornstarch slurry. Add the scallions and mix everything together. Cook for 1 minute.', '7 Remove from heat, stir in cilantro: Turn the heat off and mix in the cilantro. Serve at once with steamed white rice.']",7
600,Stir Fried Green Beans with Ginger and Onions Recipe,15,7,22,"['2 to 3 tablespoons canola or peanut oil', '1/2 pound to 3/4 pound of fresh, tender, crisp green beans, cut into 1 1/2 to 2 inch pieces', '1 small yellow or white onion, sliced root to stem (see how to slice an onion), about 1 cup of sliced onion', '1 ounce of fresh ginger, peeled and cut into matchsticks (see how to peel and cut ginger)', '1 large garlic clove, sliced very thin', '2 tablespoons soy sauce (use gluten-free soy sauce for gluten-free version)', '1 tablespoon sugar', '1 teaspoon toasted sesame oil', 'A generous pinch of freshly ground black pepper']",9,"['1 Heat oil in a wok until shimmery hot: Heat a wok or large frying pan over high heat on the hottest burner you have for about 90 seconds. Add the vegetable oil and let it heat up until shimmery.', ""(Toss a sliver of onion into the oil when you think it's hot. If the oil is hot enough, the onion will sizzle.)"", '2 Add green beans, onions, ginger, then garlic: Add the cut green beans, sliced onions and julienned ginger and toss to combine. Break up any clumps of sliced onion that might have stuck together.', 'Spread everything out in the pan and let it sear untouched for anywhere from 30-90 seconds, you want to get a little browning on the vegetables. Stir the vegetables and let sit for another 30-90 seconds.', 'Add the sliced garlic, stir again and cook for another minute.', '3 Add mixture of soy sauce and sugar, stir fry a few seconds: Mix the soy sauce and sugar together and pour into the pan. Turn off the heat and immediately toss the vegetables to combine. The sauce will start to caramelize and may burn unless you keep everything moving for a few seconds.', '4 Add sesame oil and black pepper: Pour the sesame oil over the green beans and onions and sprinkle with black pepper. Toss to combine one more time. Serve immediately or let rest and serve at room temperature. The beans should still be somewhat crisp. They will cook a little more in the residual heat of the pan or serving dish.']",7
601,Sous Vide Sesame Chicken Recipe,16,120,136,"['For the chicken:', '1 1/2 pounds chicken breast, cubed into 1-inch pieces', '1-inch piece fresh ginger, thinly sliced', '2 cloves garlic, smashed', '1 tablespoon sesame oil', '1 tablespoon soy sauce', '1 tablespoon rice wine vinegar', 'For the sesame sauce:', '1/4 cup soy sauce', '1/4 cup rice wine vinegar', '1/3 cup honey', '1 tablespoon cornstarch', '1/3 cup chicken stock or water', '1 tablespoon sesame seeds', '2 teaspoons sesame oil', '1 teaspoon chili garlic sauce (optional)', 'Sesame seeds, garnish', 'To serve:', 'Cooked white rice', 'Scallions, green parts minced for garnish', 'Special equipment:', 'Sous vide immersion circulator', 'Gallon-sized, zip-top freezer bags']",23,"['You can do this in the pot of water as it heats. (Just be careful if the water is already steaming!) Set the chicken aside on a kitchen towel until the water has finished heating. Seal it when it is submerged so most of the air is out of the bag.', '4 Cook the chicken:  Once the water has come to temperature, submerge the sealed bag of chicken. Make sure the bag is completely submerged so the food cooks evenly.', 'Cook the chicken for 2 hours. When cooking time ends, remove the chicken from the water and turn off the circulator.', '  6 Make the sauce and combine with the chicken. Whisk together all of the sauce ingredients in a medium skillet. Bring to a simmer over medium heat; it and should start to thicken immediately.', 'Scoop out the chicken from the zip-top bag, discard the garlic and ginger, and add the chicken to the pan with the sauce. (The leftover cooking liquid can be saved and used in another recipe, if you like!)', 'Turn heat down to low, and toss to coat and combine. The sauce should get very thick and stick to the chicken.', '7 Serve the chicken: Serve sesame chicken over rice garnished with sesame seeds and scallions.']",7
602,Singapore Noodles with Shrimp Recipe,30,10,40,"['2 teaspoons sesame oil', '2 tablespoons soy sauce, or more to taste', '2 tablespoons seasoned rice vinegar', '6 ounces Asian rice sticks or rice vermicelli noodles', '2 large eggs', '3 tablespoons peanut or canola oil', '2 tablespoons minced ginger', '1 clove garlic, finely chopped', '2 carrots, shredded', '1 jalape\\xc3\\xb1o pepper, cored and thinly sliced', '1/2 sweet onion, thinly sliced', '1/2 teaspoon salt, or more to taste', '4 ounces flavorful baked ham, cut into thin 2-inch strips', '1/2 Napa cabbage (1/2 pound), thinly sliced', '4 scallions, green and white parts cut into 1-inch lengths', '1/2 red bell pepper, cored, seeded, and cut into 2-inch thin strips', '2 teaspoons curry powder', '1/2 pound shrimp, peeled and deveined', '2 tablespoons cilantro leaves, for garnish', 'Special equipment:', 'Wok or deep 12-inch skillet']",21,"['1 Make the sauce: In a bowl, combine the sesame oil, soy sauce, and rice vinegar.', '2 Cook the rice noodles: Bring a large saucepan of water to a boil, add the noodles, and use tongs to turn them so they are submerged. Cook for 2 minutes, or until they are tender but still have some bite (they will cook a little more once you add them to the skillet).', 'Drain, rinse with cold water, and use scissors to snip the noodles several times to break them up into shorter lengths.', '3 Scramble the eggs: In a small bowl whisk together the eggs. Heat the skillet or Dutch oven over medium heat. Add 1 tablespoon of the peanut or canola oil. Add the eggs and scramble them for 2 minutes, or until they form large, soft curds. Transfer them from the pan to a plate or bowl.', '4 Cook the vegetables: Add 1 tablespoon of the remaining oil to the pan. When it is hot, add the ginger, garlic, carrots, jalape\\xc3\\xb1o, onion, and salt. Cook, stirring constantly, for 2 minutes or until the vegetables start to soften.', '5 Add the remaining ingredients: Sprinkle the vegetable mixture with the remaining 1 tablespoon peanut or canola oil. When the oil is hot, add the ham, cabbage, scallions, red pepper, and curry powder to the pan. Cook, stirring constantly, for 1 minute.', 'Add the shrimp and cook, stirring, for 3 more minutes or until the shrimp are bright pink and cooked through.', '  6 Add the noodles in batches: Add the eggs, the sauce mixture, and half the noodles to the pan. Toss for 1 minute.', 'Add the remaining noodles and continue tossing for 1 minute more until they are thoroughly combined and the mixture is heated through.', '7 Serve: Taste for seasoning and add more salt or soy sauce, if you like. Sprinkle with cilantro leaves and serve.']",10
603,Scallion Pancakes Recipe,25,55,80,"['For the scallion pancakes:', '2 cups all-purpose flour', '1 teaspoon salt', '1/2 teaspoon garlic powder, optional', '3/4 cup hot (just boiling) water, plus a few more tablespoons, if necessary', '1/4 cup canola oil', '3 to 4 scallions, thinly sliced', 'For the dipping sauce:', '2 tablespoons soy sauce', '2 1/2 tablespoons rice vinegar', '1/2 teaspoon toasted sesame oil']",11,"['1 Mix the dough: Add flour, salt and garlic granules to a medium bowl. Stir to combine. Add 3/4 cups of hot water to the flour and stir with a wooden spoon. Continue stirring until all the water has been absorbed by the flour. Don\\xe2\\x80\\x99t worry if the dough has not formed completely yet.', '2 Knead the dough: Using your hands, knead all the bits of dough together inside the bowl. If your dough is still very dry, add a splash of hot water, about 1 to 2 tablespoons, until it comes together and all the flour is absorbed.', 'Continue kneading the dough for about 2 more minutes. The dough will feel moist but it should not stick to your hands too much.', '3 Rest the dough: Shape the dough into a round ball. Cover the bowl with plastic wrap and let the dough rest for 30 minutes.', '4 Roll out the pancakes: Sprinkle flour on top of a work surface. Divide the dough into 4 pieces of equal size. Work with one piece at a time, leaving the remaining pieces in the bowl.', 'Shape piece of dough into a small ball. Use a rolling pin to roll out the dough into a thin circle, about 7 to 8 inches in diameter.', '5 Add the scallions: Brush a thin layer of canola oil on top of the dough, making sure not to miss the edges. Sprinkle sliced scallions all over the dough.', ""6 Roll and flatten the pancake: Starting on one end, roll the circle of dough into a log. Take one end of the rolled up dough and curl it toward the center, like a snail's shell. Tuck the end of the dough underneath the spiral."", 'Use the palm of your hand to flatten the dough into a thick circle. Roll it out again with your rolling pin. Try to roll it out as thinly as possible. A few slices of scallions may pop out during the process, and that\\xe2\\x80\\x99s perfectly normal.', 'Transfer rolled out scallion pancake to a plate. Repeat steps 4 through 6 with the remaining dough pieces.', '7 Cook the pancakes: Heat about 2 teaspoons of canola oil a small nonstick or cast iron skillet over medium heat.', 'Place one of the pancakes in the middle of the pan and pan fry each side for about 2 to 3 minutes, until they\\xe2\\x80\\x99re golden brown. Transfer to a plate and repeat with the 3 remaining scallion pancakes, adding more oil to the pan as needed.', '8 Prepare the dipping sauce: Mix all the sauce ingredients in a small bowl. Adjust the seasonings to your liking, adding more soy sauce or vinegar, if you like. Add any leftover scallions to the dipping sauce, and add a pinch of red pepper flakes if you would like a bit of spice.', '9 Serve the hot pancakes: Cut the scallion pancakes into small wedges and serve while hot, with the dipping sauce. (The pancakes are still good when cooled, but will no longer be crispy.)']",14
604,Shrimp with Snow Peas Recipe,20,5,25,"['Marinade', '2 teaspoons cornstarch (or potato starch)', '1 Tbsp shaoxing Chinese cooking wine or dry sherry', '1/2 teaspoon salt', 'Stir Fry', '1 pound shrimp, peeled and deveined', '2 Tbsp peanut oil (or other vegetable oil)', '1 Tbsp minced ginger', '3 garlic cloves, sliced thinly', '1/2 pound snow peas, strings removed', '2 teaspoons soy sauce (use gluten-free soy sauce if cooking gluten-free)', '1/4 cup chicken stock', '4 green onions, white and light green parts, sliced diagonally', '2 teaspoons dark roasted sesame oil']",14,"['1 Marinate the shrimp: Mix all the ingredients for the marinade in a large bowl, then add the shrimp. Toss to coat. Let sit for 15 to 20 minutes while you prep the peas, ginger, and garlic.', '2 Stir-fry ginger and garlic: Heat a wok or large saut\\xc3\\xa9 pan over high heat for 1 minute. Add the peanut oil and let it get hot, about 30 seconds. Add the ginger and garlic and toss to combine. Stir-fry for about 30 seconds.', '3 Add shrimp, snow peas, soy sauce, stock, stir-fry: Add the shrimp and all the marinade to the pan (scrape out all the marinade with a rubber spatula). Add the snow peas, soy sauce and chicken stock. Stir-fry until the shrimp turns pink, about 2 minutes.', '4 Add green onions, finish with sesame oil: Add the green onions and stir-fry 1 more minute. Turn off the heat and add the sesame oil. Toss to combine once more and serve with steamed rice.']",4
605,Pressure Cooker Chinese Pulled Pork Recipe,10,80,90,"['2 1/2 teaspoons Chinese Five-Spice Powder', '3 to 3 1/2 pounds pork shoulder, cut into large chunks (3- to 4-inch pieces)', '1/3 cup water', '1/4 cup hoisin sauce', '3 tablespoons soy sauce', '3 tablespoons honey', '2 tablespoons dry sherry', '1 tablespoon cooking oil (I like avocado oil)', '5 cloves garlic, minced', '2-inch (1-ounce) piece ginger, minced', 'To serve:', '2 scallions, sliced thinly', 'Hamburger or slider buns', 'Special equipment:', '6-quart Instant Pot or other electric pressure cooker', 'Fat separator']",16,"['1 Season the pork: Sprinkle the spice blend evenly over the pork chunks, making sure to coat them on all sides.', '2 Make the sauce: In a small bowl, whisk together the water, hoisin sauce, soy sauce, honey, and sherry.', '3 Cook the garlic and ginger in the pressure cooker: Select the \\xe2\\x80\\x9cSaut\\xc3\\xa9\\xe2\\x80\\x9d setting and heat the oil in your electric pressure cooker. Add the garlic and ginger, and saut\\xc3\\xa9 until the garlic is fragrant but not yet beginning to brown, 1 to 2 minutes.', '4 Pressure cook the pork: Use a pair of tongs to add the seasoned pieces of pork into the pressure cooker, arranging them in a single layer. Pour the cooking sauce over top.', 'Secure the lid on the pressure cooker. Make sure that the pressure regulator is set to the \\xe2\\x80\\x9cSealing\\xe2\\x80\\x9d position. Cancel the \\xe2\\x80\\x9cSaut\\xc3\\xa9\\xe2\\x80\\x9d program on the pressure cooker, then select the \\xe2\\x80\\x9cManual\\xe2\\x80\\x9d or \\xe2\\x80\\x9cPressure Cook\\xe2\\x80\\x9d setting. Set the cooking time to 55 minutes at high pressure. (The pressure cooker will take about 10 minutes to come up to pressure and then the actual cooking time will begin.)', '5 Release the pressure: You can either perform a quick pressure release by immediately moving the vent from \\xe2\\x80\\x9cSealing\\xe2\\x80\\x9d to \\xe2\\x80\\x9cVenting\\xe2\\x80\\x9d (be careful of the steam), or you can let the pot depressurize naturally, which takes about 20 minutes.', '6 Separate the pork and cooking liquid. Use tongs to transfer the pork to a large platter or sheet pan. Use heatproof mitts to lift the inner pot out of the pressure cooker, pour the cooking liquid into a fat separator, then pour the liquid back into the pot.', ""(If you don't have a fat separator, let the cooking liquid stand for about 10 minutes until the fat floats to the top, then use a to skim as much fat as possible from the surface.)"", '  7 Reduce the cooking liquid: Return the pot to the pressure cooker, select the \\xe2\\x80\\x9cSaut\\xc3\\xa9\\xe2\\x80\\x9d program, and let the cooking liquid come to a rapid simmer. Continue simmering for 10 minutes to reduce the cooking liquid.', '8 While the liquid is reducing, use a pair of forks to shred the pork.', '9 Toss the shredded pork with the reduced liquid: Return the pork to the pot with the reduced cooking liquid and toss to coat the pork evenly. If the pork seems a little dry, add a tablespoon or two of the reserved fat.', '10 Serve: Serve the pulled pork with scallions sprinkled over top.']",12
606,Chili Garlic Chicken Recipe,5,60,65,"['3 tablespoons olive oil', '2 tablespoons chili garlic, sauce such as Huy Fong', '1 tablespoon honey', '1 tablespoon rice wine vinegar', '2 cloves garlic minced', '1 (3-pound) chicken, cut into pieces, or the equivalent in chicken pieces', 'Thinly sliced scallions, for garnish', 'Sesame seeds, for garnish']",8,"['1 Marinate the chicken: Whisk together olive oil, chili garlic sauce, honey, rice wine vinegar, and minced garlic. Add chicken to the marinade in a covered container and let it marinate in the fridge for at least 30 minutes or overnight.', '  2 Prep and heat the grill: Heat your grill to medium-high heat (about 400\\xc2\\xb0F) with two zones for direct and indirect cooking. Use tongs to oil the grill grates using a small folded piece of paper towel dipped in oil.', ""3 Grill the chicken: Arrange the chicken skin-side down over the high-heat section of the grill and cook for about 5 minutes, or until you see dark, seared grilled marks. (If you'd like crosshatched grill marks, rotate the chicken 90-degrees halfway through.) Flip the chicken and keep over the hot section for another 4 to 5 minutes."", 'Transfer the chicken to the indirect section of the grill (this helps avoid overcooking) and cook the chicken until it reaches a safe internal temperature of 165\\xc2\\xb0F in the thickest part of the meat, another 10 to 15 minutes.', 'Exact timing will depend on your type of grill and the temperature, so check the chicken frequently and use your best judgment on when to flip and when the chicken is done.', '4 Remove, garnish, and serve: When the chicken is cooked through, remove it from the grill and let it rest for a few minutes. Then garnish with diced scallions and roasted sesame seeds. Serve while warm.']",6
607,Pressure Cooker Chicken Lettuce Wraps Recipe,10,20,30,"['For the cooking liquid:', '2 tablespoons soy sauce', '2 tablespoons rice wine', '1 tablespoon oyster sauce', '1/4 cup water', 'For the chicken:', '2 tablespoons neutral cooking oil (I use avocado oil)', '1/2 small red onion, or two shallots, diced small', '2 cloves garlic, minced', '1-inch piece fresh ginger, peeled and minced', '2 medium zucchini, diced small', '1 pound ground chicken or turkey', '1 (8-ounce) can sliced water chestnuts, drained and chopped', '1/2 teaspoon salt', 'To serve:', '8 whole leaves butter lettuce', '2 green onions, sliced thinly', '1/4 cup roasted unsalted peanuts, chopped coarsely', '1/2 cup chopped cilantro', 'Special equipment:', '6-quart Instant Pot or other electric pressure cooker']",21,"['1 Make the sauce: Combine the soy sauce, rice wine, oyster sauce, and water for the sauce in a small bowl. Set aside.', '2 Begin cooking the chicken mixture: Select the \\xe2\\x80\\x9cSaut\\xc3\\xa9\\xe2\\x80\\x9d function on your electric pressure cooker and heat the oil. Saut\\xc3\\xa9 the onion, garlic, and ginger for about 2 minutes, just long enough to take the raw bite out of the garlic.', 'Add the zucchini, ground meat, water chestnuts, and 1/2 teaspoon of salt. Use a wooden spoon or spatula to break up the meat and saut\\xc3\\xa9 for 3 minutes. It\\xe2\\x80\\x99s fine if the meat is not yet fully cooked through\\xe2\\x80\\x94you just want to make sure it is broken up into small pieces and mixed in with the diced vegetables.', '   3 Add the liquid and seal the pot: Stir in the soy sauce, oyster sauce, rice wine, and water. Quickly close the pot and lock the lid into position. Since this recipe uses a minimal amount of liquid, you want to make sure to trap as much steam as possible.', '  4 Pressure cook the chicken: Cancel the \\xe2\\x80\\x9cSaut\\xc3\\xa9\\xe2\\x80\\x9d program on the pressure cooker, then select the \\xe2\\x80\\x9cManual\\xe2\\x80\\x9d setting and set the cooking time to 10 minutes at high pressure. Make sure the pressure release valve is set to ""sealing.""', 'When the cooking program has ended, you may either perform a quick release by moving the pressure release valve to \\xe2\\x80\\x9cventing,\\xe2\\x80\\x9d or just letting the pressure release on its own.', '5 Serve the chicken with lettuce wraps and toppings: Use a slotted spoon scoop out some of the chicken mixture and place into the lettuce cups. Top each cup with some of the green onions, chopped peanuts, and cilantro. Serve right away.']",7
608,Happy Shrimp Stir Fry Recipe,10,15,25,"['For the sauce (mix together in a bowl)', '2 teaspoons sugar', '1/2 cup chicken or vegetable broth', '3 tablespoons ketchup', '1 teaspoon rice vinegar (or white vinegar)', '1/2 teaspoon sesame oil', 'For the shrimp', '1 pound raw shrimp, deveined', '2 teaspoons cornstarch', '2 tablespoons canola, vegetable or peanut cooking oil', '1 teaspoon grated fresh ginger', '1-2 garlic cloves, finely minced', '1 tablespoon finely sliced green onion', 'Handful of shredded iceberg lettuce']",14,"['1 Toss shrimp with cornstarch: Pat the shrimp very dry and place them in a bowl. Toss with the cornstarch.', '2 Fry in hot pan 1 minute each side: Heat a wok or large frying pan on high heat until a bead of water instantly sizzles and evaporates upon contact.', 'Add the cooking oil and swirl to coat. Add the cornstarch coated shrimp to the wok and spread out in one layer. Let fry untouched for 1 minute.', 'Flip and fry other side for another minute. Remove the shrimp from the frying pan, keeping as much oil in the pan as possible.', '3 Fry garlic and ginger: Return the pan to the stove. Add an additional teaspoon of cooking oil to the pan if needed. When the pan is hot, turn the heat to medium and add the garlic and the ginger and fry for 15-30 seconds until fragrant.', '4 Add sauce and shrimp: Pour in the sauce mixture and bring to boil. Add the cooked shrimp back into the wok and let simmer for an additional minute until the shrimp are cooked through.', 'Serve on bed of shredded lettuce and top with garnish of sliced green onions.']",7
609,Easy Cashew Chicken Recipe,10,65,75,"['For the chicken:', '4 skinless, boneless chicken breasts (about 1 1/2 to 1 3/4 pounds total), cut into 1-inch cubes', '3/4 cup peanut oil or other vegetable oil', '3 tablespoons chili powder', '1/2 cup tamari (or soy sauce; use wheat-free tamari or soy sauce if you need to cook gluten-free)', '1/2 cup honey', '2 cups raw cashews', '3 cups roughly chopped onions (about 2 medium large onions)', '3 cups roughly chopped mushrooms', 'For garnish, optional:', '1 to 2 teaspoons minced fresh ginger', '1/4 cup chopped scallions or green onions, green parts only']",12,"['1 Marinate the chicken: Place the cubed chicken in a medium bowl. Add the oil. Add the tamari until the marinade turns dark brown (about 2 tablespoons per breast). Sprinkle the chili powder over the chicken pieces while stirring, so that each piece of chicken gets well coated with the chili powder and marinade.', 'Stir in the honey, about 2 tablespoons for each breast. Add chopped ginger if using. Marinate for 1/2 hour to several hours, the longer the better.', '2 Toast the cashews: Heat a skillet on medium high heat. Spread the cashews in a single layer over the bottom of the pan. Stir until lightly browned, remove from heat.', ""3 Saut\\xc3\\xa9 the chicken: Heat a large skillet on medium high heat. Working in batches if needed so you don't crowd the pan, use tongs to remove the chicken pieces from the marinade and place them in the pan, reserving the extra marinade."", 'Saut\\xc3\\xa9 the chicken pieces until just cooked through, remove from the pan and set aside.', 'Place any extra marinade back in the pan and simmer for several minutes (to kill any bacteria). Pour off all but 1 tablespoon of the marinade into a separate bowl and reserve.', '4 Saut\\xc3\\xa9 onions and mushrooms: In the same pan, saut\\xc3\\xa9 the onions on medium high to high heat for several minutes.', 'Add mushrooms and continue to saut\\xc3\\xa9 until onions are translucent and mushrooms are cooked, several minutes more. Add some reserved marinade to the pan if necessary.', '5 Combine all the ingredients. Add the chicken and cashews back to the pan with the mushrooms and onions. Stir to combine.', '6 Serve: Stir in onion greens (if using) right before serving. Serve over rice. This will keep for about 5 days in the refrigerator, covered.']",10
610,Air Fryer Chinese Egg Rolls Recipe,20,25,45,"['For the egg rolls:', '1 tablespoon olive oil', '1 pound ground pork or chicken', '1 clove garlic, minced', '1 tablespoon grated fresh ginger', '1 medium carrot, shredded', '3 scallions, chopped', '3 cups shredded green cabbage', '1 tablespoon soy sauce', '1 tablespoon rice wine vinegar', '12 egg roll wrappers', 'Oil, for brushing', 'For dipping:', 'Duck sauce', 'Plum sauce', 'Soy sauce', 'Special equipment:', 'Krups Air Fryer']",18,"['1 Cook the filling: In a large skillet over medium heat, add the olive oil along with the ground pork or chicken. Break apart the meat with a spatula or wooden spoon as it cooks. Cook until the meat is cooked through, 6 to 8 minutes.', 'Add garlic, ginger, carrot, scallions, and cabbage. Continue to cook until cabbage wilts down and is soft, another 3 to 4 minutes, stirring regularly. Season the filling with soy sauce and rice wine vinegar and take off the heat to cool. (This filling can be made in advance.)', '2 Assemble the egg rolls: Place a single egg roll wrapper on a dry surface with one point of the square facing you (like a diamond). Place about 1/4 cup of the egg roll filling mixture in the middle of the wrapper.', 'Dip your fingers in water and run around the edges of the wrapper. Then fold the edges of the wrapper over the center and start rolling the egg roll away from you to form a tight cylinder. Place on a plate and repeat until you are out of filling. You should get at least a dozen egg rolls.', '3 Air fry the egg rolls: Place the egg rolls in the basket of your air fryer. Spray or brush them lightly with oil. Add as many as you can without stacking the egg rolls, making sure they don\\xe2\\x80\\x99t touch. Air needs to circulate around them. Brush the egg rolls lightly with oil.', 'Place the basket in the air fryer and turn the air fryer to 350\\xc2\\xb0F. Cook for 6 to 7 minutes, then flip the egg rolls, spray or brush with oil a second time on the bottom side, and cook for another 4 to 5 minutes.', 'Finished egg rolls should be golden brown and crispy! Serve immediately.']",7
611,Bacon-Wrapped Shrimp Recipe,20,40,60,"['For the brine (optional, but recommended):', ""1/4 cup (Diamond Crystal) kosher salt (if using Morton's kosher salt, use only 3 tablespoons)"", '1/4 cup sugar', '4 cups water', '1 cup ice', 'For the bacon-wrapped shrimp:', '1 pound (12 to 20 count), raw, peeled and deveined shrimp (tail on)', '2 tablespoons extra virgin olive oil', 'Zest from 1 lime', '2 tablespoons lime juice', '1/2 teaspoon chipotle powder or chili powder (less or more to taste)', '6 to 10 strips thin bacon, cut in half (half as many pieces of bacon as there are shrimp)', 'Special equipment:', 'Skewers (for grilling) or toothpicks (for oven)']",14,"['1 Brine the shrimp (optional, but recommended): Whisk the salt, sugar, and water until the salt and sugar dissolve. Add the ice and the shrimp, and let sit for 30 minutes (no longer). Remove the shrimp from the brine.', '2 Prepare grill or preheat oven: Prepare grill on high, direct heat (if grilling) or preheat the oven to 400\\xc2\\xb0F. If grilling and using thin bamboo or wood skewers, soak them in water first for 30 minutes.', '3 Season the shrimp: Mix together in a small bowl the lime zest, lime juice, olive oil, and chipotle powder. Stir the shrimp into the lime chipotle mixture; make sure each piece is well coated.', '4 Partially cook the bacon: Spread the bacon pieces out over several layers of paper towels on a microwave-safe plate. Cover with another layer of paper towel. Microwave on high until the bacon fat begins to melt but the bacon is still somewhat pliable, about 1 1/2 to 2 minutes.', '5 Wrap the shrimp with bacon: Working one at a time, wrap a half piece of partially cooked bacon around each piece of shrimp.', '6 Prep the shrimp for cooking: If you are grilling, thread the shrimp onto skewers.', 'If you are using the oven, secure each the bacon onto the shrimp with toothpicks. Place the bacon-wrapped shrimp on a foil-lined baking pan. Brush remaining lime chipotle mixture on the outside of the bacon-wrapped shrimp.', '7 Grill or bake the shrimp: Grill uncovered for 3 minutes on each side (less or more time depending on the heat of your grill), or bake in the 400\\xc2\\xb0F oven for 8 to 11 minutes, or until the bacon is lightly browned and the shrimp is cooked through.']",8
612,Instant Pot Chipotle Chicken and Rice Bowls Recipe,15,40,55,"['For the chipotle chicken:', '2 cloves garlic', '1/2 medium yellow onion', '2 chipotles in adobo sauce (from a can)', '1/3 cup water', '1/3 cup fresh lime juice (from 2 medium limes)', '1 tablespoon honey', '2 teaspoons ground cumin', '2 tablespoons paprika', '1 teaspoon salt', '1/2 teaspoon ground black pepper', '1 1/2 to 2 pounds boneless skinless chicken thighs', 'For the rice:', '1 cup long-grain white rice', '1 cup water', '1/2 cup cilantro, chopped', '2 medium green onions, sliced', '1 jalape\\xc3\\xb1o pepper, seeded and minced', '1 tablespoon fresh lime juice', '1/2 teaspoon salt', 'To serve:', '2 ounces crumbled cotija cheese', '12 thin slices jalape\\xc3\\xb1o pepper', '1/2 lime, cut into 4 wedges', 'Special equipment:', '6-quart pressure cooker', 'Raised steam rack', 'Wire mesh strainer', 'Small 1 1/2-quart stainless steel bowl']",29,"['1 Make the sauce: In a blender, combine the garlic, onion, chipotle peppers, water, lime juice, honey, cumin, paprika, salt, and pepper. Blend for about a minute, until it becomes a smooth sauce. If necessary, scrape down the sides of the blender halfway through blending.', '2 Mix the chicken with the sauce: Put the chicken thighs in the pot of a 6-quart or larger electric pressure cooker, then pour the sauce over the chicken and stir to evenly coat the chicken in the sauce.', '3 Nestle a raised steam rack in with the chicken. Make sure all of its legs are touching the bottom of the pot.', '4 Rinse the rice. Place the rice in a wire mesh strainer and rinse under running water. Let it drain for a minute or so, then combine the rice with a cup of water in a small (1 \\xc2\\xbd-quart) stainless steel mixing bowl.', 'Place the bowl of rice and water on top of the steam rack in the pot. The bowl should fit snugly inside the pot; make sure that you can still lock the lid of the pressure cooker closed.', '5 Cook the chicken and rice: Secure the lid on the pressure cooker. Make sure the pressure regulator is set to the \\xe2\\x80\\x9cSealing\\xe2\\x80\\x9d position.', 'If you are using an Instant Pot, select the \\xe2\\x80\\x9cPoultry\\xe2\\x80\\x9d or \\xe2\\x80\\x9cManual\\xe2\\x80\\x9d program, then adjust the time to 15 minutes. If your pressure cooker does not have a \\xe2\\x80\\x9cPoultry\\xe2\\x80\\x9d program, set it manually to \\xe2\\x80\\x9cHigh Pressure\\xe2\\x80\\x9d for 15 minutes. For stovetop pressure cookers, cook for 12 minutes at high pressure.', 'It will take about 15 minutes for your pressure cooker to come up to pressure, and then the actual cooking will begin. Total time from the time you seal the pressure cooker to the end of cooking is about 30 minutes.', '6 Release the pressure: When the cooking time ends, let the pressure release naturally for at least 10 minutes, then perform a quick pressure release by moving the pressure release knob from \\xe2\\x80\\x9cSealing\\xe2\\x80\\x9d to \\xe2\\x80\\x9cVenting.\\xe2\\x80\\x9d', '7 Fluff the rice: Wearing a pair of heat-proof mitts, remove the bowl of rice and the steam rack from the pot.', 'Fluff the rice with a fork and mix in the cilantro, green onions, jalape\\xc3\\xb1o, lime juice, and salt.', '8 Working in the pot, shred the chicken thighs into bite-sized pieces with two forks.', '9 Serve: Divide the rice between individual bowls and spoon the chicken on top, along with a some of its sauce. Top each bowl with the cotija cheese, sliced jalape\\xc3\\xb1o, and a wedge of lime.']",13
613,Slow Cooker Honey Chipotle Chicken Tacos Recipe,10,240,250,"['1 1/2 pounds boneless, skinless chicken breasts, thighs, or a mix', '1/2 cup plain tomato sauce', '1/4 cup honey', '1/2 white onion, chopped', 'Juice from 1 lime (about 2 tablespoons)', '1 teaspoon garlic powder', '1/2 teaspoon kosher salt', '1/2 teaspoon black pepper', '1 to 3 chipotle peppers from a can of Chipotles en Adobo, chopped (stems and seeds removed)', '1 to 2 tablespoons Adobo sauce, from a can of Chipotles en Adobo', '1 package soft flour tortillas', 'Toppings:', 'Crumbled queso fresco', 'Diced red onion', 'Diced radish', 'Fresh cilantro', 'Special equipment:', '6-quart slow cooker']",18,"['1 Combine everything in the slow cooker: Combine the chicken, tomato sauce, honey, onion, lime juice, garlic powder, salt, and pepper to your slow cooker. Add 1 to 3 chopped chipotle peppers and 1 to 2 tablespoons of Adobo sauce, depending on your preferred level of heat. Mix together well.', '2 Cover and cook on high for 4 hours or low for 6 to 8 hours.', '3 Shred the chicken: At the end of cooking time, use two forks to shred chicken in the pot. Mix the shredded chicken with the sauce.', 'At this point, the chicken can be held on the ""warm"" setting, covered, for 1 to 2 hours. Stir additional water as needed if the pot starts to become dry.', '4 Serve: Set out a stack of tortillas and all the toppings. Assemble and serve the tacos from the slow cooker.', 'Leftover chicken will keep refrigerated for up to 5 days or frozen for up to 3 months.']",6
614,Spicy Orange Marinated Chicken Recipe,20,140,160,"['2 cups freshly squeezed orange juice from 3 to 4 large navel oranges, or 6 small oranges, peeled and chopped', '1 onion, chopped (about 1 1/2 cups)', '1/2 of a 7-ounce-can of chipotle chili peppers in adobo (3 1/2 ounces total)', '3 cloves garlic, chopped', '1/3 cup chopped fresh cilantro', '1 tablespoon fresh rosemary leaves, chopped (or 1 teaspoon dried)', '1 Tbsp fresh thyme leaves (or 1 teaspoon dried)', '1 Tbsp fresh marjoram or oregano leaves, or 1 teaspoon dried of either', '1 teaspoon salt', '2 tablespoons extra virgin olive oil', '3 pounds boneless skinless chicken thighs (4 pounds if buying bone-in)', 'Chopped fresh cilantro or parsley and orange slices for garnish']",12,"['1 Make the marinade: In a blender or food processor, combine the orange juice or chopped oranges, onion, chipotle in adobo, garlic, cilantro, rosemary, thyme, marjoram, and salt.', 'Pulse a few times to make a coarse pur\\xc3\\xa9e. Transfer to a large bowl.', '2 Trim the fat from the chicken thighs: With scissors, snip off the excess fat from the thighs.', '3 Pound the chicken thighs to even thickness: Put the chicken thighs between two sheets of plastic wrap or wax paper and pound with a meat mallet or rolling pin until an even thickness of about 1/2-inch.', '4 Marinate the chicken: Add the chicken to the bowl of marinade (or transfer both to a zipper freezer bag). Refrigerate 2 hours or overnight.', '5 Cook the chicken: Heat the olive oil in a large cast iron pan or heavy skillet on medium high heat.', 'Remove the chicken pieces from the marinade, blotting off the excess (but not all) with a paper towel.', 'Working in batches, cook the chicken pieces for 5 minutes on each side, or until browned and cooked through.', '6 To serve: Sprinkle the chicken with chopped cilantro or parsley, garnish with orange wedges and serve with Spanish rice.']",9
615,Christmas Crack Recipe,10,15,25,"['28 to 35 saltine crackers (about one sleeve, enough to line your tray)', '1 cup (220 g) packed dark brown sugar', '1 cup (225 g or 2 sticks) unsalted butter', '1/4 teaspoon kosher salt', '1 teaspoon vanilla extract', '2 cups (10 to 12 ounces) semi-sweet chocolate', 'Special equipment:', 'Jelly roll pan (10x15-inches)']",8,"['1 Preheat the oven to 400F. Line a 10x15-inch jelly roll pan with nonstick aluminum foil (preferred) or regular heavy duty foil, making sure that the foil completely covers the bottom and sides of the pan. If using regular foil, spray lightly with baking spray. Line the saltine crackers in a single layer on the bottom.', '2 Make the caramel sauce: Place the brown sugar, butter and salt in a medium sized saucepan. Cook on medium heat, stirring frequently, until the butter melts. Continue to cook, stirring occasionally, for another 3 to 5 minutes, just until the mixture comes to a boil and starts to darken. Remove from heat and stir in the vanilla extract.', ""(Note: You\\'re not actually making true caramel here, so you don\\'t need to be as precise or worry about the temperature of the caramel. Just make sure it comes to a boil and wait for it to darken slightly, then continue.)"", '3 Pour the hot brown sugar mixture over the saltine crackers. Spread to evenly coat the crackers.', '4 Move the pan to the oven and bake for 5 minutes. The caramel will be hot and bubbly.', '5 Melt the chocolate: Place the chocolate in a microwave-safe bowl. Cook it in the microwave in 30-second intervals at full power, stirring between each cook time, until the chocolate has melted.', '6 Pour the chocolate over the baked crackers: Once the crackers are done baking, remove from oven and allow to cool for 1 minute, until the caramel is no longer bubbling. Then pour the melted chocolate over the crackers. Use a spatula to spread the chocolate evenly over the top.', '7 Cool the crackers overnight: Let the crackers cool to room temperature then move to the refrigerator and cool over night.', '8 ""Crack"" the crackers: The crackers will form a single sheet once cool. Remove from pan and gently peel the foil away, being careful not to tear the foil. (If any bits of foil tear and get stuck in the caramel, break those bits away and discard.) Cut the candy into snack-sized pieces using a chefs knife (you can use your hands, too, but I find it easier with a knife).', 'Store in an airtight container in the refrigerator for about a week.']",10
616,Chocolate Peanut Butter Bars Recipe,30,5,35,"['Peanut butter layer:', '1 1/4 cup of graham cracker crumbs (use toasted matzo crumbs* or ground Passover crispy cereal if following the Passover dietary rules)', ""1 1/4 cup of confectioner's sugar (use Passover-friendly confectioner's sugar** if following Passover dietary rules)"", '3/4 cup plus 2 Tbsp of crunchy, natural peanut butter (no added preservatives or corn syrup)', '8 Tbsp (4-ounces) unsalted butter, melted', '2 Tbsp honey', 'Chocolate topping:', '9-ounces semi-sweet chocolate chips (1 1/2 cups) (use Kosher chocolate chips if making for Passover)', '1 Tbsp butter', 'Equipment needed:', 'A 9x9-inch square baking pan with straight sides (can also use an 8x10 or 8x11 baking pan)', 'Food processor', 'Parchment paper or non-stick aluminum foil', '* Take 4 or 5 sheets of matzo, roughly break into chunks, toast in a hot dry skillet on high heat until the crumbs begin to brown and you can smell the matzo toasting. Remove from heat, let cool for a minute, place in a food processor or mini-chopper, and pulse until ground to the consistency of coarse bread crumbs.', ""**2 cups of granulated sugar in a food processor or blender, and 2 Tbsp of potato starch. Process until very fine. Use 1 1/4 cups for this recipe. You'll have some leftover which can be used for other recipes for Passover.""]",15,"['1 Line the baking pan with parchment paper or non-stick aluminum foil. Line the pan in a way so that you have an overhang on at least 2 opposite sides of the pan to make it easy to lift up the bars once they have set.', ""2 In the bowl of a food processor place the crumbs and the powdered sugar. Pulse until well mixed. Add the peanut butter, melted butter, and honey. Process until well blended. The mixture should hold together, almost like a dough. If it's too dry, add a little more melted butter. If it's too wet, after you press it into the bottom of the pan in the next step, you can chill it in the fridge for 10 minutes to firm up a bit."", '3 Press the peanut butter mixture into the bottom of your lined pan in an even layer. You can use the flat bottom of a measuring cup, small saucepan, or smaller baking pan to press on the mixture to help make the surface more even.', '4 Place a metal bowl over a saucepan with simmering water (not boiling, but gently simmering). Place the chocolate chips and butter into the bowl.  Melt the chocolate chips, stirring occasionally, until smooth.', '5 Spread the melted chocolate evenly over the peanut butter layer in the pan. (An offset spatula is a good tool for this.) Refrigerate for at least an hour.', '6 Lift the contents from the pan onto a cutting board. Cut into 36 bars, 1-inch by 2 1/4 inches.']",6
617,7-Layer Magic Bars Recipe,5,30,35,"['2 cups (225 g) graham cracker crumbs', '1/2 cup (115 g / 1 stick) melted unsalted butter', '14 ounces (396 g / 1 can) sweetened condensed milk', '1 cup (185 g) semi-sweet chocolate chips', '1 cup (185 g) butterscotch chips', '1 cup (115 g) chopped pecans', '1 cup (105 g) shredded sweetened coconut', '1 teaspoon flaky sea salt (like Maldon), optional']",8,"['1 Preheat oven to 350F. Spray a 9 x 13-inch baking pan with cooking oil then line it with parchment paper.', '2 Make the graham cracker crust: Place the graham cracker crumbs and the melted butter in a bowl. Toss with a fork until the crumbs are moist and hold together when squeezed with your hand.', 'Dump the crumbs in the middle of the pan and then press them into an even layer with your fingers or the back of a flat-bottomed cup.', '3 Pour the sweetened condensed milk over the graham cracker crust. Spread to edges of the pan with a spatula.', '4 Layer on the rest of the toppings: In this order, sprinkle the chocolate chips, butterscotch chips, pecans, and then sweetened coconut over the top of the condensed milk.', 'Gently press the ingredients down with your palm so they stick to the condensed milk.', '5 Bake in the oven for 30 to 35 minutes. Bake until the edges of the bars turn golden-brown and start to pull away slightly from the sides of the pan. Remove from the oven and sprinkle with the sea salt (if using).', '6 Cool completely before lifting the bars out of the pan using the parchment paper. (Stick them in the fridge for a few hours or overnight if needed to help firm up.) Cut into 24 pieces and store in an airtight container with wax paper or parchment paper between layers.', 'The flavor of the bars is even better the day after baking. Bars stored at room temperature will be fairly soft and are best eaten within 3 to 5 days. For firm and chewy bars, store in the fridge for up to a week.']",9
618,Chocolate Layer Cake Recipe,40,90,130,"['2 cups (260 g) all purpose flour', '1 3/4 cups (270g) granulated sugar', '3/4 cups (75g) dark cocoa powder', '2 teaspoons baking soda', '1 teaspoon kosher salt', '2 large eggs', '1 cup buttermilk', '3/4 cup organic canola oil', '1 teaspoon vanilla extract', '1 cup piping hot coffee or hot water', 'For the frosting:', 'Chocolate Swiss Meringue Buttercream', 'Special equipment:', 'Two 9-inch round cake pans', 'Parchment paper', 'Fine mesh sieve for dusting the frosting with powdered sugar']",16,"['1 Preheat the oven and prepare the pans: Preheat oven to 300\\xc2\\xb0F degrees. Cut parchment rounds to fit two 9-inch round cake pans. Butter and flour the pans. Set aside.', '2 Whisk the dry ingredients: In a large bowl, whisk together flour, sugar, cocoa powder, baking soda, and salt.', '3 Whisk wet ingredients: In a small bowl, whisk together eggs, buttermilk, oil, and vanilla.', '4 Combine the wet and the dry: Pour the wet ingredients into the dry and stir together with a stiff spatula. The batter will be thick.', 'Pour in the piping hot coffee. Stir until combined (the batter will look like a muddy, clumpy lake) then thin out to a cohesive pourable consistency. Just keep stirring. No worries.', '5 Pour into pans and bake: Divide the batter equally between the 2 pans (about 1 lb 7 oz or 652 g per pan). Place in oven for about 30 minutes or until a toothpick poked into the center comes out clean. I like to rotate the pans back to front halfway through the cooking time, because it helps with even baking.', '6 Cool the cakes: Remove the cakes from the oven and onto a cooling rack for 20 minutes. Then remove the cakes from the pans, peel back the parchment paper, and let the cakes cool completely, about 1 hour.', '7 Frost the cake: Put one cake round onto a platter or cake board, then place the cake on a rotating cake stand (if using). Spread a generous amount of chocolate frosting on top of the cake round. Using an offset spatula, smooth the frosting into a thick, even layer. Then place the next cake round top down on top of the frosted round.', 'Place a generous amount of frosting on top and spread it evenly across the top until it hangs over the sides. Gently spread the frosting onto the sides in a thin, even layer. This is your crumb coat. Transfer it to the refrigerator for at least an hour, and up to overnight.', 'Once the crumb coat has set, use 2/3 of the remaining frosting to frost the cake as you did before. Once the sides and top are smooth, you can start to decorate.', '8 Decorate the cake: To make the spiral swirl on top, take the tip of your offset spatula and tilt it at a slight angle on the outside edge of the top of the cake. Hold it there and start to spin the rotating cake stand. Move the spatula slightly inward toward the center as you spin the stand, until you\\xe2\\x80\\x99ve made the spiral swirl.', 'Fit a pastry bag with a large coupler and secure a Wilton Large 2D Drop Flour Tip to the end. Add the remaining frosting to the piping bag. Pipe large and small blobs of frosting around the top edge of the cake. Dot some of the tip with the silver pearls. Then dust with powdered sugar.']",12
619,Mini Flourless Chocolate Olive Oil Cakes Recipe,20,18,38,"['1/2 cup extra-virgin olive oil, plus more for greasing the pan', '4 ounces bittersweet chocolate (or 2/3 cup dark chocolate chips)', '3 large eggs', '1/4 cup honey', '1/4 cup coconut sugar or lightly packed brown sugar', '1/2 cup fine almond flour', '1 teaspoon vanilla extract', '1/4 teaspoon kosher salt', 'Powdered sugar for dusting the top']",9,"['1 Preheat oven to 350\\xc2\\xb0F.', '2 Grease the pans: Generously grease 8 wells of a cupcake tin (or an 8-inch round cake pan) with olive oil.', '3 Melt the chocolate: Chop the chocolate into small pieces. Melt in a microwave-safe bowl on high in 30-second bursts, stirring after each one, until melted. Alternatively, melt over the stove in the top of a double boiler.', '4 Make the batter: In a large bowl, use an electric hand mixer or a stand mixer to beat the eggs for 1 minute. Add the honey, coconut sugar, olive oil, almond flour, vanilla, salt, and melted chocolate and beat on high for 1 minute.', '5 Bake: Spoon a scant 1/3 cup batter into each well of the cupcake tin and bake just until the tops lose their raw appearance, about 17 to 18 minutes. If using an 8-inch cake pan, figure about 23 minutes to bake.', '6 Cool and serve: Remove from the oven and cool for at least 10 minutes. Wedge the mini cakes from the tin and dust lightly with powdered sugar. For the full cake, serve wedges directly out of the pan.']",6
620,S\xe2\x80\x99mores Cookies Recipe,10,12,22,"['5 ounces (142 g) graham crackers (typically one full sleeve)', '1 3/4 cups (245 g) all-purpose flour', '1 teaspoon salt', '1 teaspoon baking soda', '3/4 cup (170g) unsalted butter, very soft', '3/4 cup (161 g) packed brown sugar', '3/4 cup (150 g) granulated sugar', '2 large eggs', '1 teaspoon vanilla', '2 cups (12 ounces) roughly chopped chocolate or chocolate chips', 'About 2 cups mini-marshmallows', 'Special equipment:', 'Medium cookie scoop', 'Baking sheets', 'Silpat baking mat']",15,"['1 Make the graham cracker crumbs: Place the graham crackers in the bowl of a food processor. Process in pulses until the crackers are completely broken down into crumbs. (Alternatively: Place the crackers in a zip-top plastic bag and crush with a rolling pin.)', '2 Combine the dry ingredients: Combine the graham cracker crumbs, flour, salt, and baking soda in a mixing bowl. Whisk to combine.', '3 Beat the butter and sugars: With an electric mixer or in a stand mixer with a beater attachment, beat together the granulated sugar, brown sugar, and softened butter on medium speed until combined and thick, 30 to 60 seconds. Pick out any large pebbles of hard brown sugar that you see. Scrape down the sides of the bowl and the beater.', '4 Mix in the eggs and vanilla: Add the two eggs and vanilla to the butter-sugar mixture and beat at medium speed until no clumps or streaks remain, 10 to 20 seconds. Scrape down the sides of the bowl and the beaters.', '5 Mix in the dry ingredients: Add the graham cracker and flour mixture all at once. Beat on low speed just until no more dry streaks of flour are visible, 20 to 40 seconds.', '6 Mix in the chocolate: Add all of the chocolate chips or chopped pieces, and beat on low speed for just a few seconds until incorporated.', '7 Chill the dough: Scrape down the sides of the bowl and the beater. Cover the bowl and refrigerate for at least 30 minutes or up to three days. (Or freeze in individual scoops for up to 3 months.)', '8 Heat the oven to 375F: Place a rack in the middle of the oven. Line two baking sheet with silicon baking mats or parchment.', 'I usually bake my cookies one sheet at a time to help them bake evenly. If you prefer, or are crunched for time, bake two sheets at a time with one sheet in the upper third of the oven and the other in the lower third of the oven.', '9 Scoop the dough: Use a medium cookie scoop (or a well-mounded tablespoon measure) to scoop the dough out onto one of the baking sheet. Space the cookies about 2 inches apart.', '10 Bake the cookies: Bake the cookies for 10 minutes, then remove from the oven. Gently press 3 to 4 mini marshmallows into the tops of each cookie. (See Recipe Note for more ways to tinker with when to add the marshmallows.)', 'Return the cookies to the oven and bake for another 2 to 3 minutes, until the marshmallows look like puff balls and are just starting to melt around the bottom. The marshmallows will continue to melt after the cookies come out of the oven.', '11 Cool the cookies: Cool the cookies on the baking sheet for about 5 minutes, or until the puffed middles collapse down and the cookies have firmed a little. Transfer the cookies to a wire cooling rack to cool completely.', '11 Continue baking cookies in batches until all the cookie dough has been used.', '12 Enjoy! Cooled cookies can be stored in an airtight container with wax paper between the layers for up to a week. The marshmallows may stick to the wax paper; just gently peel the paper away when removing cookies.']",15
621,Laura Bush\xe2\x80\x99s Cowboy Cookies Recipe,20,20,40,"['1 1/2 cups flour', '1 1/2 teaspoons baking powder', '1 1/2 teaspoons baking soda', '1 1/2 teaspoons cinnamon', '1/2 teaspoon salt', '1 1/2 sticks butter (6 ounces, 12 tablespoons), at room temperature', '3/4 cup white sugar', '3/4 cup brown sugar', '1 1/2 large eggs, beaten (See Recipe Note)', '1 1/2 teaspoons vanilla extract', '1 1/2 cups semisweet chocolate chips', '1 1/2 cups old fashioned rolled oats', '1 cup sweetened flaked coconut (we used shredded)', '1 cup chopped pecans']",14,"['1 Preheat oven, prep baking sheets: Preheat oven to 350\\xc2\\xb0F with racks in upper and lower third. Line two large baking sheets with Silpat or parchment paper.', '2 Whisk dry ingredients: In a large bowl, vigorously whisk together the flour, baking powder, baking soda, cinnamon, and salt.', '3 Make the cookie dough: Place butter in a standing electric mixer and beat on medium speed until smooth and light, about 1 minute. Slowly add in the white sugar and brown sugar, and beat to combine, about 2 more minutes.  Add half the eggs, beat, and then add the other half and beat again. Add the vanilla extract and beat again.', 'Reduce the speed of the mixer to low and slowly add the flour mixture, until just combined. Add the chocolate chips, oats, coconut, and pecans, mixing until just combined.', '4 Scoop out the cookies: If you want large cookies, drop about 1/4 cup lumps of the dough onto the prepared cookie sheets, separated by 3 inches to allow for enough room for the cookies to spread as they cook.', 'For smaller cookies, use about 2 tablespoons of the cookie dough per cookie.', '5 Bake the cookies: Bake at 350\\xc2\\xb0F for 14 to 18 minutes for large cookies, or 13 to 16 minutes for small cookies. Rotate the pan halfway through baking, front to bake and top to bottom.', ""Note that if you are using a dark baking sheet, it will absorb more heat, and you won't need as much baking time. Also, the top rack will bake more quickly because heat rises. "", '6 Cool the cookies: Remove from oven and let cool on the baking sheets for 5 minutes. Then remove the cookies to a rack to cool completely.', ""You'll likely need to work in batches, depending on the size of your oven and your baking sheets.""]",10
622,Fudgy Chocolate Brownies Recipe,15,25,40,"['3/4 cup (105 grams) all-purpose flour', '1/8 teaspoon baking powder', '1/4 teaspoon salt', '6 tablespoons (3 ounces) unsalted butter, cut up', '2 ounces unsweetened chocolate, broken into 1-inch pieces', '1 cup (200 grams) granulated sugar', '2 large eggs', '1 teaspoon vanilla extract', '1 cup (6 ounces) mini bittersweet-chocolate chips, optional', 'Special equipment:', '8x8 baking pan', 'Medium saucepan, 2-quarts or larger', 'Heatproof spatula', 'Wire cooling rack']",14,"['1 Heat the oven to 350F and prepare the pan: Line an 8x8 baking pan with a sling of parchment, long enough so that the parchment hangs over the sides of the pan. Coat the exposed sides of the pan with cooking spray (also, a little cooking spray under the parchment will help it stick in place, if needed).', '2 Combine the dry ingredients: In a bowl, whisk together the flour, baking powder, and salt. Set aside.', '3 Melt the chocolate and butter: In a medium saucepan over medium-low heat, melt the butter. It should not brown at the edges.', 'Add the chocolate and let it melt, stirring occasionally with a heatproof spatula, until the mixture is smooth.', '4 Set the pan on a cooling rack to cool until you can touch the bottom of with your hand comfortably.', '5 Make the batter: Using a rubber spatula, stir the sugar into the chocolate mixture until it combined. The mixture may look crumbly or smooth after mixing; either is fine.', 'Add the eggs, one at a time, followed by the vanilla. Add the flour mixture, and stir until no more white patches show. Stir in the chips until well distributed.', '6 Pour the batter into the pan. Use a spatula to spread it to the edges of the pan and smooth the top. Tap the pan once or twice hard on the counter to settle any air pockets; you can also poke the air pockets with the tip of a paring knife.', ""7 Bake the brownies: Transfer the pan to the oven and bake for 25 to 30 minutes, or until the top is slightly puffed and just set. If in doubt, it's better to under-bake these brownies a touch rather than over-bake. (The toothpick test doesn't work well for these brownies because the chocolate chips get melty!)"", '8 Cool the brownies completely: Set the pan on a wire rack until completely cooled.', '9 Once cool, cover the pan and refrigerate for several hours or until firm and cold. This makes the brownies easier to slice cleanly.', ""If you're eager for brownies and can't wait for them to chill, skip this chilling step and serve them warm or just-cooled! They will be a little crumbly when you cut them.)"", '6 Cut the squares: Run a thin knife around the edge of the pan to make sure the block of brownies is loose, then lift from the pan using the parchment paper sling. On a cutting board, slice the brownies into a 4x4 grid (to make 16 squares) or into a 5x5 grid (to make 25 mini-brownies).', 'Brownies can be served right away. Leftovers can be stored in an airtight container at room temperature for at least a week. (They will keep for longer, but may start getting dry and crumbly after a while.)']",14
623,Nut-Free \xe2\x80\x9cPeanut Butter\xe2\x80\x9d Chocolate Chip Cookies Recipe,25,55,80,"['1 tablespoon flaxseed meal (or ground flaxseed)', '1/2 cup coconut oil, softened at room temperature (but not melted or liquidy; see Recipe Note for allergy info)', '1/3 cup (72g) brown sugar', '1/2 cup (100g) granulated sugar', '1/2 cup plus 2 tablespoons (104g) sunflower butter, store-bought or homemade (or another favorite nut or seed butter)', '2 teaspoons pure vanilla extract', ""1 1/4 cup (170g) all-purpose gluten-free flour blend (such as Bob\\'s Red Mill Gluten Free 1-to-1 Baking Flour Blend)"", '1 teaspoon baking soda', '1 3/4 teaspoons cornstarch', '1 teaspoon salt', '1 cup (165g) allergen-free chocolate chips (such as Enjoy Life brand)']",11,"['7 Chill the dough: Cover the mixing bowl with plastic wrap and chill in the refrigerator for 30 minutes, or up to overnight.', '8 Preheat the oven and prepare the pan: Preheat the oven to 350\\xc2\\xb0F. Line a large baking sheet with parchment paper.', '9 Warm the dough slightly: After chilling, remove the dough from the refrigerator and let it sit at room temperature for 10 minutes. Because the dough is a bit crumbly, letting it sit out on the counter before forming it into balls will help ensure you have nice, smooth cookie dough balls to work with versus ones that may crack a bit if they\\xe2\\x80\\x99re too cool.', '10 Roll into cookies: Using 2 heaping tablespoons (about 45g) of dough per cookie, roll the dough in between your hands until it forms a ball. It doesn\\xe2\\x80\\x99t need to be perfect\\xe2\\x80\\x94if the dough crumbles a little, just press it back together.', ""Place each ball on a parchment-lined baking sheet spaced about 1 1/2 inches apart (they\\'ll spread a bit). Using the palm of your hand, flatten each cookie slightly to about 1/2-inch thickness. If the cookies start to crack or break as you flatten them, just use your hands to form them back together."", '11 Bake cookies: Bake for 9 to 11 minutes, or until the edges just begin to turn golden brown. The cookies will still feel soft but will firm up as they cool.', '12 Cool and serve: Allow to cool on the baking sheet for 5 minutes. Transfer to a wire rack to cool completely.', '13 Store leftovers: Keep the cookies covered at room temperature for up to 5 days. Freeze in an airtight freezer bag or container for up to 3 months.']",8
624,Chocolate Chip Pancakes with Raspberry Sauce Recipe,5,30,35,"['For the raspberry syrup:', '2 cups (about 9 oz) frozen raspberries', '3/4 cup sugar', '1/2 cup water', '2 teaspoons lemon juice', '1 1/4 teaspoons cornstarch', 'For the pancakes:', '1 1/4 cups (about 5 1/2 ounces) all-purpose flour', '1 teaspoon baking powder', '1/2 teaspoon baking soda', '1/4 teaspoon kosher salt', '3 tablespoons sugar', '1 1/4 cups buttermilk', '1 large egg', '1 teaspoon vanilla extract', '1/2 cup mini chocolate chips', 'Butter, for the pan']",17,"['1 Make the syrup: Place the raspberries, sugar, water, lemon juice, and cornstarch in a small saucepan, stirring to combine. Cook over medium-high heat until the raspberries break down and the mixture begins to boil. Boil for 3 to 5 minutes, until thickened. Remove from the heat and set aside to cool.', '2 Make the batter. In a medium mixing bowl, whisk together the flour, baking powder, baking soda, kosher salt, and sugar. In a second small bowl, whisk the buttermilk, egg, and vanilla together to combine.', 'Pour the buttermilk mixture into the flour, and stir gently to combine. Break apart any large pockets of flour with your spatula; a few small lumps are okay. Fold in the mini chocolate chips.', '3 Cook the pancakes: Heat a large nonstick skillet or griddle over medium heat. Add a pat of butter and swirl to coat the bottom of the pan. Ladle the batter (about 1/4 cup per pancake) onto the skillet and cook until the bottoms are golden and bubbles cover the surface of the pancakes. Flip and cook until golden on the other side.', 'Repeat with the remaining batter. Serve warm drizzled with raspberry syrup.']",5
625,Peanut Butter Chocolate Chip Banana Bread Recipe,15,55,70,"['2 to 3 very ripe bananas, peeled', '1/3 cup (74g) melted unsalted butter', '1/2 cup milk, (whole, 2 percent or even a nut milk works)', '1 large egg', '1 teaspoon vanilla extract', '1 cup (200g) sugar', '1/2 cup (113g) creamy peanut butter', '1 teaspoon baking soda', 'Pinch of kosher salt', '1/2 teaspoon cinnamon (optional)', '1 1/2 cups (191g) all-purpose flour', '3/4 cup (143g) chocolate chips']",12,"['1 Preheat the oven to 350\\xc2\\xb0F. Spray or grease a 4x8-inch loaf pan very well.', '2 Make the batter: Mash the bananas in a mixing bowl using a fork. Whisk in the melted butter, milk, egg, and vanilla. Mix in the sugar.', 'In another mixing bowl, using the hand mixer (or a whisk), beat peanut butter until smooth. Beat this into the banana mixture.', 'Scrape the bowl down and beat in the baking soda, salt, cinnamon, and flour. Fold in the flour until completely combined, followed by the chocolate chips.', '3 Bake the loaf: Spread the batter in the prepared pan and bake on the center rack of the oven for 55 to 60 minutes, or until the bread is deeply golden and a toothpick inserted in the center comes out clean.', '4 Cool the loaf: Remove the bread from the oven and place on a rack to cool completely before turning out.', '5 Enjoy! Store the leftover bread wrapped well in plastic at room temperature for 3 days. Leftovers are great toasted lightly in a pan with butter.']",7
626,Worms in Dirt Chocolate Pudding Recipe,15,185,200,"['For the pudding:', '2 tablespoons natural unsweetened cocoa powder', '2 tablespoons cornstarch', '2 cups cold chocolate milk', 'Pinch of salt', '1 large egg', '4 ounces chopped chocolate (about 3/4 cup)', 'To assemble:', '10 ounces chocolate vanilla sandwich cookies, about 20 cookies', '12 gummy worms']",10,"['1 Combine pudding ingredients: Place the cocoa powder, cornstarch, chocolate milk and salt in a large saucepan and stir to incorporate the dry ingredients into the milk mixture.', '2 Cook the pudding: Cook on high heat until the mixture starts to boil, then reduce heat to a simmer. Cook until the mixture starts to thicken, about 3 to 5 minutes.', ""3 Temper the egg: Place an egg in a large bowl and beat it with a whisk. Slowly drizzle a little bit of the hot chocolate mixture into the bowl with the egg, whisking continuously. Continue to slowly add the chocolate mixture, whisking well, until you\\'ve incorporated all of it. The mixture should still be warm."", '4 Fold in the chocolate: Add the chopped chocolate and stir until the chocolate has completely melted.', ""5 Chill: Divide the pudding into four cups. If you don\\xe2\\x80\\x99t want a skin to form, place a piece of parchment paper on top of the surface of the pudding. (Omit if you don\\'t mind the pudding skin.)"", 'Chill for 3 hours or overnight in the refrigerator.', '6 Prepare the ""dirt"": Place the chocolate vanilla sandwich cookies in a large gallon resealable bag. Using a rolling pin, crush the cookies into crumbs. ', '7 Assemble: Divide the cookie crumbs over the four pudding cups. Place three gummy worms into the cookie crumb layer, making sure to \\xe2\\x80\\x9cbury\\xe2\\x80\\x9d a little bit of the gummy worm end as if the worm is coming out of the dirt. Serve immediately. Enjoy with a glass of real dairy milk!']",8
627,Huevos Motule\xc3\xb1os Recipe,20,30,50,"['Olive oil', '1 cup chopped red onion', '3 cloves garlic chopped', '4 ounces sliced button or cremini mushrooms', '1 1/2 cups of refried black beans', '6 fresh epazote leaves, finely chopped (optional)', '1/4 pound chorizo Mexican sausage (out of casing)', '1 tomato, roughly chopped', '1/2 serrano chile with seeds, minced (stem discarded)', '2 cloves of garlic, roughly chopped', '1/2 cup water', 'Pinch of salt', '1 plantain', '4 corn tortillas', '4 to 8 eggs, depending on how many eggs people want', 'Garnishes:', '1 avocado, peeled, pitted, sliced', '4 ounces of queso fresco, crumbled', 'Small bunch of fresh cilantro, chopped']",19,"['1 Cook the onions, garlic, mushrooms, and beans: Heat 2 Tbsp olive oil in a large saut\\xc3\\xa9 pan on medium high heat. Add the onions, garlic, and sliced mushrooms. Cook until onions are translucent, but not browned, and the mushrooms have given up some of their moisture, about 5 minutes.', 'Stir in the refried beans and epazote (if using). Cook for another 3 or 4 minutes. Remove from pan into a bowl, set aside.', '2 Cook the chorizo: While onions and mushrooms are cooking, heat 1 tablespoon of olive oil in another, smaller saut\\xc3\\xa9 pan or cast iron skillet on medium heat.', 'Add the chorizo (out of its casing), breaking it up into chunks. Cook for about 5-6 minutes until cooked through and lightly browned. Remove from pan into a bowl and set aside.', '3 Make the sauce: In a blender, blend together the chopped tomato, 2 cloves garlic, 1/2 serrano chile, 1/2 cup of water, and a pinch of salt. Blend until smooth.', 'Pour the sauce into a saucepan and cook on medium high heat until cooked through, bubbly and thick, 4 to 5 minutes. Remove from heat and put into a small bowl, set aside.', '4 Fry the plantain: Peel the plantain, slice it on the diagonal in 1/4 inch thick slices. Heat 3 tablespoons of olive oil in a large saut\\xc3\\xa9 pan on medium high heat.', 'Line the pan with the plantain slices. Brown on one side, then flip and brown on the other side. Remove the plantain slices to a paper towel-lined plate, reserving the oil in the pan.', '5 Cook the tortillas: Continue heating the oil on medium high heat. One at a time, cook the tortillas. Place a tortilla in the pan and cook until lightly browned and bubbles are forming in the tortilla.', 'Flip over and cook until lightly browned on the other side too. Continue to cook until the tortilla is somewhat stiff.', 'Use tongs to remove to a paper towel lined plate and continue the same process with the other tortillas. You will need to add more oil, make sure it heats up before adding another tortilla to the pan.', '6 Fry the eggs, sunny side up: Heat a couple tablespoons of olive oil in a stick-free saut\\xc3\\xa9 pan (cast iron will work fine).', 'Crack the eggs into the pan and cook, sunny side up, until egg whites are cooked and the yolks are still a little runny.', '7 Assemble the dish: Place a cooked tortilla (tostada) on a large serving plate. Spread some beans over the tostada.', 'Place a fried egg or two over the beans. Line the outside of the tostada with fried plantain, some chorizo.', 'Put some salsa over the egg. Put sliced avocado on top of that. Sprinkle crumbled queso fresco over everything. Sprinkle everything with fresh chopped cilantro.']",16
628,Sopa Seca de Fideo with Tomatillos Recipe,20,60,80,"['3/4 pound tomatillos (about 6 medium sized), husks removed', '1 to 2 serrano chiles', '1/4 medium onion', '1 clove garlic', '2 tablespoons chopped fresh cilantro, plus extra for garnish', '4 tablespoons extra virgin olive oil, divided', '4 ounces fresh Mexican chorizo, casing removed, crumbled', '8 ounces capellini, or angel hair pasta, broken into 1 to 1 1/2-inch pieces', '1 teaspoon sea salt', 'Freshly ground black pepper', '2 1/2 cups chicken stock', '4 ounces goat cheese, crumbled', '1 avocado, seeded, peeled, diced', 'Crema fresca or sour cream']",14,"['1 Broil tomatillos, chiles, onion: Place the tomatillos, serrano chiles, an quarter onion on a baking sheet lightly greased with olive oil. Broil for about 15 minutes until somewhat charred and blistered. Remove the stems from the serranos.', '2 Make tomatillo sauce: Working in batches if necessary, pur\\xc3\\xa9e the chiles, tomatillos, onion, a clove of garlic, and 2 tablespoons of the chopped cilantro in a blender, making sure not to fill the blender more than halfway. Once blended you should have about a cup of sauce.', '3 Cook the chorizo: Heat 2 Tbsp of oil in a large saucepan on medium heat. Add the chorizo and cook 3 to 4 minutes until cooked through and crispy. Use a wooden spoon to crumble up the chorizo as it cooks.', 'Use a slotted spoon to remove the chorizo to a paper-towel lined plate, keeping the fat and oil in the pan.', '4 Brown the dry noodles: Place the broken up dry pasta into the pan and increase the heat to medium high. Lightly brown the dry noodles in the chorizo oil. Remove the pasta from the pan and set aside.', '5 Cook the tomatillo sauce: Add the remaining 2 Tbsp of oil to the pan and heat on medium high heat. Add the tomatillo sauce and the salt. The sauce should bubble up from the heat of the pan. Cook for about a minute, allowing the sauce to reduce by about a quarter cup. Dragging your spoon through the sauce should leave a trail for a second or two.', '6 Add pasta: Add the pasta back to the pan with the tomatillo sauce and cook it until it has absorbed the liquid.', '7 Add stock, simmer and cook: Add the chicken stock. Bring to a boil and reduce to a simmer. Let cook undisturbed for about 15 minutes, or until the pasta is soft and the stock absorbed. The pasta will be past ""al dente"" but shouldn\\\'t be cooked to a mush.', '8 Serve: Place in serving bowls and garnish with crumbled chorizo, goat cheese, avocado, cilantro, and crema fresca or sour cream.']",9
629,Chorizo and Egg Breakfast Tacos Recipe,10,20,30,"['12 ounces Mexican-style chorizo sausage, removed from casing if necessary', '12 large eggs', '1/2 teaspoon salt', '1/4 teaspoon pepper', '6 tablespoons milk, whole or whatever you have on hand', '12 5-inch tortillas, preferably corn and flour blend', '1 cup chopped tomatoes (about 2 medium tomatoes)', '1 avocado, chopped', '3 to 4 tablespoons Cotija cheese', '1 /4 cup chopped cilantro leaves (optional)', 'Salt and pepper to taste', 'Hot sauce (optional)', 'Lime wedges (optional)']",13,"['1 Cook the chorizo: Place the chorizo in a large skillet and cook over medium heat, breaking up the sausage with a wooden spoon as it browns. Cook the chorizo until it is completely brown, then transfer to a bowl lined with paper towels to drain.', '2 Scramble the eggs: Wipe the skillet with a paper towel, but don\\xe2\\x80\\x99t bother cleaning it. Any residual oil will help flavor the eggs. In a medium bowl, whisk the eggs with the salt, pepper, and the milk, and then pour into the skillet and turn the heat to medium low. (See our recipe for How to Make Fluffy Scrambled Eggs.)', 'Stir the eggs gently as they cook, making sure to scrape all the sides of the skillet to form egg curds.', '3 Warm the tortillas: While the eggs are cooking, warm the tortillas one at a time in a clean, dry skillet over medium high heat. Warm until the side starts to char a bit, about 20 to 30 seconds, then flip to the other side and repeat. Move the warm tortillas to a plate as they are ready, and cover with a damp paper towel.', 'You can also warm all the tortillas at once in a microwave. Stack them and then wrap them in a damp paper towel, and cook in the microwave for 30 seconds. Leave the paper towel on until ready to use.', '4 Add the sausage to the eggs: When the eggs are still slightly runny but just about to set up in curds, add the sausage back to the eggs to warm it back up. Stir and remove from heat.', '5 Assemble and serve the tacos: Divide the filling between tortillas, or let people assemble their own tacos right from the pan. Sprinkle tomatoes, avocado chunks, crumbled Cotija cheese, and cilantro leaves (if using) over each taco. Add salt and pepper to taste.', 'Serve with hot sauce and wedges of lime on the side.']",8
630,Chorizo-Stuffed Sweet Potatoes Recipe,10,85,95,"['4 medium sweet potatoes', '2 tablespoons vegetable oil', '2 green or red bell peppers, sliced', '1 medium yellow onion, sliced', '1 1/2 teaspoons kosher salt', '1/2 teaspoon chili powder', '1 (14-ounce) package fresh chorizo, casings removed', 'Cotija cheese, for sprinkling, to taste', 'Chopped cilantro, for sprinkling, to taste']",9,"['1 Bake the sweet potatoes: Preheat oven to 400\\xcb\\x9aF. Thoroughly wash the potatoes under running water, making sure to get off any dirt. Pierce the potatoes all over with a fork and arrange them on a baking sheet.', 'Bake until soft and a fork easily reaches the middle of the potato, about 1 hour depending on the size of the potatoes.', '2 Make the chorizo filling: Heat the oil in a large skillet over medium heat. Add the peppers, onions, salt, and chili powder and cook until the vegetables are softened, about 15 minutes.', 'Add the chorizo and cook, breaking up the sausage with a wooden spoon, until fully cooked, about 10 minutes.', '3 Stuff the sweet potatoes: Split each sweet potato down the middle with a knife and push open at the ends to make a pocket. Stuff the sweet potatoes with the chorizo mixture, sprinkle with some cheese and cilantro, and serve.', 'The leftovers will keep for a few days, covered, in the refrigerator.']",6
631,Clam Chowder with Corn Recipe,30,30,60,"['About 6 pounds of quahog or cherrystone clams', '1 tablespoon unsalted butter or extra virgin olive oil', '4 ounces salt pork, cubed (or chopped bacon or pancetta, cubed)', '2 cups chopped onion', '1 tablespoon all-purpose flour (less or more, depending on how thick you want the soup)', '1 cup dry white wine, like a Sauvignon Blanc (or 2 tablespoons white or cider vinegar, or lemon juice)', '2 pounds potatoes (russets or Yukon gold), peeled and diced', '1 to 2 cups water', '1 bay leaf', '2 sprigs thyme', '1/2 teaspoon freshly ground black pepper', '1 teaspoon Old Bay seasoning (or paprika with a dash of cayenne)', '1 1/2 cups corn (frozen is fine)', '1 cup heavy whipping cream', '2 tablespoons chopped fresh parsley']",15,"['1 Clean and prep clams: Rinse and scrub the clams to remove any dirt. Place clams in a bowl, cover with cold, well salted water and refrigerate for 30 minutes to an hour. This will allow the clams to expel some of their grit into the water. Discard any broken clams or clams that are open and do not close when you touch them.', ""2 Steam the clams: Place the clams in a large pot and add about a half inch of water to the pot. Cover the pot and bring the water to a boil. Let the clams steam until they all open up, 5 to 10 minutes. The steaming water may foam up a bit; just watch so it doesn't overflow."", 'Use a slotted spoon to remove the clams from the pot to a bowl. Strain the remaining clam steaming liquid through a fine mesh sieve to catch any grit, and reserve. You should have 2 to 3 cups of clam liquid.', 'Separate the clams from the clam shells. Discard the shells. Roughly chop the cooked clams. You should have 1 1/2 to 2 cups of chopped clams.', ""3 Brown the salt pork: Place the salt pork and butter or oil in the bottom of a large, thick-bottomed pot. Heat on medium and brown the salt pork. (Note that if you are using salt pork that is mostly fat, you won't need any additional fat from butter or oil, but you might want to put a little water in the pan to help render the fat from the salt pork.)"", '4 Add onion: Add the chopped onion to the pan, and cook, stirring occasionally, until the onions are translucent, about 5 minutes.', '5 Add flour, let cook, then add wine: Sprinkle flour over the onions and stir until everything is coated with the flour. Let the flour cook for a minute or two. Slowly add the white wine to the pot, stirring after each addition.', '6 Add potatoes, clam steaming liquid, spices: Add potatoes to the pot. Add 2 to 3 cups of the strained clam steaming liquid and a cup of water. The liquid should cover the potatoes. If not, add a little more water or clam cooking liquid.', 'Add the bay leaf, thyme, black pepper, and Old Bay. Heat to a boil and reduce to a simmer.', 'Cover and cook for 10 minutes, then add the corn (if using) and cook for 5 minutes more, or until the potatoes are cooked through.', '7 Heat cream: While the potatoes are cooking, heat a cup of cream in a small saucepan until steamy.', '8 Add clams, stir in cream: When the potatoes are tender, add the chopped clams and turn off the heat under the soup. Slowly stir in the heated cream. Adjust seasonings. Stir in the fresh parsley.', 'Note that if you simmer the soup after the cream has been added, the soup may curdle. This is why we turn off the heat before adding the hot cream.', 'Serve with oyster crackers or rustic bread.']",14
632,Salmon Chowder Recipe,25,45,70,"['4 ounces bacon, chopped', '2 cups cleaned, sliced leeks (see How to Clean Leeks)', '1 cup sliced celery', '3 cups cubed Yukon gold potatoes, 1 1/2-inch pieces (about 3 medium potatoes, 1 1/2 lbs)', '2 cups chicken stock', '2 1/4 cups water', '1/2 teaspoon salt', '2 bay leaves', '1 sprig of thyme', '1 Tbsp butter', '1  to 1 1 /4 pounds of trimmed, skinned, salmon fillet, cut into 1-inch cubes', '1/2 cup corn (optional, use when in season or frozen)', '2 Tbsp flour (use rice flour if cooking gluten-free)', 'A pinch of ground black pepper', '3/4 cup (6 ounces) heavy cream', '1/2 teaspoon lemon zest', 'Chopped fresh chives for garnish']",17,"['1 Cook the bacon: Place bacon in a thick-bottomed 5 to 6 quart pot. Heat on medium to medium  high heat.', 'Cook until lightly browned and the fat mostly rendered out of the bacon, about 5 to 6 minutes.', 'Remove all but 1 Tbsp of the bacon fat. (Do not put bacon fat in your sink drain, it will clog the pipes.)', '2 Add the celery and leeks to the bacon and cook on medium heat until softened, about 5 to 6 minutes.', '3 Add diced potatoes, chicken stock, water, 1/2 teaspoon salt, bay leaves, and thyme to the pot. Increase heat to bring to a simmer. The lower the heat to maintain a gentle simmer. Simmer for 10 to 15 minutes, until the potatoes are cooked through.', '4 While the potatoes are cooking, prepare the salmon. Place salmon in a bowl, sprinkle with flour and black pepper. Toss to coat. Melt 1 Tbsp butter in a non-stick skillet on medium high heat.', ""Working in batches if necessary, lightly brown the salmon on one side, then turn over to brown on the other side. (The salmon doesn't have to be cooked through, just lightly browned.)"", '5 When the potatoes are cooked through, use a slotted spoon to transfer the salmon to the pot with the potatoes, bacon, leeks, and stock. Stir in corn if using. Cook gently for 5 minutes then remove from heat. Stir in the cream and lemon zest. Add salt to taste.', 'Garnish with chives to serve.']",9
633,Tarragon Corn Chowder Recipe,10,60,70,"['4 ears corn, in the husk (resulting in about 3 cups corn kernels)', '3 Tbsp unsalted butter', '1 cup chopped white or yellow onion', '1 cup chopped fennel bulb', '2 minced garlic cloves', '3 bay leaves', '4 small waxy potatoes, such as Yukon Gold, peeled and cut into chunks', 'Salt', '1/2 cup white wine', '1-2 Tbsp fresh chopped tarragon (French)']",10,"['Prep the onions, fennel and potatoes while you are cooking the corn or making the corn broth.', '1 Cook the corn (or not): If you are starting with fresh corn-on-the-cob (versus frozen), you can either cook the corn first, or not. We grill the corn first to get the extra flavor from the corn. You can make this soup with leftover whole cooked corn, or you can use raw corn corn on the cob.', 'To grill, keep the corn-on-the-cobs in their husks, and grill them directly over high heat until the outer husks are nicely charred, about 10-15 minutes. Then remove from the grill, let cool a little, then remove the husks and silk.', '2 Cut the corn kernels away from the cobs. (See our tip for removing corn from the cob using a bundt pan to stabilize the cobs.) Set aside the corn kernels. Do not discard the cobs.', '3 Simmer the cobs: Break the corn cobs in half, and put them in a pot with 6 cups water and the bay leaves. Bring to a boil and simmer, covered, for 30 minutes. If you skip this step, use a quart of vegetable or chicken stock, plus 2 cups water in place of the corn broth in 5.', '4 Cook onion and fennel, garlic: Heat the butter in a Dutch oven or separate large, thick-bottomed pot set over medium-high heat. Add the chopped onion and fennel and cook until soft and translucent, about 5 minutes.', 'Add the garlic and saut\\xc3\\xa9 for another minute.', '5 Add the white wine to the onions and boil it down by half.', '6 Add potatoes, corn broth, bay leaves: While the wine is boiling, remove the corn cobs from the corn broth and discard. Add the potatoes to the pot with the onions and fennel, then pour in the corn broth, along with the bay leaves.', ""7 Simmer until potatoes are tender, add corn: Stir well and add salt to taste (you'll need to add more salt than you expect, as the corn broth is unsalted). Simmer gently until the potatoes are tender, about 20 minutes."", ""If you are using raw corn on the cob or frozen corn, you'll want to add the corn to the soup about halfway into the cooking. If you are using grilled or cooked corn, add at the end of cooking and heat for a few minutes."", '8 Add tarragon:  To finish, add the fresh chopped tarragon to the pot.']",12
634,Perfect Cheesecake Recipe,20,400,420,"['For the crust:', '1 3/4 cups (230g) of Graham cracker crumbs (from about 15 Graham crackers)', '2 Tbsp sugar', 'Pinch salt', '4 Tbsp plus 1 teaspoon (60g) unsalted butter (if using salted butter, omit the pinch of salt), melted', 'For the filling:', '2 pounds cream cheese (900g), room temperature', '1 1/3 cup granulated sugar (270g)', 'Pinch of salt', '2 teaspoons vanilla extract', '4 large eggs', '2/3 cup sour cream (160 ml)', '2/3 cup heavy whipping cream (160 ml)', 'For the sour cream topping:', '2 cups sour cream (475 ml)', '1/3 cup powdered sugar (35g)', '1 teaspoon vanilla extract', 'For the raspberry sauce:', '12 ounces (340g) fresh raspberries', '1/2 cup granulated sugar (100g)', '1/2 cup water (120 ml)', 'Special equipment:', '9-inch, 2 3/4-inch high springform pan', 'Heavy-duty, 18-inch wide aluminum foil', 'A large, high-sided roasting pan']",25,"['PREPARE THE CRUST', '1 Process graham crackers, mix with sugar, salt, butter: Pulse the graham crackers in a food processor or blender until finely ground. Put in a large bowl, and stir in the sugar and salt. Stir in the melted butter.', 'Preheat oven to 350\\xc2\\xb0F (175\\xc2\\xb0C), with rack in lower third of oven.', '2 Press the graham cracker crumbs into the bottom of the springform pan: Gently press down on the crumbs using your fingers, until the crumbs are a nice even layer at the bottom of the pan, with maybe just a slight rise along the inside edges of the pan.', '3 Bake the crust: Place the pan on a baking sheet and bake at 350\\xc2\\xb0F (175\\xc2\\xb0C) for 10 minutes. Remove from the oven and let cool. While the crust is cooling, you can skip ahead and start on the filling. Wait until the crust has cooled to wrap the pan in foil in the next step.', '4 Triple wrap pan in heavy duty foil: Prepare the springform pan so that no water leaks into it while cooking. Place a large 18-inch by 18-inch square of heavy duty aluminum foil on a flat surface.', ""Place the springform pan in the middle of the foil. Gently fold up the sides of the foil around the pan. Make sure to do this gently so that you don't create any holes in the foil."", 'If there are any holes, water will get into the pan and ruin the crust.', 'Press the foil around the edges of the pan. Place a second large square of foil underneath the pan, and repeat, gently folding up the sides of the foil around the pan and pressing the foil against the pan.', 'To be triply safe, repeat with a third layer of heavy duty foil. Gently crimp the top of the foil sheets around the top edge of the pan.', 'MAKE THE CHEESECAKE', '1 Beat cream cheese, then sugar: Cut the cream cheese into chunks and place in the bowl of an electric mixer, with the paddle attachment. Mix on medium speed for 4 minutes until smooth, soft and creamy. Add the sugar, beat for 4 minutes more.', '2 Add salt, vanilla, then eggs, then sour cream: Add the salt and vanilla, beating after each addition. Add the eggs, one at a time, beating for one minute after each addition. Add the sour cream, beat until incorporated.', '3 Add the heavy cream, beat until incorporated. Remember to scrape down the sides of the mixer bowl, and scrape up any thicker bits of cream cheese that have stuck to the bottom of the mixer that paddle attachment has failed to incorporate.', '4 Prepare pan and boiling water: Place the foil-wrapped springform pan in a large, high-sided roasting pan. Prepare 2 quarts of boiling water.', 'Heat the oven to 325\\xc2\\xb0F (160\\xc2\\xb0C).', '5 Pour filling into pan: Pour the cream cheese filling into the springform pan, over the graham cracker bottom layer. Smooth the top with a rubber spatula.', '6 Place in oven: Place the roasting pan with the springform pan in it, in the oven, on the lower rack.', '7 Carefully pour the hot water into the roasting pan (without touching the hot oven), to create a water bath for the cheesecake, pouring until the water reaches halfway up the side of the springform pan, about 1 1/4 inches. (Alternatively you can add the water before putting the pan in the oven, whichever is easier for you.)', '8 Bake at 325\\xc2\\xb0F (160\\xc2\\xb0C) for 1 1/2 hours.', '9 Turn off the heat of the oven. Crack open the oven door 1-inch, and let the cake cool in the oven, as the oven cools, for another hour. This gentle cooling will help prevent the cheesecake surface from cracking.', ""10 Chill 4 hours: Cover the top of the cheesecake with foil, so that it doesn't actually touch the cheesecake. Chill in the refrigerator for a minimum of 4 hours, or overnight."", 'FINISH AND SERVE THE CHEESECAKE', '1 Prepare the sour cream topping: Place sour cream in a medium sized bowl, stir in the powdered sugar and vanilla, until smooth. Chill until you are ready to serve the cake.', 'Note that this recipe produces enough sour cream topping for a thick topping and some extra to spoon over individual pieces of cheesecake, if desired. If you would like a thinner layer of topping and no extra, reduce the sour cream topping ingredients in half.', '2 Prepare the raspberry sauce: Place raspberries, sugar, and water in a small saucepan. Use a potato masher to mash the raspberries. Heat on medium, whisking, about 5 minutes, until the sauce begins to thicken. Remove from heat. Let cool.', '3 Prepare the cheesecake to serve: Remove the cake from the refrigerator. Remove the foil from the sides of the pan, and place the cake on your cake serving dish. Run the side of a blunt knife between the edge of the cake and the pan.', ""Dorie recommends, and we've done with success, that you use a hair dryer to heat the sides of the pan to make it easier to remove. Open the springform latch and gently open the pan and lift up the sides."", 'Spread the top with the sour cream mixture. Serve plain or drizzle individual slices with raspberry sauce.']",29
635,Roast Leg of Lamb Recipe,0,210,210,"['Marinade', '1/2 cup orange juice', '1 cup white wine', '3 cloves garlic, minced', '2 teaspoons of fresh thyme or 1 teaspoon of dried thyme', '2 Tbsp of fresh chopped rosemary or 1 Tbsp of dried rosemary', '1/4 teaspoon of fresh ground pepper', 'Blend marinade ingredients in a blender, just a few pulses until well mixed.', 'Lamb Roast', 'One 6-pound leg of lamb, bone-in or boneless. (If boneless, the leg should be tied up with kitchen string by butcher.)', 'Marinade', 'Salt and freshly ground black pepper', 'Special equipment:', 'Remote meat thermometer']",14,"['Also, the shape of the roast will have an impact on the cooking time. Our roast was rather long and thin, so it cooked up fairly quickly. A thicker roast may take longer than expected.', 'So, use a meat thermometer!', ""About 20 minutes before you expect the roast to be done, start checking the meat thermometer. Note that every time you open the oven door, you'll need 10 minutes or so to bring the oven back up to temperature, thus slowing down the cooking process. So, don't check too often, or use a remote meat thermometer. Remove the roast from the oven anywhere from 125\\xc2\\xb0F to 135\\xc2\\xb0F for medium rare. Lamb should never be cooked until well done or it will be too dry."", ""5 Let rest: Let stand for 25-30 minutes before carving (so the juices don't all run out when you cut into it). Cut away the kitchen string and slice with a sharp carving knife, 1/2 inch thick slices, against the grain of the meat."", '6 Collect drippings for gravy or sauce: While the roast is resting, use a metal spatula to scrape up the drippings in the roasting pan. Use the drippings to make a gravy, or use just the drippings themselves to serve with the lamb.', 'Serve with some mint chimichurri or homemade mint jelly.']",6
636,Peanut Butter Cookies Recipe,30,190,220,"['1/2 cup butter (1 stick, 4 ounces, 112 g), unsalted or salted, room temperature', '1/2 cup (100 g) white granulated sugar', '1/2 cup (110 g) packed brown sugar', '1/2 cup (130 g) peanut butter', '1 large egg', '1 1/4 cups (160 g) all purpose flour', '3/4 teaspoon baking soda', '1/2 teaspoon baking powder', '1/4 teaspoon salt (if using salted butter, omit the salt)']",9,"['1 Make the cookie dough: Beat the butter until creamy, 2 minutes. Add the brown sugar and white sugar, beat for 2 more minutes. Mix in the peanut butter and the egg.', 'In a separate bowl, vigorously whisk together the dry ingredients\\xe2\\x80\\x94the flour, baking soda, baking powder and salt. Stir the dry ingredients into the sugar butter mixture.', '2 Chill the dough: Wrap dough in plastic and refrigerate at least 3 hours.', '3 Preheat oven to 375\\xc2\\xb0F (190\\xc2\\xb0C).', '4 Shape the cookies: Shape the dough into 1 1/4 inch balls. Place the balls of dough about 3 inches apart on un-greased cookie sheet. Flatten in crisscross pattern with a fork. (It helps to dip the fork in sugar to keep it from sticking to the dough.)', '6 Bake: Bake at 375\\xc2\\xb0F (190\\xc2\\xb0C) until light brown, about 9 to 10 minutes. (Remove the cookies from the oven and let cool in their baking sheets for a minute. After a minute, transfer the cookies to a rack to cool completely.', 'Note: For chewier cookies, bake at 300\\xc2\\xb0F (150\\xc2\\xb0C) for 15 minutes.']",7
637,Yorkshire Pudding Recipe,5,95,100,"['1 cup flour', '1/2 teaspoon salt', '1 cup milk', '2 tablespoons melted butter', '2 eggs, beaten*', '2-4 tablespoons of roast drippings', '* If you double the recipe, add an extra egg to the batter.']",7,"['1 Make batter: Whisk together the flour and salt in a large bowl. Form a well in the center. Add the milk, melted butter, and eggs and beat until the batter is completely smooth (no lumps), the consistency of whipping cream.', 'Let sit for an hour.', '2 Preheat baking dish with drippings: Heat oven to 450\\xc2\\xb0F. Add roast drippings to a 9x12-inch pyrex or ceramic casserole dish, coating the bottom of the dish. Heat the dish in the oven for 10 minutes.', 'For a popover version you can use a popover pan or a muffin pan, putting at least a teaspoon of drippings in the bottom of each well, and place in oven for just a couple minutes.', '3 Pour batter into dish, bake: Carefully pour the batter into the pan (or the wells of muffin/popover pans, filling just 1/3 full), once the pan is hot.', 'Cook for 15 minutes at 450\\xc2\\xb0F, then reduce the heat to 350\\xc2\\xb0F and cook for 15 to 20 more minutes, until puffy and golden brown.', 'Cut into squares to serve.']",7
638,Coquito (Puerto Rican Coconut Eggnog) Recipe,5,35,40,"['1 (14-ounce) can sweetened condensed milk', '1 (15-ounce) can cream of coconut (like Coco Lopez or Goya)', '1 (12-ounce) can evaporated milk', '1 (13.5-ounce) can of coconut milk', '2 teaspoons vanilla, or 1 vanilla bean, split and seeded', '2 whole cinnamon sticks', '1/2 teaspoon grated nutmeg', '1 to 2 cups rum', 'Grated nutmeg or ground cinnamon for garnish (optional)']",9,"['1 Steep the spices: Place the sweetened condensed milk, cream of coconut, evaporated milk, coconut milk, vanilla, cinnamon sticks, and nutmeg (all the ingredients except the rum) in a large saucepan. Warm over medium-high heat until just starting to simmer.', 'Remove from heat, cover, and let infuse for 30 minutes.', '2 Mix in the rum: Remove the cinnamon sticks and the vanilla bean (if using) and pour the mixture into a punch bowl or pitcher. (Note: I rinse and dry the vanilla bean and cinnamon sticks, and save them future infusions such as rice pudding.)', 'Add 1 cup of rum and taste; add more rum for a stronger punch. I usually stick to around 2 cups as I prefer it strong.', '3 Chill: Chill this in the fridge for at least 2 hours or for up to 3 days.', '4 Serve: Serve neat or over ice in small portions. Garnish with grated nutmeg or ground cinnamon as desired.']",6
639,Gingerbread Cookies Recipe,50,70,120,"['For the Gingerbread Cookies:', '3 1/4 cups all-purpose flour', '3/4 teaspoon baking soda', '1 tablespoon ground ginger', '1 tablespoon ground cinnamon', '1/2 teaspoon ground cloves', '1/2 teaspoon ground nutmeg', '1/2 teaspoon salt', '1/4 teaspoon finely ground black pepper', '3/4 cup (1 1/2 sticks) unsalted butter, softened to room temperature', '1/2 cup dark brown sugar, packed', '1 large egg', ""1/2 cup unsulfured molasses (do not use blackstrap molasses, it\\'s too bitter)"", 'For the Royal Icing:', '1 egg white, raw or pasteurized (or 1 tablespoon egg white powder)', '1/2 teaspoon lemon juice', '1 3/4 cup powdered sugar, sifted', 'Optional, for decorating:', 'Raisins, currants, chocolate chips, candy pieces, frosting', 'Special equipment:', 'Gingerbread man cookies cutters']",21,"['1 Combine the dry ingredients: In a large bowl, vigorously whisk together the flour, baking soda, and spices. Set aside.', '2 Make the dough: In an stand mixer fitted with the paddle attachment, beat the butter until light and fluffy. Add sugar and beat until fluffy. Mix in the egg and molasses.', 'Gradually add the flour mixture; combine on low speed. (You may need to work it with your hands to incorporate the last bit of flour.)', '3 Chill the dough: Divide dough into thirds; wrap each third in plastic. Chill for at least 1 hour or overnight. Before rolling out, let sit at room temperature for 5 to 10 minutes. If after refrigerating the dough feels too soft to roll out, work in a little more flour.', '4 Preheat oven to 350\\xc2\\xb0F.', '5 Roll out dough: Place a dough third on a large piece of lightly floured parchment paper or wax paper. Using a rolling pin, roll dough 1/8 inch thick. Transfer the rolled out dough to the refrigerate again to chill for 5 to 10 minutes. This will make it easier to cut out the cookies.', '6 Cut out the cookies: Use a cookie cutter to cut out shapes, or place a stencil over the dough and use a knife to cut into desired shapes.', '7 Transfer to baking sheet: Transfer to ungreased baking sheets. Press raisins, chocolate chips, or candy pieces in the center of each cookie if desired for ""buttons.""', '8 Bake: Bake at 350\\xc2\\xb0F until crisp but not darkened, 8 to 10 minutes. Remove from oven. Let sit a few minutes and then use a metal spatula to transfer cookies to a wire rack to cool completely. Decorate as desired.', '9 Make the royal icing: Beat the egg whites and lemon juice together, adding the sifted powder sugar until the mixture holds stiff peaks.', 'If using powdered egg whites: Combine 1 tablespoon egg white powder with 2 tablespoons water. Proceed as you would otherwise.', 'If the icing is too runny, add more powdered sugar until you get the desired consistency.', 'Once you make the royal icing, use quickly before it hardens.', '10 Decorate the cookies: Fill a piping bag with the icing to pipe out into different shapes on the cookies. (Or use a plastic sandwich bag, with the tip of one corner of the bag cut off.) Keep the icing covered while you work with it or it will dry out.', 'Once the cookies are decorated, the surface of the royal icing will dry quickly, within 15 minutes. But the icing may still be soft inside. Let the decorated cookies sit at room temp for 12 hours for the icing to dry completely.']",15
640,Lemon Cheesecake Recipe,30,540,570,"['For the gingersnap crust:', '7 ounces (198g) crisp gingersnap cookies (or graham crackers)', '4 tablespoons (57g) unsalted butter, melted', '3 tablespoons sugar', 'Pinch of kosher salt', 'For the cheesecake batter:', '2 pounds cream cheese, softened', '1 cup (200g) sugar', '1 packed tablespoon lemon zest (from 1-2 fresh lemons)', '4 large eggs', '1 cup (227g) sour cream', 'Pinch of kosher salt', 'To serve:', 'Prepared lemon curd, store-bought or homemade', 'Special equipment:', '10-inch springform pan']",16,"['1 Prepare the oven and baking sheet: Preheat the oven to 350\\xc2\\xb0F. On a baking sheet place a sheet of aluminum foil large enough to wrap around the outside of the springform pan. Set it aside.', '2 Make the crust: To make the crust, place the cookies into the bowl of a food processor and process until you get fine, even crumbs. Mix the cookie crumbs with the melted butter, sugar, and kosher salt until you get the consistency of wet sand, and the mixture clumps together when squeezed in the palm of your hand.', 'Press the crust mixture into the bottom of a 10-inch springform pan in an even layer. You can either keep the crust layer only on the bottom, or on the bottom and pressed up against the sides. It is totally up to you!', 'Bake for 15 minutes. Remove from the oven and set on a cooling rack while you prepare the cheesecake filling.', '3 Reduce the heat and create a steam bath: Turn the oven down to 325\\xc2\\xb0F. Place a 9x13-inch baking dish on the lower rack of the oven and fill with boiling water; this will create a steamy environment for the cheesecake to bake.', '4 Make the batter: In the bowl of a stand mixer (or using a mixing bowl and hand mixer) beat the cream cheese until smooth and creamy, scraping the sides of the bowl a few times so there are no lumps of firm cream cheese. Beat in the sugar, lemon zest, and salt, then scrape down the sides.', 'Beat in the eggs one at a time, mixing until each egg is combined and scraping down the sides and bottom of the bowl after each addition. Resist the urge to whip the mixture too much; just beat in each egg until mixed well\\xe2\\x80\\x94over-beating can pull too much air into the batter, resulting in a cracked cheesecake.', '5 Add the sour cream and spread the filling over the crust: On low speed, beat in the sour cream until just combined. Spread the cheesecake filling into the pre-baked crust.', '6 Bake the cheesecake: Put the cheesecake onto the foil-lined baking sheet. Press the foil up and around the outside of the springform pan.', 'Place the baking sheet with the cheesecake on it, on the center rack of the oven, above the pan of hot water, for 1 hour or until the cheesecake appears set and dry on top but still jiggles in the center like Jello.', '7 Allow the cheesecake to cool slowly: Turn off the oven and allow the cheesecake to cool for 60 minutes with the oven door closed.', 'Crack open the oven door (place a wooden spoon between the door and the frame of the oven to keep it just cracked) and allow the cheesecake to cool for an additional 45 minutes before removing from the oven to cool on a baking rack, until it reaches room temperature.', 'The cheesecake may have domed slightly while baking but should deflate to a flat top with a small ridge around the edge, as it slowly cools.', ""Remove the foil once the cheesecake has cooled to room temperature (anytime after the cheesecake has pulled away from the edges of the pan and it's cool enough to handle)."", '8 Transfer to the refrigerator: Once the cheesecake is at room temperature, transfer it to the refrigerator to chill for at least 6 hours before serving.', '9 Top with lemon curd and serve: To create the petal pattern as shown in the photos, pipe or dollop small blobs of curd in a ring around the perimeter of the cheesecake, leaving about 1/2-inch border.', 'Using an offset spatula or the back of a teaspoon, gently smash and drag the blobs toward the center of the cheesecake. If you have leftover lemon curd, serve the rest when you slice the cheesecake.']",17
641,Classic Coffee Cake Recipe,25,55,80,"['For the streusel topping:', '1 cup (150g) brown sugar, packed', '1 cup (96g) all-purpose flour', '1 teaspoon ground cinnamon', 'Pinch of kosher salt', '1/2 cup (113g) unsalted butter, very soft', 'For the cinnamon layer:', '1/4 cup (50g) sugar', '1 tablespoon all-purpose flour', '1/2 teaspoon ground cinnamon', 'For the cake batter:', '3 cups (384g) all-purpose flour', '2 1/4 cups (450g) sugar', '3/4 teaspoon baking powder', '1/2 teaspoon baking soda', '1/2 teaspoon kosher salt', '1 cup (227g) unsalted butter, very soft', '1 cup (227g) sour cream', '1/4 cup whole milk', '4 large eggs', '1 tablespoon vanilla extract']",21,"['1 Heat the oven and prepare the pan: Preheat the oven to 350\\xc2\\xb0F and butter or spray a 9x13 inch pan.', '2 Make the streusel layer: In a small bowl combine flour, brown sugar, cinnamon, and salt. Use a fork to mash the butter into the mixture until completely combined and crumbly.', '3 Make the cinnamon layer: In another small bowl, combine sugar, flour, and cinnamon. Set both to the side.', '4 Begin making the batter: In the bowl of your mixer, add flour, sugar, baking powder, baking soda, and kosher salt. Using the paddle attachment for your stand mixer, stir on low to combine.', 'Add the softened butter and beat on medium-low speed for 2-3 minutes, or until all of the butter is mixed in and the mixture resembles moist sand.', ' 5 Combine wet ingredients and finish the batter: In a medium bowl, whisk together the sour cream, milk, eggs, and vanilla until combined. Add the mixture to the dry ingredients. Beat the batter on medium speed until you get a smooth batter. A few small lumps are totally fine.', '6 Prepare the cake: Spread half of the batter into the prepared pan. Sprinkle the cinnamon-sugar layer over the top of the batter in an even layer. Spread the remaining batter over the top (this does require some patience since the batter likes to lift off the cinnamon-sugar layer). Top the final layer of batter with the crumble mixture.', '7 Bake the cake: Bake for 55 minutes or until a toothpick inserted in the center comes out clean. Cool on a rack for 1 hour (or until the cake comes to room temperature) before serving.', '8 Store the cake: You can make this cake a day or two in advance. Remove the cake from the pan and cover with plastic wrap. Keep it on the counter.  To freeze the cake, wrap it in plastic, followed by foil.']",9
642,How to Make Homemade Chocolate Truffles Recipe,10,155,165,"['Basic truffle ingredients', '8 ounces of semi-sweet or bittersweet chocolate (high quality, 62% cacao or higher), well chopped into small pieces', '1/2 cup of heavy whipping cream', '1 teaspoon of vanilla extract', 'Optional base flavorings:', 'Mint leaves (1 bunch, stems removed, chopped, about 1 cup)', 'Cinnamon and cardamon (1 cinnamon stick, 2 cardamom pods)', 'Amaretto (1-2 tablespoons)', 'Almond extract (1 teaspoon)', 'Truffle coatings', 'Cocoa powder', 'Finely chopped walnuts', 'Finely chopped almonds']",13,"['1 Heat cream to a simmer: In a small, heavy saucepan bring the heavy whipping cream to a simmer (stir and scrape down the sides with a spatula every few minutes).', 'If you are using one of the other recommended flavorings, stir it in with the cream (and ignore vanilla in the next step). If adding mint or other solids, after the cream simmers, remove from heat and let seep for an hour. Then strain away solids, and return the cream to a simmer and proceed with recipe.', '2 Make chocolate base: Place the chocolate in a separate bowl. Pour the cream over the chocolate, add the vanilla, and allow to stand for a few minutes then stir until smooth. (This chocolate base is called ganache.)', '3 Refrigerate for 2 hours: Allow to cool, then place in the refrigerator for two hours.', '4 Roll into balls and chill overnight: Use a teaspoon to roll out balls of the ganache. Roll in your hands quickly (as it will melt from the heat of your hands) and place on a baking sheet lined with parchment paper. Place in the refrigerator overnight.', '5 Roll in cocoa powder: Roll in cocoa powder or chopped nuts and serve. If not using right away, keep the coated truffles covered in the refrigerator for up to 4 days. For the best flavor and texture, let the refrigerated truffles come back to room temperature before serving.']",6
643,Swedish Meatballs Recipe,20,60,80,"['Meatballs:', '1 Tbsp butter', '1/2 large yellow or white onion, peeled, grated (use the large holes of a box cheese grater)', '1/4 cup milk', '3 slices of bread, crusts removed, bread cut into cubes (2 cups of cubed bread)', '1 large egg', '3/4 pound ground beef', '1/2 pound ground pork', '1 teaspoon kosher salt', '1 teaspoon black pepper', '1/2 teaspoon freshly ground nutmeg', '1/2 teaspoon ground cardamom', 'Sauce:', '3 Tbsp butter', '3 Tbsp flour', '2 cups beef stock', '1/4 cup sour cream (use full-fat sour cream or the sauce may curdle)', 'Salt and pepper', '2 Tbsp of Lingonberry, red currant, raspberry or cranberry jelly, less or more to taste (optional)']",19,"['1 Soak bread in milk, shred: Place the cubed bread in a large bowl and mix with the milk. Let sit for 5 to 10 minutes for the bread to absorb all of the milk. Once the bread has soaked up the milk, shred with the tines of a fork or by hand.', '2 Saut\\xc3\\xa9 grated onion: Melt the butter in a saut\\xc3\\xa9 pan on medium-high heat. Stir in the grated onion and cook until translucent and softened, 3-4 minutes. Remove from heat and let cool for a minute.', '3 Make meatball mixture with bread, onions, eggs, meat, spices: Stir the cooled onions into the milk bread mixture. Add the eggs, ground pork and beef, salt, pepper, nutmeg, and cardamom. Use your (clean) hands to mix everything together until well combined.', '(If you have extra time, chilling the mixture for 20 minutes or so will make it easier to roll out the meatballs.)', '4 Form meatballs: Use your hands to form the mixture into meatballs about 1 1/4-inch to 1 1/2-inch wide and place them on a plate or sheet pan. This recipe should make about 40 meatballs. Note that the meatballs will be a bit on the wet side.', '5 Brown meatballs on all sides: Heat 3 Tbsp of butter in a large saut\\xc3\\xa9 pan on medium heat. When the butter is melted and foamy, start adding some meatballs to the pan.', 'Working in batches as to not crowd the pan, slowly brown the meatballs on all sides. Use a spoon or tongs to turn them. Handle the meatballs gently so they do not break apart as you turn them.', ""   Once the meatballs have browned on all sides and are just cooked through, remove them from the pan to a bowl. You'll warm the meatballs in the sauce later."", 'Once you have removed the meatballs from the pan, wipe out the butter and browned and blackened bits with a paper towel and rinse out the pan.', ""We'll want to start with fresh butter because that way we won't pick up any burnt bits from the pan, and we will be able to more accurately gauge the amount of fat in the pan for making the meatball sauce in the next step."", '6 Make a roux: To make the sauce, first make the roux. Add 3 Tbsp of fresh butter to the pan. Heat the butter in the pan on medium heat until it melts and starts to bubble up.', 'Slowly whisk in 3 Tbsp of flour. Stir until smooth. Continue to stir, allowing the flour mixture to cook, several minutes, until the roux is the color of coffee-with-cream.', '   7 Add stock to roux to make sauce: When the roux has cooked to a lovely shade of light brown, slowly add the stock to the roux, stirring as you add the stock.', 'The stock will sputter at first and the roux may seize up, but keep adding the stock slowly and keep stirring. Eventually the sauce will loosen and become silky.', '8 Stir in sour cream and jelly if using: Remove the pan from heat and stir in the sour cream. If you are including jelly, either stir it in now or serve it on the side. Taste for seasonings and add more salt and pepper to taste (I use about 1/2 teaspoon of kosher salt, and 1/4 teaspoon of pepper.)', '9 Add meatballs to sauce: Return the meatballs to the pan with the sauce and cook on low heat to warm the meatballs through for a few minutes.', '10 Serve: Serve over mashed potatoes or egg noodles. Or serve individual Swedish meatballs dipped in gravy as an appetizer.']",17
644,Thumbprint Cookies Recipe,10,45,55,"['1 cup unsalted butter (2 sticks or 8 ounces), room temperature', '1/2 cup sugar', '2 large eggs, room temperature', '1 teaspoon vanilla extract', '1/4 teaspoon salt', '2 cups all-purpose flour', '1 cup chopped nuts (optional)', '3/4 cup jam, any kind']",8,"['1 Make the cookie dough: Beat the butter and sugar on high speed with an electric mixer for about 3 minutes.', 'Separate the eggs. Add the yolks and vanilla extract to the butter mixture. Set aside the egg whites in a separate shallow bowl.', 'Add the flour and salt to the mixing bowl and mix until just combined.', '2 Chill the dough: Place the dough in the fridge and chill for 30 minutes.', '3 Preheat the oven to 350F. Line two baking sheets with parchment paper.', '4 Roll the cookies: Roll the dough into balls about 1 inch in diameter. Place the balls on the parchment-lined cookie sheets spaced a few inches apart.', 'If using nuts, whisk the reserved egg whites until frothy. Dip the dough balls into the egg whites and then roll them into the nuts until covered. Arrange them on the baking sheets a few inches apart.', '5 Add the jam: Press down on each ball of dough with your thumb to make a small well in the center of the cookie. Do not press too hard or the cookie will fall apart. Fill with 1/2 teaspoon of jam.', '6 Bake and cool: Bake for 12 to 15 minutes or until slightly firm. Allow to cool for a few minutes on the cookie sheet to firm up before moving them to a wire rack to finish cooling.']",9
645,Best Holiday Fruitcake Recipe,15,120,135,"['1 teaspoon baking soda', '1 cup sour cream', '1 cup chopped dates', '2 cups raisins', '1/2 cup chopped glazed cherries (can sub dried sweetened cranberries)', '1 cup chopped walnuts', '2 cups all-purpose flour (divided into 1/4 cup and 1 3/4 cups)', '1/2 cup butter (1 stick)', '1 cup granulated sugar', '1 large egg, room temperature', 'Grated rind of one orange', '1 teaspoon salt', '1 to 2 ounces Brandy (optional)']",13,"['1 Preheat oven, prepare loaf pan: Preheat oven to 325\\xc2\\xb0F. Line a 9x5-inch loaf pan with greased parchment paper or brown baking paper, cut to fit the pan.', 'Place one piece to run the length of the pan and stand up above the rim about an inch. Place the other piece or pieces to cover the other sides. When the cake comes out of the oven, you can easily remove it by holding the sides of the paper and lifting the cake out of the pan.', '2 Mix together sour cream and baking soda: In a small bowl, mix together the baking soda and sour cream; set aside.', '3 Toss the fruits and nuts with flour: Combine the dates, raisins, cherries, and nuts with 1/4 cup of the flour and toss to coat the fruit and nuts. Set aside.', '4 Make the fruitcake batter: Beat together the butter and sugar until fluffy. Mix in the egg, then the orange rind, then the sour cream/baking soda mix.', 'Add the flour and the salt and mix together. Combine fruit/nut mixture with creamed ingredients and mix well to distribute the fruit and nuts evenly.', '5 Bake the fruitcake: Pour batter into a prepared 5x9-inch loaf pan.', 'Place the batter-filled pan into the preheated oven. Place a separate pan of water in the oven either on a rack underneath the fruitcake or beside it. (The water will help with a more even, gentle cooking.)', 'Bake at 325\\xc2\\xb0F for 1 1/2 to 2 hours, or until a wooden skewer inserted into the center comes out clean. Water may need to be replenished during baking.', '6 Cool on a rack: Remove to a rack to cool for 5 minutes. Use the edges of the parchment paper to lift the cake out of the pan. Let cool completely.', 'Wrap tightly with plastic wrap and then aluminum to store. If you want, you can poke a few holes over the top of the cake and sprinkle on a few ounces of brandy or bourbon, especially if you would like to store the fruit cake for a while.']",11
646,Classic Stuffed Mushrooms Recipe,20,20,40,"['18 to 24 button or cremini mushrooms, scrubbed clean, stems separated from the caps, stems finely chopped', '1 tablespoon butter', '2 small shallots, minced, about 2 tablespoons', '1 large garlic clove, minced', '2 tablespoons chopped walnuts', 'Salt', '2 tablespoons chopped parsley', '1 teaspoon Herbes de Provence or dried thyme', '2 tablespoons breadcrumbs', '2 tablespoons sherry or chicken stock', '2 tablespoons extra virgin olive oil', '2 tablespoons grated Parmesan cheese']",12,"['1 Preheat oven to 375\\xc2\\xb0F (190\\xc2\\xb0C).', '2 Make filling: Heat 1 tablespoon butter in a small frying pan over medium-high heat. Saut\\xc3\\xa9 the chopped mushroom stems and the shallots for 4 to 5 minutes, stirring often. Add the garlic and walnuts and sprinkle with salt. Stir well and saut\\xc3\\xa9 2 more minutes.', 'Turn off the heat and add the parsley, herbes de Provence and breadcrumbs. Pour the sherry into a food processor, then the rest of the stuffing. Pulse several times to get a fine mixture, almost a paste.', '3 Stuff mushroom caps: Toss the mushroom caps with olive oil. Fill each mushroom with the stuffing, and place on a baking sheet. Sprinkle grated parmesan cheese over each mushroom.', '4 Bake: Bake for 10 to 20 minutes at 375\\xc2\\xb0F (190\\xc2\\xb0C), or until the cheese browns a little and a little water starts to pool at the base of each mushroom. Allow to cool for 5 minutes or so before serving.']",5
647,Candy Cane Cookies Recipe,20,188,208,"['1 cup (2 sticks, 8 ounces) unsalted butter, at room temperature', '1 cup (200 g) granulated sugar', '1 1/2 teaspoons peppermint extract', '1 teaspoon vanilla extract', '1 teaspoon baking powder', '1/2 teaspoon kosher salt', '1 large egg', '2 3/4 cup (385 g) all-purpose flour', '1 teaspoon liquid red food coloring', 'To finish:', '1 egg white', '2 tablespoon sparkling sugar']",12,"['1 Make the dough: Place the butter, sugar, peppermint, vanilla, baking powder, and salt in the bowl of stand mixer. Beat until a paste forms and clings to the side of the bowl.', 'Scrape down the side of the bowl and beat in the egg until it is absorbed. Add the flour and beat until just combined and no more dry streaks of flour remain.', '2 Color half the dough: Divide and remove half the dough from the bowl. Carefully add the red food coloring to the remaining dough. Mix on low until the color is evenly distributed.', '3 Chill the dough: Pat each piece of dough into a disk, wrap in plastic wrap, and refrigerate for at least 3 hours or overnight.', '4 When ready to bake, preheat the oven to 350\\xc2\\xbaF. Line a baking sheet with parchment paper or silicon baking mat.', ""5 Shape the cookies: The chilled dough should be firm, but still easy to shape straight from the fridge. If not, let it warm for just a few minutes until malleable. Don\\'t let it warm too much or it will be too soft to work with again."", 'Pinch off a 1-inch round piece of the white dough and roll it out to a 5-inch rope. Do the same with a piece of the red dough (make sure the ropes are the same length).', 'Place the ropes next to each other and twist together. Transfer to the baking sheet and curve the top of the dough into a candy cane shape.', 'Repeat with the remaining dough, spacing the cookies about 2 inches apart.', '6 Top the cookies with sparkling sugar: Make the egg white wash by beating the egg white with 1 tablespoon of water until foamy. Brush the top of each cookie with the egg white wash and then sprinkle with the sugar.', '7 Bake the cookies: Bake in the oven for 8 to 10 minutes or until the edges are just barely brown. Let cool on the baking sheet for 10 minutes before moving to a wire cooling rack.', 'These cookies will keep for a week or two in a sealed container at room temperature.']",12
648,Duchess Potatoes Recipe,10,45,55,"['2 pounds potatoes (Yukon Golds work best), peeled and cut into chunks', 'Salt', '1/4 cup heavy cream', '4 tablespoons unsalted butter, divided', '1/4 teaspoon nutmeg', '1/2 teaspoon black pepper', '3 egg yolks']",7,"['1 Boil the potatoes: Place potatoes in a medium to large pot (3 qt) and cover with a couple inches of cold water. Add a couple teaspoons of salt to the water. Bring to a simmer and cook until the potatoes are tender (the tines of a fork easily pierce), about 20-25 minutes.', '2 Melt butter, preheat oven: While the potatoes are boiling, melt 2 tablespoons of butter and set aside. You will use this butter to coat the potatoes right before they go in the oven. Preheat the oven to 425\\xc2\\xb0.', '3 Drain potatoes and let them release steam: When the potatoes are cooked, drain in a colander and put the potatoes back in the pot set over low heat. Allow them to release steam for a minute or so.', '4 Mash with butter, then with spices and cream, then with salt and egg yolks: Add 2 tablespoons of butter and mash the potatoes until the butter has been incorporated. Add the nutmeg, black pepper, heavy cream and continue mashing the potatoes.', 'Once everything is incorporated, add salt to taste and the egg yolks.', 'Continue to mash until the mixture is smooth. Do not over-mash or your potatoes will end up with a gluey consistency.', '5 Pipe onto a baking sheet, brush with melted butter: Using a piping bag with a large star point, pipe the potatoes onto a cookie sheet. Alternatively, you can just fill a casserole dish with the mashed potatoes, and use a fork to create lots of peaks on the surface.', 'The swirled edges from the star-point piping bag forms or the peaks of mashed potatoes in a casserole dish will brown nicely in the oven. The browned parts taste great, so you want to maximize them.', 'Whether you make piped portions or a casserole, paint the potatoes with the melted butter.', '6 Bake: Bake in the 425\\xc2\\xb0F oven until nicely browned, about 20 minutes.']",10
649,Cheddar Cheese Puffs Recipe,5,45,50,"['1 stick butter (8 Tbsp or 4 ounces)', '1 cup water', '1/2 teaspoon salt', '1 cup all purpose flour', '4 large eggs', '1 cup (4 ounces) grated sharp cheddar cheese', '2 teaspoons chopped fresh thyme (or rosemary)', 'Freshly ground pepper']",8,"['1 Boil the water, butter, salt: In a medium sized saucepan, add the water, butter, and salt, and bring to a boil over high heat.', '2 Add the flour and stir: Reduce the heat to medium and add the flour all at once. Stir rapidly. The mixture will form a dough ball that will pull away from the sides of the pan.', 'It helps to use a wooden spoon to stir as the dough will be rather thick. Continue to cook for a couple minutes.', '3 Let cool a couple minutes, then add eggs, one at a time: Remove the pan from the heat and let cool for a couple of minutes. Stir so that the dough cools more evenly. You want the dough to be warm, just not so hot that when you start adding eggs they cook as they hit the dough.', 'Add the eggs one at a time, stirring after each addition until the eggs are incorporated into the dough. (Do this part in a mixer if you want, or by hand with a wooden spoon.) The dough should become rather creamy.', '4 Stir in the grated cheese, thyme, and a few grinds of pepper.', '5 Scoop spoonfuls onto lined baking sheet: Heat oven to 425\\xc2\\xb0F. Spoon out small balls (about a heaping tablespoon) of the dough onto a silicone or parchment lined baking sheet, with at least an inch separating the spoonfuls.', '6 Bake: Place in oven and cook for 10 minutes at 425\\xc2\\xb0F. Lower heat to 350\\xc2\\xb0F and cook for another 15-20 minutes, until puffed up and lightly golden.']",8
650,Gingersnap Cookies Recipe,15,730,745,"['8 oz unsalted butter', '1 1/4 cup + 2 tablespoons granulated sugar', '1/2 teaspoon vanilla extract', '2 small eggs or 1 1/2 large eggs', '1/3 cup molasses', '3 cups all-purpose flour', '2 1/2 teaspoon baking soda', '1/2 teaspoon salt', '2 1/2 teaspoons cinnamon', '2 1/2 teaspoons ground ginger', '1/8 teaspoon finely ground black pepper']",11,"['1 Beat butter, add sugar, add vanilla, eggs, add molasses: Beat the butter until soft; add sugar, and beat until light and fluffy.  Add vanilla and eggs, and beat until fluffy.  Add molasses and beat until well-mixed.', '2 Whisk together dry ingredients: Vigorously whisk together the dry ingredients (flour, baking soda, salt, cinnamon, ground ginger, finely ground black pepper) in a bowl.', '3 Add dry ingredients to wet ingredients: Add flour mixture to the butter/sugar/egg mixture, 1/3 at a time.  Mix only until the dry ingredients become incorporated.', '4 Press into lined loaf pan, freeze: Line a 9"" x 5"" loaf pan with plastic wrap, so that some hangs over the outsides.  Press the dough into the bottom of the pan.  Pack it tightly, and try to make the top as level as possible.  Cover the dough with the plastic overhangs.  Freeze until very firm, preferably overnight.', '5 Thinly slice from frozen dough: Unwrap and remove dough from the pan.  Slice brick into thin slices, no more than 1/8"".', '6 Bake: Working in batches, place thin slices on a parchment or a Silpat-lined sheet pan (space at least an inch apart) and bake at 350\\xc2\\xb0F until the edges turn dark brown, 7-12 minutes, depending on how thinly you have sliced the dough. Check the oven for doneness at 7 minutes.']",6
651,Holiday Pinwheel Cookies Recipe,30,250,280,"[' 1 1/4 cup (250 g) white granulated sugar', '1 cup (225 g or 2 sticks) unsalted butter, at room temperature', '1 teaspoon vanilla extract', '1/2 teaspoon baking powder', '1/2 teaspoon salt', '1 large eggs', '3 cups (420 g) all-purpose flour', '1/2 teaspoon liquid red food coloring', '1/2 teaspoon raspberry extract']",9,"['1 Beat the butter and sugar: Place the sugar, butter, vanilla, baking powder, and salt in the bowl of stand mixer fitted with a paddle attachment. Beat the ingredients together until the batter is creamy, light in color, and clings to the side of the bowl, about 2 minutes on medium speed.', '2 Add the egg: Scrape down the side of the bowl and add the egg. Mix until incorporated.', '3 Add the flour: Add the flour and mix it into the dough on low speed until no more streaks of flour remain.', '4 Divide and color the dough: Scrape the dough out onto a clean surface and divide in half. Set one half aside. Place the other half back in the bowl, and add the red food coloring and raspberry extract. Mix until incorporated and uniform in color.', 'Divide each half of the dough in half again \\xe2\\x80\\x93 you should have 4 balls of dough, two plain and two raspberry. Roughly shape each ball into a square or rectangle, and tightly wrap each square in plastic wrap.', '5 Refrigerate the dough for at least 30 minutes, or up to a day, to let the dough firm.', ""6 Roll out the dough: Remove one piece of dough, unwrap it, and place on a piece of wax paper or parchment paper. Place another piece of wax paper or parchment paper on top, and roll the dough into a 6 x 12 rectangle. If the dough is too hard to roll out, let it soften for a few minutes until it's easier to roll."", ""As you roll the dough, occasionally flip it over. If the parchment paper has become wrinkled, unpeel it from the dough and reapply (so you don't get wrinkles in your dough)."", 'When done, transfer the rolled-out dough to a baking sheet, still sandwiched between sheets of paper. Repeat with the remaining 3 pieces of dough, stacking the sheets of dough on top of each other on the baking sheet.', '7 Once all four pieces of dough are rolled out, place the cookie sheet with the dough in the freezer for 15 minutes. The dough should be firm, but not frozen through.', '8 Sandwich together the vanilla and raspberry doughs: Remove one of the sheets of vanilla dough and one of the sheets of raspberry dough from the freezer. Peel back the top paper on both.', ""Carefully flip the raspberry dough onto the vanilla dough so they are sandwiched together (vanilla on bottom, raspberry on top \\xe2\\x80\\x93 the colors are reversed in the photos below, but they'll give you the general idea!). Peel away the remaining paper from the raspberry dough."", 'Trim the edges so the two sheets of dough line up. Carefully roll the dough from the long edge to make a 12-inch long log of dough, peeling away the bottom layer of parchment as you go.', '9 Repeat with remaining dough: Repeat this sandwiching and rolling process, but this time put the raspberry layer on the bottom so that when you roll the dough, the raspberry dough is on the outside.', '10 Chill the logs of dough: Wrap each log of dough tightly in the parchment paper or plastic wrap. Chill in the fridge for 2 hours or overnight. (Or freeze for up to a month.)', '11 Heat the oven to 350\\xc2\\xbaF and line a baking sheet with a piece of parchment paper or silicon baking mat.', '12 Slice the cookies: Remove the chilled dough from the fridge. The bottom of the dough will be slightly flat from where it was resting in the fridge. To smooth this out, gently roll the log against the counter with your hands until the edges are smooth again.', 'Slice the dough into slice 1/4- to 1/2-inch thick. Place them the baking sheet about an inch apart.', '13 Bake for 10 to 12 minutes or until the cookies start to brown ever so slightly on the edges.', 'Transfer baked cookies to a wire rack to cool. Repeat with slicing and baking the remaining dough. Store in an airtight container for up to 3 days.']",20
652,Stained Glass Cookies Recipe,60,70,130,"['1/2 cup (1 stick) butter', '1/2 cup white granulated sugar', '1/4 cup brown sugar', '1 tablespoon molasses', '1/2 teaspoon vanilla extract', '1 egg', '2 cups flour', '1/4 teaspoon salt', '3/4 teaspoon baking powder', '30-40 hard candies (such as Life Savers), preferably in several flavors/colors']",10,"['1 Preheat oven, prepare baking sheets: Pre-heat oven to 375\\xc2\\xb0F. Line two baking sheets with parchment paper or Silpat.', '2 Beat butter, sugars, then add molasses, vanilla, then egg: Using an electric mixer, beat together butter, white sugar, and brown sugar until fluffy, about 2 minutes. Beat in the molasses and vanilla extract. Add egg and beat on medium speed until light and smooth.', '3 Whisk together dry ingredients, add to wet: In a separate bowl, whisk together the flour, salt, and baking powder. Add dry ingredients to wet ingredients a third at a time, mixing until the flour is just incorporated.', '4 Chill the dough: Divide the dough in half and flatten into two disks. Wrap disks in plastic wrap and refrigerate at least an hour and up to 2 days.', '5 Crush candies: Remove any plastic wrapping on the hard candies. Sort the hard candies by color and place them into separate plastic bags. Crush the candies with a mallet or hammer.', '6 Roll out dough: Place one of the dough disks between two large sheets of waxed paper and use a rolling pin to roll out to an even thickness of 1/4-inch', '.', '7 Cut shapes with cookie cutters: Use cookie cutters to cut the dough into forms. Transfer the cookies to a prepared baking sheet, placing them about 1 inch apart from each other. Using a smaller cookie cutter of similar shape or a knife, cut shapes into centers of cookies. (You can use the centers for extra dough.)', '8 Sprinkle crushed candies into cookie centers: Sprinkle the crushed candy into the empty centers of the cookies, filling them to the edges. Try to keep the candy within the centers. Any candy specks that fall on the cookie will color the cookie.', '9 Poke hole if using for decorations: If you plan on using the cookies as decoration, to be hung as an ornament, poke a small hole in the top of each cookie before baking.', '10 Bake: Bake at 375\\xc2\\xb0F for 9 to 10 minutes. The candy should be bubbly and the cookies just barely beginning to brown. Remove baking sheets from oven and place on wire racks to cool.', 'Allow cookies to cool on pans at least 10 minutes; otherwise, the candy centers may separate from the dough. When cookies are completely cooled, remove and store in an airtight container.', 'String with ribbon if you want to hang as an ornament.']",13
653,Soft and Chewy Lemon Cookies Recipe,10,72,82,"['For the cookies:', '3/4 cup (170g or 1 1/2 sticks) unsalted butter, room temperature', '1/4 cup (60g) cream cheese, room temperature', 'Zest of 1 medium lemon', '2 teaspoons lemon extract', '1/2 teaspoon vanilla extract', '1 cup (200g) granulated white sugar', '1/4 cup (55g) packed light brown sugar', '1/4 teaspoon kosher salt', '1 large egg', '1/4 cup lemon juice, from 1 medium lemon', '2 1/2 cups (350g) all-purpose flour', '1/8 teaspoon baking soda', 'To finish:', '1/2 cup (100 g) granulated white sugar', 'Special equipment:', 'Medium cookie scoop, optional (this tool makes it much easier to scoop this soft dough)']",17,"['1 Beat the butter and sugar together: Place the softened butter, cream cheese, lemon zest, lemon extract, vanilla extract, both sugars and salt in the bowl of a stand mixer fit with a paddle attachment. Beat the ingredients together until the butter is light, fluffy, and clings to the side of the bowl.', '2 Beat in the egg and lemon juice: Add the egg and beat to incorporate. Scrape down the sides of the bowl with a spatula. Add the lemon juice and mix to incorporate, about a minute. The batter may look \\xe2\\x80\\x9cbroken\\xe2\\x80\\x9d but don\\xe2\\x80\\x99t worry about that. Again scrape down the sides of the bowl.', '3 Mix in the flour: Add the flour and baking soda. Mix on low speed until the dry ingredients are mostly absorbed, then increase the speed for a few seconds until fully incorporated.', '4 Cover the bowl and chill the dough in the fridge for at least 1 hour, or overnight. This makes the sticky, soft dough easier to roll out.', '5 Heat the oven to 375\\xc2\\xb0F: Line a baking sheet with a silicon baking mat or parchment.', '6 Roll the cookies: Use a cookie scoop or a tablespoon measure to scoop up a heaping tablespoon dough. Lightly roll the dough in the palms of your hands to form a ball roughly 1 1/2 inches in diameter, about the size of a ping-pong ball. If the dough is too sticky to work with even after chilling, wet your hands, dry them slightly with a paper towel, and try rolling again with damp hands.', 'Roll the dough in the granulated white sugar and place on the baking sheet. Repeat, leaving about 2 inches between each ball.', 'Using the flat bottom of a glass, press down and form thick disks, about 2 inches wide. If the dough starts sticking to the bottom of the glass, dip the glass in the sugar before continuing. Sprinkle some extra sugar over each cookie.', '7 Bake 12 to 15 minutes, or until the edges of the cookie are starting to turn golden brown. Let cool for 10 minutes on the baking sheet, then use a very thin spatula (like a fish spatula) to transfer the cookies to a wire rack to cool completely.', 'Store in an airtight container for up to 3 days at room temperature.']",10
654,White Chocolate Cranberry Cookies Recipe,20,72,92,"['1 cup of brandy (enough to soak the cranberries in, then saving 1 1/4 teaspoons of it for later)', '1 cup of dried cranberries', '1 cup (two sticks) of butter, room temperature', '3/4 cup of granulated sugar', '3/4 cup of lightly packed brown sugar', '2 eggs, room temperature', '1/2 teaspoon of vanilla extract', '1 teaspoon of baking soda', '1 teaspoon of salt', '2 1/4 cups of all-purpose flour', '1 cup of white chocolate chips']",11,"['1 Soak the dried cranberries: Put the cranberries in a wide and shallow bowl. Add enough brandy to surround the cranberries. Cover and aside for 1 hour. Strain out the plumped cranberries, reserving remaining brandy.', '2 Preheat oven to 375\\xc2\\xb0F.', '3 Beat butter and sugars: Beat the butter until light and fluffy. Add the sugars and beat again until light, fluffy and well incorporated.', '4 Add the eggs, vanilla extract, and add 1 1/4 teaspoons of the brandy that the cranberries soaked in (as for the rest, I suggest popping it in a glass and topping it off a bit for yourself). Beat well until light and fluffy. Scrape down the sides of the bowl midway through to ensure even mixing.', '5 Whisk dry ingredients, add to wet: Whisk together the flour, baking soda, and salt, then add to the mixture a bit at a time, beating until just mixed.', '6 Fold in the brandy soaked cranberries and white chocolate chips. Let chill for 15 minutes in the fridge.', ""7 Spoon out dough onto lined baking sheet: Line a baking sheet with parchment paper (a baker's best friend) and place rounded spoonfuls down on the sheet."", '8 Bake: Bake at 375\\xc2\\xb0F for 10-12 minutes or until golden brown. Let cool for a minute, then transfer to a wire rack to cool completely.', ""*I find that adding the baking soda separately seems to form softer cookies. This is how my mom and grandmother taught me, and if there is actual science behind it, I'm not aware but it seems pretty consistent, and it won't ruin the cookies if you try it this way.""]",9
655,Simple Cut-Out Sugar Cookies Recipe,30,200,230,"['Cookie:', '1 1/2 cups sifted confectioners sugar', '1 cup unsalted butter, room temperature', '1 large egg', '1 teaspoon vanilla extract', '1/2 teaspoon almond extract', '2 1/2 cups sifted all-purpose flour', '1 teaspoon baking soda', '1 teaspoon cream of tartar (a dry acid sometimes used in baking)', 'Icing:', '2 cups confectioners sugar, sifted', '1/2 teaspoon almond extract', '1/4 cup milk', 'Food coloring']",14,"['1 Make the cookie dough: Beat the butter and sugar together for 1 minute. Add egg, vanilla and almond extract, beat until incorporated. Combine dry ingredients and add to batter, stirring to blend.', '2 Chill the dough: Divide dough in half, form 2 balls. Wrap and refrigerate for at least 3 hours.', '3 Roll out the dough and cut out shapes with cookie cutters: Using a rolling pin, roll out dough (about 1/2 of one dough ball at a time) on a lightly floured surface to about 1/8"" thickness. Dip cookie cutters into flour; cut out shapes.', '4 Bake: Place cookies on silpat lined or lightly greased cookie sheets. Bake at 375\\xc2\\xb0F for 7-8 minutes.', '5 Make the icing: Combine the sugar, almond extract and just enough milk (about 1/4 cup) to make the frosting the consistency of thin glue. Pour icing into shallow bowls wide enough for dipping cookies. Add food coloring.', '6 Decorate the cookies: To decorate, dip the topside of each cookie into the icing. Remove quickly and let icing drip of excess back into the icing bowl. Let dry. Pour additional colored frosting into pastry piping, or use a plastic sandwich bag with the tip of one corner nicked off. Gently squeeze frosting on to cookies in whatever patterns you choose.']",6
656,White Chocolate Macadamia Nut Cookies Recipe,15,15,30,"['1 1/4 cups all-purpose flour (160 g)', '1/4 teaspoon salt', '1/2 teaspoon baking powder', '1/2 cup unsalted butter (1 stick, or 8 Tbsp, or 112g) at room temperature', '1/2 cup white sugar (90 g)', '1/2 cup dark brown sugar, packed (85 g)', '1 large egg', '1 teaspoon vanilla extract', '1/2 teaspoon instant coffee granules or instant espresso powder', '1/2 cup chopped macadamia nuts (3 1/2 ounces, or 100 g)', '1/2 cup white chocolate chips']",11,"['1 Preheat the oven to 350\\xc2\\xb0F (175\\xc2\\xb0C).', '2 Whisk dry ingredients: Vigorously whisk together the flour, salt and baking powder in a bowl and set aside.', '3 Make cookie dough: Beat the butter until fluffy. Add the brown and white sugars and beat until smooth. Beat in the egg. Add the vanilla extract and instant coffee and beat until creamy.', 'Add the dry ingredients a third at time, mixing after each addition.', 'When the batter is combined, fold in the nuts and chocolate chips with a wooden spoon.', '4 Place on baking sheet: Drop the cookie dough by heaping tablespoon amounts on a greased baking sheet, place 2 inches apart from each other to allow enough room for the cookies to spread as they bake.', '5 Bake: Bake at 350\\xc2\\xb0F (175\\xc2\\xb0C) for 9 to 11 minutes, or until the edges are nicely browned and the center is just barely cooked.', '6 Cool: Take the cookies from the oven and let rest for 5 minutes, then move them to a rack to cool completely.']",8
657,Apple Cranberry Chutney Recipe,10,25,35,"['2 good cooking apples (2 cups, peeled and chopped)', '1 cup fresh or frozen cranberries', '1/2 cup chopped onion', '1/4 cup cider vinegar', '1/3 to 1/2 cup of brown sugar', '1 Tbsp orange zest', '1 Tbsp freshly grated ginger', '1 1/2 teaspoon cinnamon', 'Small pinch of ground clove']",9,"['Put all ingredients into a medium saucepan. Bring to a boil, reduce to a low simmer. Cover and cook for 20 minutes. Uncover and cook for a few minutes more, to reduce any remaining liquid.', 'Refrigerate up to 2 weeks.']",2
658,Green Tomato Chutney Recipe,15,60,75,"['2 1/2 pounds firm green tomatoes, about 7 cups, cored and chopped', '1 1/4 cups brown sugar, packed', '1 cup chopped red onion', '1 cup golden raisins', '1 cup cider vinegar', '2 Tbsp chopped candied ginger', '1 Tbsp mustard seeds', '1 teaspoon chili pepper flakes', '1 teaspoon fennel seeds', '1 teaspoon of salt', '1/2 teaspoon ground allspice', '1/8 teaspoon ground cloves', '1 cinnamon stick', 'Pinch of ground nutmeg', 'Special equipment:', '3 pint jars or 6 8-ounce jars for canning', 'Steamer rack', 'Jar lifter (helpful for lifting jars out of boiling water)', 'Large 16-quart pot']",19,"['1 Sterilize the jars and lids: Place a steamer rack in a large (16 quart) pot, and place the jars on the rack. Fill the jars and the pot with water up to the rim of the jars.', ""If you don't have a rack you can place a clean dish towel at the base of the pot. You want to prevent the glass jars from touching the bottom of the pot which can get quite hot and cause the glass to crack."", 'Put the burner on high and heat until a rolling boil. Boil for 10 minutes. To sterilize the lids, place them in a bowl and pour boiling water over them.', '2 Put all ingredients into a large pot and cook them 45 minutes: Place all of the ingredients in a medium sized (about 4 qt) thick-bottomed pot.', 'Bring to a boil and reduce to a simmer. Cover and cook for 45 minutes. Taste and adjust seasonings.', '3 Scoop chutney into jars: Remove the jars from the pot of hot water (reserving the water if you plan to can for shelf storage.). Scoop the green tomato chutney into the jars, filling them to 1/4 of an inch from the rim.', 'Wipe the rims with a clean wet paper towel. Place sterilized lids on the jars. Secure with canning rings.', '4 Process filled jars in a water bath: Place the filled jars back on the steamer rack in the pot of hot water. Make sure the jars are covered with an inch of water.', 'Bring to a boil and process for 15 minutes, or 20 minutes if you are at altitudes between 1000 and 6000 feet.', 'Remove the jars from the pot and place on a dish towel spread out on your counter. Allow the jars to cool completely.', ""The jar lids should make a popping sound as they seal. If a lid doesn't seal for some reason, store the jar in the refrigerator.""]",11
659,Hot Mulled Cider Recipe,5,25,30,"['1/2 gallon of fresh, unfiltered apple cider (non-alcoholic)', '1 orange', '12 whole cloves', '4 3-inch sticks of cinnamon', '15 allspice berries', '1/4 teaspoon of freshly ground nutmeg', '7 pods of cardamom', '2 Tbsp brown sugar (optional)']",8,"['1 Simmer apple cider with orange and spices: Pour apple cider into a 3-quart saucepan, cover, turn the heat on medium-high.', 'While cider is heating up, take a vegetable peeler and peel away a couple thick strips of peel from the orange. Press about half of the cloves into the peeled part of the orange. (You can also just quarter the orange and add the slices and cloves separately. I just like seeing the orange bob up and down.)', 'Place orange, orange peel strips, the remaining cloves, and the rest of the ingredients into the sauce pan with the cider. Keep covered and heat the mulled cider mixture to a simmer and reduce heat to low. Simmer for 20 minutes on low heat.', '2 Strain out the orange and spices: Use a fine mesh sieve to strain the hot mulled cider away from the orange, cloves, and other spices.', 'If you want, you can add a touch of bourbon, brandy, or rum to spike it up a bit.', 'Serve hot. Add a cinnamon stick to each cup if desired.']",6
660,Cilantro Lime Rice Recipe,0,30,30,"['2 tablespoons extra virgin olive oil', '1 1/2 cups basmati long grain white rice', '1 clove garlic, minced', '2 1/4 cup water', '1 teaspoon salt', 'Zest of one lime', '3 tablespoons lime juice', '1 cup lightly packed chopped cilantro, leaves and tender stems']",8,"['1 Brown the rice: Heat the olive oil in a medium saucepan on medium high heat. Add the raw rice and stir to coat with the olive oil. Cook, stirring occasionally, until the rice has started to brown.', 'Add the garlic and cook a minute more.', '2 Add water, salt, zest, then simmer: Add water, salt, and lime zest to the rice. Bring to a rolling boil, then cover and lower the heat to low to maintain a very low simmer.', 'Cook undisturbed for 15 minutes (check your rice package instructions), then remove from heat and let sit for 10 minutes.', 'Fluff the rice with a fork.', '3 Stir in lime juice and cilantro: Transfer the rice to a serving bowl. Pour lime juice over the rice and toss with chopped cilantro.', 'Serve with chicken, steak, shrimp, Mexican or Asian food.']",7
661,Grilled Sweet Potatoes Recipe,20,10,30,"['2 pounds sweet potatoes', '3-4 tablespoons extra virgin olive oil', 'Kosher salt', 'Dressing', '1/4 cup finely chopped fresh cilantro (including tender stems)', '1 teaspoon of lime zest or lemon zest', '2 tablespoons of fresh lime or lemon juice', '1/4 cup extra virgin olive oil', 'Pinch of salt']",9,"['1 Prepare the grill, prep the sweet potatoes: Prepare your grill for hot, direct heat.', 'While the grill is heating up, peel the sweet potatoes and slice lengthwise, or on a diagonal, into 1/4 inch-thick pieces.', 'Coat the sweet potato slices with olive oil and lightly sprinkle with Kosher salt.', '2 Make cilantro lime dressing: Combine all of the dressing ingredients into a small bowl.', '3 Grill the sweet potatoes: Once the grill is hot, lay the sweet potato pieces down onto the grill grates. Cover the grill and cook until each side gets some grill marks, between 3-6 minutes for each side, depending on how hot your grill is.', '4 Toss with dressing: Toss the sweet potatoes in a bowl with the dressing and serve hot.']",6
662,Sesame Noodle Salad Recipe,10,25,35,"['Honey Soy Dressing:', '1/4 cup extra virgin olive oil or vegetable oil', '3 Tbsp dark sesame oil', '1/2 teaspoon crushed dried red pepper or chili powder (optional)', '3 Tbsp honey', '2 Tbsp soy sauce (less if using tamari which is more concentrated than soy sauce)', 'Salad:', '12 ounces of vermicelli, thin spaghetti, or angel hair pasta', 'Salt', '2/3 cup coarsely chopped cilantro', '1/3 cup chopped roasted salted peanuts', '1/3 cup thinly sliced green onions', '1/2 cup diced red bell pepper', '1 Tbsp toasted sesame seeds']",14,"['1 Prepare the dressing: Put the dressing ingredients into a small saucepan and bring to a boil. Remove from heat.', '2 Cook the pasta: Put the pasta in a large pot in salted boiling water (1 Tbsp salt for every 2 quarts of water). Cook al dente, according to the directions on the pasta package. Drain.', '3 Toss with dressing, chill: Stir together the cooked pasta and the dressing in a large bowl until the pasta is well coated. Cover and chill for several hours.', '4 Stir in cilantro, peanuts, green onions, bell pepper: When ready to serve, mix in the cilantro, peanuts, green onions and bell pepper. Garnish with toasted sesame seeds.']",4
663,Cilantro Lime Shrimp Recipe,5,15,20,"['2 tablespoons peanut oil, canola oil, or rice bran oil', '1  Serrano chile (more if you like it spicy, or just a fraction of one if you want less heat), sliced into thin rings', '1-2 garlic cloves, sliced thinly', '1 pound shrimp, peeled and deveined', 'Salt', '1/4 cup chopped cilantro', '1-2 tablespoons lime juice']",7,"[""1 Heat oil until shimmering hot: Place a large saut\\xc3\\xa9 pan or a wok over your strongest burner on high heat. Let the pan heat up for a minute and then add the oil. Let the oil heat until it's shimmering. If it starts to smoke, remove the pan from the heat for a moment."", '2 Add the chiles to the pan and toss to coat with oil. Cook 30 seconds.', '3 Add the shrimp and garlic to the pan and sprinkle with salt. Toss to coat with oil. Let the shrimp cook undisturbed for 1 minute before tossing again so they get a little bit of a sear. Stir-fry until cooked through, about 2-3 minutes.', '4 Turn off the heat and mix in the cilantro, then the lime juice.', 'Serve hot or at room temperature. Serve alone, over rice, or in a folded heated flour or corn tortilla.']",5
664,"Lemon Chicken with Pasta, Olives, and Herbs Recipe",10,785,795,"['1 lemon', '2 chicken breast halves with skin and bones (about 1 1/4 pounds)', '1/4 teaspoon salt', '2 pinches ground black pepper', '1/3 cup yogurt', '1/2 small red onion, cut into thin wedges', '1 tablespoon olive oil', '1/2 cup chicken stock or white wine', '1 cup small pasta such as cavatelli, orzo, or ditalini', '1/4 cup chopped parsley', '1/4 cup chopped cilantro', '1/2 cup pitted green olives, halved or quartered']",12,"['1 Cut the lemon: Slice half of the lemon into rounds and use the other half to squeeze over the chicken.', '2 Marinate the chicken: Place the chicken in a shallow dish. Sprinkle both sides with salt and a few pinches of pepper. Squeeze the juice from the lemon half over the chicken and spread it with the yogurt. Turn the chicken a few times in the yogurt, and let marinate at room temperature for 30 minutes or covered in the refrigerator for up to 12 hours.', '3 Preheat the oven: Set an oven rack in the upper third of the oven and preheat the oven to 375\\xc2\\xbaF.', '4 Bake the chicken: In the bottom of an ovenproof skillet or small roasting pan, scatter the onion wedges and lemon slices. Drizzle with the oil and sprinkle with a pinch of salt and pepper.', 'Place the chicken on top with the skin side up and bake for 35 to 40 minutes, or until the skin is golden and an instant read thermometer inserted into the thickest part of the chicken registers 165\\xc2\\xbaF. (Exact cooking time depends upon the size of the breasts.)', '5 While the chicken roasts, cook the pasta: In a large saucepan, bring 5 to 6 cups salted water to a boil. Add the pasta and cook for 10 to 12 minutes (or according to the package directions) until tender. Drain in a sieve.', '6 Add the pasta, herbs, and olives to the pan: Remove the cooked chicken from the pan and stir in the stock or wine. Stir in the pasta, parsley, cilantro, and olives. Spoon it onto 2 plates and set the chicken on top.']",7
665,\xe2\x80\x9cSpooky\xe2\x80\x9d Cinnamon Sugar Flour Tortilla Crisps Recipe,15,12,27,"['1/4 cup sugar', '1 1/2 teaspoons cinnamon', '4 Tbsp butter, melted', '2 flour tortillas']",4,"['1 Cut wedges or shapes out of each flour tortilla: Cut each flour tortilla into 6 to 8 wedges or use a cookie cutter to cut out shapes in the tortillas.', '2 Prepare oven and baking sheet: Preheat oven to 350\\xc2\\xb0F. Line a baking sheet with parchment paper or foil.', '3 Dip tortilla pieces in melted butter, then one side in cinnamon sugar, place on lined baking sheet: Mix the sugar and cinnamon together in a small bowl and spread out over the bottom of a small plate. Melt butter in a small bowl.', 'Dip the cut pieces of flour tortilla in the melted butter, gently shake off the excess and place on the plate of cinnamon sugar. Only coat one side of the crisp in cinnamon sugar.', 'Then place coated tortilla pieces, cinnamon sugar side up, on the lined baking tray.', '4 Bake: Bake for 10 minutes at 350\\xc2\\xb0F, or until the tortilla crisps are indeed ""crisp"". Remove from oven and let cool for 2 minutes.']",6
666,Tembleque (Puerto Rican Coconut Pudding) Recipe,10,10,20,"['2/3 cup granulated sugar', '1/2 cup cornstarch', '1/4 teaspoon ground cinnamon', 'Pinch of salt', '2 (13.5 ounce) cans full-fat coconut milk', '1 1/2 teaspoons vanilla extract', '3-inch peel of lime, optional', '1 cinnamon stick, optional', 'To garnish:', '1/2 cup sweetened coconut flakes, toasted', '1 teaspoon ground cinnamon', 'Special equipment:', 'Small molds or bundt pan']",13,"['1 Whisk together dry ingredients: In a large, heavy-bottom pot (preferably one with sloping sides) whisk together the sugar, cornstarch, ground cinnamon, and salt. You are doing this in a cold pot off heat.', '2 Gradually add the coconut milk: Gradually whisk one can of coconut milk and vanilla into the sugar. This will smooth out the sugar and cornstarch mixture and prevent any clumps. Once a thick, lump-free paste has been created, whisk in the remaining coconut milk.', '3 Add the lime and cinnamon stick: Add the lime peel and cinnamon stick.', '4 Cook the tembleque: Place the pot over medium heat. Whisk frequently while bringing the mixture up to a simmer. Once small bubbles form on the edges of the pan, begin whisking constantly, but not vigorously. If you whisk too aggressively, it will cause too much air to incorporate into the tembleque, which will create bubbles in the final molded dessert.', 'Ultimately, you will cook the tembleque on medium for 5-10 minutes, or until the whisk leaves behind a ribbon when lifted from the pot.', 'Remove the pot from the heat. Fish out and discard the lime peel and cinnamon stick and allow the tembleque to cool slightly while you rinse the mold(s).', '5 Rinse the molds: Pour cold water into your mold and swish it around, kind of like you\\xe2\\x80\\x99re washing dishes and rinsing the soap from it.', '6 Fill your molds: Shake any excess water out of the molds, but don\\xe2\\x80\\x99t dry them. Fill each mold using a ladle or spoon. If you\\xe2\\x80\\x99re using individual molds spoon a cup of the hot liquid into each mold. If you\\xe2\\x80\\x99re making dessert for a crowd, pour all of the custard into a large 10-inch mold.', '7 Release the air bubbles: Gently tap the bottom of the mold against the countertop to release any bubbles trapped in the custard.', '8 Chill the tembleque: Press a layer of plastic wrap onto the surface of the tembleque and refrigerate until completely chilled. This may take anywhere from two to four hours depending on the size of your molds.', '9 Carefully unmold and garnish: Gently pull the custard from the mold with your fingertip or run a thin, sharp knife between the tembleque and the mold. Invert the mold over a plate and allow gravity to release the custard from the mold.', '10 Garnish and serve: Sprinkle the tembleque with toasted coconut flakes and ground cinnamon. Store the unmolded tembleque in an air-tight container or covered in plastic wrap (touching the custard) in the fridge.']",12
667,Candied Kumquats Recipe,10,0,10,"['4 cups of roughly chopped kumquats (roughly 1-1\\xc2\\xbd lbs.)', '1 cup of water', '2 cups of sugar']",3,"[""1 With a pairing knife roughly chop the kumquats. Discard any seeds you can that are easy to get too, but they're edible so don't fret if some get chopped up or stay in the fruit. Feel free to leave any small kumquats whole."", '2 Heat the water and sugar over high heat until it comes to a boil. Simmer for 4 minutes. Add the kumquats and simmer for 10 minutes.', '3 Drain the kumquats through a sieve set over a bowl. Return the syrup to the pan and simmer for 5 minutes to reduce the syrup. Combine the kumquats and 1/4 cup of the syrup together.', 'Serve or jar and refrigerate. Can be stored for up to two weeks.']",4
668,Citrus Pork with Egg Noodles Recipe,15,20,35,"['1/2 teaspoon ground cumin', '1/2 teaspoon salt', '1/2 teaspoon freshly ground pepper', '1/2 pound boneless pork loin, cut into 2x1/2-inch strips', '2 cloves garlic, minced', '1 tablespoon extra virgin olive oil', '1 cup chicken broth', '1/2 cup orange juice', '2 tablespoons cider vinegar', '1 teaspoon soy sauce', '1 1/2 teaspoons brown sugar', '2 medium carrots, sliced into thin rounds (about one heaping cup)', '1 tablespoon cornstarch', '1/2 cup sliced green onions', '1/2 teaspoon grated fresh ginger', '1/2 pound egg noodles, cooked, drained']",16,"['Get the water boiling for your noodles...', '1 Toss pork and garlic with spices: In a small bowl combine cumin, salt and pepper. Add the pork and garlic; toss to coat. Let sit for a few minutes while you prep the other ingredients.', '2 Make the sauce mixture and cornstarch slurry: Stir together the broth, orange juice, vinegar, soy sauce, and brown sugar in a bowl. Take 1/4 cup of the broth mixture and stir with the cornstarch in a separate small bowl to make a slurry.', '3 Saut\\xc3\\xa9 the pork and garlic: In a large skillet heat oil over medium hight heat. Add the pork and garlic. Saut\\xc3\\xa9 for 2 minutes or until lightly browned on all sides. Remove the pork from the pan and set aside.', '4 Add pasta to the boiling water, cook until al dente.', '5 Cook the carrots in the broth mixture: While the pasta is cooking, add the carrots to the skillet you used to cook the pork. Pour all but the reserved broth mixture over the carrots. Bring to a boil and reduce the heat to medium. Cook 7-8 minutes.', '6 Add the pork back to the pan.', '7 Add the cornstarch slurry to the pan: Stir the cornstarch mixture. Pour the cornstarch slurry into the skillet and stir to thicken the sauce.', '8 Add the green onions and ginger. Bring everything to a boil and simmer for 1 more minute.', '9 Toss with the noodles. Serve immediately.']",10
669,Manhattan Clam Chowder Recipe,10,45,55,"['2 slices bacon (can sub with 2 more Tbsp extra virgin olive oil)', '1 tablespoon extra virgin olive oil', '2 carrots, peeled and sliced', '2 celery stalks, chopped', '1 onion, chopped', '1 large garlic clove, minced', '1/2 teaspoon dried thyme', '1/4 teaspoon celery seed', '2 bay leaves', '12 ounces of tomato juice, strained tomatoes or crushed tomatoes', '1 14-ounce can of clam broth or juice*', '2 10-ounce cans of baby clams, juice reserved*', '1 pound waxy potatoes, peeled and cut into 2-inch chunks', 'A dozen or so live small clams, such as littlenecks or Manila clams', 'Salt and black pepper to taste', 'Tabasco or other hot sauce', '*If using fresh quahogs, scrub clean a dozen or more quahogs. Place clams in a small pot and add two cups of water. Bring water to a boil. Cover the pot and steam the clams until they completely open, about 10 to 20 minutes. Remove from heat. Remove clams from pot and set aside. Strain the clam steaming liquid through a fine mesh sieve or cheesecloth to catch any grit, reserving the liquid. Remove the clams from the shells, chop. Use chopped clams in place of canned. Use steaming liquid in place of clam broth.']",17,"['1 Cook the bacon: Slowly cook the bacon with the olive oil on medium heat until the bacon is crispy and its fat rendered. Remove, chop and set aside.', '2 Cook the carrots, celery, onion, then garlic: Increase the heat to medium-high and saut\\xc3\\xa9 the carrots, celery and onion until soft and translucent, about 4-5 minutes. Do not brown the vegetables. Add the garlic and cook for another minute. Return chopped bacon to the pot.', '3 Add the herbs, tomato juice, clam broth and the juice from the canned clams, mix well, then add the potatoes. Bring to a simmer, cover and simmer gently until the potatoes are done, about 30-40 minutes.', '4 Add clams: When the potatoes are tender, add the canned clams and the live clams, cover the pot and simmer until the live clams open up, about 5-10 minutes.', 'Add Tabasco, salt and black pepper to taste.', 'Place a clam in shell or two in each bowl for serving.']",6
670,How to Cook and Eat Steamer Clams,10,15,25,"['3 to 4 pounds of soft shell steamer clams', '1/2 cup butter, melted']",2,"['1 Soak the steamers in sea water or salty water: Ideally, if you have the time, place the steamers in a bucket and cover with several inches of sea water or salty water (a tablespoon of sea salt completely dissolved in every quart of water), and let sit several hours in a cool place (not in direct sunlight), preferably overnight.', ""After a while, you\\'ll notice that each clam has a foot that will start to extend out of the shell. This is normal. The clams are usually buried in the sand with only the foot extending up to the surface of the water."", 'The steamer clams will discharge any sand or dirt while they are sitting in the water, so the water may become rather murky. You can change the water if you want.', ""If you don\\'t have time to let the clams soak for hours, just put several of them at a time in a large bowl, cover with salt water, and gently swirl the water around with your fingers for half a minute."", 'If the clams release sand or grit, dump out the water and rinse the clams out in the same manner again, until no more sand is released. (They may still release some sand and grit while cooking, but you will dip them in the clam broth before dipping them in butter when you eat them, helping to rinse away any remaining grit.)', ""2 Steam the clams: When ready to cook, put about an inch of water (you can also use beer or a stout) in the bottom of a tall, large pot. Place a steamer rack at the bottom of the pot. Carefully place the clams on the steamer rack (if you don\\'t have a steamer rack, don\\'t worry about it, just put the clams in the pot with the water)."", 'The clam shells are on the thin side and can easily break, so be gentle as you put the steamers in the pot.', 'You may notice some of the clams ""spitting"" water at you as you handle them. This is normal, don\\\'t worry about it. If any of the clams seem dead, are stinky, or whose siphons don\\\'t retract a bit when you touch them, toss them out.', ""Cover the pot. Bring the water to a boil. Let the clams cook in the steam from the boiling water for about 5-10 minutes, until the steamer clam shells are wide open, then remove the pot from the heat. Any steamers that didn\\'t open should be discarded. (The pot might foam up and boil over while cooking, so keep an eye on it while cooking.) Let the clams cool for a couple minutes."", '3 Place steamer water in bowls for serving: Carefully remove the cooked clams from the pot, placing them in a serving bowl. Do not discard the clam broth left in the pot. Instead pour a bit of the hot broth into bowls for serving. Put the melted butter into small bowls for dipping.', '4 Serve with melted butter: Serve the steamers with a bowl for the clams, an empty bowl for the shells, a small bowl with broth for dipping, and a smaller bowl with butter for dipping.', ""5 Here\\'s how to eat the steamers: To eat, open the shell and remove the cooked clam. Use your fingers to pull off the skin covering the siphon of the clam. Discard with the shells into the shell bowl."", 'Grip the siphon with your fingers, swirl the clam around in the hot broth (it will help to warm up the clams and to dislodge any remaining grit or sand). Dip the clam into melted butter and eat!', 'Note, the siphon end of the clam may be a bit tough and rubbery. You can eat it or not. In any case, it makes a great handle for dipping.']",14
671,How to Make Ghee,2,25,27,['1 pound organic unsalted butter'],1,"['1 Cut the butter and put it in a pan: Cut the sticks of butter into smaller pieces (any shape or size is fine) and put them in a large, heavy-bottomed saucepan set over medium-low heat.', 'Let the butter and heat play with each other. Just stay around to keep an eye out, but do not touch it and definitely do not stir it.', '2 Skim the foam: Once the butter melts and the milk solids begin to cook, it will start to sputter and a white foam will slowly rise to the surface over the course of the next 5-8 minutes.', 'Use a large spoon to carefully scoop the foam off the surface without touching the base of the pan, and discard the foam. This should continue for a few minutes, some 5-8 minutes after the butter melts.', '3 Look for more foam and turn off the heat: Once you have scooped pretty much all the foam off the melted butter, you should see an almost clear liquid with golden browned milk solids at the bottom of the pan.', 'About 30 seconds after this stage you will again see very faint foam forming on the surface of the ghee. It will be less dense than the previous foam\\xe2\\x80\\x94more like a thin cloud of small, clear bubbles covering the surface of the ghee. When you see this second foam form, it is time to turn the heat off. Take ghee off the heat and let it sit for 10 minutes.', '4 Strain the ghee: Place a fine mesh sieve layered with cheesecloth over a clean, dry mason jar. Pour the ghee through the sieve and into the jar. Let the ghee cool down completely before putting the lid on the jar.', 'Store in a dry place at room temperature. It is shelf stable. If you have a hot kitchen, you can keep ghee in your fridge just to keep it solidified.']",8
672,Shrimp Cobb Salad with Creamy Basil Dressing Recipe,30,10,40,"['For the creamy basil dressing:', '1/3 cup mayonnaise', '1/3 cup plain Greek yogurt', '1 tablespoon lemon juice', '1/2 teaspoon honey', '1/8 teaspoon salt', '1/8 teaspoon pepper', '1/2 cup packed basil leaves', '1/3 cup olive oil', 'For the salad:', '1 pound large (16-20 per pound), shell-on shrimp, thawed', '1/2 yellow onion, sliced', '2 bay leaves', '1 teaspoon salt', '1/2 teaspoon peppercorns', '2 sprigs parsley', '4 slices bacon, cut crosswise into slices', '2 small heads baby romaine lettuce, or other crisp lettuce, torn into pieces', '1 pint cherry tomatoes, halved', '2 small avocados, sliced', '2 small yellow mangoes, peeled and diced', '2 Persian cucumbers, sliced', '8 ounces cotija cheese, crumbled']",23,"['1 Make the dressing: In a food processor or blender, process the mayonnaise, yogurt, lemon juice, honey, salt, pepper, and basil leaves until smooth.', 'With the motor running, slowly stream in the oil through the feed tube until blended. Taste and add more salt, pepper, or lemon juice, if you like.', '2 Cook the shrimp: Prepare a large bowl of ice water and set it aside. You will use this to stop the shrimp from cooking.', 'In a wide saucepan set over medium heat, bring 4 cups of water to a simmer. Add the onion, bay leaves, salt, peppercorns, and parsley. Turn the heat to low and simmer for 10 minutes. Add the shrimp to the pot, and stir.', 'Bring the water back to a simmer and remove the pan from the heat. Cover with a lid and leave for 3 minutes, or until the shrimp are opaque in the center.', 'With a slotted spoon, quickly scoop the shrimp into the bowl of ice water. Swish them around for one minute. Drain and pat dry. Refrigerate for up to 24 hours, or until ready to use.', '3 Peel and devein the cooked shrimp: Starting underneath where the legs are attached, pull off the legs and shell. Leave the tail segment on (for appearance.)', 'Make a shallow slit down the middle of the back of the shrimp to reveal the black thread (intestine). Use the tip of a paring knife to lift out the black vein. Rinse the shrimp under cold running water.', '4 Cook the bacon: In a skillet over medium heat, cook the bacon until crisp and golden. Transfer to a paper towel-lined plate to drain.', '5 Assemble the salad: Serve on one large platter or on individual plates. Spread the lettuce on the bottom and top with separate mounds of shrimp, bacon, tomatoes, avocados, mangoes, cucumbers, and cheese. Serve with basil dressing.']",10
673,Strawberry Rhubarb Cobbler Recipe,40,35,75,"['Fruit mixture', '4 1/2 cups rhubarb stalks (about 1 1/4 pounds or 560 g)  cut into 1-inch pieces (Trim outside stringy layer of large rhubarb stalks; make sure to trim away any and discard of the leaves which are poisonous; trim ends.)', '1 1/2 cups strawberries (1/2 pound or 225 g), stemmed and sliced', '1/2 cup (100 g) white sugar (1/4 cup to 1/2 cup more if you want the cobbler filling sweeter)', '2 Tablespoons of quick cooking tapioca', '1 teaspoon of grated orange peel', 'Cobbler crust', '1 cup (130 g) all purpose flour', '2 Tbsp white granulated sugar', '1 1/2 teaspoon baking powder', '1/4 teaspoon salt', '1/4 cup (4 Tbsp, 57 g) butter, cut into cubes', '1/4 cup (60 ml) milk', '1 egg, lightly beaten']",14,"['1 Toss the rhubarb and strawberries with sugar, tapioca, zest, let rest: In a bowl, mix the rhubarb and the strawberries with the sugar, tapioca, and orange zest.', 'Let sit to macerate for 30 minutes to an hour.', '2 Preheat oven to 350\\xc2\\xb0F (175\\xc2\\xb0C).', '3 Make the biscuit topping: In a medium bowl, whisk together the flour, 2 Tbsp sugar, the baking powder and salt.', 'Use your (clean) hands to work the butter into the flour until the mixture resembles coarse crumbs, with pieces of butter no bigger than a pea.', 'Stir in the milk and egg until just moistened (do not over-mix!).', '4 Put fruit in casserole, top with biscuit dough: Pour the strawberry rhubarb mixture into a 2-quart casserole dish. Drop the biscuit dough on top of the fruit, like cobblestones.', '5 Bake: Bake in a 350\\xc2\\xb0F (175\\xc2\\xb0C) oven for 35 minutes until cobbler crust is golden brown.', 'Serve with whipped cream (optional).']",9
674,Berry Cobbler with Coconut Walnut Streusel Recipe,15,35,50,"['Filling', '4 cups mixed berries (i.e. blackberries, raspberries, blueberries, boysenberries, strawberries), fresh or frozen', '1/4 cup plus 1 Tbsp sugar', '2 Tbsp instant tapioca', '1 Tbsp fresh lemon juice', 'Topping', '1/2 cup flour', '1/2 cup shredded coconut', '1/4 cup sugar', '1/4 cup chopped walnuts', '1/4 teaspoon baking powder', 'Pinch of salt', '4 Tbsp (1/4 cup) cold, unsalted butter, cut into cubes']",13,"['1 Preheat oven to 375\\xc2\\xb0F. Butter a 9x9 inch baking dish.', '2 In a large bowl, mix together the filling ingredients - berries, sugar, tapioca, and lemon juice. Pour into the baking dish.', '3 In a medium sized bowl, stir together the flour, coconut, sugar, walnuts, baking powder and salt from the topping ingredients. Use your fingers to mix in the cubes of butter. Rub the butter into the other ingredients until the mixture looks like coarse crumbs.', '4 Sprinkle the topping over the filling. Bake for 35-40 minutes, until the topping is golden brown and crispy, and the filling is bubbling.', '5 Let cool for at least an hour. Serve with vanilla ice cream or whipped cream.']",5
675,How to Make Simple Syrup,2,2,4,"['1 cup water', '1 cup granulated sugar']",2,"['1 Dissolve the sugar: In a saucepan over medium heat, stir the water and sugar together. Bring to a boil and adjust the heat to a simmer for 2 to 3 minutes, or until the sugar is dissolved.', '2 Remove the pan from the heat and leave to cool completely.', '3 Store the syrup: Pour the syrup into a glass jar or bottle, and refrigerate until needed. The syrup will last for about 1 month in the refrigerator and almost indefinitely in the freezer.']",3
676,Cocoa Coconut Macaroons Recipe,20,12,32,"['2 1/4 cups (254g) unsweetened shredded coconut', '3 large egg whites', '3/4 cup (148g) sugar', '4 tablespoons (22g) cocoa powder', '5 tablespoons smooth applesauce', 'Flaky sea salt', 'Special equipment:', 'Piping bag', 'Large star piping tip']",9,"['1 Heat the oven to 400F. Line a baking sheet with parchment.', '2 Grind the coconut: Pulse the coconut in a food processor for 30 seconds, until coarsely ground. (Skip this if you are shaping your macaroons by hand instead of piping in Step 4.)', '3 Make the batter: In a saucepan off the heat, whisk the egg whites, sugar, cocoa, and applesauce together. Stir in the coconut.', 'Place the pan over medium heat and cook, stirring constantly, until the mixture is pasty and hot to the touch.', '4 Shape the macaroons: Remove the pan from the heat and scoop the macaroon batter into a piping bag fitted with a large star tip. Pipe mounds onto a parchmentined baking sheet roughly the size of walnuts in their shells.', 'To shape by hand without piping: Use a cookie scoop or a large soup spoon to portion out the batter.', '5 Bake the macaroons: Sprinkle the tops with flaky sea salt and bake for about 12 minutes, until they feel dry to the touch and yield slightly to gentle pressure (they will still look glossy). Remove from the oven and cool on the sheet pan on a rack. Once cool, gently lift each macaroon off the sheet pan.']",7
677,Savory Coconut Rice Recipe,15,45,60,"['3 tablespoons coconut oil (for vegan option), ghee, or clarified butter', '1 cup finely chopped onion', '1 clove garlic, minced (1 teaspoon)', '1 teaspoon salt', '1/8 teaspoon cayenne', '2 cups basmati long grain rice', '1/2 cup grated, unsweetened coconut', '2 cups unsweetened coconut water (See recipe note)', '1 3/4 cups plain water', '3 cardamom pods', '5 whole cloves', '1 stick cinnamon']",12,"['1 Cook chopped onions, add garlic, cayenne, salt: Melt coconut oil, ghee, or clarified butter in a medium saut\\xc3\\xa9 pan (that has a cover) on medium low heat. Add the finely chopped onion and cook until golden, 8 to 10 minutes. Add the garlic, cayenne, and salt, and cook a minute more.', '2 Add the rice: Stir the rice into the onion mixture to coat with the oil or butter and cook for 3 more minutes, stirring occasionally.', '3 Add coconut, coconut water, water, spices, simmer and cover: Add the grated coconut to the rice onion mixture and stir in the  coconut water and the water.', 'Stir in the cardamom pods, cloves, and cinnamon. Increase heat to bring the rice mixture to a simmer.', 'Lower the heat the low, cover, and simmer gently for 15 minutes.', '4 Remove from heat and let the rice steam in the residual heat, covered, for 10 more minutes.', '5 Remove lid and remove cardamom pods, cloves, and cinnamon. Fluff with a fork.']",7
678,Coconut Cupcakes with Coconut Cream Cheese Frosting Recipe,20,20,40,"['Cupcake Ingredients', '3/4 cup of unsalted butter, room temperature', '1 1/4 cup of sugar', '3 eggs, room temperature', '1 cup of canned coconut milk (full fat is best)', '1 teaspoon of vanilla extract', '2 1/4 cups of flour', '1 teaspoon of salt', '1 teaspoon of baking powder', '1/2 cup of sweetened desiccated coconut', 'Coconut Cream Cheese Frosting Ingredients', '1/2 cup of butter (1 stick), room temperature', '8 oz of Philly cream cheese (1 package), room temperature', '1/2-1 cup of powdered sugar, sifted', '1/4 cup of sweetened desiccated coconut']",15,"['First make the cupcakes:', '1 Preheat the oven to 350\\xc2\\xb0F.', '2 Beat butter and sugar: Beat the butter until light and fluffy, about 3 minutes. Add sugar and beat until light and fluffy again, another 3 minutes, scraping down the sides halfway through to ensure even mixing.', '3 Beat in eggs, one at a time: Add the eggs, one at a time, beating for 30 seconds each. Be sure to scrape down the sides after each egg to ensure even mixing.', '4 Combine dry ingredients: Whisk together the flour, salt, and baking powder in a bowl.', '5 Combine coconut milk and vanilla: Stir together 1 cup of a well shaken can of coconut milk and a teaspoon of vanilla in a separate bowl.', '6 Alternating dry ingredients and coconut milk mixture, add to butter sugar mixture, fold in coconut: Add 1/3 of the dry ingredients to the butter sugar mixture and mix, then add 1/2 of the coconut milk mixture.', 'Continue alternating with the wet and dry mixtures, ending with the dry. Stop mixing once just as the ingredients become incorporated; do not over-mix!', 'Fold in the sweetened desiccated coconut.', '7 Fill cupcake liners: Place cupcake liner papers into muffin tins. Scoop the batter into the cupcake papers about one half to three-quarters of the way full.', '8 Bake: Bake at 350\\xc2\\xb0F for 18-22 minutes, rotating the pan after the first 15 minutes to ensure even baking.', ""Check with a toothpick to see if the cupcakes are done. If the toothpick comes out of the cupcake clean, then they're ready."", 'Allow the cupcakes to cool for a minute or two in the pan, then transfer to a wire rack to cool completely.', 'While the cupcakes are cooling, make the cream cheese frosting:', '1 Beat cream cheese and butter: Beat the cream cheese for a minute. Then add the butter and beat an additional 3 minutes. Scraped down the sides and bottom of the bowl.', '2 Add powdered sugar: Slowly add the powdered sugar, taste as you go adding more sugar until you have reached the desired sweetness.', '3 Add coconut, spread onto cupcakes: Fold in the coconut. Spread onto cooled cupcakes. Sprinkle on a bit of extra shredded coconut on top to serve.']",17
679,Coconut Shrimp with Sweet Chili Mayo Recipe,20,15,35,"['1/4 cup mayonnaise', '2 tablespoons sweet chili sauce', '1 teaspoon chili-garlic hot sauce (optional)', '1 pound tail-on shrimp, shelled but leave tail on', '1/2 cup all purpose flour', '1 egg', '2 tablespoons coconut milk (or regular milk)', 'Salt and pepper', '1/2 cup Japanese panko bread crumbs', '1/2 cup sweetened coconut flakes', 'Oil, for frying']",11,"['1 In a small bowl, combine the mayonnaise, sweet chili sauce and the chili-garlic hot sauce (optional). Set aside.', '2 With a paring knife, slice down deep at the middle of the back of the shrimp, but do not cut all the way through. Discard the black vein/tract.', '', '3 Set three shallow bowls side by side. Place flour in the first bowl; whisk the egg and coconut milk in the second; and combine the panko and coconut flakes in the third.', '4 Heat 2 inches of oil in a saut\\xc3\\xa9 pan over moderate heat until thermometer registers 350\\xc2\\xb0F.', '', '5 As the oil is heating, bread the shrimp by dipping the shrimp on both sides in the flour and shaking excess off. Next dip in the egg/coconut milk mixture and then in the panko/coconut flakes, patting to ensure the coating sticks well.', '6 Fry the shrimp in small batches for 2-3 minutes until golden brown on both sides. Serve with Sweet Chili Mayo for dipping.']",8
680,Coconut Curry Mussels Recipe,15,15,30,"['2 lbs of mussels, cleaned and debearded', '1 tablespoon of vegetable oil', '1 yellow onion, chopped', '1 thai chili, finely chopped (can substitute good pinch of chili flakes)', '3 teaspoons of ginger, minced', '1 1/2 tablespoons of curry powder', '1/2 cup of chicken broth', '1 can of coconut milk (13.5 fl. oz.)', 'Pinch of salt', '1 stalk of lemongrass, chopped into four pieces and smashed', '3 kaffir lime leaves* (optional)', 'Chopped cilantro', 'Lime wedges', ""*Kaffir lime leaf: a key ingredient in Vietnamese, Thai, and Hmong cuisine; can be found in Asian Markets, though many markets now carry them in the produce aisles with other fresh herbs. The taste is very distinct and can\\'t be substituted. However, you can make this dish without the leaves and the mussels will still taste great.""]",14,"['1 Soak raw mussels in cold water, then de-beard: Place mussels in a bowl of cold water so the mussels will spit out any sand or mud. Let them sit for 10 minutes. Drain and repeat. Toss any mussels that are open as these are dead.', 'Debeard the mussels, pulling out their byssal threads (aka: their ""beards"") and place them in a bowl of cold water until ready to use.', '2 Saut\\xc3\\xa9 onions, chiles, ginger, curry powder: Heat the oil in a pot (large enough to hold all of the mussels) on medium high heat and add the onion and stir for a few minutes until they become soft and slightly translucent.', 'Add the chilies, ginger, and curry powder and stir for a minute until fragrant.', '3 Add broth and reduce, then add coconut milk, salt, lemon grass, kaffir lime leaves: Add the chicken broth and reduce half. Add the coconut milk, salt, lemongrass and kaffir lime leaves if using and bring to a boil.', '4 Add mussels: Drain and add the mussels, reduce heat to medium and cover with a tight fitting lid. Cook for 6-7 minutes until the mussels open.', ""Discard any that are closed as these were dead before cooking. (Some may only be slightly open, if you have to debate on whether it\\'s good to eat or not, toss it.)"", 'Spoon mussels into bowls and pour over with broth. Garnish with chopped cilantro and juice from lime wedges.']",8
681,Coconut Banana Cream Pie Recipe,60,1690,1750,"['For the crust:', '12 whole graham crackers (about 200 g)', '6 tablespoons (85 g) unsalted butter', '3 tablespoons sugar', 'Pinch of kosher salt', 'For the custard:', '1/3 cup (66 g) sugar', '3 large egg yolks', '3 tablespoons cornstarch', '1 1/4 cup (295 ml) whole milk', '1 1/4 cup (295 ml) full-fat coconut milk', 'Pinch of kosher salt', '1 teaspoon vanilla', '1 1/2 cups sweetened shredded coconut, plus additional for the top', '2 medium ripe bananas', 'For the whipped cream topping:', '2 cups heavy whipping cream', '3 tablespoons powdered sugar', 'Special equipment:', 'Food processor', '9-inch pie plate']",21,"['1 Heat the oven to 350\\xc2\\xb0F.', '2 Make the graham cracker crust: Heat the oven to 350\\xc2\\xb0F. Break the graham crackers into a few pieces and place in the bowl of a food processor. Process the crackers until there are no large chunks left. The mixture should be sandy but not powdery.', 'Pour the crumbs into a bowl and stir in the melted butter, sugar, and salt. The mixture should be like wet sand and clump together when pinched.', 'Press the crumbs firmly into the bottom and sides of a 9-inch pie plate to form a crust, using a measuring cup or glass to help you press firmly.', '3 Bake the graham cracker crust: Bake for 10 to 12 minutes or until the crust has started to turn a slightly darker brown color and smells fragrant. Remove from the oven and set aside to cool completely.', '4 Make the cream pie filling: Combine the sugar, egg yolks, and cornstarch in a medium saucepan. Whisk off the heat until they gain a little volume and turn a light yellow. Whisk in the milks and salt.', ""Place the pan over medium heat and whisk constantly until thickened, 15 to 20 minutes. (If this seems to be going really slowly, it's ok to nudge the heat up a little.)"", 'When the filling ready, the whisk should momentarily leave some visible trails on the surface before disappearing. Stir in the vanilla and shredded coconut.', '5 Transfer to pie crust: Spread half of the cream filling mixture into the cooled graham cracker crust. Slice the bananas and layer them on top, then cover with the remaining custard. Make sure to cover all the bananas (so they don\\xe2\\x80\\x99t brown!).', 'Smooth the surface and press plastic wrap directly on top.', '6 Refrigerate the pie at least 4 hours or up to 24 hours to set.', '7 Make the whipped cream topping: When ready to serve the pie, use a stand mixer or hand mixer to whip the cream until it holds soft peaks. Whisk in the sugar, and continue beating until the cream holds a medium peak. Generously dollop the cream over the top of the chilled pie. Sprinkle the top with extra shredded coconut.', 'Once assembled, the pie can be kept refrigerated for a few hours before serving. (Longer than a few hours, however, and the whipped cream can start to weep. It still tastes good, but is less visually appealing!)']",13
682,Spicy Garlic Shrimp with Coconut Rice Recipe,15,5,20,"['1 1/2 cups long grain white rice', '1 pound (about 20 large) jumbo shrimp', '6 large garlic cloves', '1 1/2 cup of water', 'Salt', '1 jalape\\xc3\\xb1o pepper, seeded, ribs removed, julienned', 'Juice of one lime (or 2 inches of white tender end of lemongrass, finely sliced)', '1 tablespoon extra virgin olive oil', '2 small cans (5.6 ounces) coconut milk (full fat)', '1/2 to 1 teaspoon of red chili powder or red chili sauce (to taste)', 'Cilantro for garnish (optional)']",11,"['1 Cook the rice: Put 1 1/2 cups of long-grain rice, 2 1/2 cups of water, and 1 teaspoon of salt into a medium-sized, thick-bottomed pot and bring to a boil. Cover the pot and lower the heat to the lowest setting and cook for 15 minutes. Remove from heat and let sit, covered, for 10 minutes.', 'While the rice cooks, continue with the recipe.', '2 Marinate the shrimp: Pulse garlic, water, and 1/2 teaspoon salt in a blender, just a few pulses, so you can still see chunks of garlic. Pour over shrimp to marinate. Marinate for 10 minutes.', '3 Strain and season the shrimp: Strain the water from the shrimp and garlic mixture. Add the lime juice (or finely sliced lemongrass), jalape\\xc3\\xb1o, and 1/2 teaspoon of salt to the shrimp mixture.', '4 Cook the shrimp: Heat 1 tablespoon olive oil in high heat in large saut\\xc3\\xa9 pan. Add shrimp. Cook one minute. Add 1 small can of coconut milk. Cook 30 seconds more. Mix in a teaspoon red chili powder or sauce.', '5 Make the coconut rice: When the rice is done cooking, transfer it to a large bowl. Mix in the second can of coconut milk to the cooked rice. Taste and add additional salt if needed.', '6 Serve: Serve shrimp on rice. Garnish with chopped fresh cilantro (optional).']",7
683,Portuguese Salt Cod Stew (Bacalao or Bacalhoada) Recipe,0,75,75,"['1 pound salt cod fillets, preferably skinless and boneless', '3/4 to 1 cup of good quality extra virgin olive oil', 'Milk (optional)', '2 large yellow or sweet Vidalia onions, sliced', '2 pounds waxy potatoes (Yukon gold work great), peeled', '4 eggs, hard boiled and sliced', 'About 40 pitted black olives (I used Kalamata olives, can also use green olives)', 'Kosher salt and freshly ground black pepper']",8,"['1 Soak salt cod in water: Salt cod typically comes either in dry fillets, already boned and skinned, or it comes whole. The fillets need to be rinsed, then soaked in water, and kept chilled, for 24 hours, with one or two changes of the water.', 'If you are using a whole fish, not prepared fillets, it needs to be soaked in water for up to 48 hours, also with several changes of water, and the bones and the skin removed and discarded after soaking.', '2 Simmer salt cod in milk and/or water: Put salt cod in a saucepan. Add enough milk, water, or a mixture of milk and water to just cover. Bring mixture to a simmer. Let simmer for a couple minutes. Remove the fish and set aside.', '3 Parboil potatoes and slice: Parboil the potatoes for 20 minutes (you can cook them in the water you used to cook the fish if you want). Slice potatoes into 1/4-inch thick rounds.', '4 Layer casserole with onions, potatoes, salt cod, olive oil, pepper, then top with hard boiled eggs and olives: In a large pyrex casserole or Dutch oven (use Dutch oven if making on stove-top), generously coat the bottom of the pan with olive oil. Place a layer of onion rings over the bottom of the pan.', 'Place a layer of sliced potatoes over the onions.', ""Breaking up the salt cod with your fingers, place pieces of salt cod in a layer over the potatoes. Taste the fish for saltiness. After a day of soaking and further cooking, there should be just a hint of saltiness in the fish. If most of the salt was soaked out of the fish, and the fish doesn't taste at all salty, you may need to sprinkle some salt back on to the fish as you place the layers down."", 'Generously pour some olive oil over the fish. Sprinkle with freshly grated black pepper.', 'Repeat with another layer of onions, potatoes, fish, olive oil, pepper (and more salt if needed).', 'Then finish with layers of onions, potatoes, more olive oil, sliced hard boiled eggs, and olives.', '5 Cook on stovetop or bake: Place on stove top on medium heat, and cook, covered, for 30 minutes. Or heat an oven to 350\\xc2\\xb0F and cook, covered, for 30-40 minutes, or until everything is completely through.', 'Serve with sides of rice and salad.']",12
684,Cod with Tomato and Orange Recipe,10,25,35,"['1 tablespoon extra virgin olive oil', '1 medium yellow onion, thinly sliced', '1 cup green olives, pitted and halved', '2 tablespoons grated orange zest', '1 medium navel orange, peeled, segmented, membranes removed', '1 28-oz can diced tomatoes, undrained', '1 teaspoon kosher salt', '1/4 teaspoon black pepper', '2 pounds cod fillets (or any firm white fish), cut into 2-inch pieces', '1/4 cup of fresh dill, chopped, or 1 tablespoon dried dill']",10,"['1 Cook the onions: Heat the oil in a large saucepan over medium heat. Add the sliced onions and saut\\xc3\\xa9 for 5 minutes, until softened.', '2 Add the olives, orange zest, orange segments, tomatoes, salt and pepper. Cover and simmer for 10 minutes.', '3 Add the fish: Add the fish to the pan. Spoon sauce over the fish. Cover and cook for an additional 7 minutes, until the fish is just cooked through.', 'Sprinkle with dill to serve.']",4
685,Fish Taco Salad Bowl Recipe,20,15,35,"['8 radishes, thinly sliced', '1/2 cucumber, halved lengthwise, seeded, and cut into thin half moons', '1/2 red onion, cut into wedges, then slivered', '1/2 cup thinly sliced red or yellow pepper', '2 tablespoons fresh lime juice, divided', '4 tablespoons canola or vegetable oil, divided', '1 teaspoon ground cumin', '1 teaspoon chili powder', 'Kosher salt and freshly ground pepper to taste', '1 1/2 pounds flaky white fish fillets, such as cod, halibut, or red snapper, cut crosswise into 1-inch wide slices', '1 clove garlic, finely minced', '8 cups thinly shredded romaine hearts', '2 tablespoons cider or rice wine vinegar', 'For serving:', 'Diced avocado', 'Fresh cilantro leaves (optional)', 'Tortilla chips']",17,"['1 Prep the veggie slaw: In a medium bowl combine the radishes, cucumbers, red onion, peppers, 1 tablespoon of the lime juice, and 1 tablespoon of the oil. Season with salt and pepper.', '2 Season and cook the fish: Mix together the cumin, chili powder, and salt and pepper. Sprinkle it over the fish.', 'Heat 1 tablespoon of the oil in a large skillet (preferably nonstick or well-seasoned cast iron) over medium high heat. Add the garlic, swish it around, then add the fish without crowding (cook it in batches if necessary), and cook for 3 minutes. Then flip and cook for another 2 or so minutes until cooked through.', 'The pieces may fall apart a little as you cook them; that\\xe2\\x80\\x99s perfectly fine, since this is how you will serve them anyway. Place them on a serving plate and sprinkle with the remaining 2 tablespoons lime juice.', '3 Assemble the salad and dressing: Meanwhile toss the lettuce with the vinegar and remaining 2 tablespoons oil, and season generously with salt and pepper.', '4 Serve the bowls: Pile the lettuce into 4 individual shallow bowls. Break up the fish into bite-sized chunks, and divide the fish evenly between the bowls, piling it onto the lettuce.', 'Spoon the vegetable slaw in equal amounts over the fish, then top with avocado and cilantro, if desired, and serve with tortilla chips on the side.']",7
686,Pacific Black Cod Escabeche Recipe,15,20,35,"['3/4 cup extra virgin olive oil, divided', '2-3 red, yellow, and green bell peppers, seeded and julienned', '1 white onion, julienned', '1 carrot, julienned', '1 habanero or scotch bonnet chili, seeded and minced', '1 cup white or cider vinegar', '3/4 pound pacific black cod (sablefish) fillets, pin bones removed, cut into 4 inch pieces', 'Salt and pepper', '1/2 cup flour for dredging', '1 bay leaf', '6 allspice berries']",11,"['1 Make the escabeche vegetable vinegar mix: Heat 1/2 cup olive oil in a large saut\\xc3\\xa9 pan on medium high heat (do not be tempted to cut back on this amount of oil, it is needed for the marinade). Saut\\xc3\\xa9 the bell peppers, onion, carrot and chili until softened, 5-10 minutes. Stir in vinegar, bay leaf, allspice berries, remove from heat, and set aside.', '2 Partially cook the fish fillets: Pat the fish fillets dry with a paper towel and sprinkle them on both sides with salt and pepper. Place flour on a plate and dredge the fillets in the flour on both sides.', 'Heat remaining 1/4 cup of oil a frying pan on high heat. When the oil is hot (but not smoking), add the fish fillets to the pan. Cook on one side for 1-2 minutes, then flip and cook the other side for 1-2 minutes.', 'Remove the fish from the pan when they are only half-cooked through, as the vinegar in the marinade will finish the cooking process.', '3 Cover fish with vegetable vinegar mixture: Place the partially cooked fish fillets in a non-reactive dish, such as a ceramic or pyrex casserole dish. Spoon the vinegar vegetable mix over and around the fish. Refrigerate overnight.', 'The fish will finish ""cooking"" in the acidic marinade and will become firmer.', '4 Serve: Bring to room temperature before serving.', 'Serve on a small plate, or on a crostini for an appetizer. Or add to a cheese taco (cheddar in softened corn tortilla) for a quick fish taco.', 'Will last several days in the refrigerator.']",9
687,Alaska Rockfish with Turmeric Cauliflower Steaks and Curry Butter Recipe,20,40,60,"['For the cauliflower:', '1 large (at least 3 pounds) or 2 small heads cauliflower', '4 tablespoons olive oil', 'Salt and pepper, to taste', '1 1/4 teaspoons ground turmeric', '1 teaspoon coriander seeds, coarsely crushed with a rolling pin or mortar', '1 lemon, sliced into wedges', 'For the butter:', '1 lemon', '4 tablespoons unsalted butter, at room temperature', '1 tablespoon chopped fresh ginger', '1 teaspoon curry powder', '1 teaspoon finely grated lemon zest', '1/8 teaspoon salt', 'Pinch of black pepper', 'For the fish:', '4 (6-ounce) Alaska rockfish fillets', '2 tablespoons olive oil', '1/2 teaspoon salt', '1/8 teaspoon freshly ground black pepper', '2 scallions, finely sliced, including some of the green part (for garnish)', '2 tablespoons chopped parsley']",22,"['1 Preheat the oven to 450\\xc2\\xbaF. Spray or brush a rimmed baking sheet with olive oil.', '2 Slice the cauliflower into steaks: Remove all the outer leaves from the cauliflower and stand it upright on your cutting board (trim the bottom of the stem as needed to keep the cauliflower stable).', 'With a large knife, cut it into 3/4-inch thick slices. You will have some \\xe2\\x80\\x9cscraps\\xe2\\x80\\x9d\\xe2\\x80\\x94slices or florets of cauliflower that are not attached to the core and fall apart, but you should get at least 4 slices that are intact.', '3 Roast the cauliflower: Brush both side of the steaks with oil, and toss the \\xe2\\x80\\x9cscraps\\xe2\\x80\\x9d with a little oil as well. Arrange them on the baking sheet, and sprinkle generously with salt and pepper, followed by the turmeric and coriander. Squeeze the lemon wedges over top.', 'Roast for 25 to 30 minutes, or until golden and tender when you insert the tip of a knife into the steak. Remove from the oven and set aside.', '4 Lower the oven temperature down to 400\\xc2\\xbaF.', '5 Make the lemon-curry butter while the cauliflower bakes: Remove about 1 teaspoon of zest from the lemon and squeeze about 1 1/2 tablespoons of juice. In a food processor, process the butter, lemon zest and juice, ginger, curry powder, 1/8 teaspoon salt and a pinch of black pepper until combined. Scrape down the bowl once or twice as needed. Transfer to a bowl.', '6 Cook the fish: Line a baking sheet with foil and lightly brush with oil or spray with olive oil spray. Set the fillets on the baking sheet. Brush with 2 tablespoons of olive oil and sprinkle generously with salt and pepper.', 'Bake in the oven at 400\\xc2\\xbaF for 6 to 8 minutes, or until the fish is cooked through and opaque.', 'Remove from the oven, cover loosely with foil, and let the fish rest for 5 minutes.', '7 To serve: The cauliflower can be served warm or room temperature; return it to the oven for a few minutes to rewarm, if desired. Transfer the cauliflower to a large platter. Set the fillets on top and dot each fillet with the curry butter. Sprinkle with chopped scallions and parsley and serve.']",11
688,Fish Cakes with Tarragon Mayo Recipe,25,72,97,"['For the Tarragon Mayonnaise:', '1/2 cup mayonnaise', '2 or more tablespoons chopped fresh tarragon, or fresh herb of your choice', 'For the cod fish cakes:', '2 russet potatoes, peeled and cut into 2-inch chunks', '1 1/2 teaspoons table salt', '1 bay leaf', '1/2 onion, 1/4-inch slices', '1 sprig fresh thyme, or a pinch dried thyme', '1 pound cod fillet', '2 large eggs', '1/8 teaspoon black pepper', 'Finely grated zest and juice of 1 lemon', '1/4 cup chopped fresh parsley', '2 tablespoons chopped fresh herbs such as basil, cilantro, dill, or tarragon', '1 tablespoon Dijon mustard', '2 tablespoons drained and chopped capers', '4 scallions, finely sliced', '3/4 cup panko bread crumbs', '4 to 6 tablespoons olive oil']",20,"['1 Make the mayonnaise: In a small bowl, stir the mayonnaise and tarragon together. Cover and keep in the refrigerator until ready to serve with the fish cakes.', '2 Cook and mash the potatoes: Place the potatoes in a saucepan and cover with cold water. Add 1 teaspoon salt. Bring the potatoes to a boil, adjust the heat to a simmer, and cook for 12 to 14 minutes, or until the potatoes are tender when pierced with the tip of a knife.', 'In a colander, drain the potatoes and return them to the pot. With a potato masher, coarsely mash them. Set aside.', '3 Poach the fish: Sprinkle the fish on both sides with salt and pepper. In a wide skillet, place the onions, bay leaf, and thyme. Place the fish on top of the onions. (If your fish still has the skin on it, place it skin side up.) Add 1/2 teaspoon salt and enough water to barely cover the fish. Cover with a lid.', 'Over medium heat, bring the water to a simmer. Simmer the fish for 2 to 3 minutes. The fish may be done at this point, but if not, set it aside, covered, for 5 to 6 minutes, or until it is opaque. The cooking time will vary according to the thickness of the fish. Transfer it to a plate to cool. With a fork or your fingers, break the fish into large flakes.', '4 Make the fish cake mixture: In a large bowl, beat the eggs. Add the pepper, lemon zest, lemon juice, parsley, additional fresh herbs of your choice, mustard, capers, and scallions. Mix to blend them. Add the mashed potatoes and stir until the ingredients are combined. Add the fish and panko, and stir to combine.', '5 Form the patties: Divide the mixture into 8 portions and shape them into patties that are about 3 inches wide and 1-inch thick. Refrigerate, covered with plastic wrap, for at least 1 hour or for up to 1 day.', '6 Cook the fish cakes: Set a rack 4 inches from the broiler element and preheat the boiler. Line a baking sheet with foil and brush generously with oil. Place the patties on the baking sheet and brush the tops with oil. Broil for 5 to 6 minutes, or until golden brown.', 'Remove the pan from the oven and flip the patties over. Brush the tops with more oil. Broil for another 5 to 6 minutes, or until browned. Serve hot with tarragon mayonnaise or tartar sauce.']",9
689,Crispy Fish Tacos with Red Cabbage Slaw Recipe,30,20,50,"['For the slaw:', '1 1/2 limes, zested and juiced', '2 tablespoons honey', '2 tablespoons avocado or canola oil', '1 teaspoon kosher salt', '1/4 teaspoon black pepper', '1 1/2 cups thinly sliced red cabbage (about a 1/2 small head of cabbage)', '5 radishes, cut into matchsticks (3/4 cup of matchsticks)', '1/4 cup minced red onion', '1/2 cup fresh cilantro', '1 jalape\\xc3\\xb1o pepper, seeded and minced', 'For the crema:', '1/2 cup sour cream', 'Juice from 1/2 lime', '1/2 teaspoon chili powder', '1/2 teaspoon garlic powder', '1/4 teaspoon ground cumin', '1/4 teaspoon kosher salt', 'For the fish:', '1 1/2 pounds skinless cod fillets', '1 lime', '1/2 cup all-purpose flour', '1/4 cup cornmeal', '2 teaspoons smoked paprika', '1 1/2 teaspoons kosher salt', '1 teaspoon garlic powder', '3/4 teaspoon ground cayenne pepper', '1/2 cup whole milk, heavy cream, or buttermilk', '4 cups high heat oil, such as canola oil', '10 small (5-inch) flour tortillas, street taco style']",30,"['1 Make the slaw and crema: Zest both limes, then slice in half. In a medium bowl, add lime zest and lime juice from 1 1/2 limes, honey, oil, salt, and black pepper. Whisk to combine. Add the cabbage, radishes, onion, cilantro, and jalape\\xc3\\xb1o pepper. Toss to combine. Set aside.', 'To make the crema, stir together sour cream, juice from the remaining lime half, chili powder, garlic powder, cumin, and salt. If the crema seems top thick, you can always thin it with a little milk or additional lime juice. Set it aside.', '2 Prepare to fry: Line a platter with paper towels to drain the fish after you fry it.', '3 Prepare the fish and breading: Zest the lime and put the zest on a medium plate, add the flour, cornmeal, paprika, salt, garlic powder, and cayenne pepper. Set it aside.', 'On another medium plate, add the milk, and juice from half of the lime. The milk will thicken and look slightly curdled.', 'Cut the fillets on the bias (a diagonal cut) into strips about 1 inch thick, season them with the juice from the remaining lime half, and sprinkle with salt and pepper.', '5 Heat the oil: In a large Dutch oven, add the oil. Heat it to 360\\xc2\\xb0F. It will take about 15 minutes for the oil to come to temp. If you don\\xe2\\x80\\x99t have a thermometer to test the temperature of the oil, sprinkle a little of the breading into the oil. If it sizzles and pops, it\\xe2\\x80\\x99s ready.', '6 Bread the fish: While you\\xe2\\x80\\x99re waiting for the oil to come up to temperature, dip the fish in the milk, then coat it in the flour, spice, and cornmeal mixture. Bread all of the fish before you begin to fry it.', '7 Fry the fish: Once all the fish is breaded, gently place the fish one piece at a time in the hot oil. Depending upon the size of your Dutch oven, you can probably fry 4 to 6 pieces at a time.', 'Fry the fish in batches so you don\\xe2\\x80\\x99t bring down the temperature of the oil too much. Cook on each side for about 2 to 3 minutes, until the coating is a deep amber brown. Remove from the oil and drain on paper towels.', '8 Serve: Transfer the fish to a platter, serve alongside tortillas, slaw, and crema. Let everyone assemble their own tacos. Start with a little slaw; add a piece of fish, and drizzle with the crema.']",11
690,Walnut Mocha Torte Recipe,25,60,85,"['Cake:', '6 eggs', '1 cup (200 g) white granulated sugar (divided into 3/4 cup and 1/4 cup)', '1 cup (120 g) finely ground walnuts (from about 1 1/3 cup of shelled walnuts)', '1/2 cup (55 g) fine dry bread crumbs (plain, unseasoned)', 'Mocha Topping:', '1/2 cup (100 g) white granulated sugar', '2 Tbsp corn starch', '1 cup (8 fluid ounces, 236 ml) strong coffee (I use decaf, with twice the amount of coffee for the liquid as I would usually use to drink)', '1 ounce (30 g) of chocolate chips (a little less than 1/4 of a cup)', '1 Tbsp butter', '2 teaspoons vanilla extract', '1 cup (8 fluid ounces, 236 ml) heavy whipping cream']",13,"['1 Separate the eggs: Separate the eggs, into yolks and whites (see How to Separate Eggs).  Take care to make sure there are no pieces of shell or egg yolk in the whites, and that the bowl you are using to contain them is completely clean with no residue of fat. Any fat from yolks or oil will make it difficult to beat the egg whites.', '2 Prepare cake pans: Prepare two 9-inch cake pans. Line the pans with parchment paper or wax paper. Lightly butter the sides of the pans (not the paper).', '3 Preheat oven to 350\\xc2\\xb0F (175\\xc2\\xb0C). ', '4 Mix ground walnuts and breadcrumbs: Mix together the ground walnuts and the bread crumbs in a small bowl and set aside.', '5 Beat egg yolks with sugar: Place the egg yolks into a mixing bowl and beat until smooth. Slowly add  3/4 cup of white sugar and continue to beat the egg yolks until thick and pale. (I use a hand mixer for this.)', '6 Whip egg whites, add sugar: Using a stand mixer, beat the egg whites with the whisk attachment until foamy.  Slowly drizzle in 1/4 cup of white sugar, and beat until soft peaks form.', '7 Fold egg whites and walnut mixture into yolk mixture: With a rubber spatula, gently fold the egg whites into the yolk mixture, alternately with the walnut mixture.', '8 Bake: Spoon the batter into the prepared, parchment-layered cake pans. Bake for 25 to 30 minutes at 350\\xc2\\xb0F (175\\xc2\\xb0C) until a slight imprint remains when touched.', '9 Make mocha frosting base: While the cake is cooking prepare the mocha frosting base. Place 1/2 cup of white sugar and 2 tablespoons of cornstarch into a saucepan. Turn the heat onto medium and gradually stir in the coffee and the chocolate chips. Stir continuously until the mixture starts to simmer and thicken quite substantially.', 'Continue to stir while the mixture simmers for 1 minute. Then remove from heat and stir in the butter and vanilla extract until well blended.', 'Let cool completely. (You will incorporate this mocha base into whipped cream when you frost the cake.)', '10 Let cakes cool, remove from pans and remove paper: Remove the cakes from oven and cool in the pans for 10 minutes. Run a dull knife around the edges of the cakes to separate it from the sides of the pans.', 'Carefully invert the cakes onto a rack. Carefully peel back and discard the parchment or wax paper. Let cool completely.  Note that if you want to make ahead, you can cook the cakes first, let cool to room temp, wrap with plastic wrap, and freeze until you are ready to frost and serve.', '11 Complete the frosting: Whip the cream until it is rather thick, just before that point to which if you kept on whipping it would turn to butter. This will help it hold up as a frosting. Once whipped, fold the whipped cream and mocha base together.', 'It may be a little speckled, and if you fold it only lightly, you can have almost a marbling effect of light and dark with the frosting, if you wish.', 'Place one cake on a serving platter. Frost the top. Place the second cake on top of it, and frost the top and sides of the cake.  Serve immediately, or keep chilled until serving.']",16
691,Snip Doodles (Snickerdoodle Coffee Cake) Recipe,10,20,30,"['For the cake batter:', '1 stick (4 ounces) unsalted butter, at room temperature', '1/2 cup (3 1/2 ounces) refined coconut oil, at room temperature', '1 1/2 cups (10 1/2 ounces) white granulated sugar', '1 1/4 teaspoon kosher salt (or 1/2 teaspoon iodized table salt)', '1 teaspoon baking powder', '1/8 teaspoon grated nutmeg', '1 tablespoon vanilla extract', '1 large egg, straight from the fridge', '2 1/3 cups (10 1/2 ounces) all-purpose flour', '1 cup (8 ounces) milk, any percentage', 'For topping:', '2 tablespoons white granulated sugar', '2 teaspoon ground cinnamon', 'Special equipment:', '9x13 baking dish']",16,"['1 Preheat the oven to 350\\xc2\\xb0F. Spray a 9x13-inch pan with cooking oil, then line the bottom and sides of the pan with parchment paper, letting 1-inch of the paper hang over the sides.', '2 Make the batter. Combine butter, coconut oil, sugar, salt, baking powder, nutmeg, and vanilla in the bowl of a stand mixer fitted with a paddle attachment. Mix on low speed to moisten, then increase to medium and beat until light and fluffy, about 5 minutes, pausing to scrape with a flexible spatula halfway through.', 'With the mixer running, crack in the egg and continue beating until smooth. Add a third of the flour, then a third of the milk, alternating between the two, until fully incorporated and smooth. Fold once or twice with a flexible spatula to ensure the batter is well mixed from the bottom up.', 'Pour the batter in the prepared baking and spread into an even layer. Mix together the sugar and cinnamon for the topping and sprinkle over the top of the batter.', '3 Bake the bars: Bake in the oven for 18 to 22 minutes or until a toothpick inserted in the middle comes out with a few crumbs attached.', 'Cool for 15 to 20 minutes in the pan then carefully remove the entire cake from the pan by grabbing the sides of the parchment paper and lifting directly up from the pan and moving the cake to a cutting board. \\xe2\\x80\\x9cSnip\\xe2\\x80\\x9d the cake into squares with a knife or pizza cutter. Serve warm.', 'Wrapped in foil, Snip Doodles will keep up to 3 days at room temperature.']",7
692,Spicy Zucchini Soup Recipe,15,40,55,"['4 tablespoons extra virgin olive oil', '1 onion, finely chopped', '1/2 jalape\\xc3\\xb1o chile (or more to taste, depending on how spicy you would like the soup to be), seeds, stems and ribs removed and discarded, chopped', '3 chopped garlic cloves', '2 pounds chopped zucchini (skin on), about 5-6 cups', '1 1/2 cups chopped day-old bread (or 1 cup rice or cooked or uncooked potatoes)', '3 cups chicken broth (use vegetable broth for vegetarian or vegan option)', '1 cup water', '1/2 cup fresh mint leaves (spearmint), loosely packed, chopped', '1/2 cup fresh cilantro, loosely packed, chopped (optional)', '2 teaspoons lemon juice', 'Salt, to taste', 'Pepper, to taste', 'Lemon wedges (for garnish), optional']",14,"['1 Saut\\xc3\\xa9 the onions and jalape\\xc3\\xb1o: Heat the olive oil in a large pot over medium-high heat. Add the onion and the chopped jalape\\xc3\\xb1o, and saut\\xc3\\xa9 for 4 to 5 minutes until the onions are translucent, but not browned.', '2 Cook the garlic and zucchini. Add the garlic and zucchini to the pan and saut\\xc3\\xa9 for another 3 to 4 minutes, stirring often. Sprinkle with salt.', ""3 Add the bread and liquids: Add the bread, broth, and water, and bring to a simmer. Reduce the heat to low and simmer gently for 20 minutes. (Note: If you're using uncooked potatoes instead, you may need to simmer a little longer, depending on what kind of potatoes you use.)"", '4 Pur\\xc3\\xa9e the soup: Remove the soup from the heat. Add the mint and cilantro (if using). Pur\\xc3\\xa9e in a blender or food processor until smooth, working in batches if necessary. (You can also use an immersion blender.)', '5 Add lemon juice, salt, pepper: Return the soup to the pot. Add the lemon juice, along with salt and pepper to taste.', '6 Garnish and serve: Garnish with lemon wedges and sprigs of mint or cilantro. Serve hot or chilled. Keeps for up to a week in the fridge.']",6
693,Jamaican Jerk Burgers Recipe,20,45,65,"['2 teaspoons white vinegar', '1 Tbsp water', '1/2 Scotch bonnet or habanero chili pepper, seeds removed, minced', '1/2 cup chopped green onion, including greens', '2 cloves garlic, chopped', '1 Tbsp fresh thyme', '1 teaspoon ground allspice', '1 teaspoon ground cinnamon', '1/4 teaspoon ground nutmeg', '1 teaspoon ground ginger', '1 teaspoon molasses', '1/2 teaspoon salt', '1/2 teaspoon freshly ground black pepper', '1 1/2 pounds ground beef, at least 16% fat', 'Coleslaw:', '2 cups shredded cabbage', '1/4 cup chopped red onion', 'Pinch of chopped thyme', '3 Tbsp mayonnaise', '2 Tbsp of orange juice or lime juice (if using lime juice add a teaspoon of sugar)', '1 teaspoon of grated orange or lime zest', 'Salt and freshly ground black pepper to taste']",22,"['1 Make the jerk mixture: In a food processor, put the vinegar, water, chili, green onion, garlic, thyme, allspice, cinnamon, nutmeg, ginger, molasses, 1/2 teaspoon each of salt and pepper. Pulse until finely chopped.', 'If you do not have a food processor, finely mince the chili, garlic, and green onion. Mix ingredients together in a bowl.', '2 Make the patties: Using your hands, gently mix the jerk mixture in with the ground beef in a large bowl until just incorporated. Do not over-mix.', 'Shape into patties, about 1/2 inch thick and wider than the diameter of your hamburger bun.', '3 Chill the patties: Chill about 30 minutes or until you are ready to cook. (Remember to wear gloves while handling jerk seasoning or thoroughly wash hands with soap and water after handling.)', '4 Make the coleslaw: In a medium bowl, gently mix the cabbage, red onion, thyme, mayonnaise, citrus juice, zest, salt and pepper.', ""5 Grill the jerk burgers: Prepare gas or charcoal grill for cooking over high direct heat. Place the patties on the clean, well-oiled grill grate. Grill the burgers for about 5 minutes per side. Do not press down on the burgers while cooking. If you don't have a grill, you can use a grill pan or a cast iron frying pan."", '6 Serve: Serve burgers topped with coleslaw, with or without hamburger buns.']",8
694,Southern Style Collard Greens Recipe,10,120,130,"['2 Tbsp bacon fat, lard or vegetable oil', '1 medium onion, sliced from root to tip', '1 ham hock', '2 garlic cloves, smashed', '1 quart chicken broth', '1-2 cups water', '8-10 cups chopped collard greens, about 2 pounds', 'Vinegar and hot sauce to taste']",8,"['1 Cook the onions in bacon fat: Heat the bacon fat in a large pot set over medium-high heat. Saut\\xc3\\xa9 the onion in the bacon fat, stirring often, until the edges begin to brown, about 5 minutes.', '2 Add the ham hock, smashed garlic, chicken stock and water and bring to a simmer. Cover and cook for 1 hour.', '3 Add the collard greens to the pot and cook until tender, another 45 minutes to an hour.', '4 Chop the meat, add to the greens: To serve, remove the ham hock, pull the meat off the bones and chop. Mix the meat back with the greens and serve with vinegar and hot sauce at the table.']",4
695,Collard Greens with Bacon Recipe,10,30,40,"['4 strips thick-sliced bacon, sliced crosswise into 1/2-inch pieces', '1 small yellow onion, chopped', '2 garlic cloves, minced', '2 tablespoons sugar', '1 teaspoon kosher salt', '1/2 teaspoon freshly ground black pepper', 'Several dashes hot sauce', '1/4 cup apple-cider vinegar', '2 pounds collard greens, stems removed, sliced into 3-inch-wide strips (can substitute kale or chard)', '1 cup chicken broth (or water)*']",10,"['1 Cook bacon and onions: Heat a large skillet on medium heat. Cook the bacon in the skillet until it just begins to brown around the edges, stirring occasionally.', 'Add the onions and cook until they have softened and are just starting to brown.', '2 Add the garlic, salt, pepper, sugar and hot sauce. Cook until the garlic becomes fragrant, about a minute.', '3 Add the vinegar, bring to a simmer, and cook until the amount of liquid is reduced by half, stirring and scraping up any browned bits from the bottom of the pot.', '4 Add the collard greens and the chicken broth (or water) and bring to a simmer. Reduce the temp to medium-low. Cook, stirring occasionally, until the collard greens have wilted and have lost their brightness.', 'Season to taste with additional vinegar and hot sauce.', 'Serve with some of the pan juices from the pan.']",7
696,Instant Pot Refried Beans Recipe,5,555,560,"['1 pound dried pinto beans', '8 cups water', '2 teaspoons kosher salt, plus more for seasoning', '3 tablespoons bacon fat, lard, or extra virgin olive oil', '1 medium yellow onion, diced', 'Garnish:', 'Grated cotija, Monterey jack, or cheddar cheese', 'Lime wedges', 'Hot sauce', 'Special equipment:', '6-quart Instant Pot']",11,"['1 Combine the beans, water and salt: Add the pinto beans, water, and salt to the pressure cooker and stir to dissolve the salt.', 'At this point, you can let the beans soak for 8-10 hours, or cook them right away. You can also cook the beans in their soaking water, or drain and replace with fresh water if you like. It\\xe2\\x80\\x99s up to you!', '2 Cook the beans: When you\\xe2\\x80\\x99re ready to cook the beans, secure the pressure cooker lid in its sealed position.', 'Select the manual setting on your pressure cooker (or the bean setting, if it has one) and set the time for 20 minutes at high pressure for soaked beans, or 25 minutes at high pressure for unsoaked beans.', '(It will take about 15 minutes for the pot to come up to pressure before the cooking program begins.)', '3 Release the pressure: When the cooking program ends, let the pressure release naturally\\xe2\\x80\\x94this will take about 35 minutes. (When cooking foods like beans, grains, and fruit sauces in a pressure cooker, it\\xe2\\x80\\x99s best to let the pressure release naturally to avoid a hot, spurty mess.)', 'Open the pot. If the beans are not cooked through at the end of the cooking program, close the pot and cook them for another 5 or 10 minutes. You\\xe2\\x80\\x99ll need to let the pressure release naturally for at least 15 minutes before opening the pot once more, to prevent any liquid spurting out of the pressure cooker lid.', '4 Drain the beans: Ladle out 1 1/2 cups of the cooking liquid and reserve. Next, wearing heat-resistant mitts, lift the inner pot out of the pressure cooker and drain the beans in a colander. Rinse out the inner pot, wipe it dry, and place it back in the pressure cooker housing.', '5 Saut\\xc3\\xa9 the fat and onions: Reset the pressure cooker\\xe2\\x80\\x99s cooking program by pressing the cancel button, then select its medium saut\\xc3\\xa9 setting and add the bacon fat, lard, or olive oil.', 'Once the fat has melted (if using olive oil, heat for a minute or two), add the onions and saut\\xc3\\xa9 them for about 3 minutes, just until softened but not browned. Cancel the saut\\xc3\\xa9 program and turn off your pressure cooker, then add the beans (they should still be steaming hot).', ' 6 Mash the beans: For a chunky texture, use a potato masher to mash the beans as much as you like. For a smooth texture, use an immersion blender to pur\\xc3\\xa9e them.', 'Add 3/4 cup of the reserved cooking liquid and stir to combine. Continue adding the cooking liquid a little at a time until the beans reach your desired texture. (I like to use a full cup.) They will also thicken as they sit. Taste for seasoning, adding salt if needed.', '7 Serve or keep: At this point, you can serve the beans right away, or set your pressure cooker to its \\xe2\\x80\\x9cKeep Warm\\xe2\\x80\\x9d setting, cover the pot, and let the beans sit, covered, for up to 10 hours.', 'Spoon the beans into bowls or onto serving plates, sprinkle with cheese, and serve warm, with lime wedges and hot sauce at the table.']",14
697,Slice-and-Bake Pistachio Butter Cookies Recipe,30,75,105,"['3/4 cup (90 g) shelled raw pistachio nuts', '2 cups (280 g) all-purpose flour', '2/3 cup (85 g) powdered sugar', '1/4 teaspoon salt', '14 tablespoons (1 3/4 sticks, 198 g) unsalted butter, softened to room temperature', '1 egg yolk', '1 teaspoon vanilla extract']",7,"['1 Finely chop the pistachios: Place the pistachios in a food processor. Pulse until very finely chopped, but not so much that the nuts become powder or start to break down into nut butter. Transfer to a rimmed baking sheet and set aside.', '2 Make the cookie dough: Into a food processor, measure the flour by scooping up the flour in the measuring cup and then sweeping across the top with the dull edge of a butter knife. Measure the sugar in the same manor. (Or weigh your ingredients.) Add the salt.', 'Pulse a few times to mix the dry ingredients. Cut the butter into a few chunks and scatter over the top of the dry ingredients. Pulse just until the mixture forms crumbs.', 'Whisk the yolk with the vanilla with a fork (this helps them mix more easily), and add to the food processor, scraping the small bowl with a rubber spatula so all the yolk is added. Pulse again in 15 or so long bursts, just until the dough forms large moist clumps.', ""(If your dough isn't forming clumps or seems very dry and crumbly, let it sit at room temperature for 10 to 15 minutes to let the butter warm and soften a little more, then try pulsing again.)"", '  3 Shape the dough into logs: Turn the dough out onto the counter and use your hands to gather the clumps together to form a ball. Knead once or twice against the counter so the dough sticks together and looks smooth, but be careful of overworking. The dough should be smooth and pliant, like firm play-dough.', 'Use the bench scraper or a knife to cut the dough in half. Shape each half into a log that is 13-to-14-inches long and 3/4-inch wide, rolling them under your palms until they are smooth. Cut each log in half again to make 4 shorter logs.', '4 Roll the logs in nuts: Working one log at a time, roll the logs in the chopped nuts. Gently press the pistachios into the dough so the logs are coated.', '5 Chill the logs: Wrap the logs in plastic wrap and refrigerate until firm, at least an hour. Logs can also be left refrigerated for up to 3 days or frozen for up to 3 months. (If frozen, thaw overnight in the fridge before baking.)', '6 Slice and bake the cookies: Set the oven to 350\\xc2\\xb0F (175\\xc2\\xb0C). Line 2 baking sheets with parchment paper. Use a small sharp knife to cut the chilled logs into 1/4-inch slices. If any nuts fall off, just press them back into the dough.', 'Arrange the cookies 1-inch apart on the baking sheet.', '7 Bake the cookies for 12 to 15 minutes, or until the nuts begin to brown at the edges. The cookies should be set and firm but not golden. Lift the cookies, still on the parchment paper, to wire racks to cool completely.', 'Store in an airtight container for up to 4 days.']",13
698,Cranberry Pistachio Chocolate Biscotti Recipe,20,50,70,"['2 cups (280 grams) all-purpose flour', '1 cup (200 grams) sugar', '1/2 cup (47.5 grams) unsweetened Dutch process cocoa powder', '1 1/2 teaspoons baking powder', '1/8 teaspoon baking soda', '1/2 teaspoon salt', '1 tablespoon finely grated orange zest', '3/4 cup dried sweetened cranberries', '3/4 cup shelled pistachios', '3 large eggs', '2 teaspoons vanilla extract']",11,"['1 Preheat the oven to 350\\xc2\\xbaF. Line 2 baking sheets with parchment paper.', '2 Combine dry ingredients: In a large bowl, sift the flour, sugar, cocoa powder, baking powder, baking soda, and salt. Stir in the orange zest, cranberries and pistachios until combined.', '3 Whisk together the eggs and vanilla, in a separate bowl.', '4 Make the dough: Add the eggs to the bowl of dry ingredients and stir until blended. Use your hands as necessary to bring the dough together, mixing until no more dry flour remains.', '5 Shape the dough: On a lightly floured surface, turn out the dough and divide it in half. Shape each half into a log roughly 12 inches long and 2 inches wide. Place the logs about 4 inches apart on one of the baking sheets.', ""6 Bake the biscotti logs: Bake the logs for 30 minutes, rotating the pans halfway through. When done, the logs should be risen and slightly firm. (They will still be a little soft in the center and that's ok.)"", '7 Cool the logs for 10 minutes: Slide the logs, still on the parchment, onto a wire rack to cool for 10 minutes. The logs should still be warm and a little soft. Do not let the logs cool for longer or they become to crisp and brittle to slice neatly.', '8 Slice the logs into biscotti: Transfer the logs to a cutting board. Use a serrated knife to cut the logs into slices roughly 1/2-inch thick \\xe2\\x80\\x93 cut at a right angle for small biscotti or at a sharp angle for larger biscotti.', 'Transfer the biscotti to the baking sheets. Arrange the cookies close together, but without touching.', '9 Bake the cookies: Bake for 8 minutes. Turn the slices over and continue baking for 5 to 6 minutes longer, or until the biscotti are firm and dry. Cool on a wire rack.', 'The finished biscotti will keep for 2 weeks in an airtight container, but I doubt you will have them around that long. The baked cookies will also freeze well for up to 3 months.']",11
699,Couscous with Pistachios and Apricots Recipe,20,10,30,"['1/2 cup chopped red onion', '1/4 cup lemon juice', '1 10-ounce box of couscous, about 1 1/3 cups', '2 tablespoons extra virgin olive oil, divided', '1 teaspoon salt, plus more to taste', '1/2 cup shelled raw pistachios*', '10 dried apricots, chopped', '1/3 cup chopped parsley', 'Optional 2 teaspoons harissa, prepared or homemade (see this Paula Wolfert harissa recipe)', '*If you only have access to shelled roasted pistachios, use them and skip step 2 in the method instructions.']",10,"['1 Soak chopped onion in lemon juice: Place the chopped onion in a small bowl. Pour the lemon juice over the onions, set aside and let the onions soak in the lemon juice.', ""2 Toast pistachios: Toast the pistachios in a small pan on medium-high heat until lightly browned and fragrant. (Take care when toasting nuts, they can burn quickly if you don't pay attention!) Remove from heat and place into a small bowl to cool."", '3 Cook the couscous: Put 2 cups of water in a medium saucepan and bring to a boil. Add one tablespoon of olive oil and one teaspoon of salt to the water. Once the salt dissolves, stir in the couscous, turn off the heat and cover the pot. Move the pot off the hot burner and let the couscous steam, covered, for 5-6 minutes.', '4 Combine ingredients to make salad: Scoop out the couscous into a large bowl and fluff with a fork. Stir in the harissa, if using. Stir in the pistachios, chopped apricots and parsley. Stir in the red onion and lemon juice. Add one more tablespoon of olive oil, stir well and add salt to taste. Serve warm or at room temperature.']",4
700,Pistachio White Chocolate Chip Cookies Recipe,20,10,30,"['1 cup of unsalted butter, room temperature', '1 cup of sugar', '1 cup of dark brown sugar, packed', '2 eggs', '2 tablespoons of milk', '2 teaspoons of vanilla extract', '2 1/2 cups of flour', '1 teaspoon of baking soda', '1 teaspoon of baking powder', '1 teaspoon of kosher salt (can sub table salt)', '1 cup of rolled oats', '1 1/2 cups of coarsely chopped pistachios, raw and unsalted', '1 1/2 cups of white chocolate chips']",13,"['1 Preheat the oven to 350\\xc2\\xb0F.', '2 Beat the butter and sugars together on high speed for three minutes.', '3 Add the eggs, milk, and vanilla and beat for 3 minutes, being sure to scrape down the sides of the bowl to ensure even mixing.', '4 Combine dry ingredients, add to wet: In a separate bowl combine the flour, baking soda, baking powder, salt, and rolled oats. Add the dry ingredients to the butter mixture slowly, being sure to scrape down the sides and bottom of the bowl once or twice to ensure even mixing.', '5 Fold in the pistachios and white chocolate chips.', '6 Drop heaping teaspoonfuls onto parchment lined cookie sheets, add an extra pistachio or two on top of each bit of dough for decoration if desired.', '7 Bake at 350\\xc2\\xb0F for 8-10 minutes or until golden brown. Allow to set up on the cookie sheets before moving to a baking rack to cool completely.']",7
701,Radish Salad with Mint and Pistachios Recipe,20,5,25,"['1 pound of red or pink radishes, cut into 1/4-inch thick wedges', 'Grated zest of one lemon, about 1 teaspoon', '1/4 cup minced shallots, from 1 to 2 shallots', 'Juice from one lemon, about 3 to 4 Tbps', '1/2 teaspoon salt', 'A heaping 1/4 cup shelled pistachios', '10 large mint (spearmint) leaves, chopped or sliced thin, about 1/4 cup', '1 Tbsp extra virgin olive oil']",8,"['1 Marinate radish wedges: Mix the radish wedges, minced shallots, lemon zest, lemon juice, and salt in a bowl.  Let sit for 15 to 30 minutes.', '2 Toast the pistachios: Toast the shelled pistachios by heating a small skillet on medium high heat. Add the pistachios and heat until lightly browned. Remove from heat and let cool.', '3 Strain excess liquid: When you are ready to serve, if there is a lot of excess liquid in the radishes, strain some of it out.', '4 Toss the toasted pistachios, mint, and olive oil in with the radishes.', 'Serve immediately.']",5
702,Whipped Goat Cheese 7-Layer Dip Recipe,10,10,20,"['For the whipped goat cheese:', '10 ounces goat cheese, at room temperature', '1/4 cup plain whole milk yogurt', '1/4 cup whole milk', '1/2 lemon, juice only', 'Pinch of salt', 'For the toppings:', '4 strips cooked, crispy bacon, chopped', '2 tablespoons honey', '2 tablespoons golden raisins', '2 tablespoons chopped pistachios', '2 tablespoons chopped dates or dried figs', '1 tablespoon sunflower seeds', '1 tablespoon minced chives', 'Pita chips, for serving', 'Special equipment:', 'Hand mixer or stand mixer', '2 1/2 quart baking dish or 8x8 baking dish']",18,"[""1 Whip the goat cheese: In a medium bowl, add goat cheese, yogurt, milk, lemon juice, and a pinch of salt. Use a hand mixer or a stand mixer to whip the goat cheese mixture until it has a smooth, light consistency. (If you don\\xe2\\x80\\x99t have a hand mixer or stand mixer, you can use a fork to mash the ingredients together, but they won't have the same whipped consistency.)"", 'The finished dip should be easily spreadable with a knife. If it is too thick or seems dry, add more milk by the tablespoon.', '2 Assemble the dip: Spread the whipped goat cheese in a thin, even layer along the bottom of a 2 1/2-quart baking dish or an 8x8 baking dish. It shouldn\\xe2\\x80\\x99t be more than 1/2-inch thick in any part of the dip. Drizzle the honey over the dip; then sprinkle the bacon, golden raisins, pistachios, dates, sunflower seeds, and minced chives evenly over the top.', 'Keep covered in the fridge until ready to eat, then serve with pita chips.', 'This dip can be easily made 2-3 days in advance and keeps well in the fridge. If you make it in advance, wait to add the honey and chives until right before serving.']",5
703,Mozzarella and Tomato Skillet Pita Pizzas Recipe,5,30,35,"['4 pita rounds, 8- to 12-inches', '1 1/2 pounds fresh mozzarella', '4 medium tomatoes, thinly sliced', '1 pint mixed cherry tomatoes, halved', 'Olive oil, for sprinkling', 'Salt and pepper, to taste', 'Large handful fresh basil leaves']",7,"['1 Prepare the pita rounds: Use scissors to cut around the edge of each pita to make two thin rounds. Separate the rounds and set them on baking sheet with the rough sides facing up.', '2 Cut the mozzarella: Use a thin, sharp knife to slice the mozzarella as thinly as possible. It doesn\\xe2\\x80\\x99t matter if you don\\xe2\\x80\\x99t make even or perfect rounds.', ""3 Assemble the pizzas: Divide the mozzarella among the pitas. The cheese doesn't need to cover the rounds completely. Add a few slices of the large tomatoes, enough to almost cover the mozzarella. Fill in the gaps with cherry tomatoes. Drizzle with olive oil, then sprinkle with salt and pepper."", '4 Cook the pizzas: Heat a cast-iron or other heavy skillet over medium heat for 3 minutes, until a flick of water sizzles and evaporates on contact. Add 1 pizza round and cover the pan. Cook for 3 to 5 minutes, or until the mozzarella melts at the edges. Use a wide metal spatula to lift the pizza out of the pan and transfer to a plate. Cook the remaining pizzas in the same way. (If you have more than one skillet, use them to cook several pizzas at once.)', '5 Cut the basil: While the pizzas are cooking, prepare the basil. Stack the leaves on top of each other, then roll them up into a tube. Use a sharp knife to slice the tube thinly across. With your hands, fluff up the basil to separate the shreds. (Alternatively, just tear the basil with your fingers.)', '6 Finish and serve: Sprinkle the hot pizzas with a pinch of salt and basil. Serve immediately.']",6
704,Homemade Pizza Recipe,120,30,150,"['Pizza Dough: Makes enough dough for two 10-12 inch pizzas', '1 1/2 cups (355 ml) warm water (105\\xc2\\xb0F-115\\xc2\\xb0F)', '1 package (2 1/4 teaspoons) of active dry yeast', '3 3/4 cups (490 g) bread flour', '2 tablespoons extra virgin olive oil (omit if cooking pizza in a wood-fired pizza oven)', '2 teaspoons salt', '1 teaspoon sugar', 'Pizza Ingredients', 'Extra virgin olive oil', 'Cornmeal (to help slide the pizza onto the pizza stone)', 'Tomato sauce (smooth, or pur\\xc3\\xa9ed)', 'Firm mozzarella cheese, grated', 'Fresh soft mozzarella cheese, separated into small clumps', 'Fontina cheese, grated', 'Parmesan cheese, grated', 'Feta cheese, crumbled', 'Mushrooms, very thinly sliced if raw, otherwise first saut\\xc3\\xa9ed', 'Bell peppers, stems and seeds removed, very thinly sliced', 'Italian pepperoncini, thinly sliced', 'Italian sausage, cooked ahead and crumbled', 'Chopped fresh basil', 'Baby arugula, tossed in a little olive oil, added as pizza comes out of the oven', 'Pesto', 'Pepperoni, thinly sliced', 'Onions, thinly sliced raw or caramelized', 'Ham, thinly sliced', 'Special equipment:', 'A pizza stone, highly recommended if you want crispy pizza crust', 'A pizza peel or an edge-less cookie or baking sheet', 'A pizza wheel for cutting the pizza, not required, but easier to deal with than a knife']",30,"['MAKING THE PIZZA DOUGH', '1 Proof the yeast: Place the warm water in the large bowl of a heavy duty stand mixer. Sprinkle the yeast over the warm water and let it sit for 5 minutes until the yeast is dissolved.', ""After 5 minutes stir if the yeast hasn\\'t dissolved completely. The yeast should begin to foam or bloom, indicating that the yeast is still active and alive."", '(Note that if you are using ""instant yeast"" instead of ""active yeast"", no proofing is required. Just add to the flour in the next step.)', '2 Make and knead the pizza dough: Add the flour, salt, sugar, and olive oil, and using the mixing paddle attachment, mix on low speed for a minute. Then replace the mixing paddle with the dough hook attachment.', 'Knead the pizza dough on low to medium speed using the dough hook about 7-10 minutes.', ""If you don\\'t have a mixer, you can mix the ingredients together and knead them by hand."", ""The dough should be a little sticky, or tacky to the touch. If it\\'s too wet, sprinkle in a little more flour."", '3 Let the dough rise: Spread a thin layer of olive oil over the inside of a large bowl. Place the pizza dough in the bowl and turn it around so that it gets coated with the oil.', 'At this point you can choose how long you want the dough to ferment and rise. A slow fermentation (24 hours in the fridge) will result in more complex flavors in the dough. A quick fermentation (1 1/2 hours in a warm place) will allow the dough to rise sufficiently to work with.', 'Cover the dough with plastic wrap.', 'For a quick rise, place the dough in a warm place (75\\xc2\\xb0F to 85\\xc2\\xb0F) for 1 1/2 hours.', 'For a medium rise, place the dough in a regular room temperature place (your kitchen counter will do fine) for 8 hours. For a longer rise, chill the dough in the refrigerator for 24 hours (no more than 48 hours).', 'The longer the rise (to a point) the better the flavor the crust will have.', 'MAKE AHEAD FREEZING INSTRUCTIONS', 'After the pizza dough has risen, you can freeze it to use later. Divide the dough in half (or the portion sizes you will be using to make your pizzas). Place on parchment paper or a lightly floured dish and place, uncovered, in the freezer for 15 to 20 minutes. Then remove from the freezer, and place in individual freezer bags, removing as much air as you can from the bags. Return to the freezer and store for up to 3 months.', 'Thaw the pizza dough in the refrigerator overnight or for 5 to 6 hours. Then let the dough sit at room temperature for 30 minutes before stretching it out in the next steps.', 'PREPARING THE PIZZAS', ""1 Preheat pizza stone (or pizza pan or baking sheet): Place a pizza stone on a rack in the lower third of your oven. Preheat the oven to 475\\xc2\\xb0F (245\\xc2\\xb0C) for at least 30 minutes, preferably an hour. If you don\\'t have a pizza stone, you can use a pizza pan or a thick baking sheet; you need something that will not warp at high temperatures."", '2 Divide the dough into two balls: Remove the plastic cover from the dough. Dust your hands with flour and push the dough down so it deflates a bit. Divide the dough in half.', 'Form two round balls of dough. Place each in its own bowl, cover with plastic and let sit for 15 minutes (or up to 2 hours).', '3 Prep toppings: Prepare your desired toppings. Note that you are not going to want to load up each pizza with a lot of toppings as the crust will end up not crisp that way.', 'About a third a cup each of tomato sauce and cheese would be sufficient for one pizza. One to two mushrooms thinly sliced will cover a pizza.', '4 Flatten dough ball, and stretch out into a round: Working one ball of dough at a time, take one ball of dough and flatten it with your hands on a lightly floured work surface.', 'Starting at the center and working outwards, use your fingertips to press the dough to 1/2-inch thick. Turn and stretch the dough until it will not stretch further.', 'Let the dough relax 5 minutes and then continue to stretch it until it reaches the desired diameter - 10 to 12 inches.', 'Treat the dough gently!', 'You can also hold up the edges of the dough with your fingers, letting the dough hang and stretch, while working around the edges of the dough.', 'If a hole appears in your dough, place the dough on a floured surface and push the dough back together to seal the hole.', 'Use your palm to flatten the edge of the dough where it is thicker. Pinch the edges if you want to form a lip.', '5 Brush dough top with olive oil: Use your fingertips to press down and make dents along the surface of the dough to prevent bubbling. Brush the top of the dough with olive oil (to prevent it from getting soggy from the toppings). Let rest another 10-15 minutes.', 'Repeat with the second ball of dough.', '6 Sprinkle pizza peel with corn meal, put flattened dough on top: Lightly sprinkle your pizza peel (or flat baking sheet) with cornmeal. (The corn meal will act as little ball bearings to help move the pizza from the pizza peel into the oven.)', 'Transfer one prepared flattened dough to the pizza peel.', 'If the dough has lost its shape in the transfer, lightly shape it to the desired dimensions.', '7 Spread with tomato sauce and sprinkle with toppings: Spoon on the tomato sauce, sprinkle with cheese, and place your desired toppings on the pizza.', '8 Sprinkle cornmeal on pizza stone, slide pizza onto pizza stone in oven: Sprinkle some cornmeal on the baking stone in the oven (watch your hands, the oven is hot!). Gently shake the peel to see if the dough will easily slide, if not, gently lift up the edges of the pizza and add a bit more cornmeal.', 'Slide the pizza off of the peel and onto the baking stone in the oven.', '9 Bake pizza: Bake pizza in the 475\\xc2\\xb0F (245\\xc2\\xb0C) oven, one at a time, until the crust is browned and the cheese is golden, about 10-15 minutes. If you want, toward the end of the cooking time you can sprinkle on a little more cheese.']",39
705,How to Make the Best Cauliflower Pizza Crust,30,15,45,"['For the cauliflower pizza crust:', '2 cups cauliflower florets (7 ounces), cut into 1/2-inch pieces', '1/2 cup corn flour (or masa harina) (57 g)', '1 large egg', '2 tablespoons olive oil', '1/4 teaspoon Morton kosher salt', '2 tablespoons cornstarch', '5 ounces grated Parmesan cheese', 'Suggested toppings:', '1/2 cup tomato sauce, homemade or store-bought', '4 ounces fresh or shredded mozzarella cheese', 'Sliced tomatoes, basil, pepperoni, ham, pineapple, mushrooms, and/or olives (enough to lightly coat the cheese)']",12,"['1 Preheat oven: Place the oven rack in the upper-middle position and preheat the oven to 475\\xc2\\xbaF.', '2 Process the dough: Add cauliflower florets, corn flour, egg, olive oil, and salt to a food processor. Process on high speed, scraping down the bowl every 30 seconds, until a smooth and sticky puree if formed\\xe2\\x80\\x94about 3 minutes total.', 'Add the cornstarch and process on high speed for 30 seconds. Add Parmesan cheese and pulse until just combined, 5 to 6 pulses.', '3 Shape the crust: Lightly grease a piece of parchment paper with olive oil. Transfer pizza dough to the paper. Lightly sprinkle more corn flour on top.', 'Use your hands to press and shape the dough into a 10-inch circle, then use a rolling pin to gently roll out the dough to about 11-inch circle. Dust the dough with more corn flour as needed to prevent sticking while shaping and rolling.', '4 Par-bake the crust: Bake the crust for 10 minutes. Remove the crust from the oven and allow it to cool for 3 minutes, and then run a spatula underneath the crust to carefully remove and then transfer to a wire rack set inside a baking sheet. Discard the parchment.', '5 Add toppings: Spread the pizza sauce over the crust, leaving a 1/2-inch border. Place the cheese and tomatoes (or other toppings) on top.', '6 Bake the pizza: Bake until the cheese is melted and pizza edges are golden and lightly crisp, 5 to 7 minutes.', '7 Serve: Garnish pizza with fresh basil leaves, sprinkle with salt and black pepper.', 'Leftovers will keep for about a week. To reheat, place on a foil-lined baking sheet and cook at 375\\xc2\\xbaF until the cheese is melted and the crust is warm and crisp, 5 to 7 minutes.']",10
706,Easy Ham and Cheese Stromboli Recipe,15,40,55,"['1 pound prepared pizza dough (homemade or store-bought)', 'All-purpose flour, for sprinkling', '16 thin-cut slices Genoa salami (1/3 pound)', '8 thick-cut slices capicola ham (1/3 pound)', '16 slices provolone (1/4 pound)', '1 1/2 cups shredded mozzarella', '1 cup peppadews, or roasted red peppers, drained', '1 tablespoon drained capers', '1 large egg, lightly beaten', '2 tablespoons grated Parmesan, for sprinkling']",10,"['1 Heat the oven to 400\\xc2\\xb0F. Place an oven rack in the lower third of the oven.', '2 Roll out the dough: Lay a 16-inch sheet of parchment paper on the counter and dust it with flour. Roll the dough on the floured parchment paper to a 14-by-11-inch rectangle.', '3 Add the filling: Layer the salami on the dough to within 1/2-inch of the edges, and overlap the slices so that no dough shows beneath the salami. Add provolone, followed by the ham, mozzarella, and then the peppadews. Finally, sprinkle with capers.', ""4 Roll up the dough: Brush the edges of the dough with egg. Using the parchment to help you, lift up one long end and start rolling. Continue rolling until the seam on the log is on the bottom. Pinch the ends so they don\\'t open and tuck the dough under the roll."", '5 Transfer to the baking sheet: Using the parchment paper as a sling, transfer the log on the paper to the baking sheet. Brush all over with egg and sprinkle with Parmesan. Use a paring knife to cut diagonal slits at 1-inch intervals all along the top.', '6 Bake the stromboli: Bake the stromboli for 15 minutes. Turn the oven down to 375\\xc2\\xb0F and continue baking for 25 minutes, or until the log is golden and the cheese is oozing at the slits.', '7 Cool and serve: Cool on the pan for about 10 minutes. Cut into slices along the slits. Serve immediately while hot; stromboli is also delicious at room temperature.']",7
707,Skillet Tortilla Pizza Recipe,5,5,10,"['Flour tortillas (about 8-inches diameter)', 'Grated mozzarella cheese', 'Tomato sauce', 'Fresh basil leaves, thinly sliced']",4,"['1 Heat flour tortilla on skillet until it puffs up: Heat a large cast iron skillet or griddle on medium high to high heat. Place a flour tortilla in the center of the skillet.', 'When the tortillas begins to puff up or form air bubbles, flip it and turn the heat down to medium low. Pierce the air bubbles with a knife tip or the tines of a fork to deflate them a bit.', '2 Add toppings: Sprinkle the top of the tortilla with a thin layer of grated mozzarella cheese. Once the cheese is about half-way melted, spoon on a thin layer of tomato sauce, using the back of the spoon to spread over the cheese. Sprinkle the top of the tomato sauce with a little more cheese.', '3 Remove from heat and cover to melt cheese: Once the edges of the tortilla are browning, indicating that the bottom of the tortilla is getting nice and brown, remove the pan from the heat.', 'Cover the top of the pan with a cover for about a minute or so, so the cheese on top can melt with the residual heat from the pan.', '4 Sprinkle with fresh sliced basil. Remove to a plate and cut with a pizza cutting wheel or sharp knife.', 'Serve immediately.']",7
708,"Tortilla Pizza with Onions, Mushrooms, and Ricotta Recipe",10,20,30,"['1 tablespoon extra virgin olive oil, plus more for brushing on tortilla and pan', '1 small red onion, halved and thinly sliced, about 3/4 cup sliced onion', 'Pinch of sugar', '1 teaspoon balsamic vinegar', '2 large flour tortillas (sandwich wraps)', '1/2 cup shredded Asiago cheese', '2/3 cup ricotta cheese', '4 button or cremini mushrooms, trimmed and thinly sliced', 'Kosher salt and freshly ground black pepper']",9,"['1 Preheat oven: Place racks in the upper and lower thirds of the oven. Preheat the oven to 450\\xc2\\xb0F.', '2 Saut\\xc3\\xa9 onions: Heat 1 Tbsp olive oil in a small saut\\xc3\\xa9 pan on medium high heat. Add the sliced onions and cook, stirring occasionally, until the onions begin to soften.', 'Add a pinch of sugar and the balsamic vinegar, cook for a few more minutes until the onions are thoroughly softened and translucent. Remove from heat.', '3 Brush sheet pan and tortillas with olive oil: Brush a sheet pan with olive oil. Place a tortilla on each baking sheet and brush each with olive oil.', '4 Sprinkle tortillas with cheese, mushrooms, onions: Sprinkle each tortilla with half a cup of shredded Asiago cheese. Add bits of ricotta cheese, 1/4 cup for each tortilla.', 'Sprinkle with mushrooms and with the slightly caramelized onions. Sprinkle with a little salt and pepper.', '5 Bake: Place the baking sheets in the oven. Bake until the crust is crisp and brown all over, about 10 minutes (the time varies, depending on the oven), rotating the sheet pans and swapping out their positions on the racks halfway through the cooking to ensure even baking.', 'Cut with a pizza cutter or a knife.']",8
709,Spinach & Artichoke Sheet Pan Pizza Recipe,30,15,45,"['3 tablespoons olive oil, divided', '1 pound pizza dough (store-bought or homemade)', '1 teaspoon Italian seasoning', '4 cloves garlic, chopped', '1 (6-ounce) bag baby spinach', '1 (12- to 14-ounce) jar marinated artichoke hearts, drained thoroughly (and sliced if needed; see Recipe Note)', '1 1/2 cups (6 ounces) shredded mozzarella cheese', 'Crushed red pepper flakes (optional)', 'Special equipment:', '13x18 baking sheet']",10,"['1 Preheat the oven to 450\\xc2\\xbaF. Position an oven rack in the lower half of the oven. Grease an 13x18-inch baking sheet with 1 tablespoon of the olive oil.', '2 Roll out the dough: If your pizza dough has been in the refrigerator, remove it and set it on the counter at room temperature for 20 minutes.', 'Generously flour a pastry board, then turn the dough out onto the board. Use a rolling pin to roll the dough into a large rectangle.', '3 Transfer the dough to the pan: Transfer the dough to the oiled sheet pan, stretching it out to the corners of the pan. If it springs back, wait a few minutes and then try again.', 'Drizzle 1 tablespoon of the olive oil onto the dough. Use a pastry brush or your fingers to gently spread the oil all over the dough, taking care not to create any tears. Sprinkle the Italian seasoning evenly over the dough.', '4 Wilt the spinach: Heat the remaining tablespoon of oil and the garlic in a large skillet over medium heat. When the garlic begins to bubble, add the spinach. Saut\\xc3\\xa9 until the spinach has wilted, about 2 minutes, then turn off the heat.', '5 Top the pizza: If the dough has shrunk away from the corners, give it a final stretch to reach the sides of pan. Sprinkle on half of the mozzarella over the pizza, followed by the saut\\xc3\\xa9ed spinach and then the artichokes. Sprinkle with the rest of the mozzarella.', '6 Bake the pizza: Bake the pizza until the cheese is bubbly and golden brown, 12 to 15 minutes.', '7 Slice and serve: Use two spatulas to lift the pizza from the pan and transfer it to a large cutting board to slice into squares, or use a pizza wheel to slice it right in the pan. Serve the pizza piping hot, sprinkled with crushed red pepper flakes (optional).']",9
710,Sheet Pan Pizza with Roasted Cauliflower and Greens Recipe,35,15,50,"['1/2 large head cauliflower', '6 tablespoons olive oil, divided', '1/2 teaspoon salt', '1/4 teaspoon pepper', '1 recipe (about 1 1/2 pounds) No-Knead Whole Wheat Pizza Dough, or store-bought dough', '1 cup (2 ounces) grated Parmesan', '12 ounces fresh mozzarella, torn into pieces', '2 tablespoons drained green peppercorns in brine, or drained capers', '3 handfuls baby greens such as arugula, kale, or spinach', '1 tablespoon balsamic vinegar', 'Special equipment:', '2 (13 x18) rimmed baking sheets']",12,"['1 Preheat the oven to 450\\xc2\\xbaF. Place a rack in the lowest position.', '2 Prepare the cauliflower: Trim away the outer leaves and cut the cauliflower in half Cut one half into slices about 1/4-inch thick, and reserve the other half for another use (or roast it all now and save half for another meal.) Some smaller florets will fall away; this is fine.', 'Spread the cauliflower slices and any florets that have fallen off on a rimmed baking sheet. Drizzle with 2 tablespoons of the oil. Using your hands, rub the oil into the cauliflower, coating both sides. Sprinkle with 1/2 teaspoon salt and 1/4 teaspoon pepper.', '3 Roast the cauliflower: Place the cauliflower on the lower rack of the oven. Roast for 20 minutes, or until tender. Let the cauliflower cool slightly on the pan and break or cut it into smaller pieces.', 'At this point, the cauliflower can be kept refrigerated for up to 5 days.', '4 Stretch the dough onto the baking sheet: Wipe clean the baking sheet used to roast the cauliflower. Place the dough in the center of the baking sheet and drizzle with 2 tablespoons of the oil. Turn the dough to coat it well, spreading some of the oil over the baking sheet.', 'Gradually stretch the dough until it reaches the edges of the baking sheet. If it springs back or is difficult to stretch, cover with plastic wrap and let rest for 10 minutes before continuing.', '6 Turn the oven to 500\\xc2\\xbaF.', '7 Top the pizza: Brush the top of the dough with 1 tablespoon of oil and sprinkle with the grated Parmesan. Top with the mozzarella, followed by the cauliflower. Sprinkle the peppercorns (or capers) evenly over the dough.', '8 Bake the pizza: Set the pan on lowest shelf of the oven and bake for 15 minutes, or until the cheese melts and the pizza is golden brown.', '9 Top with greens: In a bowl, toss the greens with the remaining tablespoon of the oil, the vinegar and salt and pepper. Top the cooked pizza with the greens; they will wilt slightly from the heat of the pizza. Cut into squares and serve hot.']",11
711,Pepperoni Pizza Pockets Recipe,20,25,45,"['2 (9-inch) pie crusts, homemade or store-bought', '1/3 cup pizza sauce, homemade or store-bought', '1 to 1 1/2 cups grated mozzarella cheese', '1/2 cup diced pepperoni', '2 tablespoons minced fresh basil', '1 egg plus 1 tablespoon water, for the egg wash']",6,"['1 Heat the oven to 375\\xc2\\xb0F. Line a baking sheet with parchment paper and set aside. ', '2 Roll and cut out the dough: Roll out your pie crust on a lightly floured surface until it\\xe2\\x80\\x99s about 1/8-inch thick. If you are using store-bought crust, make sure it\\xe2\\x80\\x99s thawed before unrolling it.', 'Use a 6-inch round to cut circles out of the pie crust. (I use a 6-inch tortilla as a guide for mine; a pot lid of same size would work, too.) You should get 3 hand pies out of each pie crust, but you will probably have to re-roll the crust to get the last few.', 'Place the pie crust rounds on the baking sheet.', '3 Fill the pizza pockets: The key to hand pies like these is to not overfill them while making sure they have enough filling to feel substantial. Add 2 to 3 teaspoons of pizza sauce, followed by 2 tablespoons grated mozzarella (you can eyeball it), followed by 1 tablespoon diced pepperoni and a sprinkle of fresh basil to each circle of pie dough. Be sure to leave a 1/2-inch border around the fillings to make sealing easier.', '4 Seal the pizza pockets: Brush a light coating of egg wash around the edges of the hand pie and fold it over. Seal the hand pie completely, either by pressing on the edge with a fork or by crimping the edge between your fingers. Poke a few holes in each hand pie with a fork, so steam can escape.', '5 Bake the hand pies: Brush the hand pies with egg wash, and bake them for 20 minutes until the pie crust is golden brown. Some of the filling might be bubbling out of the pies, but that\\xe2\\x80\\x99s okay.', 'Let the pies cool briefly before serving.', 'Leftovers can be stored in the fridge for 3 to 4 days and reheated in a 350\\xc2\\xb0F oven for 10 minutes. Also, these pizza pockets can be assembled in advance and stored in the fridge until you need to bake them.', 'They freeze best once they are baked and have cooled. Reheat from frozen in a 325\\xc2\\xb0F oven for about 20 minutes, or until warmed through.']",10
712,Air Fryer Tostones Recipe,20,45,65,"['For the dipping sauce:', '1 cup mayonnaise', '1/4 cup ketchup', '1/4 teaspoon garlic powder', 'For the tostones:', '3 green plantains', '4 cups cold water', '1 tablespoon kosher salt', '3 tablespoons neutral cooking oil (vegetable, peanut, or coconut oil)', 'coarse salt for sprinkling', 'Special equipment:', 'Tostonera, optional', 'Air fryer']",13,"['1 Prepare dipping sauce: Whisk together the mayonnaise, ketchup, and garlic powder. Store covered in the refrigerator until ready to serve. You can do this up to 48 hours in advance.', '2 Peel and cut the plantains: Remove the ends of the green plantains with a sharp knife. Score the plantain down its back side and use the fleshy part of your thumbs to push the peel up and away from the plantain.', '3 Preheat your air fryer to 350\\xc2\\xb0F.', '4 Soak the plaintains: Combine 4 cups of cold water and 1 tablespoon of kosher salt. Slice the plantain into 1 1/2-inch-thick chunks and soak them in water for 20 minutes. (Soaking the plantains prevents browning and keeps the air-fried plantains from drying out while cooking.', '5 Dry then par-fry the plantains: Remove the plantains from the water and dry each one thoroughly. Toss the plantain slices in a bowl with 1 tablespoon of the cooking oil. Make sure each plantain is coated in a thin layer of the oil.', 'Transfer the plantains to your air fryer\\xe2\\x80\\x99s basket. Organize in a single layer, leaving a 1/2 inch of space on all sides of the slices to allow the air to circulate properly. Fry until the plantain offers no resistance when pierced with the tip of a knife. This can take anywhere from 3 to 6 minutes per side.', '6 Mash the plantains: Increase the air fryer\\xe2\\x80\\x99s temperature to 400\\xc2\\xb0F. Carefully remove the plantain slices from the basket and smash each one in a tostonera or place your soft plantain between a piece of parchment paper (or a brown paper bag) and smash it with a coffee mug. The plantain should be a flat 1/4-inch thick disc that holds together.', '7 Air fry the smashed plantains: Return the smashed plantains to the air fryer basket (you may have to work in batches depending on the size of your basket).', 'Brush a light layer of oil onto the top side of the tostones and fry for 3 minutes on the first side. Flip the tostones and brush once more with a light layer of oil, then fry for the final time for 4 minutes instead of 3 minutes.', '8 Season the tostones: Immediately after removing them from the air fryer. Serve the tostones with the mayo-ketch sauce while still hot.']",10
713,Plum Upside Down Cake Recipe,20,40,60,"['1 1/4 stick butter (10 tablespoons or 1/2 cup plus 2 tablespoons), softened', '1/4 cup plus 2 tablespoons brown sugar, firmly packed', '4 plums, pitted and sliced', '5 tablespoons buttermilk OR 4 tablespoons milk plus 2 teaspoons milk and 1 teaspoon lemon juice', '3/4 cup cake flour', '1/2 teaspoon baking powder', '1/8 teaspoon baking soda', '1/4 teaspoon cinnamon', 'Pinch salt', '1/2 cup granulated sugar', 'Zest of 1/2 an orange', '1 egg', '1 teaspoon vanilla extract', 'Special equipment:', 'Four 10 or 8 ounce ramekins']",15,"['1 Preheat oven to 350\\xc2\\xb0F. Butter the insides of the ramekins.', '2 Melt butter and brown sugar, pour into bottom of ramekins: Melt 3/4 stick (6 Tbsp) of the butter in medium saucepan over medium heat. Add brown sugar and whisk until smooth. Pour into the bottoms of the buttered ramekins, dividing the sugar butter sauce evenly among them.', '3 Arrange a layer of plum slices at the bottom of each ramekin.', '4 Whisk together dry ingredients for batter: In a separate bowl, vigorously whisk together the cake flour, baking powder, baking soda, cinnamon and salt.', '5 Make cake batter: Use an electric mixer to beat together the remaining 1/2 stick (1/4 cup or 4 Tbsp) butter with the granulated sugar and orange zest.', 'Add the eggs and vanilla, mix to combine.', 'Alternately add the dry flour mixture and the buttermilk (or lemon soured milk) mixture to the batter.', '6 Bake: Divide the batter among the ramekins. Place the ramekins on a rimmed baking sheet and put in the oven on the middle rack. Bake at 350\\xc2\\xb0F for 35 to 40 minutes, until cakes are firm to the touch, and a toothpick or skewer inserted in the center does not come out with raw batter on it. (Might be wet from plum juice.) Turn the baking sheet around half-way through the baking to ensure an even baking for all the cakes.', '7 Cool and invert: Remove from oven and let cool on a rack until no longer hot to the touch. Run a paring knife around the edges of the ramekins. Invert onto a plate and gently lift off of the plate.', 'Serve alone or with whipped cream or vanilla ice cream.']",10
714,Plum Walnut Skillet Cake Recipe,30,45,75,"['Butter (for the pan)', '5 to 6 firm plums (about 1 pound)', '3/4 cup walnuts halves', '1/2 cup (1 stick) unsalted butter, cut into slices', '3/4 cup sugar', '2 large eggs', 'Zest of one lemon', '1 teaspoon vanilla extract', '1 1/4 cups all-purpose flour', '3/4 teaspoon baking powder', '1/8 teaspoon salt', '2 tablespoons turbinado sugar or sugar in the raw', '2 tablespoons honey (optional)', 'Special equipment:', '10-inch oven-proof skillet, or 9-inch cake pan', 'Food processor']",16,"['1 Preheat the oven to 350\\xc2\\xbaF. Generously butter a 10-inch ovenproof skillet with a heatproof handle or a 9-inch cake pan. Halve, pit, and thinly slice the plums.', '2 Grind the walnuts: In a food processor or a nut mill, very finely chop the walnuts. Transfer to a bowl.', '3 Make the batter: Add the butter and sugar to the bowl of the food processor and process until creamy, 30 to 60 seconds.', 'Add the eggs one at a time, and process after each addition, until fluffy. Add the lemon zest, vanilla, flour, baking powder and salt, and pulse just until the batter is smooth.', 'Finally, add the ground walnuts and pulse to mix them into the batter. The batter will be thick.', '4 Assemble the cake: Scrape the batter into the skillet and smooth the top with the back of a spoon.', 'Lay slices of plums in a ring around the outside edge of the pan, overlapping the slices slightly. Arrange a second ring of slices inside the first, and then fill in the very middle of the cake with the remaining slices. Sprinkle with the turbinado sugar.', '5 Bake the cake: Begin checking the cake around 35 minutes, and continue baking (checking every 5 to 10  minutes) until the top is browned and a toothpick inserted into the middle of the cake comes out clean. Total cooking time is typically 40 to 50 minutes.', 'Set the skillet on a wire rack to cool to room temperature.', '6 Brush with honey (optional): The cake is sweet enough as it is, but if you want to add a little shine for an even more beautiful presentation, heat the honey in the microwave for 10 seconds and brush the cake with it.', '7 Serve the cake straight from the skillet.']",11
715,Plum Conserve Jam Recipe,20,30,50,"['7 cups seeded, chopped tart plums (about 3 pounds)', '4 cups sugar', '1 navel orange, thinly sliced, including rind', '1 lemon, thinly sliced, including rind, seeds removed', '3 1/2 cups raisins', '1 cup chopped walnuts', 'Special equipment:', '6 pint-sized mason jars', '1 large 6 to 8-quart sized pan (Stainless steel, do not use aluminum which will leach)', 'A ladle or pour cup for transferring the conserve from the pan to the jars']",10,"['1 Prepare jars for canning: Prepare jars for canning in any of the following ways: You can run them through a short cycle on your dishwasher.', ""You can place them in a large pot (12 quart) of water on top of a steaming rack (so they don't touch the bottom of the pan), and bring the water to a boil for 10 minutes."", 'Or you can rinse out the jars, dry them, and place them, without lids, in a 200\\xc2\\xb0F oven for 10 minutes.', '2 Put plums, sugar, orange, lemon, and raisins into a large 6 or 8-quart pan. Heat until boiling. Gently boil for 20 to 25 minutes, stirring frequently, or until the mixture starts to thicken slightly.', 'If you want, use kitchen shears to cut some of the longer citrus rinds.', 'Stir in walnuts.', '3 Carefully ladle the conserve into the jars, one at a time, leaving 1/4 inch head space at the top of the jars for a vacuum seal.', 'Wipe the rim clean with a clean, wet paper towel. Place the lid on the jar, securing with a jar ring.', 'Allow the jars to sit overnight. You will hear them make a popping sound as a vacuum seal is created.']",9
716,Poached Egg and Bacon Salad \xe2\x80\x93 Salad Lyonnaise Recipe,5,15,20,"['2 strips bacon', '1 slice French or Italian bread', '1 teaspoon butter', '1 poached egg', 'A handful of fresh fris\\xc3\\xa9e lettuce, torn into bite sized pieces', '1 teaspoon chopped shallots', '1 tablespoon extra virgin olive oil', '1 tablespoon wine vinegar', '1/2 teaspoon Dijon mustard', 'Salt and pepper to taste']",10,"['1 Cook the bacon: Cook two strips of bacon on medium heat until done, about 5 minutes. Remove from heat, let drain of excess fat on a paper towel. Once cool, chop.', '2 Make croutons: Cut a slice of French or Italian bread into cubes. Toast on medium high heat in a small saucepan with a teaspoon of melted butter. Do not stir bread unless to turn to a different side once one side is toasted.', '3 Poach egg: Poach egg your favorite way. See how to poach an egg for our recommendation on the easiest way to do it.', '4 Make dressing: In a small jar, mix the olive oil, vinegar, mustard, salt and pepper.', '5 Assemble salad: Layer the fris\\xc3\\xa9e, chopped cooked bacon, shallots, and croutons on a salad plate. Pour dressing over salad. Top with the poached egg.', 'Devour.']",6
717,Eggs Nested in Saut\xc3\xa9ed Chard and Mushrooms Recipe,10,15,25,"['2 tablespoons extra virgin olive oil', '1/2 cup chopped onion', '1/2 pound of fresh chard', '2-3 large shiitake mushrooms, sliced into 1/4-inch thick slices', 'Salt and freshly ground black pepper', '1 to 2 eggs']",6,"['1 Prep the chard: Cut out the thick, tough center ribs of the chard leaves. Chop the ribs into 1/2 inch pieces and place in a bowl.', 'Add the chopped onions and mushrooms to the bowl.', 'Cut the remaining chard leaves crosswise into 1-inch ribbons, set aside.', '2 Saut\\xc3\\xa9 chard ribs, onions, mushrooms: Heat the olive oil in a large, stick-free saut\\xc3\\xa9 pan (with cover) on medium high heat. Add the onions, chard ribs, and mushrooms.', 'Saut\\xc3\\xa9 for about 4 to 5 minutes, until the onions are translucent and the mushrooms are a little brown on the edges and have started to give up their moisture.', '3 Add the sliced chard leaves, season with salt and pepper: Add the green sliced chard leaves to the saut\\xc3\\xa9 pan. Use tongs to turn the leaves over in the pan so that the leaves get coated with some of the olive oil and the onions and mushrooms are well mixed in with the leaves. Sprinkle with salt and pepper.', '4 Add the eggs: Spread the mixture evenly over the bottom of the pan. Crack one or two fresh eggs in the center of the pan, over the chard mushroom mixture. Cook uncovered until the bottom whites are well set. Then lower the heat to medium and cover the pan. Cook for another minute or two.', 'When the whites are cooked, remove the pan from the heat and use a spatula to gently transfer the eggs and chard to a plate to serve.', 'Serve immediately. Cut into the egg yolks so that the runny yolks run over the chard and mushrooms and form something of a sauce.']",9
718,Soba Noodle Bowls with Spinach and Poached Eggs Recipe,5,20,25,"['2 tablespoons white vinegar', '6 cups chicken or vegetable stock', '1 tablespoon finely chopped fresh ginger', '2 to 3 cloves garlic, finely chopped', '1 teaspoon toasted sesame oil (plus more for garnish)', 'Salt, to taste', '4 large eggs', '8 ounces soba (buckwheat) noodles', '2 cups (3 ounces) packed fresh baby spinach leaves', '6 scallions, thinly sliced (for garnish)', '4 teaspoons sesame seeds (for garnish)']",11,"['1 Heat the poaching water: Fill a wide a wide saucepan with 2 inches of generously salted water and bring to a boil. Add the vinegar, and adjust the heat to a gentle simmer.', '2 Heat and season the stock.  Meanwhile, in a large saucepan over medium heat, bring the stock to a boil. Add the ginger, garlic, sesame oil and salt to taste. Adjust the heat to a gentle simmer, cover, and let it cook while you poach the eggs. This gives the flavors time to mingle.', ""3 Poach the eggs. Line a tray or plate with a paper towel. Adjust the heat under the poaching water so that it's at a very gentle simmer."", 'Crack 1 egg into a small bowl or measuring cup. Hold the rim of the bowl or cup as close to the surface of the water as possible, and gently tip the egg into the water. Rapidly repeat with the remaining eggs.', 'Set a timer for 2 minutes to time the poaching. Stir the pot gently by dragging a wooden spoon around the edge of the pot, stirring the water just enough to cause the eggs to release from the bottom of the pot. You should see them bob a little in the water.', 'After 2 minutes, lift 1 egg from the water with a slotted spoon and test for doneness by pressing on the egg. The white should feel firm and the yolk should still be soft. Return to the water if necessary to complete the cooking.', 'With a slotted spoon, transfer the eggs to the paper towel lined plate. Place a lid on the pot to keep the water warm. (At this point, the eggs can be refrigerated, submerged in a container of water, for up to 5 days.)', 'Read More! Easy Poached Eggs', '4 Cook the soba noodles and spinach. Bring the seasoned stock back to a boil and add the noodles.  Cook for 6 to 8 minutes, until the noodles are tender (or according to package directions.)', 'Stir in the spinach. Stir gently until the spinach has wilted, about 30 seconds.', '5 Assemble the bowls: Divide the noodles, broth, and spinach between 4 bowls.', '4 Reheat the eggs, if necessary: If the eggs no longer feel warm to the touch, use a slotted spoon to gently drop them into the warm egg poaching water and leave for a few seconds to warm them. Remove with a slotted spoon. (If the eggs have been refrigerated, heat a pan of water to steaming before warming the eggs.)', '5 Garnish the bowls: Top each bowl of noodles with a poached egg. Garnish with chopped scallions and sesame seeds, and drizzle with a little sesame oil.']",13
719,"Salmon with Tomato, Onions, and Capers Recipe",10,25,35,"['3 tablespoons extra virgin olive oil', '1 medium onion, chopped', '2 garlic cloves, peeled and diced', '2 large fresh tomatoes, diced', '1 teaspoon fresh thyme leaves, chopped', '2 teaspoons freshly grated lemon zest', '2 tablespoons lemon juice', '2 tablespoons of capers, drained', '1 teaspoon of chopped jalape\\xc3\\xb1o peppers (no seeds, no stem, no ribs) either fresh or pickled', '1/3 cup white wine', '1/4 cup water', 'Salt and pepper', '2 fresh salmon fillets, 1/2 pound each']",13,"['1 Saut\\xc3\\xa9 the onions and garlic: In a large, wide (at least 12 inches wide) saucepan (one that comes with a cover), heat olive oil on medium heat.', 'Add the onion and cook, stirring regularly, until just beginning to brown, about 5 minutes. Add the garlic and cook for 1 minute.', '2 Add tomatoes, thyme, lemon zest and juice, capers, jalape\\xc3\\xb1o, salt, pepper: Raise the heat to medium-high and add the tomatoes, thyme, lemon zest, lemon juice, capers, and jalape\\xc3\\xb1o peppers.', 'Simmer for 10 minutes, adding a little water if needed to prevent the sauce from getting too dry. Salt and pepper to taste.', '3 Add wine and water: Add 1/3 a cup of white wine - a simple Chardonnay will work. Add 1/4 cup of water. Bring to a simmer.', '4 Add salmon fillets, cover and cook: Place the fillets in the pan on top of the sauce, skin side down, if the fillets are still in their skin. Cover and reduce heat to medium-low.', 'Cook for 4-7 minutes, depending on how thick the cuts of fish are. Poke the fish with a fork and look for doneness. The fish should still be a little rare in the middle, but not raw.', 'Serve immediately, with tomato sauce generously applied.']",8
720,Fresh Salmon Salad Recipe,15,39,54,"['For the salmon:', '1 pound salmon fillet, cut in half', '1/2 teaspoon sea salt (for the rub)', '4 cups water', '1 1/2 teaspoons sea salt (for the poaching liquid)', '1 lemon slice', '1 teaspoon lemon juice', '1 teaspoon extra virgin olive oil', 'For the salad:', '2 celery stalks, finely chopped', '1/2 red onion, peeled, finely sliced', '1 tablespoon capers (strain out the pickling juice)', '1 teaspoon lemon zest', '3 tablespoons lemon juice', '1 tablespoon extra virgin olive oil', '2 tablespoons fresh dill, chopped', '1/8 teaspoon freshly ground black pepper']",17,"['1 Prep the salmon fillets: Rub the salmon fillets all over with 1/2 teaspoon salt. Chill for 30 minutes in the refrigerator while you prep the other ingredients.', '2 Make the dressing: Combine celery, red onion, capers, lemon zest and juice, dill, olive oil, black pepper in a large bowl. Set aside for the flavors to blend.', '3 Poach the salmon: Put 4 cups water, 1 1/2 teaspoons salt, and a slice of lemon in a pot wide enough to hold the salmon. Bring to a boil and simmer for about 5 minutes. Add the salmon to the pot. Return to a simmer and cook for 4 minutes at a bare simmer.', '4 Cool and break up the salmon: When the salmon is just cooked through, remove it from poaching liquid and put it in a bowl. Drizzle with a teaspoon of olive oil and a teaspoon of lemon juice. Once it has cooled to touch, break the salmon gently into chunks.', '5 Make the salad: Add the salmon to the bowl with the celery, onions, and capers. Gently toss to combine. Serve as is, or over mixed greens or butter lettuce.']",5
721,"Salmon Lettuce Wraps with Cucumber, Jicama, and Ginger Recipe",30,20,50,"['12 ounces skinless salmon fillets, cut into two even pieces', '1/2 teaspoon Kosher salt for marinade', '1 teaspoon grated fresh ginger root', '4 cups water', '1 1/2 teaspoons Kosher salt for poaching liquid', 'Slice of lemon', '1 teaspoon extra virgin olive oil', '1 teaspoon lemon juice', 'Cucumber, Jicama, Ginger Salad:', '3/4 cup of seeded, diced, thin-skinned (English or Persian) cucumber, peel-on (you can also use regular cucumbers that have been peeled)', '2/3 cup peeled, small diced jicama', '1/4 thinly sliced red onion', '3 Tbsp chopped fresh cilantro', '1 teaspoon grated lime zest', '2 Tbsp fresh lime juice', '2 teaspoons grated fresh ginger', '1 Tbsp chopped fresh mint', '1/2 teaspoon Kosher salt', '1 ripe avocado', '6 large leaves of butter lettuce']",20,"['1 Marinate the salmon fillets: Rub with 1/2 teaspoon Kosher salt and a teaspoon of grated ginger. Set in refrigerator to chill for 30 minutes, while you prep the other ingredients.', '2 Combine cucumbers, jicama, red onion, cilantro, lime, ginger, mint, salt: In a medium bowl, gently combine the diced cucumbers, jicama, red onion, cilantro, lime zest, lime juice, grated ginger, chopped mint, and salt. Set aside for the flavors to blend.', '3 Poach the salmon: Prepare salmon poaching liquid. Place water, salt, and a slice of lemon in a pot wide enough to hold the salmon fillets. Bring to a boil and let simmer for about 5 minutes.', 'Add the salmon fillets that have been marinating in ginger and salt to the poaching liquid. Return to a simmer and cook for about 4 minute at a very low simmer.', 'When just cooked through, remove from poaching liquid and place in a bowl. Toss with a teaspoon of olive oil and a teaspoon of lemon juice. Once the salmon has cooled to touch, break up gently into large flakes.', '4 Arrange the lettuce wraps: Slice the avocado. On to each butter lettuce leaf, place a few chunks of salmon, a large spoonful of the cucumber jicama mixture, and top with some slices of avocado.', 'Fold up the lettuce wrap and eat!']",7
722,Chile Relleno Casserole Recipe,10,75,85,"['8 poblano chiles', '2 tablespoons extra virgin olive oil', '1 cup chopped onion', '4 cloves garlic, minced (about 4 teaspoons)', '1 28-ounce can tomatoes', 'Salt', '1 pound Mexican chorizo (or other spicy sausage)', '1 cup Cotija cheese, crumbled (can sub feta)', '1 teaspoon fresh oregano, minced', 'One dozen eggs', '1/3 cup flour', '1 teaspoon baking powder', '1 1/2 cup Monterey jack or mild cheddar cheese, shredded', 'Special equipment:', 'A 9x13-inch baking dish']",15,"['1 Char the whole poblano chiles: The first step is to char the outside skin of the poblano chiles. The easiest way to do that is directly over the flame of a gas burner (see How to Roast Chiles over a Gas Flame).', ""You can also do that over a grill, or in a broiling pan under a broiler (don't use a thin baking sheet or it will warp under the high heat). Just put the chiles close enough to the heating element so they char and blister on the surface."", 'Turn the chiles so that they get completely blackened all around. Place the blackened chiles in a bowl and cover with a plate or damp towel. Let the chiles steam in their own heat for several minutes.', '2 Saut\\xc3\\xa9 onion, garlic, add tomatoes, salt, and simmer: While the chilies are cooling, heat olive oil in a large saut\\xc3\\xa9 pan, on medium high heat. Add the chopped onion and cook until translucent, about 5 minutes. Add the garlic and cook for a minute more.', 'Add the tomatoes (break up any whole tomatoes before adding to the pan). Add a pinch of salt. Bring to a simmer and lower the heat to low. Gently simmer for 15-20 minutes. Remove from heat and set aside.', '3 Peel the blackened skin off the poblanos: Carefully peel and discard the blackened skin off of the chilies. Cut off the stem ends. Carefully remove the seed pod without tearing the chiles (which you will stuff later).', '4 Cook the chorizo: Put the Mexican chorizo in a large frying pan and set the heat to medium high. Break up the chorizo with the edge of a metal spatula as you cook it. Cook until cooked through, about 4 minutes.', '5 Spread tomato sauce over bottom of baking dish: Preheat oven to 375\\xc2\\xb0F. Spread the tomato sauce over the bottom of an 9x13 inch baking dish. The tomato sauce should be the consistency of a thin spaghetti sauce. If it is too thick, thin it out with a little water.', '6 Make stuffing: In a large bowl, mix together the stuffing of the cooked chorizo, cotija, and oregano.', '7 Stuff chiles with chorizo mixture and place on top of tomato sauce in the baking dish.', '8 Whisk eggs, flour, baking powder, salt: In a large bowl, vigorously whisk the eggs. Whisk in the flour, baking powder, and a pinch of salt.', '9 Sprinkle chiles with cheese and pour egg mixture over them: Sprinkle chiles with half of the jack or cheddar cheese. Pour egg mixture over chiles and sprinkle with remaining cheese.', 'At this point you can make ahead and chill for several days. Add 10 minutes to cooking time in the next step if you make ahead and chill.', '10 Bake: Bake at 375\\xc2\\xb0F until top starts to brown and the eggs are set but still soft, about 30 minutes.']",14
723,Mexican Green Rice Recipe,10,50,60,"['3 tablespoons extra virgin olive oil', '1 1/2 cups long grain white rice', '2 1/4 cups chicken stock (or more depending on your rice*)', '1 cup roughly chopped parsley, lightly packed', '1/2 cup roughly chopped cilantro, lightly packed', '2 large poblano chiles, seeded and roughly chopped', '2 Tbsp chopped onion', '1 garlic clove, peeled, roughly chopped', 'Salt to taste**', '*Use the amount of stock that is the liquid requirement of your particular brand of rice. Long grain rice typically ranges from 1 1/2 cups of liquid per cup of rice to 2 cups of liquid per cup of rice.', '**If you are using homemade unsalted stock, you will want to add at least half a teaspoon of salt to the stock.']",11,"['1 Pur\\xc3\\xa9e parsley, cilantro, chiles, onion, garlic, 1/2 cup of stock: Place the parsley, cilantro, poblanos, onion, garlic, and 1/2 cup of the chicken stock in a food processor. Pulse until smooth.', '2 Brown the rice: Heat the oil in a thick-bottomed pot on high heat. Add the rice and stir to coat all of the grains with oil. Spread out in an even layer.', 'Let the rice lightly brown. When it starts to brown, stir it and spread it out in an even layer again so that more of the rice browns.', '3 Stir parsley cilantro mixture into rice: When much of the rice has lightly browned, scrape out the parsley pur\\xc3\\xa9e from the food processor into the rice. Stir to evenly mix the pur\\xc3\\xa9e with the rice. Let cook for a minute or two.', '4 Add remaining stock, simmer, cover, cook: Add the rest of the chicken stock to the pot. Bring to a boil, then reduce the heat to a low simmer and cover the pot. Let cook on a very low simmer for 15 minutes, or as long as your package of rice indicates is the right cooking time for your rice.', '5 Remove from heat, cover with towel and lid, let sit: After the cooking time indicated on your rice package, remove the pot from heat. Uncover the pot and place a clean terry towel or dish towel over the pot, then re-cover.', ""The towel will help absorb excess liquid as the rice continues to cook in its own steam. (If you don't have a clean towel, you can skip this step, just cover normally.) Let sit for 20 minutes."", 'Fluff the rice with a fork and serve.']",8
724,Roasted Poblano Corn Chowder Recipe,30,40,70,"['5 to 6 large poblano green chiles (to yield 1 1/2 cups roasted, peeled, and chopped), (can sub canned chopped green chiles, enough to yield 1 to 1 1/2 cups, the amount depends on how hot the chiles are)', '3 Tbsp butter', '2 medium onions, diced (about 2 1/2 cups)', '2 ribs celery, diced (about 3/4 cup)', '1 clove garlic, minced (1 teaspoon)', '2 medium yukon gold potatoes, peeled, cut into 1-inch chunks (10 - 12 ounces)', '4 ears of corn (enough to yield 4 cups of corn kernels), or 4 cups of corn', '5 cups chicken stock (use vegetable stock for vegetarian option)', '1 teaspoon kosher salt', '2 bay leaves', '1 teaspoon ground cumin', '1/2 teaspoon dry oregano', '1 cup heavy cream', '1/2 teaspoon black pepper', '2 limes, one sliced for garnish, one for juice (can substitute lemon juice)']",15,"['1 Roast the chiles: There are lots of ways to do this (see How to Roast Green Chiles over an Open Flame), I tend to just put them either directly on the flame, or in one of those grill pans with holes in them, over the gas flame.', 'You can roast them on a grill or under a broiler. Just make sure they get blackened all over. Then put them in a bowl, cover the bowl and let them steam.', ""When they've cooled down enough to touch, use your fingers or a dampened paper towel to strip off the charred bits."", 'Cut them open, remove and discard the stem, seed pod and inside veins. Roughly chop the chiles and set aside.', '2 Soften the onions and celery: Melt butter in a 5 to 6 quart heavy-bottomed pot on medium high heat. Once the butter is melted, add the onions and the celery, stir to coat with the butter. Cook for 8 to 10 minutes, lowering the heat to medium, until the onions and celery are softened and are beginning to brown.', '3 Prepare corn: While the onions are cooking, if using fresh corn on the cob, cut the fresh kernels of corn away from the cobs.', '4 Add potatoes, stock, spices: Once the onions and celery are beginning to brown, add the garlic and cook for a minute more. Add the potatoes and the stock to the pot. Add the bay leaves, cumin, oregano, and salt. Increase heat and bring to a simmer. Lower heat to maintain a simmer and cook for 8-10 minutes until the potatoes are just cooked through.', '5 Add corn, then poblanos: Add the corn kernels to the pot and cook for 4 to 5 minutes, until cooked through. Add the chopped roasted poblanos to the pot.', '6 Add cream: Remove the bay leaves. Stir in the cream. Add black pepper, more or less to taste. At this point, if you want a thicker base for your chowder, you can use an immersion blender or standup blender to pur\\xc3\\xa9e about a third of the soup.', 'To serve, sprinkle with a little fresh lime juice and serve with a slice or two of lime.']",10
725,Pork and Poblano Stew Recipe,30,120,150,"['4 to 5 poblano chile peppers (about 3/4 pound)', '1 tablespoon extra virgin olive oil', '2 1/2 pounds pork shoulder, trimmed, cut into 1 to 2 inch pieces', 'Salt', '1 large onion, chopped (about 2 cups)', '1 teaspoon cumin', '3 to 4 garlic cloves, minced', '1 chipotle chili in adobo, minced', '1 tablespoon dried oregano', '1 quart chicken stock (use gluten-free stock for gluten-free option)', '1 1/2 cups fresh or frozen corn (no need to defrost if frozen)', '1 large (about 1/2 pound) sweet potato, peeled and diced (about 1/2 to 3/4-inch cubes)', 'Sour cream', 'Cilantro', 'Toasted shelled pumpkin seeds (pepitas) Optional']",15,"['1 Char, peel, and chop the poblano chiles: Char the chile peppers on all sides, directly over a gas flame, or broil, turning every minute or so until the chiles are blackened on all sides.', 'Place in a bowl and cover with a clean dish towel. Let sit for 10 minutes or so, then rub off the blackened charred skin.', 'Cut away and discard the stem, seeds, and internal veins. Roughly chop the chiles into 1 to 2 inch pieces. Set aside.', '2 Sear the cubed pork: Heat the vegetable oil in a large Dutch oven on medium high heat. Pat dry the pork pieces with a paper towel and brown them, working in batches as to not crowd the pan. Sprinkle salt generously over the pork while they brown.', '3 Saut\\xc3\\xa9 the onions and garlic: Remove the pork from the pan and set aside. Add the chopped onion and cumin to the pan and cook about 5 minutes, until translucent.', 'Scrape up any browned bits from the bottom of the pan while the onions cook. Add garlic and cook for a minute more.', '4 Add the chipotle, poblanos, pork, chicken stock and oregano, simmer: Add the chopped chipotle to the onions and garlic. Return the browned pork to the pan. Add the chopped poblano chiles to the pan. Add the chicken stock and oregano. Bring to a boil, reduce to a simmer, cover and let cook for 1 hour.', '5 Add sweet potato, corn: After an hour, add the diced sweet potato and corn to the stew. Cook for another half hour to 45 minutes, until the pork is tender and the sweet potatoes are cooked through.', 'To serve, spoon out the stew into bowls. Swirl in a spoonful of sour cream to each bowl. Top with chopped fresh cilantro and toasted shelled pumpkin seeds.']",9
726,Green Chile Mac and Cheese Recipe,20,45,65,"['2 cups elbow macaroni', 'Salt', '2 cups of whole milk', '3 Tbsp unsalted butter', '3 Tbsp flour', '1/4 pound (1 cup, packed) finely shredded jack cheese', '1/4 pound (1 cup, packed) finely shredded sharp cheddar cheese', '1 cup corn kernels (frozen is okay, if frozen, defrost before using)', '1 1/4 cups chopped roasted, seeded green chiles (or three 4 ounce cans diced roasted green chiles)*', '1 Tbsp lime juice', '1 teaspoon salt', '1/4 to 1/3 cup panko or other breadcrumbs', '*If you are roasting your own chiles (highly recommended), start with about 5-6 large green chiles\\xe2\\x80\\x94Hatch, Anaheims, or poblanos, or a mixture\\xe2\\x80\\x94and char them over a gas stove (see directions for roasting over a gas flame), under a broiler (roast until one side has blackened, then flip to blacken the other side), or on a grill. Place in a covered bowl to steam, then peel off the charred skin. Remove and discard the seeds and stems. ']",13,"['1 Cook the macaroni very al dente: Bring a large pot of salted water to a boil (a tablespoon of salt for every 2 quarts of water). Add the macaroni pasta. Return to a rolling boil, and boil, uncovered, for about 2 minutes less than the cooking time given on the pasta box instructions.', 'The pasta should be mostly cooked, but still a little too firm to eat; it will complete its cooking in the oven.', 'When the pasta is ready, drain it into a colander and run cold water over it to stop the cooking.', '2 Preheat the oven to 400\\xc2\\xb0F.', ""3 Make a roux with butter and flour: In an ovenproof pot such as a casserole or Dutch oven, heat the butter over medium heat. When the butter is melted and bubbly, stir in the flour to make a roux. Cook this, stirring often, for about 2 minutes. You don\\'t want the roux to brown."", '4 Slowly whisk in milk, then the cheeses: Add the milk to the roux, a little at a time, stirring constantly so that lumps do not form. Whisk until smooth.', 'Stir in the cheeses third at a time, stirring to incorporate after each addition.', '5 Stir in pasta, chiles, corn, lime juice, salt: Add the macaroni, chiles, corn and lime juice and stir until well combined. Taste for salt, add a teaspoon, less or more, if needed.', '6 Top with panko and bake: Top the mac and cheese with panko or breadcrumbs. Bake uncovered for 25 to 30 minutes at 400\\xc2\\xb0F, or until the breadcrumbs are lightly browned.', 'Remove from oven and let cool for 10 minutes before serving.']",10
727,Chiles en Nogada (Chilies in Walnut Sauce) Recipe,75,90,165,"['The Walnut Sauce:', '1 heaping cup of shelled walnut halves', 'Milk (about 2 cups)', ""1/4 lb queso fresco (or farmer's cheese)"", '1 1/2 cups thick sour cream (or creme fraiche)', '1 1/2 Tbsp sugar', '1/4 teaspoon of ground cinnamon', 'The Chiles:', '6 large poblano chiles (use only poblanos, not another type of chile, for this dish)', 'The Picadillo:', '1 1/4 pounds ground turkey thigh meat', 'Kosher salt', '4 Tbsp olive oil or canola oil', '1/2 medium onion, finely chopped', '3 cloves garlic, peeled and finely chopped', '1 Tbsp butter', '3/4 teaspoon ground cinnamon', '1/2 teaspoon freshly ground black pepper', '1/8 teaspoon ground cloves', '1 cup of crushed, fire roasted tomatoes', '1/2 cup of golden raisins', '2 Tbsp blanched and slivered almonds, roughly chopped', '1 apple, peeled, cored, chopped', 'Garnish:', '1/2 cup pomegranate seeds', '1/4 cup chopped fresh cilantro or parsley']",26,"['THE NIGHT BEFORE', ""1 Remove the papery bitter skins from the walnut pieces. (This is the hard part.) Sometimes the skins easily rub off. I have found that usually, for us, the skins don't easily peel off and we need to blanch them for one minute in boiling water first, to loosen the skins. If you blanch the walnuts, let them cool to the touch and carefully peel off as much of the bitter skins as you can. This is painstaking work, but unless your walnuts are shed of their bitter skins, the sauce may be a bit bitter."", '2 Place the walnuts in a bowl, cover them with milk to soak, and chill them overnight in the refrigerator.', '  THE DAY OF', 'Roast the chiles:', '3 Place the chiles directly over the flame of a gas stove, or place under a hot broiler, to char the outside tough skin. Turn the chiles to char them on all sides. Get as much of the outside skin blackened as possible, it will be easier to remove that way. (See How to roast chile peppers over a gas flame tutorial using Anaheim chiles.)', '4 Place the blackened chiles in a bowl and cover with a plate or damp clean towel and let sit for 20 minutes. The burned skin will then flake off very easily and the flesh will become a little more cooked in the steam. Make a slit in the side of each chili and carefully remove the seeds and veins. Be careful to leave the top of the chili, the part around the base of the stem, intact. (A tip from Diana Kennedy: if you taste the chiles and they are too spicy hot, soak them in a mild vinegar and water solution for about 30 minutes.) Rinse the chilies and pat them dry.', '  Make the walnut sauce:', ' 5 Drain the walnuts. Place the soaked and drained walnuts, the queso fresco, sour cream, sugar, and cinnamon into a blender and pur\\xc3\\xa9e until completely smooth.', '  Make the picadillo stuffing:', '6 Heat one tablespoon of the oil in a large wide saucepan on medium high heat. Working in batches to prevent crowding the pan, brown the meat on at least one side, sprinkling the meat with a little kosher salt as it cooks. Add another tablespoon of oil if needed for the subsequent batches. Remove meat to a bowl and set aside.', '7 Add a tablespoon of cooking oil to the pan and heat on medium heat. Add the onion and cook until soft. Add the cinnamon, black pepper, cloves, and garlic and cook another minute.', '8 Melt butter in the pan and return the ground meat to the pan and use a wooden spoon to break up any clumps.  Add the crushed tomatoes, golden raisins, and chopped slivered almonds. If the mixture seems a little dry, add a tablespoon or two of water. Add chopped apple to the picadillo mixture. Adjust spices, add more cinnamon, salt, ground cloves to taste (go easy on the cloves, they can overpower).', '  Assemble the chiles en nogada:', '10 Stuff the chilies with the picadillo until they are well filled out. Place them on individual plates or on a serving platter.', '11 To serve, cover the stuffed chiles with the walnut sauce and sprinkle with pomegranate arils and chopped fresh parsley or cilantro.']",16
728,Roasted Green Chiles in a Light Vinaigrette Recipe,0,0,0,"['Several green chiles such as Anaheims, Hatch, poblanos, or jalape\\xc3\\xb1os. They should have thick flesh and sturdy peels (not a thin skinned pepper like a padron).', 'Extra virgin olive oil', 'Cider or red wine vinegar', 'Kosher salt']",4,"['2 Place in covered bowl to steam: When the chiles are all well blistered and blackened, place in a bowl and cover with a plate (you can also put them in a brown paper bag and close).', 'The chile peppers will steam in the bowl (or bag), making the charred skins easy to peel. Let the chiles steam for 5 to 10 minutes, until cool enough to handle.', '3 Remove the charred bits: Use your fingers (a damp towel or paper towel helps) to gently peel off the charred skins.', '4 Remove stems, seeds, veins: Cut a slit down one side of each of the peppers. Open the chiles and remove the seeds, seed pods, and stems. Also remove any inner veins, those can carry a lot of heat.', 'It helps to either wear gloves or coat your hands with cooking oil first before handling a chile, especially if you open it up.', 'After you are done handling the chiles you can wash the oil off of your hands and take care not to touch your eyes.', '5 Toss with vinaigrette and chill: Place the chiles in a ceramic or glass bowl. Drizzle olive oil over the chiles. Sprinkle with vinegar and salt.', 'Toss so that the chiles get touched with olive oil, vinegar, and salt on all sides. Cover and chill for at least an hour and up to several days.', 'Serve as a side for steak, over burgers, chopped up to use in salsa, in quesadillas or tacos, or just eat straight as a snack.']",9
729,Polenta Sausage Mozzarella Casserole Recipe,10,35,45,"['4 tablespoons extra virgin olive oil', '1 28-ounce can crushed tomatoes', '1 tablespoon chopped fresh oregano', '1 yellow onion, chopped', '4 cloves garlic, minced', '1/2 teaspoon salt', '1/2 teaspoon freshly ground black pepper', '1 teaspoon fennel seeds', '1 pound sweet Italian sausage (removed from casings)', '2 pounds of prepared polenta, 1/2-inch slices if using prepared polenta in a tube (can use one recipe of creamy polenta, leave out the cream cheese)', '1/2 pound (8 ounces) fresh mozzarella, sliced into 1/4-inch slices']",11,"['1 Cook the onions and sausage in olive oil: Heat 3 Tbsp of olive oil in a large (2-3 qt) saucepan on medium heat. Add the sliced onion and sausage and saut\\xc3\\xa9, stirring often, until the meat is browned.', '2 Add the garlic, salt, pepper, and fennel seeds to the saut\\xc3\\xa9 pan. Cook, stirring occasionally, for 2 minutes.', '3 Add the tomato, cover the pan, lower the heat to medium, and simmer for 20 minutes.', '4 Broil the cooked polenta: While the sauce is cooking, coat the bottom of a 9x13-inch lasagna or gratin pan (a pan that can handle the heat of a broiler) with a 1 tablespoon of oil. Add the cooked polenta (or slices) to the pan. Coat the top of the polenta with a little more olive oil. Broil the polenta about 4 inches from the heating element until golden brown and crispy, about 10-15 minutes.', '5 Add sauce, mozzarella, broil again: Pour sauce over broiled polenta, then arrange mozzarella slices over the top and return the casserole to the broiler. Broil until the cheese is melted and beginning to brown, about 2 minutes. Let cool for a few minutes before serving.']",5
730,Cheesy Polenta with Grilled Sausages and Summer Vegetables Recipe,10,45,55,"['For the polenta:', 'Butter (for the baking dish)', '5 cups water', '1 1/4 cups polenta', '3 tablespoons butter, cut into little cubes', '1 teaspoon salt', '2/3 cup 3-Cheese Italian Blend', 'For the sausages and vegetables:', 'Oil, for the grill', '8 Italian sausages', '3 medium (about 1 pound) zucchini, cut on the diagonal into 1/4-inch-thick slices', '3 medium (about 1 pound) summer squash, cut on the diagonal into 1/4-inch-thick slices', '4 small tomatoes, halved', 'Olive oil, for brushing the vegetables', 'Salt and pepper']",15,"['1 Preheat the oven to 350\\xc2\\xbaF.  Butter a shallow 3-quart baking dish.', '2 Bake the polenta: In the baking dish, stir the water, polenta, cubed butter, and salt together. Bake, uncovered, for 30 minutes.', 'Remove from the oven and stir in the half of the cheese. Sprinkle the remaining cheese on top. Bake for 10 to 12 minutes longer, or until the polenta is thick and porridge-like.', 'Turn on the broiler and broil for 1 to 3 minutes, or just until the cheese bubbles and browns.', '3 While the polenta is cooking, heat the grill: For charcoal grills, fill a grill chimney with charcoal and light it. When the coals are hot (they should be covered with a layer of fine gray ash) empty the coals into the grill and push them to one side of the grill to make higher heat and lower heat cooking zones. Set the grate in place and cover the grill. Preheat the grate for 5 minutes.', 'For gas grills, heat one burner to high and one to low (225F).', 'Fold a small piece of paper towel to make a 2-inch square, and pour a few tablespoons of oil into a shallow bowl. With tongs, dip the square into the oil, and brush the grates.', '4 When the grill is ready, cook the vegetables: Place the sausages on the grill and cook, turning often, for 8 to 10 minutes, or until they are browned and cooked through (150F is the ideal internal temperature.) Move them on the cooler side of the grill if they brown too quickly but are still raw inside. As soon as they reach the desired temperature, transfer them to a plate and cover loosely with foil to keep them warm.', 'Brush the zucchini slices, summer squash slices, and tomato halves with olive oil and sprinkle with salt and pepper. Grill the zucchini and summer squash on each side until the slices are tender and there are grill marks on the sides. Grill the tomatoes, with the cut sides down, until they how grill marks and are warm but not falling apart. Use the cool side of the grill to moderate the heat if necessary.', '5 To serve: Place a spoonful of polenta on each plate. Top with a sausage, a tomato half, and a few slices of zucchini and summer squash.']",10
731,Homemade Pomegranate Molasses Recipe,0,0,0,"['4 cups pomegranate juice', '1/2 cup sugar', '2 tablespoons lemon juice']",3,"['1 Heat pomegranate juice, sugar, lemon to a simmer: In a large, wide, uncovered saucepan, heat pomegranate juice, sugar, and lemon juice on medium high until the sugar has dissolved and the juice simmers.', 'Reduce heat just enough to maintain a simmer.', '2 Reduce to a syrup: Simmer for about an hour, or until the juice has a syrupy consistency, and has reduced to 1 to 1 1/4 cups.', 'If you want your pomegranate molasses to be sweeter, add more sugar to taste, while you are cooking it.', '3 Store in a jar, chilled: Pour out into a jar. Let cool. Store chilled in the refrigerator.']",5
732,Pork Chops with Pomegranate Glaze Recipe,10,20,30,"['4 bone-in center cut pork chops, about 1-inch thick', 'Salt and pepper, to taste', '2 tablespoons olive oil', '3 tablespoons finely chopped shallots', '1 1/2 cups pomegranate juice', '1 tablespoon honey', '1 tablespoon balsamic vinegar', '2 sprigs thyme', '1 tablespoon cold, unsalted butter', '2 tablespoons chopped parsley (for garnish)', 'Seeds from 1 pomegranate (for garnish)']",11,"['1 Generously sprinkle the pork chops on both sides with salt and pepper.', '2 Sear the chops: In a large skillet over medium-high heat, heat the oil. Add the pork chops to the pan and cook for 3 to 5 minutes on a side, or until they are golden brown on both sides and a thermometer inserted into the center of a chop registers 145F.', 'Transfer to a plate and cover loosely with foil to keep the chops warm while you make the glaze.', '3 Make the glaze: Pour off and discard all but a thin layer of oil from the pan and return the pan to the heat. Add the shallots and cook, stirring, for 45 seconds. Scrape up any browned bits that have stuck to the bottom of the pan.', 'Add the pomegranate juice, honey, vinegar and thyme. Cook for 5 to 7 minutes, or until thickened slightly. Take the pan off the heat. Remove the thyme sprigs and whisk in the butter.', '4 To serve: Transfer chops to a serving platter or individual plates. Spoon the glaze over top and sprinkle with parsley and pomegranate seeds.']",6
733,Eggplant Lentil Stew with Pomegranate Molasses Recipe,10,180,190,"['One 1 1/2-pound globe eggplant (or enough eggplants for 1 1/2 pounds)', 'Salt', '1/2 cup brown lentils', 'Water', '2/3 cup extra-virgin olive oil', '1 medium onion, finely chopped', '4 medium garlic cloves, minced', '2 medium tomatoes, chopped', '2 long green chiles, such as Anaheims\\xe2\\x80\\x94stemmed, seeded and coarsely chopped', '2 tablespoons chopped mint leaves (spearmint)', '1 tablespoon tomato paste', '1/4 teaspoon crushed red pepper', '1/4 cup pomegranate molasses']",13,"['1 Salt eggplant slices to drain of excess moisture: Partially peel the eggplant so it has lengthwise stripes, then cut it lengthwise into 4 slices. Score each slice on 1 side in a crosshatch pattern. Cut each slice crosswise into 3 pieces and set on a rimmed baking sheet. Sprinkle with salt. Let stand for 1 hour.', '2 Cook the lentils: In a small saucepan, cover the lentils with 2 inches of water and bring to a boil. Reduce the heat to moderate and simmer until tender, about 15 minutes. Drain the lentils.', '3 Coat a small (3-quart) enameled cast-iron Dutch oven or casserole dish with 1 tablespoon of the olive oil.', '4 Mix vegetables: In a bowl, toss the onion with the garlic, tomatoes, green chiles, mint, tomato paste, crushed red pepper and 2 teaspoons of salt.', '5 Layer pot with eggplant slices, vegetables, and lentils: Rinse the eggplant and pat dry. Spread 1/2 cup of the vegetable mixture in the Dutch oven and top with half of the eggplant. Cover with half of the lentils and half of the remaining vegetable mixture. Top with the remaining eggplant, lentils and vegetables. Pour the remaining olive oil around the side and over the vegetables, then drizzle with the pomegranate molasses.', '6 Cook the stew: Heat the stew until the liquid in the stew is simmering. Cover and cook over low heat until the eggplant is very tender, about 1 1/2 hours.', 'Serve hot, warm or at room temperature.']",7
734,Spicy Caramel Popcorn Clusters Recipe,5,25,30,"['1 cup roasted peanuts', '1/2 teaspoon salt', '1 teaspoon chili powder', '1/2 teaspoon sugar', '1/2 teaspoon cayenne pepper', '1/3 cup popcorn', '3 tablespoons canola oil', '1/2 cup unsalted butter', '1 cup brown sugar', '1/2 cup light corn syrup', '1/2 teaspoon baking powder']",11,"[""1 Get everything ready: Add roasted peanuts to a large bowl (you'll add the popcorn later). In a separate, small bowl, mix together the spice mixture (salt, chili powder, sugar, and cayenne). Line a baking sheet with parchment paper and set it aside."", '2 Pop the popcorn: Add canola oil to a large pot over medium heat. Add one kernel of popcorn to the pot and cover the lid. When that kernel pops, it means your oil is at the right temperature.', 'Remove the single kernel and pour in all the popcorn. Off the heat, cover the pot and wait 30 seconds to bring all the kernels up to temperature. Return the pot to heat and shake vigorously while the popcorn pops to prevent burning.', 'When the popping slows to a few seconds between pops, remove from heat and pour into the large bowl with the peanuts. There may be some unpopped kernels, but that\\xe2\\x80\\x99s better than burned popcorn.', 'For more detailed instructions on how to pop popcorn, see HERE', '3 Make the caramel: Melt the butter in a medium pot over medium heat. Add the brown sugar and corn syrup and stir well to combine. Cook over medium heat for 6 to 8 minutes until the mixture thickens and coats the back of a rubber spatula.', 'Add half of the spice mixture to the caramel sauce along with the baking powder. Stir well to combine.', ""4 Coat the popcorn with caramel: Immediately after making the caramel (don't let it get cold), pour it into the popcorn and peanut mixture. Work quickly and stir to combine and coat popcorn."", '5 Cool the popcorn: Spread popcorn out on the baking sheet lined with parchment paper. Use a rubber spatula to press the popcorn down into an even layer. Sprinkle popcorn with the remaining spice mixture.', 'When the popcorn has cooled slightly, you can shape the popcorn into balls if you want, but I prefer it in freeform clusters. These popcorn clusters keep perfectly at room temperature in an airtight container for a few days, or probably up to a week.']",10
735,Lemon Poppy Seed Muffins Recipe,15,35,50,"['3 cups of all-purpose flour', '1 Tbsp baking powder (make sure your baking powder is no older than 6 months)', '1/2 teaspoon baking soda', '1/2 teaspoon salt', '2 Tbsp poppy seeds', '10 Tbsp unsalted butter (1 1/4 stick), softened', '1 cup sugar', '2 large eggs', '1 1/2 cup plain yogurt', '1 Tbsp lemon zest', 'Glaze', '2 Tbsp fresh lemon juice', ""1 cup confectioner's sugar (powdered sugar)"", 'Special equipment:', '12-well muffin tin']",15,"['1 Prepare oven: Adjust the oven rack to the middle-lower part of the oven. Preheat oven to 375\\xc2\\xb0F.', '2 Mix the dry ingredients: Whisk together the flour, baking powder, baking soda, poppy seeds, and salt and set aside.', '3 Make the batter: In a large mixing bowl, beat the butter and sugar together, beating until fluffy (about 2 minutes with an electric mixer).', 'Add eggs one at a time, beating until incorporated after each one. Beat in the lemon zest.', 'Alternate adding flour mixture and yogurt: Beat in one third of the dry ingredients until just incorporated. Beat in one third of the yogurt. Beat in a third more of the dry ingredients. Beat in a second third of the yogurt. Beat in the remaining dry ingredients and then the remaining yogurt. Again be careful to beat until just incorporated. Do not over beat.', '6 Distribute batter into muffin pan: Use a standard 12-muffin muffin pan. Coat each muffin cup lightly with olive oil or a little melted butter using a pastry brush. Distribute the muffin dough equally among the cups.', '7 Bake: Bake at 375\\xc2\\xb0F until muffins are golden brown, about 25 to 30 minutes. Use a tester to make sure the center of the muffins are done. Set muffin pan on wire rack to cool. After 5 minutes, remove muffins from pan.', '8 Make lemon glaze: While the muffins are cooling, in a bowl, whisk together the powdered sugar and lemon juice for the glaze. Add more lemon juice if necessary.', 'While the muffins are still a bit warm, use a pastry brush to brush the glaze over each muffin. The muffins will absorb some of the glaze, so you add more glaze to each muffin if you like.', 'Best eaten fresh and warm.']",10
736,Orange Poppy Seed Cookies Recipe,20,12,32,"['2/3 cup of sugar', '1/2 cup of butter, room temperature', '1 egg, room temperature', '1 tablespoon of orange zest', '1 1/4 cup of flour', '1/2 teaspoon of baking soda', 'Pinch of salt', '1 tablespoon of poppy seeds']",8,"['1 Beat together the butter and sugar until light and fluffy, about 3 minutes.', '2 Add the egg and the orange zest, beat for thirty seconds, scraping down the bowl part way through to ensure even mixing.', '3 In a separate bowl, mix together the flour, baking soda, and salt. Slowly sift it into the butter mixture until just combined. Fold in the poppy seeds.', '4 Place heaping teaspoonfuls on a baking sheet lined with parchment paper or Silpat, allowing them space as they will spread as they bake.', '5 Bake at 350\\xc2\\xb0F for 10-12 minutes or until just turning golden around the edges. Remove from oven. Let sit on the baking sheet for a minute or two to let the cookies solidify a bit, then transfer them to a wire rack to cool completely.']",5
737,Cream of Wild Mushroom Soup Recipe,35,45,80,"['2 ounces of dried wild mushrooms', '3 cups hot water', '6 Tbsp butter, divided 3 Tbsp and 3 Tbsp', '1/2 cup minced shallots', '3 cloves garlic, minced (1 Tbsp)', '\\xc2\\xbd lb fresh cremini or button mushrooms, halved and sliced into 1/4-inch slices', '1/2 cup flour', '1/3 cup dry sherry', 'Salt and Pepper', '4 cups good quality chicken stock (or vegetable broth for vegetarian version)', '1 teaspoon herbes de provence', '1/2 teaspoon dried thyme', '2 bay leaves', '1 teaspoon salt (plus more to taste)', '1/2 cup heavy cream', '\\xc2\\xbc cup finely chopped parsley', '\\xc2\\xbc cup snipped chives']",17,"['1 Soak the dry mushrooms in water: Place dried wild mushrooms in a medium bowl and cover with 3 cups of very hot water. Let sit for 30 minutes. Line a sieve with a dampened paper towel or coffee filter.', 'After 30 minutes strain the mushrooms through the filter, reserving at least one cup of the mushroom liquid. Roughly chop the reconstituted wild mushrooms.', '2 Saut\\xc3\\xa9 shallots, garlic, mushrooms: Heat 3 Tbsp butter in heavy saucepan over medium low heat and saut\\xc3\\xa9 the shallots until softened and translucent, about 7 to 8 minutes. Add the garlic and cook a minute more.', 'Add the fresh mushrooms, increase the heat to medium high, and cook several minutes more. Add chopped wild mushrooms. Lower the heat, cover and let cook for 10 minutes.', '3 Add sherry: After 10 minutes increase the heat to medium high, uncover and add 1/3 cup dry sherry to the pot.', '4 Make a roux with butter and flour: Add remaining 3 Tbsp butter to the pot and stir until melted. Add the flour to the pot and stir until the mushrooms are all well coated with the flour, making a roux. Cook for 2 to 3 minutes.', '5 Add mushroom water, stock, and herbs: Add one cup of reserved mushroom soaking water and stir until the flour has dissolved into the water and there are no lumps. Add the chicken stock. Stir until well incorporated.', 'Add the herbes de provence, the dried thyme, bay leaves, and salt.', '6 Simmer: Heat on high until the soup comes to a low simmer. Lower the heat to maintain a simmer, cover and cook for 20 minutes.', '7 Stir in cream: When ready to serve, remove the bay leaves and stir in 1/2 cup heavy whipping cream. Add black pepper and more salt to taste.', 'Garnish with chopped chives and parsley.']",11
738,Spicy Sausage Pizza Recipe,10,4,14,"['2 pounds prepared pizza dough, divided into 4 balls', '1 cup marinara sauce, store-bought or homemade', '1 pound mozzarella cheese (low moisture), grated', '8 ounces spicy Italian sausage', '2 teaspoons red pepper flakes', 'Fresh basil, garnish', 'Extra flour, for rolling and throwing the pizza', 'Hot Honey Dip:', '1/4 cup honey', '1 tablespoon hot sauce', '1/2 teaspoon red pepper flakes']",11,"['1 Warm the dough (if refrigerated): If your dough has been refrigerated, take it out of the fridge an hour before you want to make pizza.', 'Divide the dough into four balls and let them sit at room temperature so they become easier to work with. Keep the dough covered with plastic, though, so it doesn\\xe2\\x80\\x99t dry out. (If your dough was not refrigerated, divide the dough just before shaping.)', '2 Preheat the Roccbox or oven: Preheat your Roccbox to 600-700\\xcb\\x9a F (somewhere in the middle orange color); it should take about 15 minutes to preheat.', 'If cooking in the oven, preheat the oven to 500\\xcb\\x9aF with a pizza stone for 20 minutes so the stone is very hot. ', '3 Prepare the hot honey dip: Add honey to a microwave-safe bowl and heat for 10 seconds. Then stir the honey together with hot sauce and red pepper flakes. Serve the honey as a dip with any and all pizza!', '4 Assemble the pizza: On a lightly floured surface, roll out one dough ball until it forms a 10-inch round. It should be pretty thin. Top the pizza with a few tablespoons of marinara sauce. I don\\xe2\\x80\\x99t like my pizzas very saucy, but add an extra spoon of sauce if you do.', 'Then top the pizza with four ounces of cheese and dot on two ounces of spicy sausage. Be sure to tear the sausage into very tiny meatballs so they cook quickly. Season the pizza with red pepper flakes and a tiny pinch of salt and pepper.', '5 If cooking the pizza in the Roccbox: Lightly dust your pizza peel with flour and quickly slide the topped pizza onto the peel. Then slide the pizza off the peel, directly onto the hot Roccbox stone. The pizza will cook very quickly in the Roccbox. Turn it about every 30 seconds so it cooks evenly. The pizza will be done in 3-4 minutes.', '6 If cooking the pizza in the oven: Slide the topped pizza onto the pizza stone and cook for 8-10 minutes until the crust is crispy and golden brown and sausage is cooked.', '7 While the first pizza cooks, prepare the next pizza.', '8 Cool briefly and serve: Remove the cooked pizza from the Roccbox or oven, and let it cool briefly before. Garnish with fresh basil, slice, and serve with the hot honey dip. Repeat for cooking the remaining pizzas.', 'REHEATING PIZZA: If you have leftover pizza, reheat the pizza in a skillet over medium heat. Cook the pizza for a few minutes so the crust stays crispy. Add a lid to the skillet for a minute so the cheese melts. Be careful removing the pizza from the skillet. It will be very hot!']",12
739,Pork Chops with Cherry Pan Sauce Recipe,15,35,50,"['For the pork chops:', '1 tablespoon vegetable oil', '4 bone-in center-cut pork chops, about 3/4-inch-thick and 8 to 9 ounces each', '2 teaspoons kosher salt', '1/2 teaspoon ground black pepper', '1/2 teaspoon garlic powder', 'For the herb-cherry pan sauce:', '2 cups pitted halved sweet cherries (fresh or frozen)', '1 teaspoon chopped fresh thyme leaves or 1/2 teaspoon dried', '1/4 teaspoon kosher salt', '1 cup tawny Port wine', '2 tablespoons unsalted butter']",12,"['1 Season the pork chops: Sprinkle the pork chops on both sides with the salt, pepper, and garlic powder.', '2 Cook the pork chops: Heat the oil in a large skillet over medium to medium-high heat.', 'Add the pork chops two at a time, so as to not crowd the pan, and cook until browned on the first side, 4 to 5 minutes. Flip pork chops over and cook on other side for 3 to 4 minutes more.', 'Transfer to a tray or platter and cover with foil to keep warm. (You can also put them in a low oven if you wish.) Repeat with the remaining pork chops, adding more oil to the pan if dry.', '3 Make the herb-cherry pan sauce: Add the cherries, thyme, and salt to the pan and cook so they start to release their juices and soften, scraping up the stuck-on bits on the bottom of the pan, 3 to 4 minutes.', 'Add the Port and let simmer until reduced by about half, 10 to 12 minutes. Stir in the butter until emulsified and the sauce is nice and glossy. Taste and adjust with more salt to taste.', '4 Serve: Serve the pork chops with the sauce on the side for diners to spoon on their plates or over their chops. Enjoy!']",7
740,Glazed Baked Ham Recipe,30,90,120,"['For the ham:', 'One half ready-to-eat, cooked ham, bone-in, shank end or butt end, about 9 to 11 pounds', 'For the Sweet Hot Honey Mustard Glaze:', '3 tablespoons sweet hot honey mustard (or brown mustard with honey)', '2 tablespoons brown sugar', 'About 50 cloves', 'For the Honey Thyme Glaze:', '3 tablespoons melted butter', '2 tablespoons chopped fresh thyme (or 2 teaspoons dry)', '1/4 cup cider vinegar', '1/4 cup honey', '1 tablespoon brown sugar', '1 teaspoon Worcestershire sauce']",13,"['1 Let ham come close to room temp: Remove the ham from the refrigerator (still wrapped) a couple of hours before you intend to cook it so that it can get closer to room temperature. This will help it warm more evenly.', '2 Score skin and fat (if using an unsliced ham): Place the ham, fattier side up, in a foil-lined roasting pan.', ""Score a diamond pattern in the fat with a sharp knife, about 1/4-inch to 1/2-inch deep, and the parallel lines about 1 1/2-inches apart. (You won't need to do this if you're using a spiral cut ham.)"", ""Do not score the meat itself, just the fat and any skin. You can score the fat as deeply as to where the fat meets the meat. If you want, you can first cut off any skin that might still be on the ham, but it isn't necessary."", '3 Insert cloves (if using): If using cloves (with the Sweet Honey Mustard Glaze), you can either put them in before applying the glaze or after. They look better if applied after, but it is easier to see the lines in the ham as a guide for placement if you put them in first.', 'Place the cloves in the center of the diamonds to form a nice pattern around the top and sides of the ham (or along the edges of some of the precut slices if using spiral cut). Some people put the cloves in the intersection points of the scores. Do as you wish. You just want a nice pattern.', '4 Preheat oven to 325\\xc2\\xb0F.', '5 Prepare glaze:', 'If using the sweet honey mustard glaze: Mix the mustard with the brown sugar in a small bowl.', 'If using the honey thyme glaze: Mix thyme in with the hot melted butter and let sit for a few minutes. In a small saucepan on high heat, let the cider vinegar reduce down from 1/4 cup to 1 tablespoon, and remove from heat. Whisk in the butter and thyme. Add the honey, brown sugar, and Worcestershire sauce.', '6 Apply glaze: Using a pastry brush, brush whichever glaze you are using over the ham. Only use about third of it (reserve the rest for later in cooking). Try to work the glaze into the scored lines.', ""7 Bake the ham: Place ham in oven. (If using a spiral cut ham, first wrap tightly in aluminum foil so that the ham doesn't dry out while cooking.)"", 'Cook for 1 to 1 1/2 hours (check after 1 hour, will take longer if the ham is not at room temp to begin with), or about 10 minutes per pound, until the internal temperature of the ham is 110\\xc2\\xb0-120\\xc2\\xb0 with a meat thermometer. (Note that the ham is already cooked when you buy it, all you are trying to do is heat it up for eating.)', 'If using a non-spiral cut ham, baste the ham with the glaze a couple of times during the cooking. If you check on the ham and think that the glaze is at risk of getting too browned (like on the way to burnt), you can cover with a piece of foil.', '8 Baste and broil: When the ham has reached the desired temperature, baste again. (If using a spiral cut ham, open up the foil to expose the ham before basting.)', ""Regardless of which ham you're using, place it under the broiler for few minutes to get some nice browning on the top. Take the pan out of the oven and brush the ham all over with pan juices. Cover with aluminum foil and let rest for 15 minutes before serving."", '9 Slice: To slice a bone-in ham, cut around the bone first. Then use a long, sharp knife to slice off pieces around the bone.', 'Another way to slice the ham is to make first a slice on wide end to get a flat lying surface. Then stand the ham upright on the wide end and make slices down the side, working around the bone.', 'Remember to save the ham bone for soup!']",19
741,Pozole Rojo (Mexican Pork and Hominy Stew) Recipe,30,180,210,"['4 ounces dried guajillo, ancho, or a combination of both, chili pods', 'Salt', '1 large (108 ounce, 6 lb 12 oz, 3 kg) can white hominy, drained and rinsed', '3 pounds pork shoulder (preferably with bone), cut into 1 to 1 1/2 inch cubes (can also use pork shanks), make sure to use a cut well marbled with fat', '8 cloves garlic, 4 cloves roughly chopped, and 4 whole cloves', '3 bay leaves', '1 teaspoon ground cumin', '2 Tbsp of dry oregano (Mexican oregano if available)', 'Garnishes (can prep while pozole is cooking):', 'Half a small cabbage, thinly sliced', 'One bunch cilantro, chopped', '1/2 white onion, chopped', '2 avocados, chopped', '4 limes, quartered', 'A bunch of red radishes, sliced thin', 'A couple dozen tostada shells (see Recipe Note)']",16,"['1 Boil 5 quarts water: Fill a large 10-12 quart stockpot with 5 quarts of water. Set on heat to bring to a boil while you proceed with the next steps.', '2 Lightly roast chiles, cover with 3 cups hot water. Remove and discard the stems, seeds, and large veins from the chili pods. Heat a cast iron pan on medium high and lightly roast the chili pods for a couple minutes, until they begin to soften. Do not let them burn.', 'While the chilies are heating, bring a medium pot with 3 cups of water to a boil. Once the chiles have softened, remove the pot of boiling water from the heat, add the chiles to the pot and cover.', 'Let the chiles soak in the hot water for 15 to 20 minutes.', '3 Brown the pork, add garlic: Heat a tablespoon or two of olive oil (enough to coat the bottom of the pan) in a large saut\\xc3\\xa9 pan on medium high heat. Pat the pork pieces dry with paper towels. Sprinkle them generously with salt.', 'Working in batches, taking care not to crowd the pan or stir the meat much, brown the meat on all sides.', 'Right at the end of browning the meat, add 4 cloves of roughly chopped garlic to the pan with the meat, let cook with the meat for about a minute.', '4 Add pork and spices to large pot of boiling water: Once the meat has browned, transfer it to the large stockpot of boiling water. Scrape up any browned bits at the bottom of the pan, and any garlic, and add those to the pot as well. Add the rinsed hominy.', 'Add bay leaves, cumin, and oregano. When you put the oregano in, smoosh together with your hands so that the oregano breaks up more as it goes in. Add a tablespoons of salt. Bring to a simmer, reduce the heat and cook for 15 minutes.', ""5 Prepare the red sauce by pur\\xc3\\xa9eing in a blender the chilies, 2 1/2 cups or so of their soaking liquid, a teaspoon of salt, and 4 cloves of garlic. (To prevent the blender from creating too much pressure, it's probably best to start with the chiles and garlic and only a cup of the liquid in the blender, and then adding the rest of the liquid.)"", 'Strain the red sauce through a sieve, discarding the tough bits of the sauce.', '6 Add the red chili sauce to the pot with the pork and hominy. Add another couple teaspoons of salt. Return to a simmer, lower the heat to just high enough to maintain a simmer, partially covered.', '7 Cook for 2 to 3 hours until the pork is completely tender. Skim away excess fat. Taste for seasoning and add more salt to taste (you will likely need more than you expect, perhaps a tablespoon or more.)', 'The resulting soup should be rather brothy, as you will be adding a lot garnishes. Add more water if necessary.', '8 Assemble garnishes: When getting ready to serve the pozole, you can prep the garnishes (slice the cabbage, chop the cilantro, etc.)', 'To serve, arrange the garnishes in bowls on the table and serve the pozole soup into bowls. Let your guests pick and choose which garnishes they would like on their pozole.', ""Serve with tostada shells (or tortilla chips if you can't find tostada shells).""]",17
742,Brown Sugar Baked Ham with Pineapple Recipe,10,210,220,"['15-pound bone-in ham', '2 cups brown sugar, packed', '1/2 teaspoon ground cloves', '5 (20 oz) cans of pineapple rings in 100% juice', 'To Serve:', 'Variety of high-quality mustard', 'Special equipment:', 'Wooden toothpicks']",8,"['1 Prepare your roasting pan: Set your roasting pan on your counter and remove the roasting rack. You won\\xe2\\x80\\x99t need it. Place 6 to 8 pineapple rings on the bottom of the roasting pan. (You can also use a large casserole dish; if your ham fits, the dish is fine!)', '2 Season the ham: Remove the ham from its packaging and place the ham in the roasting pan. Combine brown sugar and ground cloves together in a small bowl. Massage the sugar mixture all over the ham, including the cut side. Really rub the sugar into the meat. It will turn into a paste as you rub it. That\\xe2\\x80\\x99s okay. If some sugar drops into the roasting pan, scoop it up, and keep rubbing it into the meat.', 'When finished, set the ham cut side down onto the pineapple rings.', '3 Score the ham: Score the ham 1/4-inch deep in a diamond pattern. If this is difficult to do in the roasting pan, then transfer the ham to a cutting board. Score it, and then return it to the roasting pan, putting the cut side down onto the pineapple rings.', 'Pour the juice from 1 can of pineapple into the bottom of the pan. Don\\xe2\\x80\\x99t pour the juice over the ham because it will wash off the brown sugar.', '4 Let the ham rest for 24 hours: Cover the ham with aluminum foil, secure it around the roaster, and let hang out in the fridge overnight, or for at least 8 hours.', '5 Cover the ham with pineapple slices: The next day, remove the ham from the refrigerator. Open the foil and spoon pan juices over the ham. Lay pineapple rings across the ham so they touch each other, and secure them with wooden toothpicks if necessary. Two toothpicks per slice is plenty.', '6 Bake the ham: Cover with foil. Make sure to seal the foil tightly around the edges of the roasting pan. Bake at 325\\xc2\\xb0F for 15 to 18 minutes per pound of meat. (Roughly 4 1/2 hours for a 15-pound ham.)', '7 Rest the ham before serving: Let the ham rest, covered, for 15 minutes before slicing.', '8 Slice and serve: Transfer the ham to a cutting board. Remove the pineapple slices, and save them to fry and put on leftover ham sandwiches. Discard the toothpicks.', 'Slice the ham to your desired thickness. As you slice the ham, place the sliced pieces into the roaster with all of the juices. When everything has been sliced, transfer the slices to a serving platter. Serve alongside a selection of high-quality mustard and/or chutneys.']",11
743,Italian Grilled Cheese Sandwiches Recipe,10,20,30,"['For the DAD ADD: Olive and Cauliflower Giardiniera', '1 cup hot pickled cauliflower, chopped', '1/2 cup green olives (Castelvetrano), chopped', '1/4 cup banana peppers', 'For the sandwiches:', '8 slices sandwich bread', '8 slices provolone cheese', '4 ounces Genoa salami', '4 ounces prosciutto', '2 ounces pepperoni', '1/2 cup fresh basil leaves, loosely packed', '2 tablespoons butter']",12,"['1 Make the Dad Add (optional): Chop the ingredients to roughly the same size, and stir them together in a bowl. Done!', '2 Prepare the sandwiches: Add a slice of provolone to a piece of bread. Top with a layer of salami, prosciutto, and pepperoni. Divide the meat evenly among the four sandwiches.', 'Top meat with a handful of fresh basil leaves and a second piece of provolone cheese. Add second piece of bread and press down slightly to keep the sandwich together.', '3 Grill that cheese: Preheat a large skillet over medium-low heat. Once warm, add about 1/2 tablespoon of butter per sandwich you are cooking. Usually, I cook two at a time. When the butter has melted, add the sandwich and coat the bread with the melted butter, then flip and coat the second side as well.', 'Let sandwiches cook over medium-low heat for about 3 to 4 minutes per side, making sure they don\\xe2\\x80\\x99t get too browned. After about 6 to 8 minutes total, the cheese in the sandwich should be well melted and the bread toasted. Done!', 'Repeat the process for the last two sandwiches. I like to serve the first two to kids while I make the last two for adults, but you can also keep the first two warm in a 200\\xc2\\xb0F oven while you make the last two.', '4 Serve! Serve sandwiches with chips, salad, steamed veggies, and/or giardiniera.']",7
744,Slow and Low Country Ribs Recipe,10,210,220,"['4 country ribs, about 3 pounds', 'Kosher salt', 'Vegetable oil', 'The barbecue sauce of your choice']",4,"['Let the ribs cook a minute or two so the sauce can caramelize. Pay attention, and do not let the ribs get too blackened. A little char is good, but you don\\xe2\\x80\\x99t want a briquette.', 'Serve with coleslaw, potato salad, deviled eggs or whatever you\\xe2\\x80\\x99d like. Oh, and napkins. Lots of napkins.']",2
745,"Sausage, Peppers, and Onions Recipe",10,40,50,"['4 Italian sausage links (sweet, hot, or a couple of each)', '2 tablespoons extra virgin olive oil', '1 green bell pepper, sliced into 2 to 3 inch-long strips', '1 red bell pepper, sliced into 2 to 3 inch-long strips', '1 bell pepper of another color (yellow or orange or purple), sliced into strips 2-3 inches long', '4 garlic cloves, sliced into slivers', '1 large sweet or yellow onion, sliced into 1/4-inch half-moons', '1 small (15-ounce) can crushed tomatoes', '1 tablespoon dried oregano', '1/2 cup Marsala or red wine (optional)', '1/2 teaspoon red pepper flakes (optional)', 'Salt to taste']",12,"['1 Brown the sausages: Heat the olive oil over medium heat in a large pan that has a lid. When the oil is hot, add the sausages and brown them slowly.', 'If they sizzle and crackle too much, turn the heat down. You want a gentle browning, not a sear. Cook for several minutes, turning them occasionally so they brown on all sides. When the sausages are browned, remove from the pan and set aside.', '2 Saut\\xc3\\xa9 the onions, peppers, and garlic: Increase the heat to high and add the onions and peppers. Toss so they get coated with the oil in the pan and sear them as well as you can, stirring every so often.', 'Once the onions and peppers soften, sprinkle some salt on them. Once you get some blackening from a good sear on the onions and peppers, add the garlic, and cook for one more minute.', '3 Deglaze pan with wine (optional): Add the Marsala or red wine if you are using. Scrape the bottom of the pan with a metal spatula or wooden spoon to release all the browned and blackened bits. Let the wine cook down by half.', '4 Simmer all the ingredients: Add the tomatoes, oregano, and red pepper flakes (if using) and stir well to combine. Add the sausages back in. Bring to a simmer. then reduce the heat to low.', 'Cover and simmer until the peppers are soft and the sausages are cooked through, about 20 minutes.', '5 Serve: Serve over polenta, penne pasta, or load it up on a hoagie roll. Sausage and peppers and onions will keep for several days in the fridge.']",8
746,Slow Cooker Mexican Pulled Pork Tacos Recipe,10,490,500,"['For the spice rub:', '4 tablespoons chili powder', '1 tablespoon kosher salt (if using regular table salt, only use 2 teaspoons)', '1 tablespoon brown sugar', '2 teaspoons ground cumin', '1 teaspoon cayenne', '1 teaspoon ground oregano', '1 teaspoon onion powder', '1 teaspoon garlic powder', '1/4 teaspoon cinnamon', 'Scant pinch of ground cloves', 'For the pork:', '3 1/2 pound boneless pork shoulder roast', '2 tablespoons extra virgin olive oil', 'For the tacos:', 'Sliced avocado', 'Sliced radishes', 'Thinly sliced cabbage', 'Warm tortillas, corn or flour', 'Fresh squeezed lime juice', 'Salsa', 'Special equipment:', '6-quart slow cooker, or Instant Pot on the slow cook setting']",23,"['1 Make the rub: Whisk together the rub ingredients in a small bowl.', '2 Rub spice mix into roast: If the roast is tied up with butcher string, untie it. Pat the roast dry with paper towels. Rub the spice mix into the roast all over, reserving any leftover spice mix for later.', 'Let sit at room temperature at least one hour or chill overnight.', '3 Brown the roast: Heat olive oil in a frying pan on medium high heat. (If you are using a slow cooker with a removable container that can be used on the stovetop, use that, otherwise use a separate pan.) Place the roast in the pan and brown on all sides.', '4 Put in slow cooker, cook on low: Place the roast in a slow cooker, and add any reserved spice rub. Cook on the low setting for 6 to 10 hours, until the pork is fall apart tender.', '5 Shred pork, toss with meat juices: Remove the roast from the slow cooker and place on a cutting board. Cut into large chunks. Then use two forks to pull the meat apart into bite sized shreds.', 'Return the shreds to the slow cooker and toss to coat with the juice from the roast. (Alternatively you can just shred the roast with two forks in the slow cooker itself.)', 'Serve with warm tortillas, avocados, shredded cabbage, sliced radishes, cilantro, and a splash of lime juice or salsa.']",8
747,Italian Meatballs Recipe,25,60,85,"['For the meatballs:', '1 pound ground beef (at least 16 percent fat)', '1 pound ground pork', '2/3 cup milk (whole or 2 percent)', '3 slices of white bread, crusts removed (about 3 ounces)', '1/4 cup ricotta cheese', '1/4 cup grated Parmesan or Romano cheese', '2 large eggs', '1 teaspoon salt (or 2 teaspoons of kosher salt)', '1 tablespoon chopped fresh parsley', '2 teaspoons black pepper', '1 teaspoon dried oregano or marjoram', '2-3 garlic cloves, minced', 'About 1 cup flour, for dusting', '1/3 cup extra virgin olive oil', '2 1/2 cups (24 ounces) tomato sauce (recipe follows, or use already prepared)', 'Tomato Sauce:', '2 tablespoons extra virgin olive oil', '3/4 cup finely chopped onions', '3/4 cup finely chopped carrots', '3/4 cup finely chopped celery', '2 tablespoons chopped fresh parsley', '1 clove garlic, minced', '1 28-oz can crushed or whole tomatoes, including the juice, or 1 3/4 pound of fresh tomatoes, peeled, seeded, and chopped', '1/2 teaspoon dried basil or 2 Tbsp chopped fresh basil', '1 teaspoon tomato paste', 'Salt and freshly ground black pepper to taste']",27,"['1 Make the tomato sauce: Heat olive oil in a large skillet on medium heat. Add the onions, carrots, celery, and parsley. Stir to coat with the oil, reduce the heat to low and cover the pan. Cook for 15 to 20 minutes until the vegetables are soft and cooked through.', 'Remove the cover, add the garlic, and increase the heat to medium high. Cook the garlic for half a minute, then add the tomatoes (if using whole canned tomatoes, break up with your fingers as you add them to the pan). Add the tomato paste and basil. Season with salt and pepper.', 'Bring to a low simmer, reduce the heat to low and let cook uncovered until thickened while you prepare the meatballs, 15 to 30 minutes.', 'Pur\\xc3\\xa9e in a blender, or push through a food mill for a smooth consistency. Return to pan. Adjust seasonings.', '2 Soak torn bread in hot milk: Heat the milk in a small pot until steamy. Turn off the heat, tear the bread into little pieces and soak it in the milk until it partially dissolves. Mash it until you get something that resembles a paste. Turn it out onto a plate to let it cool.', '3 Make meatball mixture: In a large bowl, combine the beef, pork, ricotta cheese, grated Parmesan, eggs, salt, parsley, oregano, black pepper, garlic cloves and the bread-milk mixture. Mix it well with your hands until it barely combines.', ""Don't overwork the mixture or it will become tough. It is OK to have some discernible bits of bread or meat in the mix; better that than overworked meatballs."", '4 Form meatballs: Wet your hands and form the meatballs. A traditional size for this sort of meatball is 2-3 inches across, but you can make them any size you want.', 'Once you roll the meatball in your hands, roll it in the flour to give it a good coating. Set each one on a baking sheet as you work. You might need to rinse your hands a few times as you make the meatballs.', ""5 Brown meatballs: When all the meatballs are formed, heat olive oil in a large skillet over medium-high heat. Brown the meatballs on at least two sides. Don't worry about the center getting cooked through, as you will finish these in the sauce."", '6 Finish cooking meatballs in tomato sauce: Once all the meatballs are browned, arrange them in the sauce, turning each one over in the sauce to coat.', 'Cover the pot and simmer gently for 15-20 minutes. Serve with the sauce and pasta or crusty bread. Sprinkle with a little chopped parsley for garnish if you want.']",12
748,Bacon-Wrapped Stuffed Pork Tenderloin Recipe,20,20,40,"['2 tablespoons olive oil', '1 medium apple, peeled and cut into small dice (about 1 cup)', '1/4 medium yellow onion, finely chopped (about 1/3 cup)', '1 tablespoon chopped fresh rosemary', '1 tablespoon chopped fresh thyme', '1 to 2 thick slices bread (enough to make 1/2 cup coarse breadcrumbs)', '1 tablespoon Dijon mustard', '1/8 teaspoon salt, plus more to taste', '1/8 teaspoon pepper, plus more to taste', '1 pork tenderloin (1 to 1 1/4 pounds)', '8 to 10 strips of bacon (about 12 ounces), cut in half']",11,"['1 Heat the oven to 450F. Have on hand a rimmed baking sheet.', '2 Make the stuffing: In a skillet over medium heat, heat the oil. Add the apple, onion, rosemary, and thyme, and cook for 7 to 9 minutes, or until softened. Meanwhile, pulse the bread slices in a food processor until you make coarse crumbs. You should have about 1/2 cup of breadcrumbs.', 'Remove the pan with the onions and apples from the heat, and stir in the breadcrumbs, mustard, salt, and pepper. Set aside to cool briefly.', '3 Butterfly the tenderloin: Cut a deep lengthwise slit down the center of the tenderloin, stopping about 1/2-inch from the bottom of the roast. Open it up like a book. Cover with a piece of plastic wrap, and with a mallet or rolling pin, gently pound it until it is of an even thickness.', '4 Stuff the tenderloin: Spread the stuffing in a line along the center of the meat. Bring the edges of the meat together to return it to its original shape. Secure with toothpicks.', '5 Wrap the bacon slices around the meat: Lay out the bacon slices on a cutting board, overlapping them slightly. Place the tenderloin on top with the toothpicks facing up. Removing the toothpicks as you work, wrap the bacon slices around the pork to form a log. Place the tenderloin, bacon seam side down, on the baking sheet. ', '6 Roast the tenderloin: Roast for 20 to 25 minutes, or until an instant-read thermometer inserted into the center of the meat registers 145F to 150F and the bacon is brown and crisp. If the roast is ready before the bacon browns, place the tenderloin under the broiler for 3 to 5 minutes to brown the bacon.', '7 Let the tenderloin rest for 10 minutes before cutting into slices. Serve with the pan juices spooned over top if desired.']",8
749,EASY Italian Sausage Spaghetti Recipe,5,35,40,"['1 tablespoon extra virgin olive oil', '1 yellow onion, finely chopped (about 1 1/2 to 2 cups)', '2 cloves garlic, minced (about 2 teaspoons)', '6 ounces (170 g) Italian sweet sausage (or one 7 to 8 inch link)', '6 ounces (170 g)  Italian hot and spicy sausage (or one 7 to 8 inch link)', '1 large (28 oz, 794 g) can of crushed tomatoes (or pur\\xc3\\xa9e a can of whole peeled tomatoes)', '1 pound (16 oz, 450 g) spaghetti pasta', 'Salt', 'Freshly grated Parmesan cheese']",9,"['1 Saut\\xc3\\xa9 onions and garlic: Heat a tablespoon of extra virgin olive oil in a large skillet on medium or medium heat. Add the chopped onion and cook until translucent, about 5 minutes. Add the minced garlic and cook a minute more.', '2 Put pasta water on to boil: While the onions are cooking, put a large pot of salted water on to boil for the pasta (4 quarts water, 2 Tbsp salt).', '3 Brown the sausage: Remove the cooked onion and garlic from the pan and set aside. Remove the sausage meat from the casings (if your sausage is in links) and add to the pan, breaking up the meat with your fingers as you add it to the pan. Cook on medium heat until just lightly browned.', '4 Add tomatoes, onions, garlic: Add crushed or pur\\xc3\\xa9ed canned tomatoes with their juices to the skillet with the sausage meat. Add the cooked onions and garlic. Heat to a bare simmer.', '5 Boil the spaghetti pasta: Once the pasta water has come to a rolling boil, add the spaghetti pasta. Allow the water to return to a rolling boil. Cook, uncovered, with a vigorous boil, for as long as the directions on the pasta package say, usually about 10-12 minutes. When pasta is al dente (cooked but still a little firm), remove the pot from the heat. Drain the pasta and place it in a serving bowl.', 'Serve immediately. Toss with the sauce and garnish with grated Parmesan cheese.']",6
750,Stuffed Delicata Squash with Pancetta and Goat Cheese Recipe,10,35,45,"['4 small delicata squash', '2 ounces pancetta, diced small', '8 ounces portabella mushrooms, diced', '1/2 medium yellow onion, diced', '3 cloves garlic, minced', '1 teaspoon dried oregano', '1 teaspoon kosher salt', '1/2 teaspoon freshly ground cracked pepper', '1/4 teaspoon fennel seeds, chopped', '1/4 cup fresh parsley, chopped and packed', '1 tablespoon balsamic vinegar', '1 pint grape tomatoes, halved', '4 ounces chevre (goat cheese)', 'For the breadcrumb topping:', '1/2 cup Panko', '2 teaspoons oil', '1/2 teaspoon salt', '1/2 teaspoon pepper', '1/2 teaspoon dried thyme', 'For the rice:', '1 tablespoon olive oil', '1/2 cup uncooked basmati rice', '1 1/2 cups water', '1 tablespoon butter', '1 bay leaf', '1 teaspoon kosher salt']",26,"['1 Roast the squash: Preheat the oven to 375\\xc2\\xb0F. Line a baking sheet with parchment paper.', 'Scrub the outside of the squash to get rid of any dirt. Cut the squash in half lengthwise and scoop out the seeds.', 'Brush the outside and inside of the squash halves with olive oil. Sprinkle with salt and pepper and transfer to a baking sheet.', 'Roast in the oven for 30 to 40 minutes. When it\\xe2\\x80\\x99s ready, you should be able to easily pierce the flesh with a fork. Start checking for doneness at 30 minutes. Remove from oven and set aside.', 'While the squash roasts, prepare the bread crumb topping and filling.', '2 Make the breadcrumb topping: Combine breadcrumbs, salt, pepper, thyme, and oil in a small bowl. Stir well with a fork to make sure everything is coated. Set aside.', '3 Make the rice: Rinse the rice in a fine mesh strainer under cold running water. Heat 1 tablespoon olive oil in a medium saucepan over medium heat. Add rice and toast, stirring occasionally, for 5 minutes. The rice should look golden.', 'Add water, butter, bay leaf, and salt to the pot. Cover, and bring to a low boil, still over medium heat for about 12 to 15 minutes. Remove from heat, but keep covered, and let it steam while you finish making the rest of the meal.', '4 Cook the pancetta: In a medium saut\\xc3\\xa9 pan, cook the pancetta over medium to medium low heat, for about 20 minutes. The goal is to render the fat.', 'When crispy, scoop out pancetta and set aside. You will add it back to the filling later. There should be about 2 tablespoons of fat in your pan.', '5 Cook the veggies: To the pan with the rendered fat, add mushrooms, onion, garlic, oregano, 1 teaspoon kosher salt, 1/2 teaspoon freshly ground pepper, and chopped fennel seeds.', 'Cook for 15 minutes over medium heat, stirring once or twice until the mushrooms have shrunk and the onions are translucent.', '6 Add the tomatoes and rice to the veggies: Add the cherry tomatoes and 1 tablespoon of balsamic vinegar to the pan with the mushrooms. Stir to coat. Continue cooking until the tomatoes begin to fall apart, about 7 to 10 minutes.', 'Stir in the cooked rice, cooked pancetta bits and chopped parsley. Taste and add more salt and pepper to your liking. Remove from the heat.', '7 Stuff the squash: Fill each half of squash halfway with the rice-veggie filling, using about 1/4 cup in each half. Crumble the chevre and sprinkle evenly over each half.', 'Spoon the rest of the filling on top of the chevre. Sprinkle each half with panko mixture.', '8 Broil the filled squashes: Turn the oven to broil. Put the squash under the broiler for 1 to 3 minutes until the filling is warmed through and the panko is a deep golden brown.']",17
751,Cranberry Glazed Ham Recipe,10,150,160,"['Glaze:', '1/2 of a 14-ounce can of jellied cranberry sauce', '1/4 cup orange juice', '2 strips of orange zest', '2 to 3 Tbsp brown sugar', '1 Tbsp whole grain mustard', 'Ham:', '1/2 spiral-cut ham (about 9 pounds, plus or minus), bone-in, natural juices or no added water']",8,"['1 Let ham sit at room temp: Let the ham sit at room temp for a couple of hours before cooking. This will help the ham heat more evenly in the oven with less risk of the outside edges drying out.', ""2 Heat the ham: Wrap the ham tightly in aluminum foil, place in a roasting pan, and heat in a 275\\xc2\\xb0F oven for 2 to 2 1/2 hours (depending on the size of the ham, could be less or more time), until the internal temperature is 100\\xc2\\xb0F. (It's already cooked, you're just heating it.)"", '3 Make the glaze: Place the jellied cranberry sauce in a small saucepan on low heat. Whisk in the orange juice and brown sugar until the brown sugar is dissolved. Add the strips of orange zest. Heat until bubbly and whisk until smooth. Then remove from heat, take out the orange strips, and stir in the mustard.', '4 Glaze the ham: When the ham is ready, remove from oven. Open up the foil and paint the ham with half of the glaze. Keep the ham uncovered and return to the oven, bake at 425\\xc2\\xb0F for 10 minutes.', '5 Glaze again and broil: Remove from oven and baste with the remaining glaze. Return to the oven on the lowest rack, and broil for 5 to 10 minutes (at least 6 inches away from the heating element) until the glaze is lightly browned and caramelized.', '6 Cut around the bone: Transfer ham to a serving dish. Use a paring knife to cut around the bone to separate the spiral cut slices from the bone. If you want pour some of the remaining pan juices over the ham. (Great flavor!)', 'Make sure to save the bone for ham soup!']",7
752,Ham and Cheese Pasta Bake Recipe,10,35,45,"['12 ounces fusilli pasta', 'Salt for pasta water', '4 tablespoons butter', '2 cloves garlic, minced,', '4 tablespoons flour', '2 1/2 cups milk', '1/2 cup heavy whipping cream', '1 cup water', '1/4 teaspoon ground nutmeg (more to taste)', '1 teaspoon ground black pepper (more to taste)', '1 teaspoon Italian seasoning (or a mix of dried oregano, thyme, and basil)', '3/4 teaspoons salt (more to taste)', '3 ounces (about 1 cup, packed) shredded or grated Parmesan cheese', '4 ounces (about 1 cup, packed) shredded Mozzarella cheese', '10 ounces diced ham (about 2 cups)', '1/4 cup chopped fresh parsley', '1/4 cup chopped fresh green onion greens or chives']",17,"['1 Make pasta: Put a big pot of salted water onto boil on high heat for the pasta (4 quarts, 2 Tbsp salt). While the pasta water is heating, prep the other ingredients.', 'Once the water has reached a rolling boil, add the pasta and stir so it doesn\\xe2\\x80\\x99t stick to the bottom of the pan. Let the water return to a rolling boil and cook, uncovered, for 9 to 10 minutes, until the pasta is \\xe2\\x80\\x9cal dente\\xe2\\x80\\x9d, cooked through but still slightly firm to the bite.', '2 Make roux: Melt the butter in a large (3 to 4 quart), thick-bottomed pot on medium heat. Add the minced garlic. Let the garlic sizzle for a few seconds. Add the flour and whisk so that any lumps are dissolved. Let the roux (flour and butter) bubble and cook for a minute or two.', '3 Make the sauce: Slowly add the milk and cream, a quarter cup at a time, whisking until incorporated after each addition. Increase the heat to medium high. Add \\xc2\\xbc teaspoon of ground nutmeg and \\xc2\\xbd teaspoon of ground black pepper. (You may want to increase these later to taste.) Add \\xc2\\xbd teaspoon of Italian seasoning.', 'Add half of the shredded Mozzarella and Parmesan cheeses, whisking until melted and incorporated into the sauce.', 'Add 3/4 teaspoon of salt (again, you may want to increase this to taste).', 'Stir in 1 cup of water (can use pasta cooking water if you want).', '4 Preheat oven to 400\\xc2\\xb0F.', '5 Combine pasta with sauce, ham, parsley, onion greens: Drain the cooked pasta and add it to the sauce. Add the ham. Add the chopped parsley and onion greens or chives. Gently stir to combine. Taste, and add more nutmeg, salt, pepper, or Italian seasoning to taste.', '6 Bake: Transfer the pasta mixture to an oven-proof casserole dish (if you are using a Dutch oven to make the sauce, there is no need to transfer to another dish). Sprinkle the top with the remaining cheese. Bake in the oven at 400\\xc2\\xb0F for 10 to 15 minutes until the cheese is bubbly and lightly browned on top.']",10
753,Slow Cooker Chinese Pulled Pork Recipe,10,240,250,"['3 to 3 1/2 pounds pork shoulder, cut into very large chunks (3 to 4 inches)', '2 1/2 teaspoons of Chinese 5-spice powder*', '1/4 cup hoisin sauce', '3 Tbsp soy sauce', '3 Tbsp honey', '2 Tbsp dry sherry or Shaoxing cooking wine', '2 Tbsp minced fresh ginger', '2 Tbsp minced garlic', '12 Hawaiian dinner rolls', '1 large scallion sliced', '*To make Chinese 5-spice powder, toast 1 teaspoon peppercorns in a skillet until fragrant. In a spice grinder, grind the roasted peppercorns with 2 whole star anise, 1/4 teaspoon cloves, 1 teaspoon of fennel seeds. Stir in 3/4 teaspoons ground cinnamon.']",11,"['1 Season the pork with 5-spice powder: Rub the 5 spice powder into the pork chunks, all over, and let sit while you prepare the sauce in the next step.', '2 Whisk together the sauce ingredients: Whisk together the hoisin sauce, soy sauce, honey, sherry, ginger, and garlic in a medium bowl.', '3 Place pork and sauce in slow cooker: Place the seasoned pork shoulder pieces in a slow cooker, cover with the sauce.', '4 Slow cook for 4 hours on high or 8 hours on low, until the meat easily pulls apart. About halfway through the cooking, turn the meat over in the pot.', ""5 Ladle off excess fat: Use a ladle or a large metal spoon to remove excess fat that has risen to the surface while the meat has been cooking. Don't discard it yet, you may want to add some of it back."", '6 Shred the pork: Use two forks to pull apart the pork into shreds. If the pork still seems dry, add back some of the fat.', '7 Serve over sweet Hawaiian dinner buns topped with sliced green onion or cilantro.']",7
754,Pork Crown Roast Recipe,20,230,250,"['1 8-9 pound crown roast of pork (14 to 22 ribs, depending on how meaty the ribs), Frenched and prepped by butcher', '1 tablespoon chopped fresh thyme (or 1 teaspoon dried)', '1 tablespoon chopped fresh sage (or 1 teaspoon dried)', '2 teaspoons kosher salt', '1/4 teaspoon freshly ground black pepper', '1 cup water', 'Stuffing', '2 tablespoons Butter', '4 cups cubed day-old bread (3/4-inch cubes)', '1/2 pound Italian sausage meat', '1/2 cup finely chopped onion', '1/2 cup finely chopped celery', '3/4 pound tart Granny Smith apples, peeled, cored, chopped (about 2 cups)', '1/4 cup fresh parsley', '1 teaspoon fresh chopped sage (or 1/2 teaspoon dry)', '1 teaspoon fresh chopped thyme (or 1/2 teaspoon dry)', 'Salt and freshly ground black pepper', 'Special equipment:', 'Remote meat thermometer']",19,"['1 Season the pork roast: Mix together the roast seasonings of thyme, sage, salt and pepper. Rub all over the pork roast. Let roast sit (wrapped) at room temperature for an hour before roasting.', '2 Toast the cubed bread: Heat a large saut\\xc3\\xa9 pan on medium heat. Melt 2 Tbsp butter in the pan, add the cubed bread, and stir to coat the bread pieces with the melted butter. Let bread cubes toast; only turn them when they have become a little browned on a side.', '3 Brown the sausage: Heat a large (4 to 6-qt) pan on medium heat. Breaking of inch-sized chunks, add the Italian sausage to the pan, taking care not to crowd the bottom of the pan.', 'Do not stir, just let cook until lightly browned on one side, then flip the sausage over and brown on the other side. When lightly browned, use a slotted spoon to remove, set aside.', '4 Cook the onions and apples: You should have at least a tablespoon of fat in the pan, if not, add some butter. Heat the pan to medium high. Add the onions and celery and cook until onions are translucent, 3-5 minutes.', 'Add the chopped apples and cook for a few minutes more.', '5 Combine the stuffing: Add back in the browned sausage, the butter toasted bread cubes, parsley, thyme, and sage. Gently mix. Season to taste with salt and pepper. Remove from heat.', '6 Prepare roasting pan and stuff the roast: Preheat oven to 350\\xc2\\xb0F. Place the crown roast in a shallow roasting pan. Fill the center of the crown loosely with stuffing (do not pack in the stuffing).', 'Whatever extra stuffing you have, place in a separate, buttered, oven proof pan.', 'Cover the tips of the ribs with aluminum foil to prevent scorching of the bones.', 'Add one cup water to the pan.', '7 Roast the pork: Roast the pork at 350\\xc2\\xb0F on middle rack of oven. Cover the stuffing with foil after about 30 minutes.', 'Cook until a meat thermometer inserted deep into center of meat (do not touch bones, which are on the outside of the roast) registers 145\\xc2\\xb0F, about 2 to 2 1/2 hours total.', '8 Bake extra stuffing: Add 1/2 cup of water to the remaining stuffing, and bake it (next to or under roast, starting 30 minutes before roast is done, or while the roast is resting), covered with foil, 30 minutes.', '9 Let the pork rest: Transfer pork to a platter and let stand 20 minutes.', '10 Carve: To carve the pork, steady the roast with a fork, with a large sharp knife, cut down through each rib to detach the pork chops.']",16
755,Pork Chops with Dijon Sauce Recipe,5,30,35,"['1 tablespoon butter', '1 tablespoon extra virgin olive oil', '4 center-cut rib or loin pork chops, boneless or bone-in (whatever you prefer), about 1 1/4 inch thick', 'Salt', 'Freshly ground black pepper', '1/4 cup chopped shallots or minced onions', '1 cup dry white wine', '3/4 cup chicken stock*', '1/2 cup heavy cream', '2 tablespoons Dijon mustard', '1 tablespoon chopped parsley (optional)', '*If cooking gluten-free, use homemade chicken stock or gluten-free packaged stock.']",12,"['1 Sear the pork chops: Pat the pork chops dry with paper towels. Sprinkle salt and pepper all over them. Heat the olive oil in a large skillet over medium high heat. Stir in the butter.', 'As soon as the butter has melted, add the pork chops to the pan and sear them, about 2-3 minutes on each side. Reduce the heat slightly if the chops brown too quickly.', '2 Saut\\xc3\\xa9 onions or shallots, deglaze the pan with wine: Remove the pork chops from the pan and pour off most of the fat. Add the shallots and cook them on med high heat until softened, about 1 minute.', 'Add 1/2 cup of the wine and bring to a boil, deglazing the pan by scraping the brown bits from the bottom of the pan.', '3 Add stock, return chops to pan, cover and cook: Stir in the stock and return chops to the pan. Bring sauce to a simmer, reduce heat, cover and cook until chops are cooked through (145\\xc2\\xb0F internal temp), about 10 to 15 minutes.', '4 Remove chops, add remaining wine, reduce: Remove the pork chops to a warm platter; cover with foil to keep warm. Add the remaining half cup of wine. Increase the heat to high to boil the pan juices. Reduce the juices by half, about 3 minutes.', '5 Add cream, reduce, whisk in mustard and parsley: Add the heavy cream and boil 3 minutes more, until sauce reduces and thickens, and scraping the pan with a wooden spoon leaves a trail.', 'Remove from the heat and whisk in the mustard and parsley. If you want, add more mustard to taste. Place chops on a bed of sauce and serve.']",8
756,"Feijoada, Brazilian Black Bean Stew Recipe",10,300,310,"['1 pound (450 grams) dry black beans', '4 tablespoons extra virgin olive oil', '1 pound (450 grams) pork shoulder, cut into chunks', '2 large onions, sliced', '1 head of garlic, peeled and chopped', '1 pound (450 grams) carne seca or corned beef, cut into chunks', '1/2 pound (225 grams) fresh sausages, such as chorizo or Italian sausage', '1 pound (450 grams) smoked sausage, such as linguica or kielbasa', '1 smoked ham hock or shank', '3-4 bay leaves', 'Water', '1 14.5 ounce can (411 grams) of crushed tomatoes', 'Salt']",13,"['1 Soak beans in hot water: Pour boiling water over the black beans and let them sit while you prepare the rest of the stew.', '2 Brown the pork shoulder: Heat the olive oil in a large pot over medium-high heat and brown the pork shoulder. When the meat has browned, remove the meat from the pot, set aside.', '3 Brown the onions, add garlic: Add the onions to the pot. Brown them, stirring occasionally, scraping up any browned bits from the bottom of the pot.', 'Sprinkle a little salt over the onions and add the garlic. Stir well and saut\\xc3\\xa9 2 more minutes.', '4 Add meat, bay leaves, cover with water, simmer: Add back the pork shoulder, and the other meats and add enough water to cover. Add the bay leaves, cover and bring to a simmer. Cook gently for 1 hour.', '5 Add soaked black beans, simmer: Drain the black beans from their soaking liquid and add them to the stew. Simmer gently, covered, until the beans are tender, about an hour and a half.', ""6 Add tomatoes and simmer: Add the tomatoes, stir well and taste for salt, adding if it's needed. Simmer this, uncovered, until the meat begins to fall off the ham hock, which will probably take 2-3 hours."", 'Serve with white rice and hot sauce. A classic side dish would be saut\\xc3\\xa9ed collard greens.']",8
757,Pasta with Ham and Peas Recipe,10,20,30,"['3/4 pound fusili pasta', 'Salt', '2 Tbsp butter', '3 garlic cloves, minced (about 1 Tbsp)', '1 1/2 cups diced ham', '1 1/2 cups frozen peas', '1/2 cup cream', '1 cup of pasta cooking water (reserved from cooking the pasta)', '1/2 cup grated Parmesan cheese', '1/2 teaspoon kosher salt', '3/4 teaspoon black pepper', '1/2 teaspoon lemon zest']",12,"['1 Cook the pasta: Heat 4 quarts of water and 2 Tbsp salt in a large pot for the pasta. Once the water starts to boil, add the pasta and cook at a rolling boil, uncovered, until al dente, cooked through, but still a little firm to the bite (the low end of the cooking times given on the package). Drain, reserving 1 cup of the pasta cooking water.', '2 Heat butter, add garlic, add ham and peas: While you are cooking the pasta, heat the butter in a medium skillet on medium heat until melted. Add the minced garlic and cook for 1 to 2 minutes. Stir in the ham and the frozen peas.', '3 Add pasta water, cream, Parm, zest, salt, pepper to make sauce: Stir in 1 cup of the pasta cooking water which will help  thaw the peas. Stir in  1/2 cup of cream, Parmesan cheese, salt, pepper, and lemon zest.', '4 Toss pasta with sauce to serve: When the pasta is ready, toss it with the sauce in a serving bowl and serve.']",4
758,Pineapple Glazed Ham Balls Recipe,15,35,50,"['Meatballs:', '1/4 pound bacon, diced', '1 pound ham, diced', '1 pound ground pork', '2 eggs', '1 cup breadcrumbs', '2 Tbsp brown sugar', '2 teaspoons dry mustard', '1 teaspoon salt', '2 Tbsp pineapple juice', 'Glaze:', '1 cup pineapple juice', '1/2 cup cider vinegar', '1/2 cup brown sugar', '1 Tbsp ketchup', '2 teaspoons dry mustard', '1/2 teaspoon cayenne (optional)', '1 teaspoon corn starch mixed with 2 Tbsp cold water']",18,"['1 Preheat the oven to 350\\xc2\\xb0F.', '2 Process bacon and ham: Put the bacon and ham into a food processor and pulse briefly 3-4 times to chop fine. Do not pur\\xc3\\xa9e.', '3 Make ham ball mixture: Place the mixture in a large bowl with the remaining meatball ingredients and mix well to combine.', '4 Form ham balls: Using your hands, form meatballs anywhere from 1-inch to 2-inches in diameter. The smaller diameter meatballs will make for easier eating if you are making them for an appetizer for a party. Larger meatballs will work well for a main course.', '5 Bake: Arrange the ham balls in a casserole pan and bake in the 350\\xc2\\xb0F oven for about 1 hour for 2-inch diameter meatballs, or 30-40 minutes for 1-inch diameter meatballs.', 'These meatballs are pretty forgiving, but look for an internal temperature of about 165\\xc2\\xb0 or so.', '6 Make glaze: Make the glaze when you put the meatballs in the oven. Mix all the ingredients except the corn starch in a small pot and bring to a boil. Whisk in the corn starch and simmer 1-2 minutes.', ""7 Baste: Baste the ham balls once they have cooked for 20 minutes, then again at 40 minutes for larger meatballs or at 10 minutes and 20 minutes if you are making small meatballs, and then again at 5 minutes before they're done."", 'Serve by themselves as a party appetizer, or on pineapple rings.']",9
759,Instant Pot Mexican Pulled Pork (Carnitas) Recipe,25,110,135,"['For the spice rub:', '4 tablespoons chili powder', '1 tablespoon kosher salt (if using regular table salt, only use 2 teaspoons)', '1 tablespoon brown sugar', '2 teaspoons ground cumin', '1 teaspoon cayenne', '1 teaspoon dried oregano', '1 teaspoon onion powder', '1 teaspoon garlic powder', '1/4 teaspoon cinnamon', 'Scant pinch of ground cloves', 'For the pulled pork:', '3 1/2 pound boneless pork shoulder roast, cut into two pieces', '2 tablespoons vegetable oil', '3/4 cup pineapple juice, orange juice, or water', 'Optional toppings (pick a few!):', 'Sliced avocado', 'Sliced radishes', 'Thinly sliced red or green cabbage', 'Thinly sliced romaine lettuce', 'Diced red onions', 'Chopped tomatoes', 'Crumbled cotija cheese', 'Chopped cilantro', 'Warm tortillas, corn or flour', 'Fresh squeezed lime juice', 'Salsa', 'Special equipment:', '6-quart electric or stovetop pressure cooker, like an Instant Pot', 'Fat separator']",30,"['1 Season the pork: In a small bowl, combine the spice rub ingredients. Pat the pork dry with paper towels, then sprinkle with half of the spice rub. Turn and rub the spice into the pork until the pieces are evenly coated.', '2 Let the pork sit 15 to 60 min: Leave the pork to absorb the rub and to take the chill off the meat, at least 15 minutes or up to an hour. (Room temperature pork will sear better!)', '3 Sear the pork: Select the \\xe2\\x80\\x9cSaut\\xc3\\xa9\\xe2\\x80\\x9d program on your pressure cooker and add the oil to the pot. (If you are using a stovetop pressure cooker, heat the oil over medium heat.)', 'Use a pair of tongs to lower the pork into the pot so the side with the most fat is facing down. Sear for 5 minutes. Flip it over and sear it for 5 more minutes. Both sides should be browned.', '4 Sprinkle the remaining spice rub over the pork, then pour the pineapple juice over the top.', '5 Pressure cook the pork: Place the lid on your pressure cooker. Make sure that the pressure regulator is set to the \\xe2\\x80\\x9cSealing\\xe2\\x80\\x9d position. Select the \\xe2\\x80\\x9cManual\\xe2\\x80\\x9d program on the pressure cooker and set the time to 1 hour and 15 minutes at high pressure. (For stovetop pressure cookers, cook for 60 minutes at high pressure.)', 'It will take about 10 minutes for your pressure cooker to come up to pressure, and then the cooking time will begin.', '6 Release the pressure: After the cooking time ends, let the pot sit and naturally release pressure for about 20 minutes, then vent the remaining steam. (For stovetop pressure cookers, perform a quick pressure release.)', '7 Separate the pork and cooking liquid: Use tongs to transfer the pork to a large baking dish or sheet pan, but be very gentle -- the pork will be VERY tender and will fall apart easily!', 'Then, use heat-proof mitts to lift the inner pot out of the pressure cooker, pour the cooking liquid into a fat separator, then pour the liquid back into the pot. Reserve the fat.', '(Alternatively, let the cooking liquid stand for about 10 minutes until the fat floats to the top, then use a shallow spoon to skim as much fat as possible from the surface.)', '7 Reduce the cooking liquid: Return the pot to the pressure cooker, select the \\xe2\\x80\\x9cSaut\\xc3\\xa9\\xe2\\x80\\x9d program, and let the cooking liquid reduce for 10 minutes. (If you are using a stovetop pressure cooker, do the same thing over medium heat.)', '8 While the liquid is reducing, use a pair of forks to shred the pork. ', '9 Broil the pulled pork until crispy (optional for carnitas): To make crispy carnitas, place the pan of shredded pork 6 to 8 inches below the broiler and broil for 5 to 10 minutes until the tips and edges of the pork are browned and crispy.', ""It's fine to skip this step if you're making a recipe where you don't need the pork to be crispy."", '10 Toss the shredded pork with the reduced liquid and serve: Return the pork to the pot with the reduced cooking liquid and toss to coat the pork evenly. If the pork seems a little dry, add a tablespoon or two of the reserved fat.', 'Serve it in tacos with the fixings listed above, or in burritos or rice bowls, or on a tostada salad.']",17
760,How to Cook Pork Chops Sous Vide,10,66,76,"['4 bone-in pork chops (about 1 1/2 pounds)', '1 teaspoon Morton Kosher salt', '1/2 teaspoon freshly ground black pepper', '1 to 2 tablespoons freshly chopped sage, thyme, or rosemary, or combination of all three', '2 tablespoons olive oil', 'Special equipment:', 'Immersion circulator', 'Gallon-sized zip-top freezer bags']",8,"['You can do this in the pot of water as it heats (just be careful if the water is already steaming!).', '  4 Cook the pork sous vide: Once the water has come to temperature, submerge the sealed bag of pork chops. Make sure the bag is completely submerged, otherwise the pork will not cook evenly.', ""Cook for 1 hour if the chops are bone-in and under an inch thick, or if you're cooking boneless pork chops. Cook for about 1 hour and 10 minutes if you're cooking bone-in chops that are thicker than 1 inch."", 'When cooking time ends, remove from the water, and turn off the circulator.', '5 To finish on the grill: Heat the grill to medium heat and place the pork chops directly on the grates. Depending on thickness, grill for a few minutes per side, until the outside is seared and develops a golden crust.', 'To finish on the stovetop, heat a saut\\xc3\\xa9 pan or cast iron skillet over medium-high heat and add a little bit of olive oil or butter\\xe2\\x80\\x94a tablespoon or two should do it. Add the chops to the pan and sear until the bottom develops a golden crust, one to two minutes. Flip and repeat on the other side.', '6 Rest and serve: Rest the chops for about 5 minutes, the serve sprinkled with some sea salt and additional fresh chopped herbs over the top, if desired. You can also drizzle the juices from the cooking process, additional olive oil, or your own favorite sauce, such as gremolata or pesto.']",7
761,Bacon-wrapped Pork Roast Recipe,5,75,80,"['1 pork loin roast (about 1 1/2 pounds or 680 g)', 'Salt and pepper', '1 tablespoon extra virgin olive oil', '2 tablespoons finely chopped fresh rosemary', '1/4 pound bacon (113 g), thinly sliced', '1 cup (236 ml) dry white wine']",6,"['1 Salt roast and let rest at room temp: About an hour before you intend to cook the roast, take it out of the refrigerator and sprinkle it with salt on all sides. Let it sit at room temp to take the chill off before you roast it.', '2 Pre-heat oven to 375\\xc2\\xb0F (190\\xc2\\xb0C).', '3 Sear roast on all sides on stovetop: Pat pork roast dry with paper towels. Sprinkle it with pepper on all sides and again with a little salt (you likely wiped off much of the earlier sprinkle of salt when you patted it dry.)', ""Heat a tablespoon of olive oil in a skillet on medium high heat. When the oil is shimmery hot, add the pork roast to the pan and brown it on all sides (don't move the roast until it has browned on one side). About 10 minutes. Remove the roast from the pan and set on a plate."", '4 Rub roast with rosemary, wrap with bacon: Rub the pork roast all over with minced fresh rosemary. Wrap the roast in bacon strips, overlapping the strips if necessary. Tie the roast up with kitchen string to hold the bacon strips in place.', '5 Roast in oven: Place the roast in a roasting pan and roast in the oven at 375\\xc2\\xb0F (190\\xc2\\xb0C), occasionally basting with the pan juices, until the internal temperature of the roast reaches 145\\xc2\\xb0F (63\\xc2\\xb0C) on a meat thermometer, about 35 to 40 minutes.', '6 Tent with foil and let rest: When the roast has reached temperature, remove it from the oven and place it on a serving dish. Tent the roast with foil to keep it warm while it rests and while you make the pan sauce.', '7 Make sauce with roast drippings: To make a sauce with the pan drippings, place the roasting pan on top of the stove on low heat. Pour white wine into the pan and start scraping up the browned bits from the bottom of the pan with a flat edged metal or wood spatula.', 'Pour the scraped up drippings through a fine mesh sieve into a small saucepan.', 'Use a metal spoon to skim off excess fat. Heat until simmering, then remove from heat and pour into a gravy boat.', 'Serve the roast with the sauce from the pan drippings.']",11
762,Mom\xe2\x80\x99s Perfect Pork Chops Recipe,10,15,25,"[""For Dad's dry rub (makes 1/2 cup):"", '1/4 cup cumin seeds', '3 tablespoons whole black peppercorns', '1 tablespoon coriander seeds', '2 tablespoons sugar', '1 1/2 teaspoons sea salt', 'For the pork chops:', '4 pork chops (bone-in or boneless)', '1 teaspoon bacon fat or extra virgin olive oil', 'Salt', '1 to 2 teaspoons dry rub']",11,"['1 Make the dry rub: Combine cumin, peppercorns, and coriander in a heavy medium skillet. Stir over medium heat until fragrant and toasted, about 8 minutes. Cool slightly.', 'Finely grind toasted spices in blender, spice grinder, or with a mortar and pestle. Transfer to a small bowl. Mix in sugar and salt.', '2 Prep the pan and the pork: Heat a large cast iron frying pan to medium high or high heat (hot enough to sear the meat).', 'If using bone-in chops, score the fat that surrounds the chops with a couple vertical cuts to help prevent the chops from buckling as they cook.', 'Sprinkle a pinch of dry rub spices (about 1/8 teaspoon or a little more) on each of the pork chops. Using your fingers, rub the spices into the meat. Turn the pork chops over and repeat on the other side.', '3 Add the chops to the pan: Once the pan is hot, add a teaspoon of oil or fat to the pan and coat the bottom of the pan. Right before you put the pork chops into the pan sprinkle each side with a little salt, or you can salt the chops in the pan.', 'Place the pork chops with the thickest, boniest parts toward the center of the pan where they get the most heat. Make sure the chops are not crowding each other too much.', 'You may need to cook them in batches. There should be space between the chops in the pan or the meat will steam and not sear properly.', '4 Sear the chops on both sides: Sear the pork chops, about 2 minutes on each side. Watch carefully, as soon as the chops are browned, flip them. As soon as you flip the pork chops, if you are using a cast iron pan, you can turn off the heat. Cast iron holds heat very well and there will be enough heat in the pan to finish cooking the meat.', '5 Cover pan if working with thick chops to finish cooking: If you have chops that are a lot thicker than 3/4-inch (many are sold that are 1 1/2-inches thick), you can put a cover on the pan and let the pork chops finish cooking for 5 minutes or so.', 'If you are using a cast iron pan and have turned off the heat, there should be enough heat if you cover the pan to finish the cooking of a thicker chop. If not, turn the heat to low and cover.', 'The easiest way to tell when the pork chops are done is to press on them with your fingertip. If they are firm to the touch, they are done. (See the touch test.) If you wait until you see juice oozing out of the top of a chop, it is definitely done. You can also check the internal temperature of the pork with a digital thermometer; when the pork registers 145\\xc2\\xb0F in the middle, it\\xe2\\x80\\x99s done.']",12
763,Pork Tenderloin with Apples Recipe,10,25,35,"['2 pork tenderloins', '2 cloves garlic, peeled and cut into slivers', 'Salt and pepper', '2 teaspoons ground cumin', '2 Tbsp extra virgin olive oil', '1 cup (235 ml) of chicken or beef broth', '1 cup (235 ml) dry white wine (can sub with apple brandy or apple cider)', '2 medium sized apples, peeled, cored, and sliced']",8,"['1 Preheat oven, prepare the tenderloins: Preheat oven to 400\\xc2\\xb0 F (205\\xc2\\xb0C). With the tip of a sharp knife, make deep little slits all over the tenderloins and insert the garlic slivers.', 'Season with salt, pepper and cumin.', '2 Sear the tenderloins on all sides: Heat the oil in a skillet on medium high heat and sear the tenderloins well on all sides (about 10 minutes).', '3 Finish cooking tenderloins in oven, with broth and wine: Remove the tenderloins from the skillet (do not discard the juices in the skillet) and place the tenderloins in a roasting pan.', 'Add the broth and white wine to the roasting pan.', 'Cook in the oven at 400\\xc2\\xb0F (205\\xc2\\xb0C) for 10-15 minutes or longer, until their internal temperature reaches 140\\xc2\\xb0F.', ""4 Cook apples in the same skillet: After you've placed the tenderloins in the oven, cook the apple slices in the same skillet (with the remaining oil and juices) that you used to brown the tenderloin."", 'Saut\\xc3\\xa9 until soft. Remove the apples from the pan, set them aside, saving the juices once again in the pan.', '5 Let tenderloins rest: After the tenderloins have reached 140\\xc2\\xb0F internal temperature, remove them from the oven. Transfer the tenderloins from the pan to a cutting board, cover with aluminum foil and let rest for 10-15 minutes. The internal temperature of the tenderloins will continue to rise while they rest.', '6 Make gravy by boiling pan juices: While the pork is resting, pour the roasting pan juices into the skillet and boil everything on high heat for 5 minutes, or until you get a gravy the consistency of melted ice cream.', '7 Slice and serve: Slice the tenderloins into 1/4 inch thick slices, add the sliced apples to the meat in the serving dish, drizzle some gravy over and serve immediately.']",11
764,Panko Crusted Pork Tenderloin with Dijon Cream Sauce Recipe,60,60,120,"['1 1/4 to 1 1/2 pound pork tenderloin', '3/4 cup buttermilk', '1 tablespoon Dijon mustard', '1 tablespoon brown sugar', '1 teaspoon kosher salt', '1 cup panko breadcrumbs', '1 tablespoon extra virgin olive oil', '1/2 teaspoon kosher salt', '1/4 teaspoon freshly ground black pepper', '1 tablespoon butter', '1 small shallot, minced (about 1 to 2 Tbps)', '1 small clove garlic, minced (about 1 teaspoon)', '1 cup cream', '1/2 teaspoon Dijon mustard', '1/4 teaspoon kosher salt', 'A pinch of black pepper', '2 Tbsp finely chopped fresh parsley']",17,"['1 Marinate pork tenderloin: Combine the marinade ingredients (buttermilk, Dijon mustard, brown sugar, salt) in a medium bowl. Add the pork tenderloin to the marinade.', 'Cover with plastic wrap and refrigerate for at least one hour, or up to overnight.', 'Remove the pork tenderloin from the refrigerator an hour before you intend to cook it.', '2 Toast the panko breadcrumbs: Heat a thick-bottomed saut\\xc3\\xa9 pan on medium high heat. Add the panko breadcrumbs to the pan. Lower the heat to medium and slowly toast the panko breadcrumbs until golden brown.', 'Remove from heat. Stir the olive oil, salt, and pepper into the panko breadcrumbs until they are well coated.', '3 Dredge tenderloin in toasted panko: Preheat the oven to 375\\xc2\\xb0F. Line a roasting pan with aluminum foil and place a baking rack or roasting rack over it. Place the toasted panko in a shallow bowl for dredging. Remove the pork tenderloin from the buttermilk marinade and place it in the bowl of breadcrumbs. Dredge the tenderloin in the breadcrumbs, pressing the tenderloin firmly into the crumbs as you roll it to help the crumbs adhere.', ""4 Bake: Place the breaded tenderloin on the baking rack and bake at 375\\xc2\\xb0F for 30 to 40 minutes, until the internal temperature is 145\\xc2\\xb0F. (Please note that the USDA now recommends that pork be cooked to 145\\xc2\\xb0F, meaning the cooked pork will be a little pink, and that's perfectly okay.)"", 'Remove the pork from the oven when done and let rest on the rack for 10 to 15 minutes while you make the sauce.', '5 Make sauce: To make the sauce, melt a tablespoon of butter in a shallow saucepan. Add the minced shallots and cook on medium heat until softened, about 3 to 4 minutes. Add the minced garlic and cook a minute more.', 'Add one cup of cream, the mustard, salt, and pepper to the shallots. Stir to combine and let come to a simmer.', 'Simmer gently until slightly thickened, 2 to 3 minutes. Stir in 1 Tbsp of chopped parsley. Set aside until ready to serve. (If you need to reheat the sauce to serve and it has thickened up, loosen it with a little water while you reheat.)', '6 Slice tenderloin and serve with sauce: Gently transfer the pork tenderloin to a cutting board and slice into 1/2-inch thick medallions. Place sauce on a serving platter and place the pork medallions on top of the sauce. Sprinkle everything with chopped parsley.']",12
765,Salsa Verde Carnitas Recipe,0,210,210,"['3 1/2 pounds pork shoulder, trimmed of excess fat (not all the fat, just the glaring excess fat), cut into large (3 to 4 inch) chunks', '2 cups tomatillo salsa verde, bottled or homemade', '1 1/2 cups chopped onion', '3 cups chicken stock', '2 teaspoons whole cumin seeds', '2 teaspoons coriander seeds', '1 teaspoon dried oregano', '1 bunch cilantro, roughly chopped, stems and tender leaves', 'Salt', '12 to 16 corn tortillas, heated and softened', '1/4 head of cabbage, very thinly sliced', '1 teaspoon seasoned rice vinegar (if you only have unseasoned, add 1/4 teaspoon of sugar to it)', 'Salt and pepper', '1 avocado, peeled, seeded, and chopped', ""1/2 cup crumbled Cotija Mexican farmer's cheese, or some grated Monterey Jack cheese"", 'Crema fresca, crema Mexican, or sour cream', 'Chopped cilantro leaves for garnish']",17,"['1 Simmer pork with salsa verde, onion, stock, spices until tender: Put the pork, salsa verde, chopped onion, chicken stock, cumin seeds, coriander seeds, and oregano in a large, thick-bottomed pot, and heat on high heat. Bring to a boil, and reduce heat to a low simmer. Cover and simmer until meat pulls away easily with a fork, about 3 hours.', '2 Shred meat with two forks, then broil: Preheat oven broiler. Remove meat from the pot and put into a roasting pan. With 2 forks, tear the meat into large shreds, spreading them out in an even layer in the roasting pan. Put pan on the top rack of the oven. Broil for 5 to 10 minutes until edges and some parts are brown and crispy.', '3 Skim fat, reduce the salsa verde sauce: While the meat is browning in the oven, skim the fat from the liquid in the large pot. (Discard but do not put the fat down the drain or you will clog your pipes.)', 'Heat the pot on high and vigorously boil the remaining liquid, stirring, until reduced to 2 1/2 cups, several minutes.', '4 Return meat to sauce, stir in cilantro: Return the meat to the pot with the liquid. Stir in chopped cilantro. Season with salt.', 'Serve with heated and softened corn tortillas (20 seconds each in the microwave spread out over a paper towel will heat and softened packaged tortillas sufficiently), diced avocado, crumbed Cotija or grated Monterey jack cheese, sour cream (or crema fresca), and seasoned cabbage slaw.', 'Seasoned Cabbage Slaw', 'Place thinly sliced cabbage in a medium sized bowl. Sprinkle with seasoned rice vinegar, salt and pepper. You can substitute white vinegar or apple cider vinegar for the rice vinegar, if you do, sprinkle on some sugar to help balance the acidity of the vinegar. Toss. Adjust seasonings. Let sit for 10 minutes for the cabbage to absorb some of the dressing.']",8
766,Grilled Pork Tenderloin with Orange Marmalade Glaze Recipe,15,75,90,"['1/3 cup soy sauce (use gluten-free soy sauce for gluten-free version)', '1/3 cup orange marmalade', '1/3 cup honey', '1 Tbsp plus 1 teaspoon rice wine vinegar', 'Pinch of crushed red pepper flakes', '1 lb pork tenderloin', '2 scallions, thinly sliced (optional)', 'Olive oil (for grill)']",8,"['1 Make marinade: In a small saucepan, bring the soy sauce, marmalade, honey, rice wine vinegar, and red pepper flakes to a simmer over medium heat. Remove from the flame and let cool.', 'Reserve half of the marinade for serving as a sauce with the finished tenderloin.', '2 Marinated the tenderloin: With the remaining half of the marinade, marinate the tenderloin for 1 hour.', '3 Prepare the grill: While the tenderloin is marinating, prepare your grill for high direct heat on one side, and a low heat on the other side.', '4 Sear tenderloin on all sides: Remove the tenderloin from the marinade and coat with olive oil. Place on the hot side of the grill, with the narrower end of the tenderloin more toward the cool side of the grill.', 'As soon as the tenderloin gets grill marks on one side (a minute or two), turn it to get grill marks on another side. Continue until all sides are lightly seared.', '5 Finish on cool side of the grill: Move the tenderloin to the cool side of the grill. Cover and cook a few minutes more, until the internal temperature of the tenderloin reaches 140\\xc2\\xb0F (no higher). Remove from heat.', '6 Tent with foil and let rest: If you have let the temp get too high above 140\\xc2\\xb0F, you may need to slice the pork immediately or the meat will continue to cook as it rests and become overcooked.', 'If you have taken it out in time, tent the tenderloin with foil and let it rest 10 minutes.', 'Thinly slice, sprinkle with the remaining glaze and scallions.', 'Serve with rice.']",11
767,Pressure Cooker Green Pork Pozole Recipe,5,65,70,"['1 small yellow onion, sliced into wedges', '2 garlic cloves, peeled', '2 jalapen\\xcc\\x83os, seeded', '1 pound tomatillos, husked and cut into quarters', '1/2 bunch (1 to 1 1/2 ounces) cilantro, bottom 4 inches of stems trimmed and discarded', '1/4 cup pepitas or shelled pumpkin seeds, toasted (can also use roasted pepitas)', '1 teaspoon dried oregano', '1 teaspoon ground coriander', '1/2 teaspoon ground cumin', '3/4 teaspoon salt', '2 1/2 cups chicken or vegetable broth, divided', '2 tablespoons olive oil', '1 (25 to 30-ounce) can hominy, drained', '1 1/2 pounds pork stew meat or boneless pork shoulder, trimmed of excess fat and cut into 1-inch pieces', 'For serving:', '3 cups shredded green cabbage', '1 bunch radishes, sliced', '2 limes, cut into wedges', 'Crushed red pepper flakes', 'Special equipment:', '6-quart electric pressure cooker, such as an Instant Pot']",21,"['1 Puree the veggies: In a blender, combine the onion, garlic, jalapen\\xcc\\x83os, tomatillos, cilantro, pepitas, spices, and salt. Add 1/2 cup of the broth and blend until smooth, about 30 seconds.', '2 Saut\\xc3\\xa9 the veggie blend: Heat the oil in the pressure cooker on its Saut\\xc3\\xa9 setting for 2 minutes. Add the blended mixture and cook, stirring often, for about 5 minutes, until a bit darkened in color.', '3 Pressure cook the pozole: Stir in the hominy, pork, and remaining 2 cups of broth. Secure the lid in its sealed position. Cancel the Saut\\xc3\\xa9 program, then select your pressure cooker\\xe2\\x80\\x99s Manual setting for 30 minutes at high pressure.', '(It will take about 15 minutes for the pot to come up to pressure before the cooking program begins.)', '4 Prep the toppings: If you haven\\xe2\\x80\\x99t yet prepared your toppings, go ahead and shred the cabbage, slice the radishes, and cut the limes into wedges while the pozole is cooking.', '5 Release the pressure naturally for 15 minutes: When the cooking program ends, let the pressure release naturally for at least 15 minutes, then move the lid to its Venting position to release the rest of the steam.', 'Open the pot. If there is a lot of fat on top of the pozole, use a ladle to skim it off. Taste for seasoning, adding more salt if needed.', '  6 Serve the pozole: Ladle the pozole into bowls. Top each bowl with the shredded cabbage and radishes. Serve with lime wedges and red pepper flakes on the side.']",8
768,Slow Roasted Pork Shoulder with Savory Apple Gravy Recipe,20,210,230,"['4-5 pounds (1.8 to 2.2 kg) boneless pork shoulder, sinew and excess fat (beyond 1/4 inch) trimmed', '1 tablespoon fennel seeds, toasted', '2 teaspoons black peppercorns', '2 Tbsp packed, fresh thyme leaves, lightly chopped, or 1 Tbsp dried thyme', '2 tablespoons fresh rosemary leaves, lightly chopped', '4 medium garlic cloves, minced', '2 teaspoons Kosher salt, plus more for seasoning', 'Extra virgin olive oil', '4 medium good cooking apples, such as Fuji or Jonagold', '1 medium yellow onion', '1/2 cup (120 ml) dry white wine (can sub water)', '1/2 teaspoon Dijon mustard', 'Freshly ground black pepper']",13,"['1 Make the spice rub: Put the fennel seeds, peppercorns, thyme and rosemary leaves, garlic and 2 teaspoons salt into a spice grinder or coffee grinder and grind to a paste.', 'Alternatively, you can pound the mixture with a mortar and pestle. Put the mixture into a bowl and stir in 2 tablespoons olive oil.', '2 Marinate roast overnight in spice rub: Rub the mixture evenly all over the pork shoulder. If the roast is tied, untie it to rub the inside with the rub mixture as well, then retie it.', 'Wrap the roast tightly in plastic wrap to hold the rub against the skin and marinate overnight (or up to two days).', '3 Prep apples and onions: Peel, halve, and core the apples. Cut each apple half into about 4 wedges. Peel the onions. Cut in half from tip to root. Trim the root and tip. Cut each onion half into about 12 thin wedges. Put the onions and the apples together in a bowl and toss to mix.', '4 Preheat the oven to 450\\xc2\\xb0F (232\\xc2\\xb0C).', '5 Place roast on bed of apples and onions: Toss the apples and onions with 2 tablespoons of olive oil and season with a little salt and pepper. Place the apples and onions in the bottom of a roasting pan or Dutch oven with a cover. Place the marinated pork shoulder on top of the apples and onions.', '6 Roast: Roast uncovered for 30 minutes. Turn the oven heat down to 325\\xc2\\xb0F and add the wine. Cover the roasting pan and slow roast for 2 1/2 to 3 hours until the pork shoulder is falling apart tender and pulls apart easily when probed with a fork.', '7 Make sauce: Transfer the pork shoulder to a serving plate and cover with foil to keep warm. Put the apples and onions into a blender. Add about 1/2 cup water and the mustard and pur\\xc3\\xa9e. Check the texture, and add water until you get the desired thickness for the gravy. Press through a sieve for a silky smooth textured gravy. Check the seasoning and correct to taste.']",9
769,Slow Cooker Brats and Beer Cheese Dip Recipe,15,20,35,"['16- to 20-ounce package beer brats (about 5 links)', '1/4 cup white onion, minced', '2 cloves garlic, minced', '12 ounces German beer (Pilsners or ambers work well in this recipe)', '1/4 cup cornstarch', '1 1/2 cups whole milk', '1 tablespoon Dijon mustard', '1 teaspoon salt', '1/4 teaspoon ground white pepper (optional)', 'Pinch of cayenne pepper', '1/4 teaspoon ground nutmeg', '8 ounces Gouda cheese, shredded', '6 ounces Asiago cheese, shredded', '3 ounces Gruyere cheese, shredded', '3 ounces goat cheese or chevre, crumbled', '2 tablespoons diced pimentos, drained', '1 tablespoon cilantro, chopped', 'To serve:', 'Tortilla chips', 'Pretzels or pretzel bites', 'Cooked brats cut into 1\\xe2\\x80\\x9d pieces', 'Special equipment:', '6-quart slow cooker']",23,"['1 Remove the sausage from its casing: Using a very sharp knife, make a slit in the casings by running the tip of the blade down the length of the sausage.', 'Remove the casing from each of the bratwurst and discard.', '2 Cook the sausages: In a cast iron skillet, or other heavy nonstick skillet, brown the brats over medium high heat and cook for 5 to 6 minutes, until the meat is cooked through and developing some caramelized spots. Break up the sausages with a wooden spoon or a potato masher as you cook\\xe2\\x80\\x94aim for bite-sized pieces the size of raisins, which are perfect for scooping with chips.', 'Use a slotted spoon to transfer the browned sausage to your slow cooker. Leave the fat behind in the pan; you will use it for the next step.', '3 Cook the onions and garlic: Add the onions and garlic to the hot pan and for 3 to 4 minutes, or until the vegetables look translucent and glossy.', '4 Add the beer: Lower the heat to medium-low, and carefully pour the beer into the pan. The beer will steam and fizz, so be careful. Using a wooden spoon, scrape up any browned bits of food that are stuck to the bottom of the pan. This deglazing of the pan is important as it adds tons of flavor to the finished dip.', 'Bring the liquid to a boil and let it bubble for about 2 to 3 minutes, until slightly reduced. (This also cooks off the alcohol.)', '5 Prepare and add the thickener: While the beer is cooking, whisk together the cornstarch, whole milk, Dijon mustard, salt, white pepper, cayenne pepper, and the ground nutmeg in a mixing bowl to form a smooth mixture.', 'Once the beer has reduced, carefully pour the cornstarch mixture into the skillet, whisking constantly. Increase the heat to medium and bring the mixture back to a boil. It should thicken quickly.', 'Once the mixture has the consistency of gravy and the whisk leaves a ribbon when pulled through the sauce, remove the pan from the stove and carefully pour the sauce into the slow cooker.', '6 Add the cheese to the slow cooker: Stir the cheese, one type at a time, with the other ingredients in the slow cooker. Make sure to stir thoroughly before adding the next one.', 'Stir in the drained, diced pimentos.', '7 Cook the dip: Cover the slow cooker and cook the dip on high for 30 minutes to melt the cheese.', '8 Hold the dip on the ""warm"" setting and serve: Once the cheese has melted completely, switch to the warm setting and stir the dip. Add the chopped cilantro and stir once more. Adjust the seasoning to suit your taste by adding more salt and/or pepper. I\\\'ve found that the flavors deepen as the dip sits and it may seem to get saltier, so I recommend erring on the side of under-seasoning at this point.', ""This dip will keep (on warm) for up to four hours. Give the dip a stir every half hour or so to prevent a skin from forming on the top. If you feel like it\\'s getting to thick, stir in a little milk to thin it out again."", '9 To serve: Spoon the dip onto individual plates, or into bowls. Enjoy with tortilla chips or good ol\\xe2\\x80\\x99 Bavarian-style pretzels!', 'Leftovers can be stored in a food storage container in the refrigerator for up to two days.', 'To reheat: Heat on high for one minute in the microwave. Stir the dip and reheat at 30-second intervals, stirring after each interval, until warmed through.']",18
770,Grilled Ginger Sesame Pork Tenderloin Recipe,10,80,90,"['1 to 1 1/4 pound pork tenderloin, trimmed of silver-skin', '1 inch piece peeled ginger root, sliced into coins', '3 cloves garlic, peeled', '1/4 cup soy sauce (use gluten-free soy sauce if cooking gluten-free)', '2 teaspoons brown sugar', '1/3 cup minced green onions', '1/4 cup minced cilantro (including tender stems)', '2 tablespoons seasoned rice vinegar', '2 tablespoons extra virgin olive oil', '1 teaspoon toasted sesame oil']",10,"['1 Make the marinade: Put the ginger and garlic into a mini-chopper or food processor. Pulse until finely chopped. Remove to a bowl. Add the soy sauce, brown sugar, green onions, cilantro, seasoned rice wine vinegar, olive oil, sesame oil. Stir to combine.', 'Remove and reserve (for basting) 1/4 cup of this marinade.', '2 Marinate the pork tenderloin: Place pork tenderloin into a marinating bag or bowl and cover with the remaining marinade. Marinate at room temp for an hour, while you prepare your grill.', '3 Prepare the grill: Prepare your grill for both direct and indirect heat. When your grill is ready (you should be able to hold your hand an inch above the grill grates on the hot side for only one second), remove the tenderloin from the marinade and brush the tenderloin with olive oil.', '4 Sear tenderloin on all sides on high direct heat: Place tenderloin on grill on direct high heat. After the tenderloin sears on one side, turn it to sear on another side.', 'Keep turning until the tenderloin has been nicely browned on all sides. Baste the tenderloin with reserved marinade while you grill it.', '5 Move to cooler side of the grill and cover: Once all side have been nicely browned, move the tenderloin to the cooler side of the grill. Cover and cook for 5 to 10 minutes more until just done.', 'Remove from grill when the internal temperature of the tenderloin is no more than 140\\xc2\\xb0F.', '6 Tent with foil and let rest: Tent with foil and let rest for 10 to 15 minutes.', '7 Slice and drizzle with reserved marinade to serve: Slice and arrange on a serving plate, drizzle with remaining reserved marinade. Serve with bok choy, rice, asparagus, or snap peas.']",10
771,Slow Cooker Cider Pulled Pork Recipe,30,505,535,"['For the rub:', '2 1/2 tablespoons brown sugar, packed', '2 1/2 tablespoons Kosher salt', '1 1/2 teaspoons pumpkin pie spice (or 1 teaspoon cinnamon, 1/4 teaspoon ground ginger, 1/4 teaspoon ground cloves, and a dash of nutmeg)', '1 1/2 teaspoons chili powder', '1 1/2 teaspoons freshly ground black pepper', '1 teaspoon ground dry mustard', '1/4 teaspoon cayenne pepper', 'For the pork:', '6 pound boneless pork shoulder, trimmed of excess fat', '1 (12-ounce) bottle hard apple cider', '2 cups apple cider', 'For the sauce:', '2 tablespoons tomato paste', '3 garlic cloves', '3/4 cup ketchup', '1/2 cup brown mustard', '1/3 cup brown sugar', '1/4 cup apple cider vinegar', '1/4 cup Worcestershire sauce', '2 teaspoons liquid smoke', '3/4 teaspoon Kosher salt', '2 cups pork stock leftover from braising', 'Special equipment:', '6-quart slow cooker']",25,"['1 Make the rub and prep the pork: In a small bowl, combine all of the ingredients for the rub. Trim your pork shoulder of excess exterior fat. Massage the rub into the meat.', '2 Slow cook the pork: Place the pork in a 6-quart slow cooker. Pour in both ciders. The liquid should come about 3/4 of the way up the side of the meat; the meat should not be completely submerged.', 'Cover with the lid, and set slow cooker to low heat for at least 8 hours.', '3 Cool the pork and refrigerate overnight: Let the pork with the cooking liquid cool completely while still in the slow cooker insert on the counter. Transfer the pork to a cutting board and pour the cooking liquid into a separate storage container.', ""Transfer the pork back to the slow cooker insert and cover. Refrigerate the pork and the cooking liquid overnight or up to three days. (Refrigerating the pork whole, rather than shredded, helps keep it moist and prevents it from drying out too much until you're ready to serve.)"", '4 Shred the pork: When ready to serve the pork, remove it and the cooking liquid from the refrigerator. Scrape any solidified fat from the outside of the pork and the surface of the cooking liquid.', 'Using your fingers or two forks, shred the pork. You can do this right in the slow cooker, on a sheet pan, or on a cutting board. Pick out and discard any large pieces of fat as you go.', '5 Warm the pork: Warm the shredded pork in the slow cooker on the Low or Warm setting while you prepare the sauce. If the pork seems dry at any point, stir in a few tablespoons of the leftover cooking liquid.', 'Alternatively, you can warm the pork on a sheet pan covered with foil in a low oven.', '6 Make the sauce: Measure out two cups of the leftover cooking liquid. The remainder can be strained and saved for another purpose, or frozen for up to three months.', 'In a medium saucepan over medium heat, add the tomato paste and garlic. Whisk together and cook for about 1 minute until fragrant. Whisk in the remaining ingredients, finishing with the reserved 2 cups of cooking liquid.', 'Increase heat to medium high and bring to a gentle boil. Reduce the sauce, whisking occasionally until it has the viscosity of thick tomato soup, but not as thick as ketchup, about 15 minutes. Taste and adjust the seasoning as you wish.', '7 Serve the pork: Reserve about 1/2 cup of sauce to serve in a small bowl alongside the pork. Pour the rest of the sauce over the pork, toss to combine, and serve it to the masses.', 'Place a pile of pork on top of buttered, toasted buns, top with pickles, pickled onions, or extra sauce, and dig in.']",14
772,Sweet Potato & Pork Thanksgiving Stuffing Recipe,45,40,85,"['Stuffing ingredients:', '2 large (8 to 10 ounce) sweet potatoes, peeled and cut into 1/2-inch cubes', '3 tablespoons olive oil, ghee, or duck fat (divided)', '2 pounds ground pork', '1 cup diced yellow onion (from 1/2 medium onion)', '1 cup diced carrots (from 1 large carrot or 2 small carrots)', '1 cup diced celery (from 2 to 3 celery stalks)', '1/2 cup port or sweet sherry', '2 large pears, peeled and diced', '1 cup dried cranberries or cherries (optional \\xe2\\x80\\x93 leave this out if you\\xe2\\x80\\x99re avoiding sugars)', '1 cup chopped fresh herbs (I used 3/4 cups flat parsley and 1/4 cup mixed fresh sage, chervil, and thyme).', '3 large eggs', 'Pecan crumble ingredients:', '1 1/2 cups unsalted pecans', '1/4 cup dried cranberries or cherries', '1 tablespoon olive oil, ghee, or duck fat (room temperature, if it was in the refrigerator)', '2 to 3 cloves garlic, peeled and roughly chopped', '1/4 cup fresh herbs (I used mostly parsley with just a couple rosemary needles and a few thyme leaves)', '1/4 teaspoon salt', '1/4 teaspoon black pepper ']",20,"['1 Roast the sweet potatoes: Preheat oven to 425F and line a large baking sheet with parchment or a Silpat. Toss the sweet potato cubes with 1/2 tablespoon of your cooking fat (if it is ghee or duck fat, melt it first) and sprinkle with salt and pepper.', 'Spread them evenly on the baking sheet and roast for 20 minutes, stirring the potatoes halfway through the cooking time.', 'When done, they should be golden brown and easily pierced with a fork.', '2 Brown the meat: While sweet potatoes are roasting, melt another tablespoon of your cooking fat in a large skillet over medium-high heat.', 'Brown the ground pork in 2 to 3 batches. Break up the pork as it cooks to make small crumbles. Cook until the meat is well-browned and no longer pink, 5 to 7 minutes per batch. Add additional cooking fat as needed if the pan becomes dry.', 'As each batch is finished, transfer it to a large bowl with a slotted spoon.', '3 Saut\\xc3\\xa9 the vegetables: In the same skillet used for the pork, melt a small amount (1 to 2 teaspoons) of cooking fat. Add the diced onion, carrot, and celery to the hot skillet.', 'Season with salt and saut\\xc3\\xa9 for 5 to 7 minutes or until the onions begin to turn translucent. Transfer to the bowl with the pork.', '4 Deglaze the pan: Place the empty pan back over high heat and add the port. Simmer the port for about a minute, scraping up any browned bits that have gotten stuck to the bottom of the pan. Pour the port over the vegetables and pork in the bowl.', '5 Heat the oven to 350F. Grease a 9x13-inch or other 3-quart baking dish.', '6 Combine the stuffing ingredients: Add the roasted sweet potatoes, saut\\xc3\\xa9ed veggies, pears, cranberries, and herbs to the bowl with the browned meat. Mix well. Taste and add more salt, pepper, or herbs, if needed.', 'At this point, the stuffing can be covered and refrigerated for 1 to 2 days before cooking.', ""When you're ready to bake the stuffing, add the eggs and mix thoroughly to combine. Transfer the stuffing to the greased baking dish and spread into an even layer."", '7 Bake the stuffing for 20 minutes, uncovered.', '8 Prepare the pecan crumble topping: While the stuffing cooks, pulse all ingredients in a food processor until the mixture is crumbly. Be careful not to over process or you\\xe2\\x80\\x99ll end up with garlicky nut butter!', ""9 Top the stuffing with the crumble: Remove the stuffing from the oven and scatter the pecan crumble evenly over the top. Bake for 20 more minutes, uncovered. The top should be toasted and smell very fragrant. (If you're not adding the pecan crumble, just bake the stuffing for 30 minutes total.)"", '10 Cool and serve: Let the stuffing cool briefly before serving.']",17
773,Santa Fe Pork and Black Bean Stew Recipe,15,130,145,"['2 tablespoons extra virgin olive oil', '2 pounds of pork shoulder, trimmed of excess fat, cut into 1 1/2-inch cubes', '1 teaspoon kosher salt', '1 large onion, chopped (about 2 cups)', '4 cloves garlic', '1-2 jalape\\xc3\\xb1o chili peppers, less or more to taste, seeded, stems removed', '2 tablespoons cornmeal', '1 teaspoon ground cinnamon', '2 teaspoons ground cumin', '1 teaspoon dried oregano', '1/2 teaspoon cayenne (less or more to taste)', '1 1/2 tablespoons molasses', '1 red bell pepper, diced, about 3/4 cup', '2 long 1-inch wide strips of orange zest (optional)', '1 cup water', ""1 15-ounce can black beans (we recommend Bush's or S&W premium), liquid included"", 'More salt to taste', '1 to 2 limes', 'Cilantro for garnish']",19,"['1 Sprinkle 1 teaspoon salt over the pork pieces and let sit while you prep the other ingredients.', '2 Brown the pork: Heat 2 Tbsp olive oil in a thick-bottomed stew pot on medium high heat. Add the pork pieces to the pot and brown them on all sides.', '3 Add the onions: Once the pork pieces have browned, add the chopped onions to the pot with the pork. Lower the heat to medium and cook until the onions are translucent, about 7-10 minutes more.', '4 Make garlic jalape\\xc3\\xb1o spice mixture: As the onions are cooking, work on the garlic spice mixture. Place the garlic and the jalape\\xc3\\xb1os in the bowl of a food processor and pulse until minced. Then add the oregano, cumin, cinnamon, cayenne, and cornmeal and pulse everything until ground.', '5 Add spice mixture to pork and onions: Once the onions are cooked, add the spice mixture to the pork and onions.', '6 Add molasses, bell pepper, zest, cover and cook: Add the molasses, bell pepper, orange zest (if using), and water to the pot. Bring it to a simmer and then reduce the heat to the lowest setting. Cover and let cook until the pork is completely tender, about 1 1/2 hours. Stir occasionally and scrape up any browned bits stuck to the bottom of the pot.', '7 Remove zest, add black beans: When pork is tender, remove the orange zest and add the black beans to the pot and cook for 20 minutes more on low heat.', '8 Remove from heat, and stir in the lime juice. Add more salt to taste.', 'Serve garnished with fresh cilantro. Great with warm corn tortillas.']",9
774,Italian Wedding Soup Recipe,40,20,60,"['For the meatballs:', '1 small soft dinner roll or 2 slices white bread, torn into 1-inch pieces', '1/4 cup milk (any kind)', '1 large egg', '8 ounces ground beef', '8 ounces ground pork', '1/4 cup chopped fresh parsley', '1/2 cup freshly grated Parmesan', '1 small onion, very finely chopped', '1 clove garlic, crushed', '1 teaspoon salt', '1/2 teaspoon pepper ', 'For the soup:', '3/4 cup tiny pasta, such as Israeli or pearl semolina couscous, orzo, ditalini, or acini de pepe', '2 quarts chicken stock', '1/2 head or bunch escarole, Swiss chard, or kale, stemmed and cut into 1-inch pieces', '1 cup freshly grated Parmesan, for serving']",17,"['1 Cook the pasta: In a soup pot, bring a generous amount of water to a boil. Add a pinch of salt and the pasta.', 'Let the water return to a boil, lower the heat, and let the pasta bubble steadily for 6 minutes, or until it is almost tender and still has a slight crunch in the middle. Drain the pasta and transfer to a bowl; set aside.', '2 Soak the bread pieces: While the pasta water is coming to a boil and the pasta is cooking, mix the bread pieces with the milk or water in a large bowl.', 'Use your fingers to work the milk into the bread, like a sponge. Set aside for 10 minutes. Again, using your fingers, work the mixture until it forms a paste. Stir in the egg until incorporated.', '3 Make the meatball mixture: To the bowl with the bread and egg mixture, add the remaining meatball ingredients. With a spoon or your hands, work the mixture until it is well blended.', '4 Shape the meatballs: Set a bowl of cold water on the counter. Dip your hands into the water. Use a spoon to scoop out tablespoon-size pieces of the mixture, then dip your hands into the water after every few meatballs to keep them from sticking to your hands.', 'Shape into rounds with your hands and transfer to a plate. Continue until all the mixture is used; you should have about 28 to 30 meatballs.', '5 Cook the meatballs: Add the stock to the soup pot used to cook the pasta and bring to a boil. Use a long metal spoon to add the meatballs to the soup, several at a time.', 'Return the liquid to a boil, lower the heat, and cover the pan. Simmer for 5 minutes.', '6 Finish the soup: Add the greens to the stock pot, pressing with a soup ladle to submerge them. Add the pasta. Return to a boil, lower the heat, and cover the pan.', 'Cook for 3 minutes, or until the greens and pasta are tender and the meatballs are cooked through.', 'Taste the broth for seasoning and add more salt and pepper, if you like. Ladle into bowls and serve with Parmesan.']",12
775,Arroz con Tocino (Puerto Rican Rice with Salt Pork) Recipe,10,40,50,"['2 cups white rice', '1 pound salt pork, or thick cut bacon, diced', '1 cup white onion, minced', '3 cloves garlic, minced', '1 heaping tablespoon recaito seasoning base, store-bought or homemade', '3 3/4 cups water', '1/4 teaspoon black pepper', 'Cilantro, to garnish', 'To Serve:', '1 large egg per serving, if desired']",10,"['1 Rinse the rice: In a fine mesh colander or strainer, rinse the rice under cold running water until the water runs clear. This step eliminates additional starch which may cause the rice to become gummy. Set the colander aside and allow the rice to drain thoroughly.', ""2 Blanch the pork: Place the pork in simmering water for 15 minutes. After cooking, rinse off the pork and allow it to cool before proceeding. (If you're using bacon, you can skip this step.)"", '3 Render the fat from the pork: In a heavy bottomed pot or Dutch oven, render the fat from the diced pork over medium heat for 4 to 6 minutes, or until golden brown and crisp. Remove the pork pieces from the pot using a slotted spoon and drain on paper towels.', '4 Cook the onions, garlic, and recaito. Drain all but 2 tablespoons of pork fat from the pot. Add the onions and cook for 2 minutes, or until glossy. Add the minced garlic and recaito to the onions, and cook for an additional minute until fragrant.', '5 Combine the rice, onion and pepper. Add the drained rice to the pot and stir to combine the rice and onion mixture and to coat the rice with the fat. Continue to stir, toasting the rice for about a minute. Add the water and pepper, then bring to a boil.', '  6 Steam the rice. Once the water has started boiling, reduce the heat to low. Place a sheet of aluminum foil over the pot. Make sure the foil has about 2\\xe2\\x80\\x9d in overhang. Place the lid onto the pot and press down. This addition of foil creates a more air-tight seal which helps to steam the rice perfectly.', 'Cook the rice for twenty minutes without removing the lid. Remove the lid and check that the rice is done; recover and continue to steam if needed. Once the rice has cooked fully, remove the lid and fluff with a spoon or a large fork.', '  7 Combine the pork, rice and cilantro. Fold the reserved pieces of pork in the cooked rice and garnish with cilantro, if desired.', '8 Top with a fried egg. When ready to serve, fry an egg in your preferred style (I like mine sunny-side up) and serve atop a heaping portion of the rice.']",9
776,Sausage Meatballs with Ricotta in Tomato Sauce Recipe,15,90,105,"['10 ounces ground pork shoulder', '10 ounces sweet Italian sausage, removed from casing', '2 ounces prosciutto or pancetta, minced (helps to put in freezer for 15 min first, before mincing, will make it easier to cut)', '4 cups cubed white bread, crusts removed first.', '1/2 cup chopped fresh flat-leaf parsley', '1 teaspoon dried oregano', '1 teaspoon fennel seeds', '1/2 teaspoon red pepper flakes', '1 1/2 teaspoons Kosher salt', '2/3 cup ricotta cheese', '3 eggs, lightly beaten', 'Extra virgin olive oil', '1 28-ounce can crushed tomatoes (high quality, either San Marzano or Muir Glen)', '1/4 cup chiffonaded* fresh basil leaves', '1/2 cup freshly grated Parmesan cheese']",15,"['1 In a large bowl, add the pork, Italian sausage, prosciutto or pancetta, bread cubes, parsley, oregano, fennel, red pepper flakes, and salt. Use your hands to mix until the ingredients are evenly distributed. Do not over-work.', '2 Incorporate eggs and ricotta: Whisk the beaten eggs and ricotta together in a separate bowl until there are no more large clumps of ricotta. Pour into the bowl of the meat mixture. Mix with your hands until just incorporated. Again, do not over-mix.', 'If you want, to test seasoning, you can take a small bit of the mix, form into a patty, and heat in a small skillet on the stovetop until cooked through. Depending on how this test patty tastes to you, add more herbs, chili, or salt to taste to the meat mixture. Keep meat mixture in refrigerator while doing this.', '3 Form meatballs and place in roasting pan: Preheat oven to 425\\xc2\\xb0F. Coat the bottom of a large roasting pan with olive oil. Form meatballs in your hand, about 1 1/2-inches in diameter, using about 3 Tbsp of the mixture to form each meatball. Arrange in pan so there is some space between them. If too crowded they will steam and not brown.', '4 Brown meatballs in the oven at 425\\xc2\\xb0F for about 30 minutes, turning the meatballs after about 20 minutes, until the meatballs are beginning to brown.', '5 Add crushed tomatoes, lower oven temp: Remove pan from oven. Use a metal spatula to dislodge meatballs from being stuck to the bottom of the pan. Add the crushed tomatoes to the pan. Carefully cover the pan with aluminum foil (carefully because the pan is still hot!)', 'Return the pan to the oven. Lower the oven temperature to 300\\xc2\\xb0F. Cook for an additional hour to 1 1/2 hours.', 'Sprinkle basil into sauce before serving.', 'Top with grated Parmesan.']",9
777,Spicy Pork Stew with Chickpeas and Sausage Recipe,20,180,200,"['1 tablespoon extra virgin olive oil', '3 pounds pork shoulder, cut into 1-2 inch chunks', 'Salt', '1 large onion, chopped', '1 large carrot, chopped', 'All of the cloves from 1 head garlic, peeled and chopped', '1 pound hot Italian sausage links (not loose) or Spanish chorizo (use gluten-free sausages for gluten-free option)', '1 15-ounce can crushed tomatoes', '3 1/2 cups water', '2 tablespoons sweet paprika', '1 teaspoon hot paprika (can sub 1/4 teaspoon red chili flakes)', '1-2 teaspoons smoked paprika', '2 15-ounce cans chickpeas, drained and rinsed', '1 bunch parsley, chopped']",14,"['1 Brown the pieces of pork shoulder in olive oil, sprinkle with salt: Heat the olive oil in a large pot over medium-high heat. Working in batches to ensure that you do not crowd the pan, brown the pieces of pork shoulder.', 'If there is a fatty side to a chunk of pork, put that side down on the pan to help render out the fat.', 'Sprinkle a little salt over the pork as it cooks. Once browned, set aside to a bowl.', '2 Saut\\xc3\\xa9 onions, carrots, garlic: Once the pork pieces have browned and have been removed from the pan, drain off all but a couple tablespoons of fat from the pan.', 'Add the chopped onions and carrots to the pan. Stir well and scrape up any bits from the bottom of the pot. Cook over medium-high heat until the onions start to brown.', 'Add the chopped garlic and cook for another minute.', '3 Add browned pork, sausage, tomatoes, water, paprikas, salt, then simmer 2 hours: Add the pork, the sausage, crushed tomatoes and water, then stir to combine. Stir in the various paprikas. Add salt to taste.', 'Bring to a simmer and cook for at least 2 hours, or until the pork shoulder is melt-in-your mouth tender.', '4 Cut up the sausage links and return to the pot, add chickpeas, parsley: Remove the sausages from the pot and cut them into chunks, then return them to the pot.', 'Add the chickpeas and parsley, stir well and adjust salt to taste. Cook for 5 minutes further.', 'Excellent served with crusty bread and red wine.']",11
778,"Sausage, Sage, and Cornbread Stuffing Recipe",20,40,60,"['1 recipe Southern cornbread, prepared and cooled (follow the gluten-free option, if needed)', '1 teaspoon canola oil (or other neutral, heat tolerant cooking oil)', '1 1/2 pounds sweet or mild Italian sausage (4 to 6 links), casings removed and broken into bite-sized pieces', '5 tablespoons unsalted butter, divided', '1 medium yellow onion, diced', '4 celery ribs, diced', '2 cloves garlic, minced', '3 tablespoons chopped fresh sage leaves', '3 tablespoons chopped fresh parsley leaves', '2 cups low-sodium chicken stock', '4 large eggs, lightly beaten']",11,"['1 Toast the cornbread cubes: Preheat oven to 350\\xc2\\xb0F. Cut the cornbread into 1/2-inch cubes; you should have about 8 cups. Spread them on a large rimmed baking sheet. Toast the cubes in oven for 10 minutes, flip, and toast 10 minutes more or until cubes look toasted and golden (about 20 minutes total). Let the cubes cool slightly, and then place in a large mixing bowl.', '2 Turn oven heat up to 375\\xc2\\xb0F. Butter a 9 x 13-inch baking dish with 1 tablespoon butter. Set aside.', '3 Brown the sausage: Set a large, deep-sided skillet over medium-high heat. Add the canola oil and then sausage. Use a spoon to break sausage into smaller hunks as it cooks. Cook until the sausage nicely browned on all sides, 7 to 10 minutes. Transfer the sausage to a bowl and pour off pork fat.', '4 Cook the onions and celery: Turn the heat to medium and add 4 tablespoons butter. Add onions, celery, and a pinch of salt. Cook 7 minutes or until very tender and fragrant. Add garlic and cook 1 minute more.', '5 Combine the stuffing ingredients: Spoon the onion mixture over the toasted cornbread. Fold in browned sausage, herbs, and stock. Taste and add salt as needed. Finally, fold in the eggs and mix until well combined. Some of the cornbread will crumble, which is fine.', '6 Spoon stuffing into buttered baking dish. At this point, stuffing can be covered and refrigerated for 1 day.', '7 Bake the stuffing: When ready, bake stuffing until piping hot and golden brown on top, 35 to 45 minutes. If the stuffing begins to brown too much on top during bake time, cover loosely with foil. Serve hot.']",7
779,"Risi e Bisi, Italian Rice and Peas Recipe",10,35,45,"['2 tablespoons extra virgin olive oil', '3 shallots, minced', '3 garlic cloves, minced', '1/4 pound diced prosciutto or other dry ham', '1 cup Arborio or other risotto rice', '2 cups vegetable or chicken stock', '2 or more cups water', '1 cup fresh or frozen peas', '1/2 cup parsley, chopped', '1/4 cup grated parmesan cheese']",10,"['1 Saut\\xc3\\xa9 shallots: Heat the olive oil in a medium-sized pot over medium-high heat. When it is hot, add the shallots and stir to combine. Let these saut\\xc3\\xa9 for 2-3 minutes.', '2 Heat stock and water: Meanwhile, heat up the stock and 1 cup of water in a small pot. You want this at a simmer while you make the rice.', '3 Add garlic and prosciutto to shallots: Add the garlic and the diced prosciutto to the pot with the shallots, stir well and cook for another 1-2 minutes.', '4 Add rice: Pour in the rice, stir again and saut\\xc3\\xa9 for 2-3 minutes, stirring constantly.', '5 Slowly ladle in stock: Ladle some of the hot stock into the pot and start stirring. Risi e bisi is cooked like risotto, and is supposed to be pretty soupy, so you need a lot of water and you need to stir it constantly. Let this first ladle of stock cook down before you add the next.', 'Keep adding stock, letting it cook down and stirring until you\\xe2\\x80\\x99re done with the simmering stock. It is likely that you may need at least one more cup of water to finish the dish, because all that stirring in an open pot means you evaporate more liquid than you would when you cook rice the normal way, i.e., covered. If you think you are going to need more water, add more to the simmering stock.', '6 When you get to this last cup of water, add the peas. Keep stirring until the water has almost cooked away. Taste some rice and test for salt and doneness: Add a little salt and some more hot tap water if the rice is still crunchy \\xe2\\x80\\x93 you want the rice to be a little al dente, but not so much you\\xe2\\x80\\x99re gnawing on raw grain.', '7 Add the parsley and the parmesan and mix well. Your finished rice should be slightly soupy, so it\\xe2\\x80\\x99s OK to add a tad more water before serving.']",8
780,Fettuccine with Creamy Tomato Italian Sausage Sauce Recipe,6,45,51,"['2 tablespoons extra virgin olive oil', '3 shallots, chopped', '2 large garlic cloves, chopped', '1/2 pound sweet Italian sausage, casings removed', '1/2 pound spicy or hot Italian sausage, casings removed', '1 cup whipping cream', '2 14.5-ounce cans diced tomatoes in juice', '1 tablespoon dried sage', '3/4 pound fettuccine', '1/2 cup grated Parmesan cheese']",10,"['1 Heat water for pasta: Put a large pot of salted water on to boil (1 Tbsp salt for every 2 quarts of water). While the pasta water is heating, prepare the sauce in the next step.', '2 Cook shallots and garlic: Heat olive oil in a large saut\\xc3\\xa9 pan on medium heat. Add the shallots and garlic and cook, stirring frequently, until beginning to soften, about 3 minutes.', '3 Add Italian sausage: Break up the sweet and spicy Italian sausages as you add them to the pan. Toss with the shallots, increase the heat to medium high, and cook until no longer pink, about 5 minutes.', '4 Stir in the cream and simmer for 5 minutes.', '5 Stir in the tomatoes, their juices, and the sage. Simmer for about 15 minutes, stirring occasionally, until the sauce thickens.', '6 Cook the pasta: The pasta water should be boiling by now. After the sauce has simmered for about 5 minutes, add the pasta to boiling salted water and cook, uncovered at a rolling boil, until the pasta is al dente, cooked through but still a little firm to the bite.', 'Reserve 1/2 cup of the pasta water and drain the pasta.', '7 Toss the pasta with the sauce and add a little of the reserved pasta water if dish seems dry.', 'Season with salt and pepper and sprinkle with cheese to serve.']",9
781,Grilled Bacon-Wrapped Stuffed Hot Dogs Recipe,10,11,21,"['1 teaspoon ketchup', '1 teaspoon Dijon mustard', '4 large hot dogs, knockwurst, or kielbasa', '1/2 ounce cheddar cheese, cut into long sticks', '2 tablespoons chopped onions', '1 cup prepared sauerkraut, drained, roughly chopped', '4 slices bacon', 'Vegetable oil', '4 long hot dog buns']",9,"['1 Prepare your grill for direct medium high heat.', '2 Slice open the hot dogs: Mix together the ketchup and mustard in a small bowl. In a separate bowl, mix the sauerkraut with the chopped onion, set aside.', 'Slice open the hot dogs, down the center, lengthwise, forming a deep pocket in each, but not cutting all the way through.', 'Coat the inside of each hot dog with the mustard ketchup mixture.', '3 Stuff the hot dogs: Place a strip of cheese deep within the pocket of each hot dog. Top with sauerkraut and onions.', 'Encapsulate the cheese at the ends with the sauerkraut mixture as well, so that no cheese is exposed (otherwise it will drip out when cooking).', '4 Wrap bacon around each hot dog: Wrap a strip of bacon around each stuffed hot dog, securing with toothpicks at each end.', 'Make sure you wrap tight enough so that the stuffing stays in, but not so tight so that when the hot dog expands will cooking the bacon would tear.', ""5 Grill the hot dogs: Brush the grates of your grill with vegetable oil so that the hot dogs don't stick. If you have a grill screen (a screen with smaller holes so that small pieces of whatever you're cooking don't fall through the grill), you can use it, just coat it with vegetable oil first and pre-heat for a couple of minutes."", 'Place the stuffed hot dogs on the grill, stuffing side down. Grill for 2 minutes, until the bacon on that side is cooked, turn the hot dogs a quarter turn and grill for a couple more minutes.', 'Continue to grill for a few minutes each on all sides until the bacon is cooked. Cover the grill in between turnings to help with the cooking.', '6 Grill the buns: During the last minute of cooking, open up the hot dog buns and place them open-side down on the grill to lightly toast.', '7 Serve: Remove the hot dogs and buns from the grill. Remove the toothpicks from the hot dogs. Place the hot dogs in the buns and serve.']",13
782,Chipotle Meatballs Recipe,25,20,45,"['Meatballs', '2 slices bacon, minced', '2 garlic cloves, minced', '2 large eggs', '1/2 cup bread crumbs', '1 1/2 teaspoons salt', '1 1/2 pounds ground pork', '2 teaspoons dried oregano or finely chopped fresh mint', '1-2 teaspoons chipotle powder (or a couple teaspoons of adobo sauce)', 'Sauce', '2 tablespoons extra virgin olive oil', '1 medium onion, chopped, about 1 cup', '3 garlic cloves, minced', '1-3 chipotles chiles in adobo (canned), minced fine and sauce reserved', '1 28-ounce can crushed tomatoes (preferably fire-roasted)', '1 teaspoon dried oregano', '1/2 cup beef or chicken broth']",17,"['1 Preheat oven to 400\\xc2\\xb0F.', ""2 Mix meatball ingredients: Mix all the meatball ingredients together in a large bowl and mix well with your clean hands for a minute or two. You want the mixture to be well integrated, but you don't want to overwork it or the meatballs will be tough."", '3 Form into meatballs and bake: With wet hands or an ice cream scoop, form meat into about 16 plum-size balls and space them out in a 13-by-9-inch baking dish, or, if you have one, a mini-muffin tin. Bake at 400\\xc2\\xb0F until lightly browned, about 15 minutes.', '4 Make the sauce: While meatballs bake, heat the olive oil in a saut\\xc3\\xa9 pan over medium-high heat and saut\\xc3\\xa9 the onions until they just start to brown. Add the garlic and cook for 1 minute.', 'Add the minced chipotles, the can of tomatoes, oregano or mint, and beef broth. Mix well and add salt to taste. If you want more chipotle flavor, add the reserved chipotle sauce spoonful by spoonful, mixing and tasting between spoonfuls. Simmer the sauce uncovered as the meatballs cook.', '5 Toss meatballs with sauce to serve: When meatballs are ready, put them into the sauce and toss to coat. If the sauce is too thin for your taste, continue to boil it down for a few minutes. Otherwise, serve with rice, tortillas or polenta. Garnish with cilantro to serve.']",6
783,Stuffed Cabbage Rolls Recipe,25,90,115,"['2 pounds sauerkraut (preferably a good brand, such as Bubbies, that you would find in the refrigerated section of your grocery store)', '1 large head green cabbage', '2 tablespoons extra virgin olive oil', '1 cup minced onions', '1/4 teaspoon minced garlic', '1 pound ground pork', '3/4 cup cooked white rice (from about 1/4 cup of dry rice)', '2 large eggs, lightly beaten', ""2 tablespoons sweet Hungarian paprika (or plain paprika if your market doesn't offer a choice)"", '1/8 teaspoon dried marjoram (can sub oregano)', '1 teaspoon Kosher salt', 'Freshly ground pepper', '1 cup water', '1 cup tomato pur\\xc3\\xa9e', '1 cup sour cream']",15,"['1 Prep the sauerkraut: Rinse the sauerkraut in cold water. Squeeze out excess moisture and set aside.', '2 Cook the cabbage: Bring a large pot of salted water to a boil (1 tablespoon of salt for every 2 quarts of water). Add the whole green cabbage to the boiling water. Cover the pot, reduce the heat to maintain a simmer, and cook for 10 to 15 minutes, depending on the size of the cabbage.', ""Remove the cabbage from the water and let drain until it is cool enough to handle. Pull off as many large, unbroken leaves as you can and lay them on paper towels dry. If the inner leaves haven't cooked enough to bend easily, return them to the simmering water to cook a little longer."", '3 Saut\\xc3\\xa9 onions and garlic: Heat olive oil in a large skillet on medium-high heat. When the oil is hot, add the onions and saut\\xc3\\xa9 them until translucent and beginning to color. Add the garlic and cook half a minute longer. Remove from heat.', '4 Make pork mixture: In a large bowl, place the ground pork, cooked rice, beaten eggs, paprika, marjoram, the cooked onions and garlic, salt, and several grinds of black pepper. Mix with your clean hands or a wooden spoon until just combined.', '5 Stuff the cabbage rolls: Working one at a time, place a couple tablespoons of the pork stuffing in the center of a blanched cabbage leaf. Start at the thick end of the leaf and fold the sides of the cabbage over the stuffing. Then roll up the whole cabbage leaf into a tight bundle.', 'Repeat with the remaining leaves until you have used up all of your stuffing.', '6 Layer stuffed cabbage rolls on top of sauerkraut: Place the rinsed and drained sauerkraut in an even layer on the bottom of a 5 or 6 quart thick-bottomed pot, such as a Dutch oven. Place the cabbage rolls on top of the sauerkraut.', '7 Simmer the rolls: Mix the cup of water with the cup of tomato pur\\xc3\\xa9e and pour over the cabbage rolls. Heat on high to bring the liquid to a boil, then reduce the heat to low, cover the pot, and cook the cabbage rolls on a low simmer for one hour.', '8 Make the sauce: Remove the stuffed cabbage rolls from the pot and place on a warm dish. Slowly stir the sour cream into the sauerkraut. Bring to a simmer and let cook for about 5 minutes.', '9 Serve: Use a slotted spoon to lift the creamy sauerkraut sauce onto a serving platter. Arrange the stuffed cabbage rolls on top of the sauerkraut and spoon some sauce over them as well. Serve remaining sauce on the side.']",11
784,"Pasta with Butternut Squash, Bacon, and Brown Butter Recipe",15,30,45,"['1 pound butternut squash, cut into 1/2-inch cubes (about 4 cups)', '2 tablespoons olive oil', '1 teaspoon Morton\\xe2\\x80\\x99s kosher salt', '1/2 teaspoon freshly cracked black pepper', '1 pound pasta, such as penne, rigatoni, or other short-shaped pasta', '8 ounces bacon (7 to 8 slices, depending on how thickly they are cut)', '1/4 cup sliced shallots', '1 stick unsalted butter (4 ounces/8 tablespoons)', '4 to 5 sage leaves', '1/4 cup freshly grated Parmesan cheese']",10,"['1 Roast the squash: Preheat the oven to 425\\xc2\\xb0F. On a rimmed baking sheet, combine the squash with olive oil, salt, and pepper on a rimmed baking sheet, and toss to coat.', 'Roast for 20 minutes, tossing half way through to evenly brown. When it\\xe2\\x80\\x99s ready, the squash will be soft and some of the edges will have browned.', '2 Cook the pasta: Meanwhile, bring a large pot of salted water to boil and cook the pasta to al dente, or according to package directions. Drain well and set aside.', '3 Fry the bacon: In a large, deep skillet (I used cast iron), put the bacon in a cold pan and cook over medium heat until crispy. Remove from the skillet and drain on paper towels.', '4 Cook the shallots: Place the skillet back on the stove, but with the heat turned off. Drain all but about 2 tablespoons of the bacon grease.', 'Add the shallots and cook in the residual heat from the skillet; this helps prevent the shallots from burning. If they don\\xe2\\x80\\x99t seem to be cooking fast enough, turn the heat to medium-low and cook for just a couple of minutes until they start to soften and become aromatic. Transfer the cooked shallots to a large bowl.', ""  5 Combine the bacon, shallots, squash and pasta: After the bacon cools, cut it into small pieces using kitchen scissors (or using a chef's knife), and combine with the shallots in a large bowl\\xe2\\x80\\x94or you can use the stockpot you cooked the pasta in (I like to do this if it's just me and the boys)."", 'Add the pasta and toss to combine. When the squash comes out of the oven, add the squash to this bowl and toss gently together.', '  6 Brown the butter: In a small saucepan, melt the butter over medium heat. Stir it constantly and keep an eye on it so it does not burn. (See here for full instructions on how to brown butter.) It will start to crackle, foam, and smell nutty. The color will deepen to a caramel/amber hue.', 'Around when the butter stops foaming\\xe2\\x80\\x94or at least it starts to subside\\xe2\\x80\\x94and the butter turns slightly brown, add the sage leaves.', 'Remove the saucepan from the heat as soon as the sage leaves start to curl. Pour the butter and the sage leaves into the bowl with the rest of the ingredients.', '  7 Combine all ingredients and serve: Toss everything gently together with a wooden spoon. Taste and add salt and/or pepper if needed. Serve immediately with freshly grated cheese over the top.', 'If you are feeling extra decadent, add a chunk of unsalted butter or a splash of extra virgin olive oil on top when you toss, or some of the reserved bacon grease.', 'Leftovers keep for about 2 to 3 days and reheat fairly well. I like to add a bit of olive oil or water to the pot when I reheat it over low heat. (I try to avoid microwaving leftover pasta because it just makes it gummy.)']",14
785,Curried Pork Empanadas Recipe,20,140,160,"['Pastry Ingredients', '16 ounces cream cheese (do not use light), room temperature', '8 ounces (2 sticks, 1 cup) unsalted butter, room temperature', '1/2 teaspoon salt', '3 cups all-purpose flour', '1 egg, beaten, for pastry egg wash', 'Filling Ingredients', 'Salt', '1/2 pound ground pork', '2 tablespoons plus one teaspoon extra virgin olive oil', '1 cup finely chopped onions', '1 clove garlic, minced', '4 shiitake mushrooms, finely chopped (optional)', '1 teaspoon curry powder', '1/2 teaspoon ground coriander', '1/2 teaspoon ground cardamom', '2 tablespoons sherry', '1/2 teaspoon soy sauce', '2 teaspoons sugar', '1 teaspoon cornstarch', '1/4 cup golden raisins, chopped']",21,"['1 Make the empanada dough: Beat together the cream cheese, butter, and 1/2 teaspoon salt, until well blended. Slowly add in the flour, mixing until incorporated.', 'Form two balls (it will be easier to work with 2 separate pieces of dough), then flatten each into a disk. Dust with flour, cover with plastic wrap, and refrigerate for at least an hour.', '2 Cook the pork: While dough is chilling, heat 1 teaspoon of olive oil in a large frying pan on medium high heat. Break off bits of ground pork and add to the pan, until all the pork is added without crowding. Sprinkle 1/4 teaspoon of salt over the pork. Do not stir.', 'Once the pork is lightly browned on one side, use a spatula to flip the pieces to the other side so the other side can cook.', 'Once the pork is lightly browned on both sides, reduce the heat on the pan to medium, and remove the pork to a bowl.', '3 Make the picadillo stuffing: Add 2 more tablespoons of olive oil to the pan. Then add the finely chopped onion. Let onions gently cook on medium heat for a few minutes until translucent.', 'Add the minced garlic. Cook until fragrant.', 'Add the finely chopped mushrooms, cooking for a few minutes more.', 'Add the curry powder, ground coriander, and cardamom to the pan. Mix the spices in with the onion mix.', 'Add the ground pork back to the pan, mixing in the seasoned onion mix.', 'Add the raisins. Add the sherry, soy sauce, sugar, and corn starch, mixing well.', 'Break bigger pieces of ground pork with the edge of a metal spatula. Remove from heat, and chill until time to stuff the pastries.', '4 Roll out the dough and cut out rounds: Preheat oven to 375\\xc2\\xb0F. On a lightly floured, smooth, clean surface, roll out one of the dough rounds to a thin 1/8-inch thickness. (If refrigerated for more than an hour, you may need to let it sit for 10 minutes to soften it enough to roll it out more easily.)', 'Use a wide-mouthed jar or biscuit cutter (about 3 inches wide) to cut out rounds. Place them on a baking sheet.', 'During this and the next step, if the dough becomes too soft and therefore difficult to work with, put whatever you are working on in the refrigerator to chill for 5 or 10 minutes.', '5 Stuff and fold the empanadas: Use a pastry brush to lightly brush the inside edge of the rounds with egg wash (to help the empanadas seal).', 'Place a teaspoon of meat inside each round.', 'Fold the round over to and press the edges to seal shut. Use the tines of a fork to flute the edges.', ""Place standing upright on a baking sheet, spaced an inch apart. (You can also lie them down, but with them upright, you'll fit more on a pan.)"", 'Use a pastry brush to brush the sides (not the bottom) of the empanadas with more egg wash.', '6 Bake in oven: Working in batches, cook in the 375\\xc2\\xb0F oven for 15 to 20 minutes, until golden brown.']",21
786,Italian Sausages with Ratatouille Recipe,20,90,110,"['Extra virgin olive oil', '1 medium chopped onion, roughly chopped', '2 cloves garlic, thinly sliced', '1/2 pound of zucchini, cut into 1/2-inch dice', '1 small eggplant, unpeeled, cut into 1/2-inch dice (1 lb or less)', '1/2 red bell pepper, cut into 1/2-inch dice', '1/2 green bell pepper, cut into 1/2-inch dice', '1/2 yellow bell pepper, cut into 1/2-inch dice', '1 pound of fresh tomatoes, skinned and chopped (or 1 14.5-oz can diced tomatoes)', '1 1/2 teaspoons kosher salt', '1/4 teaspoon black pepper', '1/8 teaspoon red pepper flakes', ""3/4 pound of sweet or old fashioned Italian sausages (you can use hot, but if you do, don't add the red pepper flakes)"", '4 sprigs of thyme', '1 sprig of rosemary']",15,"['1 Preheat oven to 400\\xc2\\xb0F.', '2 Cook onions and garlic: Using a large oven-proof pan over medium-high heat, saut\\xc3\\xa9 onions in olive oil until they begin to soften, about 5 minutes. Add garlic and reduce heat to low.', '3 Brown the zucchini: While the onions and garlic are cooking over low heat, put 2 tablespoons of olive oil in a another large skillet over high heat.', 'As soon as the pan gets hot, add enough zucchini cubes to form a layer on the bottom of the pan.', 'Cook over high heat, stirring, until zucchini is lightly browned on all sides. Remove zucchini cubes, and add them to pan with the onions.', 'Repeat process until all of the zucchini cubes have been cooked.', '4 Continue with the bell peppers, then the eggplant cubes, adding the browned vegetables to the onion pan as soon as they are cooked. Add more olive oil as needed.', '5 Add the tomatoes, spices, water: Add the tomatoes (and their juice) to your large oven-proof pan with the rest of the vegetables, along with salt, black pepper, red pepper, thyme, rosemary and 1/4 cup of water. Bring to a boil.', '6 Finish cooking in oven: Nestle the sausages in the pan. Transfer to the oven and cook, uncovered, for 30 to 40 minutes, until the sausages are cooked through.']",9
787,Pork Chops with Ginger Pear Sauce Recipe,15,20,35,"['4 pork chops', 'Salt', '2 Tbsp canola or other vegetable oil', '2 Tbsp unsalted butter', '1/3 cup minced shallots', '2 Tbsp minced ginger', '1 large pear (anjou, bartlett, or bosc), peeled and diced', '1 1/2 cups chicken stock', '3 Tbsp cider vinegar', '2 Tbsp honey', '1/4 to 1/2 teaspoon minced fresh rosemary', 'Freshly ground black pepper']",12,"['1 Salt the pork chops and score the fat: Salt the pork chops well and let them sit at room temperature while you chop all the vegetables and the pear.', 'Make a few cuts in the outer fat layer of the pork chops, all the way through to the meat, to prevent them from curling up when you cook them. Heat the oil in a large frying pan over medium-high heat until shimmering.', '2 Sear the chops: Working in batches as to not crowd the pan, when the oil is hot, pat the pork chops dry with paper towels and lay them in the pan. Sear the chops until nicely browned, about 3-5 minutes depending on how hot your burner is.', 'Turn the pork chops over and sear on the other side for a minute or two.', ""3 Finish cooking the pork chops: Then lower the heat and cook until done, 5 to 15 minutes, depending on the thickness of the chops. Remember you no longer need to cook pork well done. The recommended minimum temperature for cooked pork is now 145\\xc2\\xb0F in the U.S. (Use the finger test for meat if you don't have a meat thermometer.)"", 'When done, remove the pork chops from the pan to a plate to rest.', '4 Saut\\xc3\\xa9 shallots, ginger in butter, then add pear: When the pork is done, remove all but 1 tablespoon of the oil from the pan. Add the butter, shallots and ginger and toss to combine.', 'Cook this for 1 minute, then add the chopped pear and toss to combine. Cook another minute.', '5 Add stock, vinegar, honey, reduce: Add the chicken stock, vinegar and honey and bring to a rolling boil. Boil vigorously until the liquid is reduced by 2/3, about 4-6 minutes.', 'Turn off the heat and add the rosemary and some black pepper. Add salt to taste.', 'Serve the pork chops with the sauce on the side.']",11
788,Spareribs and Sauerkraut Recipe,5,100,105,"['2 1/2 to 3 lbs of bone-in pork spareribs', '2 Tbps vegetable oil', '1 large yellow onion, peeled and chopped', '2 garlic cloves, minced', '1 large (28 oz) jar (or 1 1/2 to 2 pounds) of sauerkraut (refrigerated)', '1 cup dry white wine (like a Sauvignon blanc)', 'Water', 'Salt and pepper', '10 Juniper berries', '2 teaspoons caraway seeds']",10,"['1 Brown the ribs: Separate the ribs, and sprinkle them with salt. Heat vegetable oil in a large heavy pot on medium high heat. Add the ribs and brown them.', '2 Saut\\xc3\\xa9 onions and garlic: Remove the ribs from the pot and add the chopped onion to the pot. Saut\\xc3\\xa9 the onions for 3 minutes. Then add the minced garlic for a minute more. Return the ribs to the pot.', '3 Add sauerkraut, wine, juniper berries, caraway seeds: Add the sauerkraut and wine to the pot. Add just enough water to cover the ribs.  Add 10 juniper berries and a sprinkle of caraway seed to taste.', '4 Simmer until meat is falling off the bones: Bring to boil and reduce heat to simmer. Simmer until the meat falls off of the bones, anywhere from one to two hours. Remove the bones and juniper berries. Add salt and pepper to taste.', 'Serve with boiled potatoes. Delicious with ketchup which creates a sweet contrast to the sour sauerkraut, or you can use whole grain mustard.']",5
789,Citrus-Brined Grilled Pork Chops Recipe,5,80,85,"['For the brine:', '1/2 white onion, quartered', '2 cloves garlic', '1/2 cup Morton kosher salt (or 1/3 cup table salt)', '1/3 cup honey', '1 teaspoon black peppercorns', '1 orange, halved', '1 lime, halved', '1 lemon, halved', '2 cups water', '2 cups ice', '4 (8- to 10-ounce) boneless pork chops, trimmed of any fat', 'For the rub:', '1 tablespoon Morton kosher salt', '1 tablespoon black pepper', '1 tablespoon paprika', '1 tablespoon brown sugar', 'Neutral oil, for grill']",18,"['1 Make the brine: In a medium pot, combine the onion, garlic, salt, honey, peppercorns, orange, lime, and lemon. Add two cups of water and bring to a slight simmer over medium-high heat. Stir until the honey and salt are dissolved.', 'Remove from heat and add ice to chill the mixture to at least room temperature.', '2 Brine the pork chops: Once cool, transfer the brine to a large dish and add the pork chops. The pork chops should be covered by the brine. If they aren\\xe2\\x80\\x99t, use a small plate or bowl to keep them in the brine.', 'Cover and refrigerate for at least 60 minutes, but longer is preferable. Don\\xe2\\x80\\x99t let them brine for longer than 24 hours\\xe2\\x80\\x94otherwise the proteins in the pork will start to cure and you\\xe2\\x80\\x99ll end up with something closer to ham.', '3 Prep the pork chops: When ready to grill, remove pork chops from the brine and pat dry with paper towels. Stir together the spices for the rub in a small bowl, and season the pork chops liberally with the rub.', '4 Heat the grill: Preheat grill to medium-high heat and rub the grill grates with some neutral oil on a clean rag (or a few paper towels) to prevent sticking.', ""5 Grill the chops: Place the pork chops on grill and grill for 5 to 6 minutes on the first side. If you'd like pretty cross-hatched grill marks, rotate the pork chop 90-degrees after 3 minutes."", 'Flip pork chop and cook on the second side for another 4 to 6 minutes. The pork chops are done when an instant read thermometer inserted in the thickest part of the chops registers 145\\xc2\\xb0F. (This is the FDA recommended cooking temperature and it will give you slightly pink pork chops in the center).', 'If your pork chops are thicker than 3/4-inch, they will need a few minutes longer on the grill and you\\xe2\\x80\\x99ll have to watch the thermometer until they are done.', '6 Rest the pork chops: Transfer the cooked chops to a plate and let them rest for about five minutes before serving.', '7 Serve! Slice and serve the chops with grilled fruit such as pineapple and a green side such as grilled Brussels sprouts (grilled in a grill pan over high heat for a few minutes until charred in spots)!']",11
790,Brined Pork Chops with Gremolata Recipe,0,20,20,"['2 to 4 thick-cut pork chops, preferably bone-in, about 10 ounces each', 'Extra virgin olive oil', 'Brine:', '5 cups water', '6 tablespoons sugar', '3 tablespoons Kosher salt', '3 bay leaves, crumbled', '1/2 teaspoon coriander seeds, lightly crushed', '1 sprig thyme', '4 strips of lemon peel', 'Gremolata:', '2 tablespoons minced fresh parsley leaves', '1 tablespoon grated fresh lemon zest', '2 teaspoons minced garlic']",14,"['1 Brine the pork chops a day or two ahead: A day (or two) ahead, prepare the brine.', 'Place one cup of water in a small saucepan and add the roughly crumbled bay leaves, coriander seeds, thyme, and lemon peel. Bring to a simmer and remove from heat. Let sit for a few minutes.', 'Then add the remaining 4 cups of water. Stir in the sugar and salt until they are dissolved and the water is no longer cloudy.', 'Place the chops in a freezer bag or marinade bag in a bowl and pour the brine into the bag. Seal and refrigerate for 1 to 2 days (1 day for thin chops, 1 to 2 days for thick).', '2 Remove chops from brine: A half hour (for thin chops) or an hour (for thick chops) before cooking, remove the pork chops from the brine and rinse off with cold water. Pat dry.', '3 To prevent the chops from buckling while they cook, score the outside rim of fat a couple of places, cutting just to the edge of the meat.', '4 Sear chops on both sides: Coat the bottom of a large skillet with oil. Heat on medium to medium high. Pat dry the chops again and coat with a little oil. When the pan is hot, place the chops in the pan. Cook until browned on one side, then flip over and brown the other side.', ""5 Lower heat and cook until done: Once browned, flip over again and lower the heat, continue to cook until done (internal temperature reads 145\\xc2\\xb0F, or use the finger test to check the doneness of meat if you don't have an instant read thermometer)."", 'Note that because of the sugar in the brine, the chops may brown more quickly than you expect. You may need to move them in the pan a bit to keep them from getting too dark.', '6 Tent with foil and let chops rest: When done, remove the chops from the pan, tent with foil and let rest for 5 to 10 minutes while you make the gremolata.', '7 Make the gremolata by combining minced parsley, grated fresh lemon zest, and minced garlic in a small bowl. Sprinkle on the pork chops to serve.', 'Great with mashed parsnips and potatoes.']",12
791,"Spare Ribs, Cabbage, and Sauerkraut Recipe",10,1620,1630,"['3 to 3 1/2 pounds pork spare ribs, bone-in', '3 cloves garlic, thinly sliced', '1 Tbsp caraway seeds', '1 Tbsp cracked black pepper', 'Kosher salt and freshly ground pepper', '1 32-ounce jar of sauerkraut, drained', '4 cups thinly shredded cabbage (about 1 medium head)', '1 medium yellow onion, thinly sliced', '2 Tbsp brown sugar', '2 cups water', '2 cups chicken stock', '1 bottle of your favorite beer', '1/4 teaspoon caraway seeds']",13,"['1 Rub the spare ribs with spices, and chill: Rub the ribs with garlic, caraway seeds, and cracked black pepper. Wrap in plastic wrap and refrigerate for up to 24 hours (if you have time, otherwise skip).', '2 Roast the spare ribs: Heat oven to 400\\xc2\\xb0F. Unwrap spare ribs from plastic wrap. Season the ribs with salt and pepper. Wrap the ribs with aluminum foil and place them on a roasting pan. Roast at 400\\xc2\\xb0F for 1 hour 15 minutes, or until tender. Remove from oven and set aside.', '3 Bake the sauerkraut: Place sauerkraut, onion, caraway seed, brown sugar, and cabbage in a Dutch oven. Stir in beer, water, and chicken stock. Add pepper to taste. Reduce the oven temperature to 375\\xc2\\xb0F. Bake the sauerkraut cabbage mixture, covered, for 3 hours.', '4 Add ribs to sauerkraut, bake one more hour: Lower the oven temperature to 325\\xc2\\xb0F. Place ribs over sauerkraut, cover, and cook for an additional hour. Add more liquid if needed.', 'Serve the ribs with the sauerkraut. Good with boiled potatoes.']",5
792,Stuffed Pork Chops with Kielbasa and Sauerkraut Recipe,10,135,145,"['Stuffing:', '1 cup finely chopped onion', '1 garlic clove, minced', '2 tablespoons minced fresh sage or 2 teaspoons crumbled dried', '2 tablespoons unsalted butter', '3 tablespoons dry breadcrumbs', 'Pork chops, Kielbasa, and Sauerkraut:', '4 1-inch thick rib pork chops (about 1/2 pound each)', '1 tablespoon extra virgin olive oil', '1/2 pound kielbasa, cut diagonally into 3/4-inch-thick slices', '1 large onion, sliced', '1 1/2 to 2 pounds sauerkraut, drained, rinsed well, and drained again', 'Salt and pepper', '3/4 cup dry white wine', '1/2 cup chicken broth', '1 bay leaf', '2 tablespoon thinly shredded fresh sage leaves or 2 teaspoons crumbled dried', '1 tablespoon cornstarch dissolved in 2 Tbsp cold water', '1 tablespoon minced fresh parsley']",19,"['1 Make the stuffing: In a heavy skillet cook the onion, the garlic, and the sage in the butter over low heat, stirring, until the onion is softened. Remove the skillet from the heat, and stir in the breadcrumbs and salt and pepper to taste. Set aside.', '2 Stuff the pork chops: With a paring knife, make a 3/4-inch long horizontal incision along the fat side of each chop and cut a deep wide pocket in the chop by moving the knife back and forth carefully through the incision. Fill the chops with the stuffing. Pat the chops dry.', '3 Brown the chops: In a large dutch oven, heat the oil over medium high heat. Brown the chops on both sides, removing the chops from the pan to a plate when done.', '4 Add the kielbasa slices to the pan, browning them slightly on both sides, removing to another plate when done.', '5 Cook the onions: Pour off all but 1 Tbsp of fat. In the remaining fat cook the onion over medium heat, until softened.', '6 Layer sauerkraut, pork chops, kielbasa, sauerkraut, add wine, broth, bay leaf: Add half of the sauerkraut, spreading it to form a layer on the bottom on the pan. Cover the sauerkraut with the pork chops. Sprinkle on salt and pepper. Add the kielbasa. Spread the remaining sauerkraut over the chops and kielbasa. Add the wine, broth and bay leaf.', '7 Simmer: Bring the liquid to a simmer and simmer the mixture, covered for 1 1/2 hours, or until the chops are tender. Discard the bay leaf.', '8 Transfer the chops and the kielbasa to a plate; cover with foil and keep warm.', '9 Add sage and cornstarch mixture to sauerkraut: Add the sage to the sauerkraut mixture, bring mixture to a simmer. Add the cornstarch mixture to the sauerkraut. Stir, and simmer for 2 minutes.', '10: Serve: Spoon sauerkraut on to a large serving plate. Place the chops and kielbasa on top of the sauerkraut, sprinkle with fresh parsley.']",10
793,Honey-Mustard Sheet Pan Pork Chops Recipe,25,30,55,"['1 pound Brussels sprouts, halved or quartered, depending on the size (about 4 cups prepared)', '2 medium sweet potatoes, cut into 1/2-inch cubes (about 3 cups chopped)', '10 sprigs fresh thyme', '2 tablespoons vegetable oil', '1 1/2 teaspoons kosher salt', '1/4 teaspoon ground black pepper', '2 cloves garlic, grated or finely minced', '2 tablespoons Dijon mustard', '2 tablespoons honey', 'Four 1-inch thick center-cut loin pork chops (about 2 1/2 pounds)']",10,"['1 Preheat the oven to 400\\xcb\\x9aF.', '2 Toss the Brussels sprouts, sweet potatoes, thyme, oil, salt, and pepper together on a rimmed sheet pan. Make sure the vegetables are all evenly coated with oil.', '3 In a small bowl, mix together the garlic, mustard, and honey.', '4 Brush the pork chops with honey-mustard: Nestle the pork chops between the vegetables on the sheet pan. Brush both sides of the pork chops with half of the honey mustard sauce (reserve the remaining) and sprinkle with some salt and pepper.', '5 Bake the pork chops: Bake in the oven for 10 minutes. Brush both sides of the pork chops with the remaining honey-mustard sauce. Cook another 10 to 15 minutes, until the meat is cooked through and has reached an internal temperature of 145\\xcb\\x9aF.', '6 Serve: Divide the vegetables and pork chops between places and serve while hot.']",6
794,Pork Chops with Sweet and Sour Sauce Recipe,5,20,25,"['4 pork chops', 'Salt', 'Pepper', '1/2 cup of red currant jelly (or any red berry jelly, not jam)', '2 tablespoons of Dijon mustard', '1/4 cup cider vinegar or white vinegar']",6,"[""1 Pat dry pork chops and sprinkle with salt and pepper: Pat chops dry with a paper towel, they'll brown better. Sprinkle with salt and pepper."", '2 Brown the pork chops on both sides: Heat a large, stick-free skillet on medium high heat. Lightly brown the pork chops on both sides, for a minute or two each.', '3 Make the sauce: While the chops are browning, mix the red jelly with the mustard.', '4 Dollop sauce over pork chops: Once the chops are browned, reduce the heat of the pan to low. Dollop the sauce over the chops. Cover the pan. Cook for 5-10 minutes or until the pork is just cooked through (thick cuts may take longer).', ""5 Add vinegar, reduce the sauce: Remove the pork chops from the pan. Add vinegar to the pan. Increase the heat to high and boil down the sauce, scraping up any browned bits from the bottom of the pan. Add any juices that have come out of the chops while they've been sitting back to the pan."", 'Serve the pork chops with the sauce spooned over them.']",6
795,Sesame-Crusted Pork Cutlets with Crispy Shallots Recipe,25,20,45,"['For the dressing:  ', '6 tablespoons water', '2 tablespoons rice vinegar', '2 tablespoons red miso paste', '1 tablespoon low-sodium soy sauce', '2 teaspoons honey', '2-inch piece fresh ginger, peeled and finely chopped', '1 small clove garlic, finely chopped', '2 tablespoons olive oil', '1 tablespoon toasted sesame oil', 'For the crispy shallots:', '1/2 cup vegetable oil', '4 shallots', 'For the pork:', '2 large eggs', '1 1/2 cups Panko breadcrumbs', '1/2 cup sesame seeds', '1 teaspoon salt', 'Ground black pepper, to taste', '4 boneless pork chops, or 8 thin boneless cutlets (about 1 1/4 pounds)', '4 large handfuls (6 ounces) baby spinach leaves', 'Special equipment:', 'Mandoline, or very sharp knife', 'Small (8-inch) skillet', 'Large (12-inch) nonstick skillet']",25,"['1 Make the dressing: In a blender, blend the water, vinegar, miso, soy sauce, honey, ginger, garlic, olive oil and sesame oil until smooth and creamy. Set aside until you are ready to plate the cutlets.', '2 Make the crispy shallots: Using a mandoline or a very sharp knife, slice the shallots into very thin rings. Separate the rings with your fingers and press them between paper towels to extract as much moisture as you can before frying.', 'In a small (8-inch) skillet combine the oil and shallots. Place over medium heat and cook, watching carefully. The shallots will begin to bubble as they cook. Stir often, turning down the heat as necessary to keep the shallots from burning. Cook for 4 to 6 minutes, or until golden brown and most of the bubbling has stopped.', 'With a slotted spoon, transfer the shallots to paper towels to drain. Strain the oil through a fine meshed sieve to catch any small bits of shallot and set aside to for cooking the cutlets. (Any leftover oil from this recipe can be saved for other recipes.)', '3 Butterfly and pound the pork chops (if necessary, skip if using cutlets): If using thick boneless pork chops instead of packaged thin cutlets, butterfly and pound the chops flat (or ask the butcher to do it for you).', 'To butterfly, make a deep, horizontal cut in each pork chop, stopping about 1/4 inch from the edge. Open the chop like a book.', 'To pound, place each butterflied chop between 2 sheets of plastic wrap, and pound with a meat mallet or rolling pin to a thickness of 1/4-inch. Set on a baking sheet.', '4 Set up an assembly line for coating the cutlets: Crack the eggs into a pie pan or shallow bowl, and whisk vigorously. In a second pie pan or bowl, combine the panko, sesame seeds, salt, and pepper. From right to left on the counter, set the baking sheet of cutlets, bowl of beaten egg, and bowl of panko mixture in a line.', '5 Coat the cutlets: With tongs, dip one cutlet into the beaten eggs and lift it up so the excess falls back into the bowl. Transfer it to the bowl of panko and coat both sides. Return it to the baking sheet. Continue with the remaining cutlets until they are all coated.', '6 Cook the cutlets in batches: Over medium heat in a large nonstick skillet, heat about 1/4 inch of the reserved vegetable oil until hot. Place a clean sheet pan in the oven and heat the oven to 250\\xc2\\xbaF.', 'Add 2 or more cutlets to the pan in a single layer (leave room between them so they are not crowded.) Cook for 4 minutes, or until golden on the underside. Turn and cook on the other side for 4 minutes, or until golden.', 'Transfer to the oven to keep warm while you finish cooking all the cutlets and dress the spinach.', '7 Assemble the cutlets and spinach: Toss the spinach with a tablespoon or two of dressing, to taste. Divide between plates.', 'Cut the chops in half if they are large, and set one on top of each plate of the spinach. Sprinkle with the crispy shallots and drizzle a little of the leftover dressing on each plate. (Any remaining dressing can be kept refrigerated for a week or so.)']",14
796,Pan-Seared Pork Chops with Garlic and Greens Recipe,5,500,505,"['For the brine', '5 cups water', '4 tablespoons sugar', '3 tablespoons kosher salt', '3 bay leaves, broken into pieces', '1/2 teaspoon coriander seed, lightly crushed', '1 sprig thyme', '4 wide strips of lemon peel, made with a vegetable peeler', 'For the chops', '4 (1- to 1 1/4-inch thick) rib pork chops, preferably bone-in (8 to 9 ounces each)', '2 tablespoons olive oil', '3 cloves garlic, smashed and peeled', '8 to 12 sage leaves', '4 (1/4-inch thick) lemon slices', 'For the greens', '4 big handfuls stemmed greens (chard, kale, or mustard greens), coarsely chopped (about 8 ounces once prepped), rinsed, even if \\xe2\\x80\\x9cprewashed\\xe2\\x80\\x9d and prepackaged.']",16,"['1 Brine the pork chops at least 8 hours ahead of time:  In a small saucepan combine 1 cup of the water, sugar, salt, bay leaves, coriander seed, thyme, and lemon peel. Bring to a simmer over medium heat, stirring to dissolve the salt and sugar. Remove from heat.', 'Fill a 4-cup measuring cup with 2 to 3 cups of ice cubes and add enough cold water to measure 4 cups. Add to the saucepan with the brine and stir until the ice has melted (this helps to quickly cool the brine).', 'Place the chops in a 1-gallon zipper freezer bag. Place the bag in a bowl and pour the cooled brine into the bag. Seal the bag and refrigerate for 8 hours, or for up to 2 days.', '2 Cook the chops: When ready to cook, remove the chops from the brine and pat them dry with a paper towel. Set another paper towel on a small plate for the sage leaves and lemon slices.', 'In a large skillet over medium heat, heat the oil. Add the chops and cook them for 2 minutes on a side, or until starting to brown. Continue to cook the chops, turning about every minute, for about 4 to 6 minutes longer, or until the chops are deep golden brown and an instant-read thermometer inserted into the thickest part registers 135\\xc2\\xbaF.', 'Total cooking time is 8 to 10 minutes, depending on the thickness of chops.', '3 Rest the chops: Transfer the chops to a plate, cover loosely with foil to keep warm and let rest for at least 5 minutes. The temperature of the chops will tick up to 145\\xc2\\xb0F, the recommended temperature for cooked pork, as it sits.', '4 Cook the sage leaves, garlic, and lemon: Pour off all but 3 tablespoons of fat from the pan. Return the pan to the heat and add the sage leaves, garlic, and lemon slices to the pan.', 'Tilt the skillet so the pan drippings are on one side and move the sage leaves to the drippings. Fry the leaves for 20 to 30 seconds, or until crisp. Transfer them to the paper towel-lined plate.', 'With the pan flat on the burner, continue cooking the garlic and lemon slices, turning often, for another 2 to 3 minutes, or until the lemon slices are charred.', 'Transfer the garlic and lemon slices to the paper towel-lined plate with the sage leaves. Discard the garlic and save the lemon slices to garnish the chops.', '5 Cook the greens. With the pan over medium-high heat, add the greens along with any water still clinging to the leaves. Cook, turning often, for 3 to 4 minutes, or until wilted.', '6 Serve the chops. Divide the greens between the plates. Place a pork chop atop the greens, a lemon slice, and some crispy sage leaves, and serve.']",13
797,Easy Smothered Pork Chops Recipe,15,25,40,"['2 tablespoons vegetable oil or lard', '4 center-cut pork loin chops, cut 1-inch thick (about 3 pounds)', '2 teaspoons kosher salt', '1 teaspoon ground black pepper', '1 large yellow onion, halved and sliced 1/2-inch thick', '2 cloves of garlic, thinly sliced', '3 tablespoons all-purpose flour', '3 cups beef stock', '1/4 cup heavy cream', '2 sprigs fresh rosemary']",10,"['1 Season and sear the pork: In a large (12 to 14-inch) skillet set over medium-high heat, add the oil. While the oil is heating, sprinkle one side of the pork chops with salt and pepper.', 'Place the chops into the hot pan, seasoned side down, and sear for 4 minutes, or until they are a dark, golden brown. While the first sides are searing, season the top side with more salt and pepper. Flip the chops over and cook for another 4 minutes. Transfer the chops from the pan to a platter. You may have to do this in batches for a good sear.', '2 Saut\\xc3\\xa9 the vegetables: Add the onion and garlic to the pan and cook them over medium heat, stirring frequently for 3-4 minutes or until they are softened and become a deep golden color.', '3 Make the roux: Once the onions and garlic are cooked down but still a little glossy, sprinkle flour over the veggies. If the onions aren\\xe2\\x80\\x99t glossy, add 1 tablespoon of oil before adding the flour. Cook the flour for one minute to remove the raw, starchy taste from it.', 'Add 1/4 cup of beef stock to the pan and use your spoon to scrape up the browned bits from the bottom of the pan. The mixture will look like a very thick paste at this point.', '4 Finish making the gravy: Combine the cream with the rest of the beef stock and pour this liquid into the pan. Add the rosemary sprigs and bring the mixture up to a gentle simmer, stirring frequently, until thickened.', '5 Return the chops to the pan to finish cooking: Nestle the pork chops into the simmering gravy, then cover the pan. Allow the chops to simmer in the thickened gravy for 10 minutes, or until their internal temperature reaches at least 145\\xc2\\xb0F and no higher than 165\\xc2\\xb0F.', '6 Serve the chops: Place the pork chops over a bed of mashed potatoes and smother them in the onion gravy.']",8
798,Cuban Sandwich (Cubano) Recipe,15,10,25,"['1-pound loaf Cuban or Italian bread', '2 tablespoons unsalted butter, softened', '1 small clove garlic, crushed', '2 tablespoons yellow mustard', '8 ounces thinly sliced Swiss cheese, about 10 slices', '1 pound shredded pork roast, heated until warmed through', 'sliced dill pickles, as needed', '10 slices Black Forest or smoked ham', 'To serve:', 'Potato chips', 'Dill pickles']",11,"['Grill the Cubano for 5-6 minutes on one side before carefully flipping the sandwich and grilling for another 5-6 minutes on the other side. If you\\xe2\\x80\\x99re using a panini press, grill for 6 minutes total, or until the cheese is melted.', 'When ready the Cubano should have a flat, crispy, slightly dark brown, top and bottom, and the cheese should be melted.', '6 Serve: Remove your sandwich from the skillet or griddle. Slice your sandwich according to the number of guests you need to serve and serve the sandwich with a handful of chips and a pickle or two.', 'LEFTOVERS! Leftovers should be wrapped in foil and stored in the refrigerator. They may be reheated by cooking the same as above.']",4
799,Cuban-Style Roast Pork,15,210,225,"['6-8 pound bone-in Boston butt or pork shoulder', 'For the mojo marinade:', '1 head garlic (about 10 cloves), peeled', '1 large white onion, roughly chopped', '1 1/2 tablespoons dried oregano', '1 tablespoon kosher salt', '1 1/2 teaspoons ground black pepper', '1 teaspoon ground cumin', '1 cup grapefruit juice, from 1 medium grapefruit', '3/4 cup fresh lime juice, from about 8 limes', '1/2 cup fresh orange juice, from 1 medium orange', '1/4 cup white vinegar', '1/4 cup extra virgin olive oil', '1 tablespoon cornstarch, to finish the mojo sauce', 'Special equipment:', 'Food processor or blender']",16,"['1 Prepare the mojo marinade: To your blender or food processor add the garlic cloves, chopped onion, dried oregano, salt, pepper, cumin, grapefruit, lime, and orange juices, vinegar, and olive oil.', 'Blend or puree the ingredients together on medium speed until the garlic and onions are very fine\\xe2\\x80\\x94almost resembling a soupy paste.', 'Reserve 1 1/2 cups of the mixture for the sauce and set it aside. You will use what remains to marinate the pork.', '2 Marinate the pork: Take your Boston butt and make 1-inch-wide slits, 4 inches deep into the meat (be careful not to hit the bone too hard with your knife). This will help the marinade penetrate the inner part of the roast.', 'Place the pork in a bowl or dish large enough to hold the meat. Pour the mojo marinade that\\xe2\\x80\\x99s still in your blender or food processor over the pork. Give the pork a turn to coat it in the marinade and cover the dish.', '3 Transfer to the refrigerator: Marinate the pork for 4-12 hours in the refrigerator. If the pork is not fully covered in the marinade, turn it over during the marinating time to make sure it\\xe2\\x80\\x99s getting all it can from the mojo. Because I usually begin marinating my pork roast the evening before cooking it, I usually turn it in the morning after it\\xe2\\x80\\x99s marinated overnight.', '4 Heat the oven to 350\\xc2\\xb0F.', '5 Roast the pork: After the meat has marinated, transfer it to a roasting pan (with or without a rack). Roast the pork, uncovered, for 3 1/2 hours or until a thermometer inserted in the fleshiest part, not touching the bone, reads 165\\xc2\\xb0F.', '6 Rest the meat: When the roast is ready, remove it from the oven. The top will be beautifully caramelized from the sugars and the aromatics that were in the mojo. Loosely cover the roast with a large piece of aluminum foil and allow it to rest for 15 minutes while you heat the reserved 1 1/2 cups of mojo sauce.', 'Mojo is pungent and can be overwhelming in its raw form. To serve it as a sauce, it\\xe2\\x80\\x99s best to cook it to soften the harshness a bit.', '7 Make a slurry: In a small bowl, combine the cornstarch and 1 tablespoon from the reserved mojo and stir together until no lumps of cornstarch remain.', '8 Heat and thicken the mojo sauce: Pour the mojo sauce and the cornstarch slurry into a small saucepan and bring it to a boil over medium heat while stirring frequently.', 'Once the mixture begins to boil, lower the temperature and allow the sauce to simmer for 5-6 minutes while stirring occasionally. Allowing the mojo to simmer will mellow out the garlic and onion flavors considerably. The sauce is ready when it reaches the consistency of maple syrup.', 'Transfer the sauce to a serving bowl. The mojo sauce may be served hot, cold, or at room temperature.', '9 Serve the roast pork and sauce: After the pork has rested, which allows the juices to settle down and not run everywhere when you cut it, use a carving knife to slice the roast. Serve it with a side of rice and beans and plantains. Pour the sauce over the sliced portions of pork after serving.', 'LEFTOVERS! Leftovers may be refrigerated for 2-3 days and reheated in the microwave or, my favorite way, by lightly saut\\xc3\\xa9ing in a skillet with a bit of mojo sauce until warmed through.  Any leftover mojo sauce should be covered and stored in the refrigerator.']",16
800,Pork Medallions with Mustard-Caper Sauce Recipe,5,15,20,"['1 lb pork tenderloin, any outer connective tissue removed, cut crosswise into 1/2-inch-thick rounds', '2 Tbsp butter', '1/2 cup sliced shallots', '2 cups low-salt chicken broth', '1/4 cup whipping cream', '3 Tbsp rinsed and drained capers', '2 Tbps Dijon mustard']",7,"['1 Flatten tenderloin rounds to an even thickness: If the tenderloin rounds are not an even thickness, use a rolling pin or mallet to flatten them to an even 1/2-inch thickness. Sprinkle with salt and pepper.', '2 Brown tenderloin medallions: Melt butter in heavy large skillet over medium-high heat. Add the tenderloin medallions to the pan and saut\\xc3\\xa9 them until browned and just cooked through, about 2 minutes per side. Remove the medallions from the pan to a plate while you make the sauce.', '3 Make sauce: Add the shallots to the pan and cook for a minute, stirring. Add the cream and chicken broth. Increase heat to a boil and boil until the sauce has thickened a bit, about 3 to 5 minutes. Scrape up any browned bits from the bottom of the pan.', 'Stir in the mustard and capers.', '4 Return pork to pan: Return the pork to the pan and simmer until the pork has reheated.', 'Season to taste with salt and pepper. Serve immediately.']",6
801,Chipotle Citrus Marinated Pork Tenderloin Recipe,5,55,60,"['2 pork tenderloins, about 1 pound each, halved crosswise', '1 cup orange juice', '6 tablespoons fresh lemon juice', '6 cloves garlic, smashed', '2 shallots, chopped', '2 dried chipotle chilies, crushed, or 1 Tbsp chipotle powder', '1 tablespoon extra virgin olive oil', 'Kosher salt and freshly ground black pepper', '3/4 cup chicken stock', '2 tablespoons chopped fresh cilantro']",10,"['1 Prep and marinate tenderloins: Trim the tenderloins of any excess fat and silver skin. Set in a small nonreactive baking dish.', 'Combine the orange juice, lemon juice, garlic, shallots and chipotle chilies in a small bowl and stir well.', 'Pour over the tenderloins and let sit for 20 minutes at room temperature.', '2 Preheat oven to 400\\xc2\\xb0F.', '3 Sear tenderloins on all sides: Heat the olive oil in a large, ovenproof skillet over medium-high heat. Remove the tenderloins from the marinade, reserving the marinade. Wipe the tenderloins dry with a paper towel and season with salt and pepper.', 'Add to the skillet and cook, turning as needed, for 4 to 5 minutes, until evenly browned.', 'Transfer to the oven and roast for 10 to 12 minutes, until an instant-read thermometer inserted into the center reads 140-145\\xc2\\xb0F.', 'Remove skillet from oven and transfer the tenderloins to a plate and cover loosely with aluminum foil to keep warm. Remember that the skillet handle is still hot after you put the skillet on the stove top. Use oven mitts or cool off the handle with ice.', '5 Make sauce: Pour the marinade into the skillet and add the chicken stock. Bring to a boil over high heat and cook for 8 to 10 minutes, until reduced and thickened. Pour through a fine-mesh sieve into a bowl.', '6 Cut tenderloins across the grain into thin slices and arrange on a platter. Drizzle sauce over top and sprinkle with cilantro. Serve.']",10
802,Pork Tenderloin with Figs and Olives Recipe,15,155,170,"['1/4 cup red wine vinegar', '2 teaspoons sugar', '1/2 teaspoon salt', '1/2 teaspoon black pepper', '4 cloves garlic, minced (about 4 teaspoons)', '1 teaspoon dried oregano', '1 tablespoon capers', '1 teaspoon caper juice', '3/4 cup pitted green olives, halved', '6 dried figs, quartered', '2 bay leaves', '1/3 cup plus 1 tablespoon extra virgin olive oil', '1 1/4 pound pork tenderloin', '1/2 cup white wine', '2 tablespoons brown sugar']",15,"['1 Make the marinade: Pour the red wine vinegar into a medium bowl and stir in the sugar and salt until dissolved.', 'Add the minced garlic, oregano, pepper, capers, caper juice, figs, green olives, and bay leaves, and stir to combine.', 'Stir in the olive oil.', '2 Prep and marinate the tenderloin: Using a very sharp knife, carefully cut away and discard any tough silver skin on the outside of the tenderloin. Cut the tenderloin in half crosswise.', 'Place the two tenderloin halves into a freezer bag or a bowl. Pour the marinade over the tenderloin halves and coat well.', 'Chill for 2 to 24 hours (the longer the better).', '3 Sear the tenderloin: Remove the tenderloin halves from the marinade, wiping off any excess, reserving the marinade.', 'Heat 1 Tbsp olive oil in a large saut\\xc3\\xa9 pan on high heat. Pat dry the tenderloin halves with a paper towel and place in hot pan. Sear on all sides until nicely browned. Remove from pan and place in a baking dish.', '4 Preheat oven to 350\\xc2\\xb0F.', '5 Deglaze pan and heat marinade: Pour half a cup of white wine into the hot skillet and scrape up any browned bits with a spatula.', 'Add the marinade to the pan with the wine and let come to a full boil.', '6 Bake: Pour the marinade over the tenderloin in the baking dish and arrange on all sides of the tenderloin.', 'Sprinkle with 2 Tbsp brown sugar.', 'Cover with foil and bake at 350\\xc2\\xb0F for 10 minutes. Then remove the foil and bake for an additional 10 minutes or until the internal temperature of the tenderloin is 135\\xc2\\xb0 to 140\\xc2\\xb0F. (The internal temp will continue to rise while the pork rests in the next step.)', '7 Let rest: Transfer the tenderloin halves from the dish to a cutting board and tent with foil. Let rest for 10 minutes.', '8 Slice and serve: Slice into 1/4-inch thick rounds (a bread knife works well for this). Serve with figs, olives, and juices from the baking dish. Terrific with couscous.']",16
803,Grilled Pork Tenderloin and Peaches Recipe,30,15,45,"['1 pork tenderloin', 'Extra virgin olive oil', '1 teaspoon kosher salt', '1 tablespoon herbes de Provence', '1-2 yellow peaches or nectarines, quartered or cut into thick slices']",5,"['1 Prep the tenderloin: Coat the tenderloin with olive oil, then sprinkle with salt. Roll the tenderloin in the herbes de Provence and set aside at room temperature for 30 minutes.', '2 Prepare the grill: Prepare your grill for high direct heat on one side, and low heat on another side. A tenderloin is thick on one end and thin on the other. You will want to cook the thinner end on the cooler side of the grill while the thicker end is on the hot part o the grill.', '3 Grill the tenderloin: Grill the tenderloin until until a meat thermometer inserted into the center of the thickest part reads 135\\xc2\\xb0F, about 5 minutes per side. Remove and let rest while you cook the peaches.', '4 Grill the peaches: Paint the peaches with a little olive oil and grill on high direct heat for 1-2 minutes per side, just enough to get some good grill marks.', '5 Serve: Slice the tenderloin into 1/4-inch pieces and drizzle any juices released from the cutting the meat over them. Serve hot with the peaches.']",5
804,Pork Tenderloin with Figs and Onions Recipe,15,25,40,"['2 pork tenderloins, about a pound each', 'Salt', '2 tablespoons extra virgin olive oil', '2 tablespoons butter', '1 white or yellow onion', '1 teaspoon sugar', '1 teaspoon balsamic vinegar', '2 teaspoons fresh rosemary, minced', '8-10 mission (dark) figs, quartered', '2 tablespoons chopped parsley', '1-2 teaspoons lemon juice', 'Black pepper']",12,"['1 Salt the pork tenderloins well and set them out at room temperature for 15-20 minutes. Heat the oven to 300\\xc2\\xb0F.', '2 Slice the onion into strips lengthwise (from the top to the root end). Cutting the onion this way helps keep the pieces hold their shape. (See How to caramelize onions for a visual).', '3 Sear tenderloins on all sides: Heat 2 tablespoons of olive oil and 1 tablespoon of the butter in a saut\\xc3\\xa9 pan over medium-high heat. Pat the tenderloins dry with paper towels. Place the tenderloins in the pan and sear on all sides, until nicely browned.', '4 Finish cooking tenderloins in oven: Remove the tenderloins to an oven-proof pan, and place in the oven at 300\\xc2\\xb0F. Cook for 15-20 minutes, until an instant read thermometer inserted into the center of the tenderloins reaches 140\\xc2\\xb0F. Then remove from oven and let rest.', '5 Saut\\xc3\\xa9 onions, add sugar and balsamic: While the tenderloins are roasting, add the onions to the saut\\xc3\\xa9 pan along with the other tablespoon of butter. Sprinkle with salt. Toss to combine and saut\\xc3\\xa9 for 3-4 minutes.', 'Add the sugar and balsamic vinegar, and toss to combine again. Reduce the heat to medium-low and cook for 15 minutes.', '6 Add rosemary and figs: Once the onions have softened and browned, add the rosemary and figs. Increase the heat to medium-high and stir to combine. Saut\\xc3\\xa9 2 minutes, stirring often.', '7 Remove from the heat. Mix in the parsley and lemon juice. Add salt and pepper to taste.', '8 Slice the pork tenderloins into 1/4-inch thick slices and serve alongside the onions and figs.']",9
805,Leftover Turkey Pot Pies Recipe,10,35,45,"['4 tablespoons unsalted butter', '1/2 cup diced sweet onion', '1/2 cup diced carrots', '1/2 cup diced celery', '2 cups chopped cooked turkey', '1/4 teaspoon salt', '1/4 teaspoon black pepper', '2 tablespoons all-purpose flour', '1 1/2 - 2 cups chicken or turkey stock', '1/2 cup frozen sweet peas', '1/2 teaspoon fresh thyme (optional)', '2 9-inch pie crusts, store-bought or homemade', '1 egg + 1 tablespoon water, whisked, for brushing', 'Special equipment:', 'Ramekins, any size']",15,"['1 Preheat oven to 350\\xcb\\x9aF.', '2 Cook the pot pie base: Add the butter to a large skillet over medium heat. Once the butter has melted, add onions, carrots, and celery. Cook for 3-4 minutes until the vegetables start to soften. Stir in chopped turkey and season with the salt and pepper.', '3 Make the gravy: Add flour to the filling and stir until the mixture is smooth. Cook for a minute or two to cook out the flour taste. Then slowly whisk in the stock to form a light gravy. If the gravy seems too thick, add more stock or water by the 1/4 cup.', '4 Add peas and thyme: When gravy is done, add peas and fresh thyme and remove from heat.', '5 Fill the ramekins: Divide the pot pie filling between ramekins. Fill ramekins up about 3/4 of the way full to prevent overflowing. (You can use any size or shape of ramekin. Round works best, but oblong is okay as well and you get more crust with that shape.)', '6 Cover with pie crust and brush with egg wash: Cover ramekins with a top piece of pie crust, either store-bought or homemade. Crimp the edges well and poke a few holes in the center of the pie crust to let steam escape. Brush with egg wash.', '7 Bake the pot pies: Bake the turkey pot pies at 350\\xcb\\x9aF for 20-25 minutes, or until the crust is golden brown around the edges and in the center. Let the pot pies cool for a few minutes before serving.', 'Leftover pot pie will keep well in the fridge for up to five days. Reheat them in a 350\\xc2\\xb0F oven until warmed through and piping hot.']",8
806,Vegetable Pot Pie Recipe,30,40,70,"['1 package (2 sheets, 17.3 ounces) puff pastry sheets, thawed', '1/3 cup unsalted butter', '1 cup diced red onions, 1/4-inch dice', '1 cup diced carrots, 1/4-inch dice', '1/2 cup diced celery, 1/4-inch dice', '1 tablespoon minced garlic', '1/2 teaspoon dried thyme', '8 ounces sliced brown mushrooms', '1 1/2 pounds russet potatoes, 1/4-inch dice', '1 teaspoon kosher salt', '1/2 teaspoon black pepper', '1/3 cup flour', '1 1/2 cups vegetable stock', '1 cup whole milk, plus 1 tablespoon for egg wash', '1 cup peas', '1 tablespoon chopped parsley', '1 large egg, whisked']",17,"['1 Prepare the puff pastry: Thaw the puff pastry overnight in the fridge. If you forget, you can thaw it on the counter: Remove the frozen pastry from its packaging and defrost on a sheet tray until cool but pliable, about 40 minutes. Meanwhile, prepare the vegetable filling.', ' 2 Cook the vegetables: Set a large skillet or Dutch oven over medium heat. Add the butter to the pot. Once melted, add the onions, carrots, celery, garlic, and thyme.', 'Saut\\xc3\\xa9 until onions are tender and translucent, 3 minutes. Add mushrooms, stir and cook for 1 minute. Add potatoes, 1 teaspoon salt, and 1/2 teaspoon black pepper. Stir and cook for 7 minutes.', '3 Make the gravy and finish the filling: Sprinkle flour over the vegetables, stir and cook, to reduce the raw flour taste, about 2 minutes.', 'Slowly pour in the vegetable stock and milk, stirring constantly until the gravy is smooth. Allow the gravy to simmer until slightly thickened and potatoes are tender but not falling apart, about 5 to 6 minutes.', 'Stir in and combine the peas and parsley. Taste the vegetable pot pie filling, season with more salt and pepper as desired.', '4 Preheat the oven and fill the ramekins: Heat your oven to 400\\xc2\\xb0F. Evenly divide the filling among ramekins, about 3/4 cup of filling per serving.', '5 Cut the puff pastry: Trim 1/4-inch around the edges of the puff pastry; this will help it look neat and allow the pastry to puff a little better. Cut each pastry sheet into four 4-inch squares, making 8 squares total. Place one square pastry sheet over each ramekin, allowing the edges to hang over the sides. Make 4 small slits in the top (1/2-inch long).', '6 Bake the vegetable pot pies: In a small bowl, whisk together egg and 1 tablespoon of milk. Brush the top and sides of the puff pastry with egg wash. Sprinkle with salt and pepper.', 'Once your oven reaches 400\\xc2\\xb0F, place the ramekins on the baking sheet. Bake until the puff pastry is puffed up and golden brown in color, 15 minutes.']",10
807,Moroccan Pot Roast Recipe,20,150,170,"['For the spice mix', '2 cloves garlic, minced', '2 teaspoons crushed coriander seed', '1 teaspoon ground turmeric', '1 teaspoon ground ginger', '1 teaspoon ground cumin', '1 teaspoon ground cinnamon', '1 teaspoon paprika', '1/4 to 1/2 teaspoon (to taste) crushed red pepper flakes (or if available, Marash or Aleppo pepper*)', 'For the beef', '1/4 teaspoon salt', '1/8 teaspoon freshly ground black pepper', '2 tablespoons olive oil', '1 (3-pound or 1.35 kg) beef chuck roast', '1 medium onion, quartered', '3 carrots, cut into 2-inch chunks', '2 bay leaves', '1 cup (235 ml) water', '1 cup (235 ml) pomegranate juice', '2 tablespoons lemon juice', '1/4 cup loosely-packed chopped fresh parsley', 'For serving (optional)', 'Couscous', 'Glazed carrots', '*Aleppo pepper from Syria is bright red, slightly chocolaty, fruity, and medium hot. Maras pepper is from Turkey and is slightly hotter than Aleppo, yet still mild, with smokey overtones. Both are a fun addition to your spice cabinet. Sprinkle the deep red flakes on hummus, or perk up roasted vegetables with them. Look for the pepper in specialty food shops or Middle Eastern grocery stores.', 'Special equipment:', '6-quart Dutch oven, or other large oven-safe pot with a lid']",27,"['1 Make the spice mix: In a small bowl, stir together the garlic, coriander, turmeric, ginger, cumin, cinnamon, paprika and pepper.', '2 Heat the oven: Set an oven rack near the bottom of the oven. Preheat the oven to 325\\xc2\\xbaF (or 160\\xc2\\xb0C).', '3 Season and sear the meat, then add vegetables, spices: Sprinkle the roast all over with salt and pepper.', 'In a large Dutch oven or other oven-safe pot with a lid, heat the oil. Add the beef and brown it on all sides, about 4 minutes per side.', 'Add the onion, carrots and bay leaves to the pot. Stir in the spice mix.', '4 Braise the meat: Add the water and pomegranate juice to the pot and bring to a simmer. Cover the pot and place in a 325\\xc2\\xb0F (or 160\\xc2\\xb0C) oven for 2 1/2 hours, turning once halfway through the cooking time.', 'When the meat is fork tender, remove it from the oven. (If it is not tender enough, leave it in a little longer.)', '5 If serving with couscous and glazed carrots, prepare these when the pot roast is close to being done.', '6 Finish the sauce: Transfer the meat to a platter and cover loosely with foil.', 'Set a strainer over a bowl and pour the sauce through. Press on the solids to extract as much liquid as possible. Discard the solids and skim off the fat from the liquid. Add the lemon juice and taste. Add more salt and pepper, if you like.', '6 Serve the pot roast: Slice the meat and serve in shallow bowls on top of the couscous and carrots. Ladle the sauce over the meat and sprinkle with parsley.']",11
808,Instant Pot Pot Roast with Balsamic and Rosemary Recipe,10,105,115,"['One (2 1/2 to 3-pound) boneless beef chuck pot roast', '2 teaspoons salt', '1 teaspoon ground black pepper', '1 tablespoon vegetable oil', '1 jumbo (12-ounce) onion, sliced', '4 cloves garlic, chopped', '2 (4-inch) sprigs fresh rosemary', '3/4 cup beef broth or vegetable broth', '1/4 cup aged balsamic vinegar', '1 1/2 pounds new potatoes (halved if over 1 1/2 inches in diameter, quartered if even larger)', '1 pound baby carrots (or regular carrots, peeled and cut into 1/2-inch rounds)', '1 tablespoon chopped fresh parsley, for serving (optional)', 'Special equipment:', '6-quart electric pressure cooker, such as the Instant Pot', 'Fat separator']",15,"['1 Dry and season the roast: Place the roast on a dish and pat it dry with a paper towel. Season it all over with the 1 1/2 teaspoons of salt and pepper.', '2 Sear the pot roast on the top and bottom: Select the Saut\\xc3\\xa9 setting on your electric pressure cooker and heat the oil for 3 minutes, until the oil is shimmering. Using a pair of tongs, lower the pot roast into the pot and sear it for 4 minutes on top and bottom (8 minutes total), until browned. Transfer the pot roast back to the dish.', '3 Cook the onions and seasonings: Add onions and 1/2 teaspoon of salt to pot and saut\\xc3\\xa9 them for about 3 minutes, until they are a bit softened. Add the garlic and rosemary and saut\\xc3\\xa9 1 minute more, until the garlic is no longer raw. Add the beef broth and balsamic vinegar, then use a wooden spoon to nudge any browned bits from the bottom of the pot.', '4 Pressure cook the roast: Use the tongs to lower the pot roast back into the pot, and spoon some of the cooking liquid over the top of the roast.', 'Secure the lid on your pressure cooker in its Sealing position. Cancel the Saut\\xc3\\xa9 program, then select the Manual or Pressure Cook program for 55 minutes at high pressure. (It will take about 5 minutes for the pot to come up to pressure before the cooking program begins.)', '5 Release the pressure: When the cooking program ends, let the pressure release naturally for at least 15 minutes, then move the pressure release valve from to Venting to release any remaining steam. ', 'You can also leave the pot roast on the Keep Warm setting for up to 10 hours. You do not need to vent the steam.', '6 Rest the pot roast: Open the pot and use the tongs to transfer the roast to a cutting board. Cover the roast with aluminum foil to keep it warm.', ""7 Strain the cooking liquid: Set a strainer over a fat separator in the sink. Wearing heat-resistant mitts, lift the inner pot out of the pressure cooker housing and pour the cooking liquid through the strainer and into the fat separator. (If you don't have a fat separator, you can pour the liquid into a ziplock bag, tilt it, let the fat rise to the top. Then, cut a hole in the bottom corner of the bag to let the liquid strain out, stopping before you get to the fat.)"", 'Discard the rosemary stems, then add the strained onions, garlic, and rosemary leaves back to pot. Pour the liquid from fat separator back into the pot as well. Discard the fat.', '8 Pressure cook the vegetables: Add the potatoes and carrots to the pot and place it back in its housing. Secure the lid in its Sealing position.', 'Cancel the cooking program, then select the Manual or Pressure Cook program for 5 minutes at high pressure. (It will take about 15 minutes for the pot to come up to pressure before the cooking program begins.)', '9 Release the pressure: When the cooking program ends, perform a quick pressure release by moving the pressure release valve to Venting to release the steam.', '10 Serve: Open the pot, then use a slotted spoon to transfer vegetables to serving dish. Taste the cooking liquid for seasoning, adding salt and/or pepper if needed.', 'Remove any string from the pot roast, then carve it into 1/2-inch thick slices. Arrange the pot roast on the serving plate with the vegetables. Ladle some of the cooking liquid over the meat and vegetables, garnish with parsley (if using), and serve.']",15
809,Dad\xe2\x80\x99s Potato Salad Recipe,10,20,30,"['3 or 4 mid sized Russet potatoes, peeled and cut into 1-inch chunks', '4 Tbsp juice from Kosher dill pickles', '3 Tbsp finely chopped dill pickles', '1/4 cup chopped parsley', '1/2 cup chopped red onion', '2 stalks celery, chopped', '1 or 2 chopped scallions, including the greens', '1-2 hard boiled eggs, chopped (optional)', '1 medium carrot, finely chopped (optional)', '1/2 red bell pepper, raw or roasted, chopped (optional)', '1/2 cup mayonnaise', '2 teaspoons Dijon mustard', 'Kosher salt and freshly ground black pepper to taste']",13,"['1 Boil the peeled, cut potatoes: Place peeled, cut potatoes in a large pot. Cover with an inch of salted water. Bring a pot of water to boil.', 'Simmer for 10-20 minutes until just fork tender. Remove the potatoes from pot. Let the potatoes cool enough to handle, but still warm.', '2 Put potatoes in a bowl, add pickle juice, pickles, parsley, onions celery, scallions, hard boiled egg, carrots, bell pepper: Put the potatoes in to a large bowl. Add the juice from the Kosher dill pickles.', 'Add the finely chopped pickles themselves. Add parsley, onions, celery, scallions and, if using, the hard boiled egg, carrots, and red bell pepper.', '3 Mix mayonnaise and mustard, stir into potato mixture, add salt and pepper: In a separate small bowl, mix mayonnaise with mustard. Add salt and pepper to taste.', 'Mix in the dressing with the potato mixture. Again, salt and pepper to taste.']",6
810,Classic Potato Salad,15,30,45,"['2 pounds Yukon Gold potatoes (you can leave the peel on if you want), cut into 1-inch pieces', '6 slices bacon', '3/4 cup sour cream', '1/4 cup mayonnaise', '2 teaspoons mustard (your favorite: yellow, Dijon, stone ground)', '1/2 cup thinly sliced green onions', '1/2 cup chopped celery', '1/4 cup chopped parsley', '2 dill pickles, chopped into 1/4 in cubes (about 3/4 cup)', 'Coarse salt', 'Freshly ground pepper']",11,"['1 Cook the potatoes: In a large pot, cover potatoes with cold, salted water (1 teaspoon salt). Bring to a boil, reduce heat to a simmer.', 'Simmer until the potatoes are tender when pierced with a fork, about 20 minutes. Drain, and rinse with cold water to stop the cooking. (If you want, add some pickle juice to the drained, still slightly warm potatoes. The potatoes will absorb some of the juices, making them even tastier!)', '2 Meanwhile, cook the bacon: Heat a frying pan on medium low. Lay out the strips of bacon in a single layer. Gently cook, turning over occasionally with tongs, until lightly browned, and much of the fat rendered out.', 'Place on a plate lined with paper towels to soak up the excess fat. Do not pour any fat from the pan down the drain, it will clog it. Instead, pour it into a jar, or sop up with paper towels and discard.', 'Once cool, chop the bacon finely.', '3 Assemble the potato salad: In a large bowl, whisk together the sour cream, mayonnaise, and mustard. Add a little salt and pepper.', 'Add the potatoes and use a rubber spatula to gently combine with the sour cream mixture. Add the green onions, celery, parsley, pickles, and bacon, again gently combining. (Include a couple tablespoons of the pickle juice for good measure.) Season to taste with salt and pepper.']",7
811,Mediterranean Potato Salad Recipe,20,40,60,"['4 pounds small new potatoes or fingerling potatoes, scrubbed clean', 'Salted water (1 1/2 teaspoons salt for every quart of water) for cooking the potatoes', '1 pound of fresh, tender green beans, trimmed and cut into 1-inch pieces (4 cups prepped green beans)', '3 large roasted red bell peppers*, core removed, flesh cut into 2 x 1/4-inch strips (about 2 cups, or a 16 ounce jar, drained)', '3/4 cup minced red onion', '1 cup minced, pitted Kalamata and green olives (mini-chopper works well for this)', 'A large handful of fresh Italian parsley leaves, roughly chopped', 'A large handful of fresh baby arugula leaves', ' Dressing:', '2 Tbsp whole grain mustard', '1/3 cup red wine vinegar', '1 teaspoon dried tarragon (or herbes de provence)', '1/2 teaspoon salt', '1/3 cup extra virgin olive oil', '* To roast bell peppers, rub with a little olive oil, place on an aluminum foil-lined roasting pan under a broiler, broil until all sides are completely blackened, turning as needed. Place the blackened bell peppers in a bowl and cover with a plate until they cool. Then peel off the blackened bits. For more details on various methods to roast bell peppers see: Marinated Roasted Bell Peppers.']",15,"['1 Boil the potatoes: Place whole potatoes in a large pot, cover with cold water, an inch above the level of the potatoes. Add salt (1 1/2 teaspoons for every quart of water used). Bring to a simmer on high heat, then reduce heat to maintain a simmer.', 'Cook for 10 to 15 minutes (or more, depending on the size of the potatoes), until pierced easily with the tines of a fork or a sharp knife. Check frequently for doneness.', 'Once done, drain and place potatoes on a sheet pan to cool. Let cool to room temperature or slightly warm. (You can speed up cooling by placing in the refrigerator if you have space.)', '2 Blanch the green beans: While the potatoes are cooking, bring another pot of salted water to a rolling boil (2 quarts of water, 1 Tbsp salt). Add the green beans.', 'Blanch for 4 to 5 minutes, more or less depending on the age and toughness of the beans.', 'Once cooked until tender, drain and place in a bowl of ice water to shock and stop the cooking.', '3 Make vinaigrette: While the potatoes and green beans are cooking, make the vinaigrette. Whisk together in a bowl the mustard, vinegar, tarragon, salt, and olive oil.', '4 Cut potatoes into bite-sized pieces: Once the potatoes have cooled, cut them into 3/4-inch to 1-inch bite-sized pieces. Place in a large bowl.', '5 Toss with green beans, bell peppers, red onion, olives, vinaigrette to marinate: To the bowl add the green beans, strips of roasted peppers, red onion, and olives. Toss with the vinaigrette.', 'Let marinate until ready to serve.', '6 Toss with parsley, arugula: Once ready to serve, toss with the parsley and arugula.', 'Can easily make ahead. Lasts several days in the fridge.']",12
812,German Potato Salad Recipe,10,45,55,"['1 1/2 pounds (about 8) small red potatoes', '3 slices (about 4 ounces) thick cut bacon, diced', '2 medium (3/4 pound) red onions, diced', '2 tablespoons white wine vinegar', '1/3 cup low sodium vegetable or chicken broth (store-bought or homemade)', '1 tablespoon prepared yellow mustard', '1/4 teaspoon salt', '1/4 teaspoon ground black pepper', '1/3 cup chopped fresh herbs (I like a mixture of chives and parsley)', 'Special equipment:', 'Steamer basket']",11,"['1 Steam the potatoes: Fill a pot with an inch or two of water and set a steamer basket inside. Bring to a simmer over medium-high heat. Rinse the potatoes and place them in the steamer basket.', 'Steam the potatoes, covered, for 20 minutes. To test for doneness, use a paring knife to pierce one of the potatoes; steam for a few more minutes if not quite done.', 'Remove the steamer basket from the pot and let the potatoes cool for 20 minutes.', '2 While the potatoes are cooling, make the bacon dressing: In a large skillet over medium heat, saut\\xc3\\xa9 the bacon until it begins to render some of its fat, about 5 minutes. (For crispier bacon, cook for 8 minutes.)', 'Add the onions and saut\\xc3\\xa9 for 5 more minutes, until the onions are softened and translucent, and the bacon is cooked through.', 'Add the vinegar to the skillet. Stir it in with the onions and bacon and let it reduce, about 2 minutes. Stir in the vegetable broth, mustard, salt, and pepper, and turn off the heat.', ""(If your potatoes aren't quite ready yet, turn off the heat, but then warm briefly again before mixing in the sliced potatoes in Step 4.)"", '3 Peel and slice the potatoes: Use your fingers or a paring knife to gently peel the potatoes. (You can also leave the skins on if you like a more rustic potato salad.) Slice the potatoes 1/4-inch thick.', '4 Stir the potatoes and herbs into the warm dressing: Add the potatoes and chopped herbs to the skillet with the vinaigrette. Gently stir until the potatoes are coated evenly with the herbs, onions, and bacon.', '5 Serve the salad warm or chilled. This salad can be made up to a day ahead.']",10
813,New Potato Salad with Sour Cream and Dill Recipe,10,85,95,"['2 pounds small red-skinned new potatoes', '3/4 cup sour cream', '1/2 cup minced green onions, including the green onion greens', '1 heaping Tbsp of minced fresh dill', '1/3 cup apple cider vinegar', '2 teaspoons kosher salt', '1/2 teaspoon freshly ground black pepper']",7,"['1 Cook the potatoes: Place potatoes, skin on, in a 2 to 3 quart saucepan. Cover with an inch of cold water. Bring to a simmer, lower the heat to maintain a low simmer. Cook for 10 to 12 minutes until they are easily pierced with a fork. Strain the potatoes in cold water, set them aside to cool.', '2 Make the dressing: In a medium bowl whisk together the sour cream, green onions, dill, cider vinegar, salt, and black pepper. The dressing should be strongly flavored (the potatoes will need it!).', '3 Prepare salad and chill: Cut the cooled potatoes in half lengthwise. Toss with the dressing. Chill for at least 1 hour before serving, to allow the potatoes to absorb some of the dressing.']",3
814,Potato Salad with Bacon and Apples Recipe,15,25,40,"['5 thick strips bacon', '1 large red or yellow onion, chopped', 'Salt', '2 Golden Delicious apples, peeled, cored, and cut in 1/2-inch dice', '3 pounds small yellow Yukon Gold potatoes, quartered', '4 green onions, thinly sliced, including the greens', '1/2 cup extra virgin olive oil', '1/4 cup red wine vinegar', '1/4 cup Dijon mustard', '1 tablespoon chopped fresh thyme or 1 teaspoon dried', '1 1/2 teaspoons pepper']",11,"['1 Boil the potatoes: Combine the potatoes and enough cold water to cover by a couple of inches in a large saucepan. Add a generous pinch of salt.', 'Bring to a boil, lower the heat, and cover the pan. Simmer for 15 minutes or until the potatoes are tender when pierced with a fork. Drain well.', '2 Cook the bacon: While the potatoes are cooking, cook the bacon in a heavy-based skillet over medium heat. Once cooked, remove the bacon to a plate lined with paper towels.', 'Reserve the bacon fat in the pan.', 'Once the bacon is cool, chop it.', '3 Cook the chopped onion: Cook the onion in the fat in the pan on medium heat, until softened and just starting to brown, about 5 minutes.', '4 Combine ingredients in a bowl: Use a slotted spoon to remove the onion from the pan to a large bowl. Add the chopped apple to the bowl.', 'Add the potatoes and chopped bacon to the onions and apple. Add the green onions, olive oil, vinegar, mustard, and thyme. Salt and pepper to taste.', 'Serve either warm or at room temperature.']",9
815,Provencal Potato Salad Recipe,10,20,30,"['2 pounds small waxy potatoes or fingerling potatoes, cut in half or quartered', 'Salt', '1 clove garlic, minced', '1/4 cup chopped parsley', '1 tablespoons capers', '1/4 cup green olives, sliced', 'Dressing ingredients:', '2 tablespoons sherry vinegar or white wine vinegar', '1/2 teaspoon salt', 'Freshly ground black pepper', '1 teaspoon herbes de provence', '1 teaspoon anchovy paste (1 to 2 anchovies, mashed)', '1 tablespoon minced shallot', '2 teaspoons Dijon mustard', '1/2 cup extra virgin olive oil']",15,"['1 Boil the potatoes: Place the potatoes in a large pot, cover with cold water. Add 2 teaspoons of salt to the water. Bring the water to a boil, reduce the heat to a simmer, and cook the potatoes until they are just tender when speared with a fork or sharp knife, 7 to 10 minutes depending on the size of the potatoes. Do not overcook. They should be a little firm.', '2 Make the vinaigrette: While the potatoes are cooking, prep the other ingredients and make the vinaigrette. In a small bowl, whisk together the vinegar, salt, pepper, herbes de provence, anchovy paste, shallot, and Dijon mustard. Slowly drizzle in the olive oil whisking the whole time to create an emulsion.', '3 Toss warm cooked potatoes with vinaigrette: When the potatoes are ready, strain them from the pot. In a large bowl toss the still warm potatoes with the vinaigrette, garlic, parsley, capers and green olives.', '4 Chill:  Chill for a couple of hours. Let come to room temperature to serve.']",4
816,Creole Potato Salad Recipe,15,90,105,"['2 pounds Yukon gold or new potatoes, scrubbed clean (peel on or off, your choice), cut in 1 to 2-inch chunks', '6 hard-boiled eggs, coarsely chopped', '1 small onion, chopped', '2 stalks celery, diced', '1 green pepper, diced', '2 tablespoons cider vinegar', '1 teaspoon sugar', '1/2 cup Creole mustard', '3/4 cup mayonnaise (less or more to taste)', 'Salt', 'Cajun seasoning, for garnish']",11,"[""1 Boil the potatoes: Place potatoes in a large pot, cover with cold water by an inch. (If you haven't already hard boiled the eggs, you can boil the eggs with the potatoes.) Bring to a boil and add about a teaspoon of salt. Lower the heat to a simmer and cover. Cook until the potatoes are fork tender, about 10 minutes. Drain in a colander."", '2 Make the dressing: While you are boiling the potatoes, mix the sugar, vinegar, mayonnaise and mustard in with the celery, peppers and onion in a large bowl.', '3 Mix warm potatoes with dressing: While the potatoes are still warm, gently mix them in with the dressing. Stirring them in while warm will allow the potatoes to soak in the seasonings better.', '4 Add hard boiled eggs: Gently fold the chopped hard boiled eggs into the potato mixture until well combined. Taste the potato salad and add salt to taste.', '5 Chill: Put the salad in the fridge for at least an hour before serving.', 'Serve chilled, garnished with paprika or Cajun seasoning.']",6
817,Corned Beef Hash Recipe,5,20,25,"['2 to 3 tablespoons unsalted butter', '1 medium onion, finely chopped (about 1 cup)', '2 to 3 cups finely chopped, cooked corned beef', '2 to 3 cups chopped cooked potatoes, preferably Yukon gold', 'Salt and pepper', 'Chopped fresh parsley']",6,"['1 Saut\\xc3\\xa9 onions in butter: Heat butter in a large skillet (preferably cast iron) on medium heat. Add the onion and cook a few minutes, until translucent.', '2 Add potatoes and corned beef: Mix in the chopped corned beef and potatoes. Spread out evenly over the pan. Increase the heat to high or medium high and press down on the mixture with a metal spatula.', '3 Cook until browned, then flip: Do not stir the potatoes and corned beef, but let them brown. If you hear them sizzling, this is good.', 'Use a metal spatula to peek underneath and see if they are browning. If nicely browned, use the spatula to flip sections over in the pan so that they brown on the other side. Press down again with the spatula.', 'If there is too much sticking, you can add a little more butter to the pan. Continue to cook in this manner until the potatoes and the corned beef are nicely browned.', '4 Stir in parsley, black pepper to serve: Remove from heat, stir in chopped parsley. Add plenty of freshly ground black pepper, and add salt to taste.', 'Serve with fried or poached eggs for breakfast.']",7
818,How to Bake a Potato,5,45,50,"['1 or more russet potatoes', 'Vegetable oil, olive oil, or bacon grease, as needed', 'Salt']",3,"['1 Preheat the oven: Position a rack in the center of the oven and preheat it to 400\\xc2\\xb0F.', '2 Wash and dry the potatoes: Wash the potatoes and dry them with a kitchen towel. If they have big eyes or tiny sprouts, dig those out (the tip of a potato peeler is the best tool for the job).', '3 Poke steam holes: Poke each potato all over 10-12 times with a dinner fork. Don\\xe2\\x80\\x99t be afraid to really get in there; drive the tines about an inch into the potato.', '4 Grease and season the potatoes: Rub the potatoes with the oil or bacon grease. You can eyeball this amount, but 1/4 teaspoon per potato should do it. They should be a little slick, but not dripping with grease.', 'Rub as much salt as you like on the skins. A lot of it will fall off, but it makes the potatoes sparkle!', '5 Bake the potatoes: Set the potatoes on a wire rack set over a baking sheet (or, if your oven racks are clean, directly on the rack). The rack helps air circulate for even baking. If you are baking a lot of potatoes, don\\xe2\\x80\\x99t crowd them on the baking sheet; they\\xe2\\x80\\x99ll steam if crowded.', 'Bake until you can easily slide a fork or skewer into the center of the potato, 30 to 60 minutes. The baking time will depend on the size of your potatoes. They\\xe2\\x80\\x99re done when the skins are slouchy and wrinkled. You may even hear a slight hissing sound, or see tiny bubbles coming from one of the poke holes. If you squeeze one, it should yield to the pressure of your fingers easily, and quite likely crack open a little. If the potato is still hard, keep baking it until it\\xe2\\x80\\x99s done.', '6 Serve: To serve, prick the center of a potato with a fork and pry it open to expose its crumbly and fluffy flesh. Season and top as you like, and dig in!']",8
819,Potato Leek Soup Recipe,20,40,60,"['3 large leeks (about 3 cups, chopped)', '2 tablespoons butter', '4 cups chicken broth (or vegetable broth for vegetarian option)', '2 pounds potatoes (Yukon gold or Russet), peeled, diced into 1/2-inch pieces', '1 teaspoon sea salt, less or more to taste', 'Pinch of dried marjoram', '1 or 2 sprigs fresh thyme, or 1/2 teaspoon dried thyme', '1 bay leaf', '1/4 cup chopped fresh parsley', 'Sprinkle of Tabasco sauce or other red chili sauce', 'White or black pepper to taste']",11,"['1 Clean and cut the leeks: Cut off the roots of the leeks. Cut the leeks lengthwise, fan them open under running water to dislodge any dirt or mud hiding inside. Cut off the tough dark green tops and discard (either compost or freeze for making stock).', 'Slice the white and light green parts of the leeks crosswise into 1/4-inch thick slices. Place the slices in a bowl of cold water and agitate them with your hands to dislodge any remaining dirt. Then scoop out the leeks with a sieve or slotted spoon. (See How to Clean Leeks)', '2 Cook leeks in butter to soften: Melt butter on medium heat in a 3 to 4 quart thick-bottomed pot. Add the chopped leeks, stir to coat with the butter.', 'Cover the pot and reduce the heat to low, cook for 10 minutes until the leeks are softened. Check to make sure the leeks are not browning.', '3 Simmer the soup: Add the broth, diced potatoes, bay leaf, marjoram, thyme, and a teaspoon of salt to the pot.', 'Increase the heat to high to bring to a simmer, then lower the heat to maintain a low simmer, and cook for 20 minutes, until the potatoes are cooked through.', '4 Pur\\xc3\\xa9e the soup: Remove and discard the bay leaf and thyme sprig. Use an immersion blender or standing blender to blend about half of the soup if you want a chunky soup, or all of it if you would like your soup to be more smooth.', ""Note: if you're using a standing blender, pur\\xc3\\xa9e the soup in batches, don't fill the blender more than a third full at a time, and remember to hold down the lid while the blender is going."", '5 Season the soup: Add the parsley, and cook a few minutes more. Add a few dashes of Tabasco to taste.', 'Add freshly ground pepper and more salt to taste. (Potatoes soak up salt, so you may need to add more salt than you expect.)']",10
820,Perfect Mashed Potatoes Recipe,10,25,35,"['1 1/2 lbs (680 g) Yukon Gold potatoes, peeled and cut lengthwise into quarters', '1/2 teaspoon salt', '4 tablespoons (60 ml) heavy cream', '2 tablespoons (30 g) butter', '1 tablespoon milk (or more)', 'Salt and pepper', 'Special equipment:', 'Potato masher']",8,"['1 Cover peeled, cut potatoes with cold, salted water, simmer until tender: Place the peeled and cut potatoes into a medium saucepan. Add cold water to the pan until the potatoes are covered by at least an inch. Add a half teaspoon of salt to the water.', 'Turn the heat to high, and bring the water to a boil. Reduce the heat to low to maintain a simmer, and cover. Cook for 15 to 20 minutes, or until you can easily poke through the potatoes with a fork.', '2 Melt butter, warm cream: While the potatoes are cooking, melt the butter and warm the cream. You can heat them together in a pan on the stove or in the microwave.', '3 Drain cooked potatoes, mash with butter, cream, milk: When the potatoes are done, drain the water and place the steaming hot potatoes into a large bowl. Pour the heated cream and melted butter over the potatoes.', 'Mash the potatoes with a potato masher. Then use a strong wooden spoon (a metal spoon might bend) to beat further.', ""Add milk and beat until the mashed potatoes are smooth. Don't over-beat the potatoes or the mashed potatoes will end up gluey."", 'Add salt and pepper to taste.']",7
821,Garlic Mashed Potatoes Recipe,5,40,45,"['1 head of garlic', '1 tablespoon extra virgin olive oil', '2 pounds potatoes, preferably Yukon Gold or another yellow, waxy potato', 'Salt', '1/3 cup cream', '3 Tbsp butter']",6,"['1 Roast the garlic: Preheat the oven to 400\\xc2\\xb0F. Remove the outer layer of papery skin of the whole garlic head, leaving the head itself intact.', 'Using a paring knife, slice off the tops (1/4-inch to 1/2-inch) of the garlic cloves so they are all exposed. Drizzle olive oil over the garlic heads, salt lightly, and wrap lightly in aluminum foil.', 'Bake at 400\\xc2\\xb0F for 30 to 40 minutes, or until the cloves feel soft to the touch and are beginning to brown. (See our Roasted Garlic recipe). Remove from the oven and let cool.', '2 Boil the potatoes: While the garlic is roasting, peel and chop the potatoes into 1-inch chunks. Place potatoes in a medium saucepan, add 1/2 teaspoon salt, cover with cold water.', 'Bring the pot to a boil, reduce to a simmer, and simmer your potatoes until tender when pierced with a fork, about 15 minutes.', '3 Warm the cream and melt the butter together, either in a small pan on the stovetop or in a bowl in the microwave.', '4 Mash potatoes with garlic, cream, butter: Drain the pot with the potatoes and put it back on the stovetop over low heat. Put the drained potatoes back in the pot.', 'Squeeze the roasted garlic into the potatoes and begin mashing with a potato masher or a large fork.', 'Add the cream and butter and mash until the potatoes are the consistency you want. Do not over-beat them, or they potatoes will become gummy.', 'Taste for salt and add some if needed.']",10
822,Pressure Cooker Shepherd's Pie Recipe,15,45,60,"['1 tablespoon avocado oil or other neutral oil with high smoke point', '1 pound ground lamb or beef', '1 yellow onion, diced', '1 celery stalk, diced', '1 large carrot, diced', '1 garlic clove, minced', '1 1/4 teaspoons kosher salt', '1 teaspoon dried thyme', '1/2 teaspoon freshly ground black pepper', '1 tablespoon Worcestershire sauce', '1 tablespoon tomato paste', '1 cup vegetable broth', '1 cup frozen peas', '4 medium russet potatoes, peeled (about 2 1/2 pounds)', '1/2 cup whole milk', 'Special equipment:', '6-quart electric pressure cooker, such as the Instant Pot', 'Steam rack for pressure cookers']",18,"['1 Brown the meat: Select the Saut\\xc3\\xa9 setting on the Instant Pot and heat the avocado oil. Add the lamb and saut\\xc3\\xa9, breaking it up with a wooden spoon or spatula, for about 7 minutes, until cooked through and no traces of pink remain.', 'Set a colander in a bowl. Wearing heat-resistant mitts, lift out the inner pot and pour the lamb into the colander, letting it drain. Return the inner pot to the Instant Pot housing. (Note from Emma: I just scooped out the meat with a slotted spoon and then poured off all but a tablespoon of fat, which I used for sauteing the vegetables.)', '2 Cook the vegetables and stir in the meat: Add the onion, celery, carrot, garlic, and 1/2 teaspoon of the salt to the pot and saut\\xc3\\xa9 for about 4 minutes, until the onion is translucent. (Note from Emma: As the onions release moisture, use that to scrape up any browned bits from the bottom of the pan. More flavor!)', 'Stir in the thyme, pepper, Worcestershire, and tomato paste. Return the lamb to the pot, then add the vegetable broth and peas.', '3  Add the potatoes: Place a tall steam rack in the pot, making sure all of its legs are resting firmly on the bot\\xc2\\xadtom. Place the potatoes in a single layer on the rack.', '4 Pressure cook the filling and the potatoes together: Secure the lid and set the Pressure Release to Sealing. Press the Cancel button to reset the cooking program, then select the Pressure Cook or Manual program and set the cooking time for 15 minutes at high pressure. (The pot will take about 15 minutes to come up to pres\\xc2\\xadsure before the cooking program begins.)', '5 Vent the pressure: When the cooking program ends, perform a quick pressure release by moving the Pressure Release to Venting.', '6 Mash the potatoes: Using tongs, transfer the potatoes to a bowl. Add the milk and remaining 3/4 teaspoon salt, then use a potato masher to mash the potatoes until smooth. (Note from Emma: If the filling seems a little liquidy at this point, put the Instant Pot on the Saut\\xc3\\xa9 function and let it simmer while you mash the potatoes.)', 'Wearing heat-resistant mitts, remove the steam rack from the pot. Stir 1/2 cup of the mashed potatoes into the lamb mixture in the pot. (Note from Emma: Taste both the mashed potatoes and the filling at this point, and add more salt if needed.)', '7 Assemble the casserole: Transfer the lamb mixture to a broiler-safe 8-inch square baking dish, dollop the mashed potatoes on top, and spread them out with a fork, creating a surface texture.', 'Note: If you like, instead of assembling and broiling the pie, you can simply serve the lamb mixture with the mashed potatoes on the side.', '8 Broil the casserole: Broil the shepherd\\xe2\\x80\\x99s pie in a toaster oven (or a conventional oven) for about 5 minutes, checking often, until the potatoes are lightly browned.', '9 Serve: Spoon the shepherd\\xe2\\x80\\x99s pie onto plates and serve immediately.', 'Note from Emma: Leftovers will keep for about a week in the fridge and can be warmed in a low oven or in the microwave.']",14
823,Scalloped Potatoes with Caramelized Onions and Gruyere Recipe,20,60,80,"['2 tablespoons extra virgin olive oil', '4 cups thinly sliced onions (sliced crosswise, see how to slice onions)', '6 medium-small Yukon gold potatoes (about 1 1/2 pounds), peeled, thinly sliced (1/8-inch thick, it helps to use a mandoline)', '3/4 cup grated Gruyere cheese, divided 1/2 cup, 1/4 cup', '1/2 cup grated Parmesan cheese', '1 teaspoon salt', '1/2 teaspoon white pepper (or black pepper if that is what you have)', '1 teaspoon of butter to butter the gratin or casserole dish', '1/3 cup stock (chicken, beef, or vegetable stock, use vegetable stock for vegetarian option)', '1 teaspoon finely minced fresh rosemary']",10,"['1 Saut\\xc3\\xa9 onions until golden: Heat 1 Tbsp of olive oil on medium high heat in a thick-bottomed saut\\xc3\\xa9 pan. Add the sliced onions, stir to coat with the olive oil, and cook until golden brown, about 15 to 20 minutes.', '2 Preheat oven to 400\\xc2\\xb0F (205\\xc2\\xb0C).', '3 Toss sliced potatoes with olive oil, cheeses, salt, pepper: In a large bowl put the sliced potatoes and gently toss with 1 Tbsp of olive oil, 1/2 cup grated Gruyere cheese, 1/2 cup of grated Parmesan, salt, and white pepper.', '(If you are making ahead, make sure that the potatoes are well coated with the olive oil, even if you have to add more olive oil. This will help prevent them from turning grey.)', '4 Layer onions in buttered dish, arrange potatoes on top, pour stock over, sprinkle with more cheese: Butter a large gratin dish or 9x13 casserole lightly and line with the caramelized onions in an even layer at the bottom of the dish.', 'Arrange the sliced potatoes (including the grated cheeses) in a pattern over the onions.', 'Pour stock over the potatoes. Sprinkle with remaining cheese.', '5 Cover with foil and bake, then broil to finish: Cover with aluminum foil and bake at 400\\xc2\\xb0F (205\\xc2\\xb0C) for 50 minutes (or until fork tender). Remove aluminum foil. Broil for 5 minutes, uncovered, until lightly browned.', 'Sprinkle with minced rosemary to serve.']",9
824,Crispy Hash Browns Recipe,5,15,20,"['3 tablespoons extra virgin olive oil', '1 pound Russet baking potatoes', 'Salt and pepper', 'Special equipment:', 'Large frying pan (at least a 9"" diameter)', 'Potato ricer']",6,"['1 Peel and grate the potatoes: Peel the potatoes and grate them using the large holes of a box grater.', ""2 Squeeze out the moisture: Squeeze out as much moisture as you can from the grated potatoes. An easy way do this with a potato ricer (or an orange or lemon press), using it much like you would a garlic press, except you don\\'t force the potatoes through the ricer. You just press out the excess moisture."", 'Work in batches and only fill the ricer half-way with the raw grated potatoes.', ""If you don\\'t have a ricer, wrap the raw grated potatoes in a clean kitchen tea-towel and squeeze it until you have squeezed out as much moisture as you can. Work in batches to make it more manageable. Note that the potatoes can sometimes stain a cloth towel, so use one that you don\\'t mind showing a bit of wear."", ""You can also use sturdy paper towels to squeeze out the moisture, though they don\\'t work as well as cloth or a ricer."", '3 Cook the hash browns: Heat 3 tablespoons of oil in a large frying pan on medium-high heat. When the oil heats up to the point of shimmering, but not smoking, add the grated potatoes, spreading them out evenly along the bottom of the pan. The potatoes should not be too thick in any one place\\xe2\\x80\\x94about 1/4 to a 1/2-inch thick.', 'Sprinkle some salt and pepper on the potatoes.', '4 Flip the hash browns: After a few minutes, lift up one edge of the potatoes and see how done they are. If they have fried to a golden brown, they are ready to flip.', 'Use a large metal spatula (or two spatulas) to flip the potatoes over all at once, or divide the large potato cake into halves or quarters and flip.', 'Continue to cook until they are golden brown on the bottom.', '5 Serve Use a metal spatula to cut into quarters and serve.']",11
825,Twice Baked Potatoes Recipe,0,105,105,"['4 large russet potatoes, about a pound each', 'Extra virgin olive oil', '1/2 cup sour cream', '1/2 cup milk', '2 tablespoons butter, softened', '1 tablespoon cream', 'Stuffing Option 1: Cheddar and Bacon:', '1 cup grated cheddar cheese', '4 strips bacon', '1/4 cup chopped green onion', 'Stuffing Option 2: Blue Cheese and Chives:', '1 cup crumbled blue cheese', '1/4 cup chopped fresh chives', '1/2 teaspoon salt']",14,"[""1 Bake the potatoes: Preheat the oven to 400\\xc2\\xb0F. Scrub the potatoes clean under running water. Poke each potato in several places with the tines of a fork so that when the potatoes are cooking they don\\'t explode."", 'Rub the potatoes all over with a little olive oil. Place directly on the middle or top rack of the oven.', 'Cook for 1 hour and 15 minutes, or until the potatoes are cooked through. They should give a little when pressed.', ""If short on time you can bake the potatoes in the microwave, 10 minutes on high heat for 2 potatoes, 15 minutes for 4 potatoes. The skins of microwave baked potatoes aren\\'t nearly as crispy, so you may want to rub a little olive oil on them and finish them in a conventional oven at 400\\xc2\\xb0F for 10 minutes."", '2 Cook the bacon if using: If you are including bacon as one of your mix-ins, while the potatoes are cooking, cook the bacon strips in a frying pan on medium low heat for 10 to 15 minutes, or until crisp. Drain on paper towels. Let cool. Crumble.', '3 Make potato ""boats"": Allow the potatoes to cool to touch. Slice the top third lengthwise off the potato.', 'Use a spoon to scoop out the insides, forming a potato ""canoe"", leaving about 1/4 inch of potato on the skin.', 'Alternatively, you can slice the potatoes in half, lengthwise. In this case you may want to bake an extra potato so that you will have more potato filling to mound into the potato boats.', '4 Mash potato insides with sour cream, milk, butter: Place the scooped out potato insides, sour cream, milk, cream, and butter into a large bowl.', 'Mash with a potato masher. If you want a creamy texture, beat with an electric beater until desired consistency. Do not over-beat the potatoes! They can turn glue-y if you do.', '5 Stuff potato shells with filling: Mix in the extras with the potato filling. Reserve some of the extras to sprinkle on the tops of the potatoes. Spoon fillings into the potato shells. Sprinkle with extra toppings.', '6 Bake: Heat oven to 350\\xc2\\xb0F. Place potatoes on a roasting pan and bake 15 to 20 minutes until heated through.']",12
826,Crispy Hasselback Potatoes Recipe,15,0,15,"['6 Yukon gold potatoes, about 6 ounces each', '4 tablespoons unsalted butter, melted', '3 tablespoons olive oil', '3 tablespoons chopped fresh parsley, plus more for garnish', 'Flaky sea salt, to taste']",5,"['1 Preheat the oven to 425\\xc2\\xbaF.', '2 Slice the potatoes: Set a potato on a cutting board and place a chopstick on either side of the potato. With a sharp, thin knife, make deep vertical cuts 1/8-inch apart, but without cutting all the way through the potato. The chopsticks should keep you from accidentally cutting too deeply or going all the way through.', 'Place the potatoes with the cut side up in the baking dish, spaced a little apart so each one has some room. Fan the potatoes open slightly.', '3 Season the potatoes: In a small bowl, combine the melted butter, oil, and parsley. Drizzle this over the potatoes and then use a pastry brush to spread the butter and oil mixture evenly and in between the slices of each potato. Sprinkle with salt.', '4 Bake for 1 hour and 15 minutes, or until golden and crispy. The potatoes will fan out more during cooking and take on their accordion-like appearance. Serve hot.']",5
827,Make Ahead Mashed Potatoes Recipe,15,70,85,"['4 to 5 pounds potatoes (russets, yukon gold or a combination), peeled and cut into 2-inch chunks', 'Salt', '3 garlic cloves, peeled and whole', '1 small sprig fresh rosemary', '3 tablespoons unsalted butter, divided 2 tablespoons and 1 tablespoon', '8 ounces cream cheese (full fat), room temperature', '1/2 cup plain or greek yogurt (or sour cream)', '1/4 teaspoon fresh minced rosemary', '2 teaspoons kosher salt', '1/8 teaspoon freshly ground black pepper', 'Chives for garnish']",11,"['1 Cook the potatoes: Place peeled cut potatoes in a large saucepan, cover with an inch of cold water. Add 2 teaspoons of salt to the water. Add the garlic cloves and rosemary sprig.', 'Heat on high to bring to a boil, then reduce to low, cover to maintain a simmer until the potatoes are just cooked through, about 10 to 12 minutes.', 'Once potatoes are done, drain the potatoes. Discard the rosemary sprig, save the garlic cloves with the potatoes.', '2 Mash the potatoes and garlic cloves: While the potatoes are still hot, use either a potato masher or a potato ricer to roughly mash the potatoes and the garlic cloves in a large bowl.', 'A ricer will yield fluffier, less gluey, mashed potatoes.', '3 Mix in cream cheese and yogurt: In a large upright mixer (or if you have strong arms, you can do this by hand), add the riced or roughly mashed potatoes into the mixer bowl, along with 2 tablespoons of butter, the softened cream cheese, and the yogurt.', ""Mix on low to start, then increase the speed to medium and mix just until everything is well incorporated. (Don't overmix!)"", 'Stir in the minced rosemary, the salt and pepper. Taste and add more salt and pepper if needed.', '4 Place in casserole dish: Butter generously the inside of a 2-quart casserole dish. Add the mashed potatoes, and spread out in an even layer. Dot with the remaining 1 Tbsp butter.', ""At this point, you've done the make-ahead part of the recipe. You can cover with plastic wrap and chill until ready to bake. You can make up to 2 days ahead. (Or you can freeze for up to 2 weeks ahead; see headnotes for more detailed freezing and reheating instructions.)"", '5 Bake: When ready to make, remove from refrigerator and let sit for an hour to come to room temperature. Bake at 350\\xc2\\xb0F for 30 to 45 minutes, until the top is lightly browned.']",11
828,Roasted New Potatoes Recipe,10,40,50,"['1 1/2 pounds of smallish new potatoes (red or yellow skinned), cleaned, cut in half or quarters', '2 tablespoons extra virgin olive oil', '2 cloves garlic, minced (about 2 teaspoons)', '1-2 teaspoons fresh rosemary, minced', '1/4 teaspoon Kosher salt', 'Freshly ground black pepper to taste']",6,"['1 Preheat oven to 450\\xc2\\xb0F (230\\xc2\\xb0C). Place potatoes in a large bowl. Sprinkle with salt and pepper, olive oil, rosemary, and garlic. Toss until potatoes are well coated with everything.', '2 Spread the potatoes out on a single layer of a roasting pan (a sturdy pan that can take high oven heat, a standard cookie sheet may warp). Roast for 40 minutes, or until potatoes are cooked through and browned. Serve immediately.']",2
829,How To Cook Potatoes in the Instant Pot Recipe,5,0,5,"['1 cup water', '2 pounds potatoes, cut into 1 1/2-inch chunks', 'Special equipment:', '6-quart Instant Pot or other electric pressure cooker', 'Steamer basket']",5,"['1 Prepare the potatoes for cooking: Pour the water into the inner pot of the pressure cooker. Put the potatoes in the steamer basket, then lower it into the pot.', '2 Pressure cook the potatoes: Secure the lid on the pressure cooker and make sure it\\xe2\\x80\\x99s set to its \\xe2\\x80\\x9csealing\\xe2\\x80\\x9d position. Select the \\xe2\\x80\\x9cSteam\\xe2\\x80\\x9d or \\xe2\\x80\\x9cManual\\xe2\\x80\\x9d setting, and set the cooking time to 3 minutes at high pressure. (The pot will take about 10 minutes to come up to pressure.)', '3 ""Quick release"" the pressure: When the cooking program finishes, perform a quick pressure release by moving the pressure vent to its \\xe2\\x80\\x9cventing\\xe2\\x80\\x9d position.', '4 Remove the potatoes from the pot: When the pressure has fully released, open the pot. Use a pair of heat-safe mitts to remove the steamer basket of potatoes.', 'If not using the potatoes right away, let them cool completely and then refrigerate in a covered container. Potatoes will keep for about a week.']",5
830,Roasted Red Pepper Potato Soup Recipe,15,30,45,"['4 large red bell peppers', '1 medium yellow onion, peeled and diced (about 1 cup)', '1 large russet potato, peeled and diced (about 1 1/2 cup)', '3 cloves garlic', '1 quart chicken stock (or vegetable stock for vegetarian option)', '1/4 cup cream or milk', '3 tablespoons butter', 'Cayenne, salt and pepper to taste']",8,"['1 Roast bell peppers until blackened all over: Roast the red bell peppers by placing them over or under an open flame until they blacken on all sides. (You can use a grill, cooktop gas burner, or oven broiler.) Place the blackened peppers in a bowl, cover the bowl with a plate, and let the peppers steam for 5 minutes, or until the skins feel like they can easily be slipped off. Remove the peppers from the bowl, peel off the blackened skins, remove the seeds. Chop the peppers roughly.', '2 Saut\\xc3\\xa9 onions in butter: Heat the butter in a large soup pot over medium-high heat. Add the chopped onion and saut\\xc3\\xa9 for 2-3 minutes, stirring occasionally.', '3 Add potatoes, garlic: Add the potatoes and cook another 1-2 minutes, then add the garlic and the chopped roasted peppers. Stir well and cook for 2 minutes.', '4 Add stock, simmer:  Add the stock, stir well and bring to a simmer. Cook over medium heat until potatoes are soft, about 12 to 15 minutes.', '5 Pur\\xc3\\xa9e soup: Pur\\xc3\\xa9e the soup in a blender or food processor until very smooth. Fill the blender about halfway with the soup. Start the blender on low and keep your hand on the top, in case the lid wants to pop off from the rising steam. Once everything is well chopped, turn the blender to its highest setting and blend until smooth, about 1 minute. You might need to do this in batches.', '6 Add cream, seasonings: Return to a clean pot set over low heat. Add the cream, stir well and taste. Add some cayenne, salt and pepper to taste.']",6
831,Creamy Scalloped Potatoes Recipe,20,100,120,"['3 Tbsp butter', '2 lbs (about 4 medium sized) Russet potatoes, peeled, sliced 1/8-inch thick', '1 large yellow or white onion, thinly sliced', '2 Tbsp chopped fresh parsley', '1 Tbsp chopped fresh chives (optional)', '2 thick slices of bacon, cooked and chopped', '2 1/2 cups grated Swiss or Gruyere cheese (about 8 ounces)', '1/2 cup grated Parmesan cheese (about 2 ounces)', '2 1/2 cups to 3 cups of half-and-half (half milk, half cream)', 'Salt and pepper']",10,"[""1 Preheat oven to 350\\xc2\\xb0F. Butter a large casserole dish with 1 1/2 Tbsp of butter. If you use a casserole dish that is about 9x13 (bigger than the one shown) you'll have more surface area, more of the potatoes will brown, and the cooking time will be faster."", '2 Layer casserole dish with potato slices, cheese, bacon, parsley, chives, Parmesan: Layer the bottom of the casserole dish with a third of the potato slices. Sprinkle with salt and pepper. Layer on half of the sliced onions and 1/2 cup of the Swiss cheese. Layer on half of the bacon, and half of the parsley and chives. Sprinkle with a little Parmesan.', 'Repeat by layering on a third of the potato slices, sprinkle again with salt and pepper. Layer on the remaining sliced onions, 1/2 cup of the Swiss cheese, the remaining bacon, parsley and chives. Sprinkle with a little Parmesan.', '3 Top the casserole with the remaining potato slices. Add the half and half. Dot the potatoes with the remaining 1 1/2 Tbsp of butter.', '4 Half-way through baking, top with remaining cheese: Cover the casserole with aluminum foil and bake at 350\\xc2\\xb0F in the oven for one hour. After an hour, remove from the oven, remove the foil, sprinkle on the remaining Swiss and Parmesan cheese.', '  5 Return to the oven for an additional 30 to 40 minutes. When done, the potatoes should be tender, but not mushy, and the liquid should be mostly absorbed.', 'For a faster cooking time, you can first parboil the sliced potatoes for 8 minutes in boiling water, patting them dry, and then layer them in the casserole pan. Bake for roughly 20 minutes covered and 15 to 25 minutes uncovered, or until the potatoes are tender and the liquid is mostly absorbed. Total oven cooking time is 35 to 45 minutes.']",7
832,New England Cioppino Recipe,20,40,60,"['1 cup white wine, or 1 cup water and the juice of 1 lemon', '2 pounds mussels, scrubbed with beards removed', '1 1/2 pounds littleneck clams (about 12 clams in their shells)', '6 small Yukon Gold or red potatoes (the size of walnuts) or fingerling potatoes, sliced into coins', '1 can (16 ounces) whole peeled tomatoes and their juices', '2 tablespoons olive oil', '2 cloves garlic, finely chopped', '1/4 teaspoon crushed red pepper', '1 1/2 cups chicken stock', '1 pound skinless boneless haddock, halibut, or other firm-fleshed white fish, cut into 6 even-sized pieces', '1/2 pound cooked lobster, out of the shell and cut into 1-inch pieces', '4 tablespoons chopped fresh parsley']",12,"['1 Prepare the mussels: In a large pot, pour in the wine or water and lemon juice. Add the mussels, cover the pot, and bring the liquid to a boil over medium-high heat. Watch the pan carefully because the liquid tends to spill out when it boils. Once boiling, lower the heat and cook the mussels for 2 minutes or until they open. Use a slotted spoon to transfer the mussels to a bowl. Discard any that are not open.', '2 Prepare the clams in the same pot: Add the clams to the cooking liquid, cover, and return to a boil. Lower the heat and cook the clams for 2 minutes or until they open. Set a colander over a bowl. Line the colander with a double layer of paper towels. Tip the clams and their liquid into the colander \\xe2\\x80\\x93 this helps strain out any sand or grit. Save the cooking liquid. Discard any clams that are not open.', '3 Cook the potatoes in a separate pot: Combine the potatoes, a large pinch of salt, and water to cover in a separate pot. Bring to a boil, lower the heat, and set on the cover askew. Simmer the potatoes for 8 minutes or until they are tender when pierced with a fork. Drain and set aside.', '4 Puree the tomatoes: In a blender, combine the tomatoes and their juice. Pulse until the mixture is coarsely pureed.', '5 Make the tomato broth: In the same pot used to cook the shellfish, heat the olive oil. Add the garlic and cook, stirring, for 1 minute. Add the tomatoes, red pepper, salt, and black pepper. Cook, stirring, for 2 minutes. Pour in the chicken stock and the leftover liquid from cooking the mussels and clams. Bring to a boil, then lower the heat and cover with the lid slightly ajar. Simmer for 10 minutes to reduce the broth and combine the flavors.', '6 Cook the fish: Add the fish pieces to the tomato broth; they should be not quite submerged. Cover the pot and cook for 5 minutes. The fish will be firm but not quite cooked through; it will finish cooking in the next steps.', '7 Add the cooked mussels, clams, lobster, and potatoes to the pot: Sprinkle 1 tablespoon of parsley over the fish, then add the mussels, clams, lobster meat, and cooked potatoes to the pot. Ladle some of the broth over top. Cover and cook for 2 minutes. Spoon more broth over top, cover, and continue cooking for 2 minutes more, or until all the shellfish is hot.', '8 Serve the stew: Divide the stew between bowls, making sure to get plenty of broth. Sprinkle with the remaining 3 tablespoons parsley.']",8
833,Crispy Parmesan Potato Stacks Recipe,15,35,50,"['2 1/2 tablespoons olive oil', '1/8 teaspoon garlic powder', '3/4 teaspoon salt', '1 3/4 pounds Yukon potatoes', '1/2 tablespoons fresh thyme leaves', '1/4 cup shredded Parmesan cheese', 'Special equipment:', '12-cup muffin pan', 'Silicone pastry brush']",9,"['1 Preheat oven to 375F. Set an oven rack in the center position. Coat a standard 12-cup muffin pan with cooking spray or brush on a thin layer of oil.', '2 In a small bowl, mix olive oil, garlic powder and salt together. Set aside.', '3 Slice the potatoes: Rinse and scrub your potatoes. Slice each potato thinly, between 1/8 and 1/16-inch thick. I use a mandoline to get 1/16-inch thick slices.', '4 Assemble the potato stacks: Place 4 slices of potatoes at the bottom of each cup of the muffin tin. Using a silicone brush, lightly brush the potatoes with some of the oil mixture. Sprinkle some thyme leaves on top. Continue stacking several layers of potatoes, brushing the oil and sprinkling thyme leaves until you have stacked all the potato slices. Each muffin cup should be filled to the top with potato slices.', 'Sprinkle half of the Parmesan evenly over the potato stacks.', '  5 Bake the potato stacks: Bake the stacks for 30 minutes, then pull out the potatoes and sprinkle the remaining cheese on top. Bake another 5 to 15 minutes, depending on how brown and crispy you want them to be (35 to 45 minutes total).', '6 Transfer the stacks to plates or serving dish: Use a spoon to help release the potato stacks from the muffin pan. Season potato stacks with more salt and pepper, if you like. Serve immediately while hot and crispy.']",7
834,How to Cook Potatoes Sous Vide,10,60,70,"['1 1/2 pounds baby red or gold potatoes', '1 to 2 tablespoons chopped fresh chives or parsley', '1 teaspoon kosher salt', '1/2 teaspoon black pepper', '2 tablespoons olive oil', 'Extra fresh chopped herbs, to garnish', 'Sea salt, to garnish', 'Special equipment:', 'Immersion circulator', 'Gallon-sized zip-top freezer bags']",10,"['Set the potatoes aside on a kitchen towel until the water has finished heating.', '5 Cook the potatoes: Once the water has come up to temperature, submerge the bag of potatoes in the pot. Make sure the bag is completely submerged; otherwise the potatoes will not cook evenly.', 'Cook for 1 hour, and check for doneness by carefully removing the bag from the water, opening the top and sticking a fork in a potato to determine its tenderness. If not tender all the way through, reseal the bag and continue cooking.', '6 Serve: Remove from the water, and turn off the circulator. Transfer to a serving platter and sprinkle some additional fresh chopped herbs and sea salt over the top, if desired. You can also drizzle the cooking oil over the plated potatoes.', 'Alternatively, let the potatoes cool in their bag and then refrigerate for 3 to 4 days. Remove from the bag and reheat in the microwave, in a skillet over medium-high heat, or by roasting in a 425\\xc2\\xb0F oven.']",5
835,Sweet Potato and Yukon Gold Bake Recipe,15,85,100,"['Caramelized Onions:', '2 tablespoons extra virgin olive oil', '4 cups sliced onions (1/8 to 1/4-inch slices)', '1 teaspoon fresh thyme, minced', '1/2 teaspoon salt', 'Sweet Potatoes and Yukon Golds:', '2 pounds of sweet potatoes, mixed in color if available, peeled and sliced into 1/8-inch thick rounds', '2 pounds Yukon Gold potatoes, peeled, and sliced into 1/8-inch thick rounds', '2 tablespoons melted butter', '1 teaspoon of salt', '1/4 teaspoon black pepper', 'Sprigs of fresh thyme']",12,"['1 Caramelize the onions: Heat olive oil in a large, thick-bottomed pot on medium heat. Add the sliced onions, toss to coat, lower the heat to medium low and cover. Let cook for 15 to 20 while you are slicing the sweet potatoes and yukon golds, stirring occasionally, until completely softened.', 'Then increase the heat to medium high and cook uncovered until golden brown. Remove from heat and stir in salt and thyme.', '2 Peel and slice all of the sweet potatoes and yukon golds. Try to make them uniform in size.', 'Place the slices in a bowl of water while you are prepping them to prevent them for discoloring. If using purple sweet potatoes, keep the slices in a different bowl of water (the color bleeds).', 'Drain the slices, place them in a bowl.', '3 Line baking dish with onions, sweet potato and potato slices: Place the caramelized onions in an even layer over the bottom of a 9x12 rectangular or oval casserole dish.', 'Arrange slices of sweet potatoes and Yukon Gold potatoes in rows on top of the caramelized onions.', 'Brush with melted butter, sprinkle with salt and pepper.', '4 Cover with foil and bake in a 400\\xc2\\xb0F oven for 45 minutes, until the potatoes are cooked through.', '5 Remove foil, bake uncovered for 15 minutes more, until the edges are crispy and browned.', 'Sprinkle with a little more salt and pepper. Garnish with sprigs of fresh thyme. Serve immediately.']",11
836,Red Flannel Hash Recipe,10,15,25,"['4 Tbsp butter', '1 cup chopped onion', '2 cups chopped cooked corned beef', '1 1/2 cups chopped cooked beets*', '1 1/2 cups chopped cooked potatoes', '1 teaspoon Worcestershire sauce (optional, and use gluten-free Worcestershire sauce if cooking gluten-free)', '1/4 cup (packed) chopped fresh parsley (optional)', 'Freshly ground black pepper to taste', '*For easy cooked beets, place a few beets in a saucepan and cover with water. Simmer for 35 to 45 minutes, depending on the size of the beets, until they are easily pierced with a fork. Let them cool, slip the peels off, then chop the beets.']",9,"['1 Cook the onions: Heat butter in a frying pan (cast iron preferred) on medium high heat. Add the onions and cook a couple minutes, until translucent.', '2 Add the corned beef, potatoes, and beets. Stir in the pan to combine, and spread out evenly in the pan. Reduce the heat to medium. Press down with a metal spatula to help brown the mixture.', ""Don't stir, but just let cook until nicely browned on one side, then use a metal spatula to lift up sections of the mixture and turn over to brown the other side."", ""If the mixture sticks to the pan too much, just add a little more butter to the pan where it's sticking."", '3 When nicely browned, remove from heat. Sprinkle in some Worcestershire sauce, if using. Stir in fresh chopped parsley, if using, and sprinkle on freshly ground black pepper to taste.', 'There should be enough salt from the corned beef, but if not, add salt to taste.', 'Serve plain or with fried or poached eggs.']",7
837,Instant Pot Mashed Potatoes Recipe,10,20,30,"['1 cup water', '3 to 3 1/2 pounds (4 large) russet potatoes, peeled and sliced 1-inch thick', '4 cloves garlic, peeled (optional)', '3/4 cup whole milk', '3 tablespoons unsalted butter', '1 1/2 teaspoons kosher salt', '1/2 teaspoon freshly ground black pepper', 'Chopped fresh chives or parsley, for garnish (optional)', 'Special equipment:', '6-quart Instant Pot or other electric pressure cooker', 'Steamer basket']",11,"['1 Pressure cook the potatoes and garlic: Place a steamer basket in the bottom of your electric pressure cooker and add 1 cup of water. Add the sliced potatoes and peeled garlic cloves (if using) on top of the steamer basket.', 'Secure the lid on your pressure cooker and make sure the pressure release valve is set to its \\xe2\\x80\\x9csealing\\xe2\\x80\\x9d position. Select the \\xe2\\x80\\x9cSteam\\xe2\\x80\\x9d or \\xe2\\x80\\x9cManual\\xe2\\x80\\x9d setting and set the cooking time to 4 minutes at high pressure. (The pot will take about 15 minutes to come up to pressure and then the actual cooking will begin).', 'When the cooking program ends, perform a quick release by moving the pressure release valve to its \\xe2\\x80\\x9cventing\\xe2\\x80\\x9d position.', '2 Drain the water from the pot, then put the potatoes and garlic back in: Use heatproof mitts to remove the steamer basket from the pot. Lift out the inner pot and pour out the water, then return the potatoes to the inner pot of the pressure cooker (don\\xe2\\x80\\x99t put it back in the pressure cooker housing).', '3 Mash the potatoes, then taste for seasoning: Add the milk, butter, salt, and pepper. Use a potato masher to work the ingredients into the potatoes, mashing until the potatoes are mashed as much as you like them. Add more milk or butter if you like. Taste the potatoes for seasoning, and add more salt and/or pepper if needed.', '4 Serve: Spoon the potatoes into a serving bowl and sprinkle the chopped chives on top. Serve hot.']",6
838,"Ham, Potato and Leek Soup Recipe",15,45,60,"['2 Tbsp unsalted butter', '1 large or 2 small leeks to make 4 cups thinly sliced leeks, white and light green parts only (see How to Clean Leeks)', '4 cups chicken broth', '2 large russet potatoes (about 1 pound), peeled, cut into 1/2 inch pieces', '1/2 teaspoon ground white pepper', '2 cups ham, diced', '1/4 to 1/2 cup cream, half and half, or chicken stock', 'Salt to taste', '3 Tbsp fresh parsley, chives or dill, chopped']",9,"['1 Cook leeks in butter: Melt the butter in a large saucepan over medium heat. Add the leeks and cook, stirring occasionally, for 5 minutes, or until leeks are soft but not browned.', '2 Add broth, potatoes, white pepper, simmer 25 min: Add chicken broth, potatoes and white pepper. Bring to a boil over medium high heat.', 'Reduce heat. Cover and simmer 25 minutes or until vegetables are very tender.', '3 Pur\\xc3\\xa9e the soup: Using an immersion blender, or a standing blender working in batches, process until smooth. (If using a standing blender, do not fill your blender more than a third full with hot soup.)', '4 Add ham, cream, seasonings: Stir in the diced ham and enough cream, milk, or half and half, or stock to thin the soup to desired consistency.', 'Season to taste with salt. Garnish with parsley, chives or dill.']",6
839,Zucchini-Feta Frittata Recipe,25,35,60,"['3 medium zucchini (1 1/4 pounds)', '1/4 teaspoon salt', '1 large Yukon Gold or Yellow Finn potato (1/2 pound), peeled and cut into eighths', '1 tablespoon olive oil', '5 large eggs, lightly beaten', '1/4 teaspoon freshly ground black pepper', '1/4 pound creamy feta, crumbled (about 1 cup)', '1 cup Monterey Jack cheese']",8,"['1 Grate the zucchini: Trim the zucchini at both ends. Quarter them lengthwise and cut out and discard the column of seeds on each piece. Use the grating disk on a food processor or a hand-held grater to grate the zucchini.', '2 Press the zucchini: Transfer the grated zucchini to a colander set inside a bowl, sprinkling salt between the layers. Set a small plate on top of the zucchini to press it down. Set aside for 15 minutes to drain (or place in the fridge overnight). When ready, squeeze the zucchini with your hands to remove any excess water.', '3 Cook the potato: Place the potato pieces in a small saucepan and cover with cold water by about an inch. Bring to a boil, lower the heat to a simmer, and cook for 12 to 15 minutes, or until tender.', '4 Mash the potato: With a slotted spoon, transfer the potato to a bowl and mash it with a fork until it is almost smooth. Leave to cool.', '5 While the potato cooks and cools, preheat oven to 375F. Use the olive oil to coat the bottom and sides of a 9-to 9 1/2-inch pie pan. Set the pan on a rimmed baking sheet to catch any drips, then place both inside the oven to warm for at least 5 minutes.', '6 Combine the frittata filling: Mix the eggs, black pepper, feta cheese, and 3/4 cup of the Monterey Jack cheese into the cooled mashed potatoes. Stir in the drained and squeezed zucchini.', '7 Transfer the filling to the pie pan: Carefully remove the hot pie pan and baking sheet from the oven. Pour the zucchini mixture in the hot pie pan, smoothing the top. Sprinkle with the remaining 1/4 cup Monterey Jack cheese.', '8 Bake the frittata: Return the pie pan and the baking sheet to the oven and bake for 35 minutes or until the top is brown and the frittata is set in the middle.', '9 Cool and serve: Let the frittata cool for 5 minutes before cutting into wedges. Leftover frittata will keep for up to a week in the refrigerator; eat cold or briefly warmed in the microwave.']",9
840,Smoked Salmon Potato Leek Torta Recipe,10,80,90,"['1 1/2 pounds small yukon gold potatoes, scrubbed, unpeeled', '2 Tbsp butter', '1 1/2 cups thinly sliced leeks, white and light green parts only (see How to Clean Leeks)', '4 ounces thinly sliced cold smoked salmon', '5 eggs', '1 teaspoon kosher salt', '1 Tbsp fresh chopped dill', '1/3 cup heavy cream', 'Special equipment:', 'An 8 or 9 inch springform pan or cake pan']",10,"['1 Boil the potatoes: Put the potatoes in a saucepan, cover with cold water by an inch. Add 2 teaspoons salt to the water. Bring to a boil and cook until the potatoes are easily pierced with the tines of a fork, 10 to 15 minutes. When done, remove the potatoes from the pot and let sit to cool to room temp.', '2 Cook the leeks in butter: While the potatoes are cooking, start on the leeks. Melt the butter in a small saut\\xc3\\xa9 pan on medium heat. Add the sliced leeks and toss to coat with the butter. Let cook until softened, about 8 to 10 minutes. Do not let the leeks brown or dry out. Remove from heat.', '3 Make egg leek mixture: Whisk the eggs in a medium bowl. Whisk in the salt, dill and heavy cream. Whisk in the cooked leeks.', '4 Prepare pan: Butter the insides of the springform pan or cake pan. Line the bottom of the pan with a round of parchment paper. Butter the top of the paper as well.', '5 Slice potatoes, preheat oven: Slice the cooked, cooled potatoes into 1/8-inch thick rounds. Preheat oven to 350\\xc2\\xb0F.', '6 Layer bottom of pan with sliced potatoes: Place a single layer of sliced potatoes at the bottom of your cake or springform pan. (Taste one of the pieces of cooked potato, if it needs salt, and potatoes usually do, sprinkle a little bit of salt over every layer of potatoes in this torta as you build it.)', '7 Add a layer of smoked salmon slices: Spread half of the smoked salmon slices on top of the potato slices.', 'If you are using a springform pan, wrap the outside of the pan tightly with foil to prevent leakage in the next step.', '8 Add a third of egg mixture, continue layering potatoes and salmon: Spread a third of the leek and egg mixture over the potatoes and salmon in the pan.', 'Then lay down another layer of potatoes and smoked salmon. Add another third of the egg and leek mixture.', 'Line the top of the torta with the rest of the potato slices and cover with the remaining egg mixture.', '9 Bake: Place in the oven (if using a springform pan, place foil wrapped pan on top of a rimmed baking sheet in case the foil leaks) and bake at 350\\xc2\\xb0F for 30 minutes, until set and a knife inserted in the center comes out clean.', ""Remove from oven and run a blunt knife around the edges of the pan to gently separate the torta from the pan while it's still warm."", 'Let cool to lightly warm or room temperature before slicing and serving.']",14
841,Provencal New Potatoes Recipe,10,50,60,"['2 lb small new potatoes (look for the smallest you can find, the potatoes should be no bigger than 1 1/2 inches, if they are bigger, cut them into 1 to 1 1/2 inch pieces)', '1 medium onion, sliced in the direction of root to top', '6 cloves of garlic, crushed with peel on (do not remove peel)', '2-3 small to medium vine-ripened tomatoes, or plum tomatoes, cut into 1 1/2-inch chunks', '10 pitted olives, green and black (Kalamata and Nicoise)', '1/2 teaspoon red chile flakes', '1/4 teaspoon garlic powder', '1 Tbsp herbes de Provence', '1/2 cup extra virgin olive oil', '2 teaspoons red wine vinegar', '2 teaspoons Kosher salt', 'Freshly ground black pepper', '1 Tbsp chopped fresh chives for garnish']",13,"['1 Preheat oven to 400\\xc2\\xb0F.', '2 Toss ingredients together: Put all ingredients (except chives) into a large roasting pan, toss with your (clean) hands to coat completely with oil and seasonings. Spread everything out evenly.', '3 Roast in oven: Put the potatoes in the oven, cook for fifteen minutes at 400\\xc2\\xb0F.', 'Then reduce the heat to 375\\xc2\\xb0 and cook for 30 to 40 minutes more, until the onions and tomatoes are somewhat caramelized and the potatoes are cooked through.', 'Halfway through cooking, stir the potatoes so that they remain well coated with oil and do not get dried out, and the bottom of the pan stays coated with oil.', '4 Let cool to room temp, sprinkle with chives: Remove from oven and let sit until cooled to room temperature.', 'Sprinkle with freshly chopped chives to serve.', 'Excellent served with steak and a side of greens. (You can toss fresh spinach or chard with the oil remaining in the potato roasting pan and put back into the oven for just a few minutes until just wilted.)']",8
842,"Frittata with Potatoes, Red Peppers, and Spinach Recipe",15,25,40,"['6 large eggs', '1/4 cup (60ml) milk', '2 1/2 tablespoon olive oil', '3/4 teaspoon ground turmeric', '1/2 cup diced red onions', '2 cloves garlic, minced', '8 ounces (225g) fingerling potatoes, thinly sliced down their length', '1 medium red pepper, seeded and diced', '1 scallion, thinly sliced', '1 cup baby spinach', 'Freshly ground black pepper']",11,"['1 Preheat oven to 400F.', '2 In a small bowl, whisk eggs and milk together. Set aside.', '3 Cook the onions and garlic: Heat olive oil in a 10-inch oven-safe skillet or pan over medium heat. Add the turmeric and stir so that turmeric dissolves into the oil.', 'Add diced onions and cook, stirring occasionally, until they start to soften, about 2 minutes. Add minced garlic and stir for 30 seconds.', '4 Cook the potatoes and other vegetables: Add the potatoes and a generous pinch of salt and cook, stirring occasionally, until some of the slices start to brown, 5 to 6 minutes.', 'Add the red pepper and cook until they start to soften, about 2 minutes. Add scallions and spinach leaves and cook until the leaves start to wilt, stirring occasionally.', '5 Pour egg mixture into the skillet and reduce heat to medium-low. Cook until the eggs start to set on the bottom, about 2 to 3 minutes.', '6 Place skillet in the oven and bake for 8 to 9 minutes, until the center is set. Remove skillet from oven with oven mitts. Let frittata cool for 5 minutes before serving. Cut into wedges and season with more salt and some ground pepper, if desired.', 'Frittata will keep refrigerated for 5 days. Leftovers can be eaten chilled or briefly warmed in the microwave.']",9
843,Creamy Potatoes with Cheese and Tomatoes Recipe,5,30,35,"['8 to 12 (about 1 pound) small red-skinned new potatoes', '1 1/2 teaspoons salt', '2 Tbsp butter', '1 medium yellow onion, finely chopped (about 1 1/2 cups)', '4 large green onions, cut into 1-inch lengths', '2 large fresh tomatoes, peeled and chopped', '1/2 cup heavy whipping cream', '1 Tbsp finely chopped fresh cilantro leaves', '1/2 teaspoon oregano leaves', '1/2 teaspoon ground cumin', 'Pepper to taste', '1 cup shredded Mozzarella cheese (fresh Mozzarella works well too!)']",12,"['1 Boil the potatoes: Scrub the potatoes; do not peel. Place the potatoes in a large pan and cover with cold water and about 1 1/2 teaspoons of salt. Bring to a boil and simmer for 20 minutes, or until tender when pierced. Drain. When cool enough to handle, cut large potatoes in halves or in quarters.', '2 Make the sauce: Melt the butter in a medium skillet over medium heat. Add the chopped onion and green onions and cook until wilted.', 'Add the tomatoes and cook, stirring often, for 5 minutes.', 'Stir in the cream, cilantro, oregano, cumin. Add salt and pepper to taste, and bring to a simmer. While stirring, slowly add the cheese and cook until the cheese is melted.', '3 Serve: Spoon the sauce over the potatoes to serve.']",5
844,Oven-fried Potato Chips Recipe,20,15,35,"['4 russet potatoes (or 6 Yukon gold potatoes), peeled and sliced diagonally 1/8 inch thick', '1/2 stick (1/4 cup) of butter, melted (can use extra virgin olive oil instead)', 'Kosher salt to taste']",3,"['1 Preheat oven and prepare baking sheet: Preheat oven to 500\\xc2\\xb0F (260\\xc2\\xb0C). Grease 2 large baking sheets with non-stick cooking spray. Make sure you are using sturdy baking sheets, or a flat roasting pan that can take high heat. A standard cookie sheet may warp.', '2 Soak potato slices in ice water, pat dry: Place the potato slices in a bowl of ice water for 5 minutes to remove some of the excess starch. Drain. Pat the slices of potatoes dry with paper towels.', '3 Put potato slices on baking sheet, brush with butter: Arrange the sliced potatoes in a single layer on the baking sheets. Use a pastry brush to brush the potato slices with melted butter.', '4 Bake: Put in the oven and lower the temp to 450\\xc2\\xb0F (230\\xc2\\xb0C). Bake until the edges are golden brown, about 12-15 minutes, depending on your particular oven.', 'Remove from oven and sprinkle with salt to serve.']",5
845,Potato Herb Tart Recipe,15,40,55,"['1 package (14 to 17 ounces) frozen puff pastry, thawed according to package directions', 'Flour, as needed', '1 or 2 medium Yukon Gold or Yellow Finn potatoes, peeled and left in cold water', '2 tablespoons olive oil', '1/2 teaspoon salt', '1/4 teaspoon pepper', '2 tablespoons chopped fresh herbs (like rosemary, thyme, parsley, or a mix)', '1/4 cup sour cream, to serve']",8,"['1 Preheat the oven to 375\\xc2\\xb0F. Line a baking sheet with parchment paper. (If your package of puff pastry contains two pieces, bake on two separate baking sheets.)', '2 Prepare the pastry: Unwrap the pastry, and if needed, unfold. Transfer to a baking sheet. The pastry should already be about 1/8-inch thick, which is what you want; if it seems thicker, gently roll it with a rolling pin. (Be careful of rolling too thin or the pastry tends to crack when cut or served.)', '3 Fold in the edges: Dip your fingers into flour to prevent them from sticking and fold in the edges all around the pastry to make a 1/2-inch border. Press the tines of a fork into the border to seal and make a decorative crust; dip the fork in flour as needed to prevent sticking.', 'Finally, prick the pastry and the border all over using the fork to prevent the pastry from puffing up during cooking.', ""4 Prepare the potatoes: Cut the potatoes 1/8-inch thick (or thinner) using a mandolin or a chef's knife."", 'Spread the potatoes evenly over the pastry, overlapping slightly. Don\\xe2\\x80\\x99t worry about making it look perfect; it should have a rustic feel. Sprinkle with olive oil, salt, pepper, and 1 tablespoon of the herbs.', '5 Bake the tart: Transfer the baking sheet to the oven and bake the tart at 375\\xc2\\xb0F for 35 to 40 minutes. Check the tart halfway through cooking, and if there are big puffs along the edge or bottom, prick them with the tip of a paring knife so they deflate.', 'When done, the pastry should be golden at the edges and the potatoes are tender when pierced with a skewer.', '6 Serve the tart: Slide the tart onto a large cutting board and sprinkle with the remaining 1 tablespoon of fresh herbs and a few pinches of salt. Slice into 12 pieces. Serve with sour cream for dipping or dolloping on top.']",9
846,Onion Potato Gratin Recipe,15,50,65,"['1 1/2 pounds Yukon Gold potatoes, peeled, cut into 1/4 inch thick slices', '1 large yellow onion, thinly sliced', '2 tablespoons unsalted butter', 'Salt', '2 teaspoons Herbes de Provence, or dried thyme', '1/2 teaspoon white pepper', '1/2 teaspoon nutmeg', '1 cup (packed) grated Gruyere cheese (about 4 oz)', '8 tablespoons (packed) freshly grated Parmesan cheese (about 2 oz)', '2/3 cup half-and-half (half cream, half milk)']",10,"['1 Preheat oven to 400\\xc2\\xb0F.', '2 Boil the potatoes: Boil the potatoes for 4 minutes in salted water (1 tablespoon of salt for 2 quarts of water). Drain and set aside.', '3 Saut\\xc3\\xa9 the onions, sprinkle with salt and herbs: Heat the butter over medium-high heat in a large saut\\xc3\\xa9 pan and cook the onions, stirring occasionally, until they are softened, about 5 minutes.', 'Sprinkle them with salt and the Herbes de Provence. Turn off the heat and set aside.', '4 Layer potatoes, cheeses, onions, nutmeg in baking dish, pour over with half and half: Spread half of the sliced potatoes over the bottom of an 11x7-inch baking dish (Pyrex works well). Sprinkle well with salt and white pepper.', 'Sprinkle with about a third of the Gruyere and Parmesan cheeses. Top with the onions, the nutmeg and another 1/3 of the cheeses.', 'Layer the remaining sliced potatoes on top of the cheeses.', 'Pour the half and half over everything. Sprinkle again with salt and pepper.', 'Sprinkle the remaining one-third of the cheeses over everything. (At this point you can make a day ahead, just cover and refrigerate until time to cook.)', '5 Bake: Bake uncovered in 400\\xc2\\xb0F oven until cream thickens and everything is nicely browned, about 25-30 minutes.']",10
847,Sheet Pan Chicken with Asparagus and Potatoes Recipe,20,90,110,"['16 small new potatoes (red or golden), halved', '3 small sweet onions (such as Vidalia or Walla Walla), quartered through the roots; or 1 large super sweet onion, cut into thin wedges', '1 medium lemon, very thinly sliced', 'Large handful fresh lemon thyme or other fresh herb (oregano, marjoram, or thyme).', '5 tablespoons olive oil', '1 teaspoon salt, or more to taste', '1/2 teaspoon black pepper, or more to taste', '2 large bone-in chicken breast halves (1 1/2 pounds, 680 g)', '2 whole chicken legs, thighs and drumsticks attached; or 2 legs and 2 drumsticks (1/2 pounds, 227 g)', '1 bunch (1 pound) fresh asparagus', 'Special equipment:', 'Sheet pan, at least 11-by-17 inches or larger']",12,"['1 Prepare the vegetables for roasting: Heat the oven to 375F. In a bowl, combine the new potatoes, onions, lemon, a few of the herb sprigs, 2 tablespoons of the olive oil, and half the salt and pepper. Toss well and spread on a rimmed baking sheet.', '2 Roast the vegetables for 40 minutes, or until the potatoes are almost tender when pierced with a skewer.', '3 Prepare the chicken: While the vegetables roast, sprinkle the chicken with 2 tablespoons of the remaining olive oil, and the remaining salt and pepper. Remove the leaves from several thyme springs and scatter them on the chicken.', '4 Add the chicken to the vegetables and roast: Move the vegetables in the pan aside to make room for the chicken. Set the chicken in the pan, skin side up, so it isn\\xe2\\x80\\x99t sitting on vegetables. Continue cooking for 30 minutes.', '5 Prepare the asparagus: Snap the spears near the base, where they break without much effort. Cut the spears in half to make shorter lengths. In a bowl, toss the asparagus with the remaining 1 tablespoon oil.', '6 Add the asparagus and roast: After the chicken has been roasting for 30 minutes, pull out the sheet pan and scatter the asparagus around the chicken.', '7 Continue roasting for 10 to 20 minutes, or until the chicken pieces all register at least 165\\xc2\\xb0F in the thickest part of the meat on an instant-read thermometer (the thighs will cook slightly faster than the breasts; you can pull them off the sheet pan as they reach temperature and keep them on a plate covered with foil, if you like).', 'All of the vegetables should also be cooked through. (Total cooking time is roughly 1 1/2 hours.)', 'If your chicken isn\\xe2\\x80\\x99t brown enough, slide the pan under the broiler for 2 minutes, watching it carefully to avoid burning.', '8 To serve the chicken: Discard the cooked thyme sprigs. Use kitchen shears to separate the legs to form 2 drumsticks and 2 thighs. Snip the breasts in half horizontally.', 'Arrange the chicken and vegetables on a platter. Remove the thyme from the remaining fresh sprigs and sprinkle it over the chicken.']",11
848,Smoked Salmon Hash Recipe,10,25,35,"['2 tablespoons extra virgin olive oil', '1 1/2 pounds Yukon gold potatoes, peeled and diced into 1/4-inch cubes', '1 cup chopped onion', '4 ounces hot-smoked salmon, broken into flakes', '2 tablespoons sour cream', '2 teaspoons prepared horseradish', '1 teaspoon Dijon mustard', '2 tablespoons chopped chives or green onion greens', '1 tablespoon minced fresh parsley', 'Salt and black pepper to taste', 'Lemon wedges and extra sour cream for serving']",11,"['1 Cook the potatoes: Heat the oil in a large cast iron frying pan on medium heat. Add the potatoes and onions, stirring to coat with the oil. Spread the potatoes and onions out in an even layer in the pan. Sprinkle the potatoes with a little salt.', 'Cook, using a metal spatula to scrape the bottom of the pan and turn the potatoes over every 2-3 minutes, until the potatoes are mostly browned and cooked through, about 15-20 minutes.', '2 Mix salmon, sour cream, horseradish, mustard, chives, parsley: While the potatoes are cooking, gently mix the salmon, sour cream, horseradish, mustard, chives and parsley into a bowl.', '3 Fold salmon mixture into cooked potatoes, rest 5 minutes: When the potatoes are done, turn off the heat and fold in the salmon mixture until it is well combined. Add salt and pepper to taste. Let this sit in the pan for 5 minutes before serving; the carryover heat in the pan will heat everything through.', 'Sprinkle with a little lemon juice if you want, and serve with a little extra sour cream on the side. Serve with runny eggs.']",5
849,Curried Potato and Vegetable Soup Recipe,15,40,55,"['4 Tbsp butter', '1 yellow onion, chopped', '1/2 yellow bell pepper, chopped', '1 large carrot, chopped', '1/2 teaspoon cumin seeds', '1 teaspoon turmeric', '2 teaspoons curry powder', '1 teaspoon yellow mustard seed', '2 cloves garlic, minced', '2 lbs Yukon Gold potatoes, peeled, quartered, cut into 1/2-inch slices', '4 cups chicken broth or vegetable broth (use vegetable broth for vegetarian option)', '2 cups water', '2 cups roughly chopped cauliflower florets (about 1/2 a head)', '1 1/2 teaspoons salt (more to taste)', '1 cup corn kernels (frozen is fine)', '2 small yellow summer squash, roughly chopped', '1/2 cup chopped fresh cilantro leaves (or parsley) for garnish']",17,"['1 Saut\\xc3\\xa9 onions, bell pepper, carrot, and cumin: In a large pot (6-quart), melt butter over medium high heat. Add the onion, bell pepper, carrot and cumin seeds. Cook, stirring occasionally until the onions are soft and the bell pepper is lightly browned.', '2 Add the turmeric, mustard seed, and curry powder and cook for a minute more.', '3 Add garlic and cook 30 seconds more.', '4 Add the potatoes, the broth, water, cauliflower, and salt. Increase the heat to high to bring to a boil, then reduce heat to medium-high or medium, enough to maintain a simmer. Let simmer uncovered for 20 minutes.', '5 Add the corn and summer squash, cook for 10 minutes more, until the vegetables are cooked through.', '6 Pur\\xc3\\xa9e half the soup: Use an immersion blender (or a regular blender) to pur\\xc3\\xa9e about half of the soup. Adjust seasonings.', 'Garnish with chopped cilantro (or parsley, though cilantro is particularly good with this soup).']",7
850,Turnip Potato Soup Recipe,15,50,65,"['6 Tbsp unsalted butter', '4 medium onions, thinly sliced', '3 pounds fresh, young turnips, peeled and thinly sliced', '1 1/2 pounds of Russet baking potatoes, peeled and thinly sliced', 'Salt', '6 Cups of chicken stock', '1/4 teaspoon freshly grated nutmeg', '2 Tbsp chopped fresh parsley for garnish']",8,"['1 Saut\\xc3\\xa9 the onions in butter: In a large, heavy, thick-bottomed pot, melt the butter on medium heat until it foams. When the butter foam subsides, add the onions and cook until translucent but not browned, about 5 minutes.', '2 Add turnips, potatoes, salt, cover and cook: Add the sliced turnips and potatoes and stir to coat with the butter. Add 2 teaspoons of salt, cover and reduce the heat to low. Cook, stirring occasionally, until the turnips and potatoes are tender, about 20 minutes.', '3 Add chicken stock: Add the chicken stock and increase the heat to bring to a simmer. Cover partially and cook over medium heat until the turnips and potatoes are very tender, about 10 minutes.', '4 Pur\\xc3\\xa9e the soup: Working in batches, pur\\xc3\\xa9e the soup in a blender until completely smooth. Return the soup to the pot and season with salt and freshly grated nutmeg. Ladle the soup into shallow bowls and garnish with the parsley before serving.']",4
851,Roasted Potatoes and Asparagus with Lemon-Mustard Dressing Recipe,10,25,35,"['For the potatoes and asparagus', 'Oil (for the baking sheet)', '1 pound small red-skinned potatoes, halved', '2 tablespoons olive oil, divided', '1/4 teaspoon salt, divided', '1 pound asparagus, bottoms trimmed and cut into 1 1/2-inch lengths', 'For the dressing', '3 tablespoons lemon juice', '1 teaspoon finely grated lemon zest', '1 teaspoon Dijon mustard', '1/8 teaspoon salt', '1/3 cup extra virgin olive oil', 'Freshly ground black pepper', '1 tablespoon chopped fresh tarragon']",14,"['1 Preheat the oven to 450\\xc2\\xbaF. Oil a rimmed baking sheet.', '2 Begin roasting the potatoes: Mound the potatoes in the center of the baking sheet. Sprinkle with 1 tablespoon of the olive oil and 1/8 teaspoon salt, or to taste. Toss to coat the potatoes and then spread on the baking sheet in one layer. Roast for 15 minutes. The potatoes should be partially cooked at this point.', '3 Add the asparagus and continue roasting: In a bowl, toss the asparagus with the remaining 1 tablespoon of oil and 1/8 teaspoon salt, or to taste.', 'Remove the baking sheet from the oven and push the potatoes to one side, keeping them in one layer. Spread the asparagus on the other side of the pan and return the pan to the oven.', 'Roast for 10 minutes longer, or until the asparagus and potatoes are tender. (Total cooking time is 25 minutes.) Transfer to a serving bowl.', '4 Make the dressing: In a small bowl, mix the lemon juice, lemon zest,  mustard, salt and a pinch of black pepper. Gradually whisk in the oil.', '5 Toss the potatoes in the dressing: Pour half the dressing over the warm potatoes and asparagus and toss to coat. Taste, and add more dressing, salt or pepper, if you like. Sprinkle with chopped tarragon and serve.']",7
852,Potato Cheddar Guinness Soup Recipe,15,50,65,"['2 Tbsp butter', '1 medium onion, chopped (about 1 1/2 cups)', '1 celery rib, chopped or sliced (about 1/2 cup)', '1 1/2 pounds (680 g) russet potatoes, peeled and thinly sliced', '3 cups (750 ml) chicken stock (add 1 1/2 teaspoons of salt if using unsalted stock)', '1 cup (250 ml) Guinness extra stout (do not use draught)', '1/2 teaspoon fresh or 1/4 teaspoon of dried thyme', '6 ounces (170 g) grated extra sharp cheddar cheese', '1 teaspoon Worcestershire sauce', '1/8 teaspoon paprika', 'Chopped chives for garnish']",11,"['1 Saut\\xc3\\xa9 onions and celery: Melt butter on medium  heat in a large, thick-bottomed pot. Add the onions and cook until golden, about 10 minutes. Add the celery and cook 5 minutes more.', '2 Add the sliced potatoes to the pot. Add the chicken stock, Guinness extra stout, and thyme. Bring to a simmer, lower the heat, partially cover, and simmer until the potatoes are tender and easily fall apart, about 15 to 20 minutes.', '3 Pur\\xc3\\xa9e the soup, adding grated cheddar: When the potatoes are tender, remove the pot from the heat.  Pour potato mixture into a bowl and let cool for a few minutes.', 'Working in batches, ladle the soup into a blender, filling the blender bowl only a third full at a time.', 'Add a portion of the grated cheddar to the blender bowl as well. (If it takes 3 batches to pur\\xc3\\xa9e the soup, divide the cheese into 3 portions.)', 'Holding the lid of the blender down (to keep the hot liquid from erupting out of the blender), pulse until smooth. Return the smooth pur\\xc3\\xa9e to the soup pot.', '4 Stir in the Worcestershire sauce and paprika. Taste for salt and add more if necessary. If the soup is too sour or bitter to your taste, add 1/2 teaspoon of sugar to the soup.', 'Garnish with chopped chives.']",8
853,Turnip and Potato Patties Recipe,15,30,45,"['1/2 pound turnips, peeled and cut into 1/4-inch cubes (about 1 1/3 cups)', '6 oz potato, peeled and cut into 1/2-inch cubes (about 1 cup)', '2 1/2 Tbsp thinly sliced scallion greens', '1 egg, beaten lightly', '1/4 cup all-purpose flour', 'Extra virgin olive oil, canola oil, or peanut oil', 'Salt and pepper']",7,"['1 Cook chopped turnip and potato in boiling water: In a large saucepan of boiling salted water, cook the turnip and potato cubes for 15 to 17 minutes, or until they are tender, and drain them.', '2 Mash turnips and potatoes: In a bowl, mash the cooked turnips and potatoes with a fork and stir in the scallions, the egg, flour, and salt and pepper to taste.', '3 Fry the patties: Coat the bottom of a large, heavy bottomed skillet with about 1/4-inch of the oil. Heat the pan on medium high heat until the surface of the oil begins to shimmer, but not smoke.', 'Spoon 1/4-cup mounds of the turnip potato batter into the pan, flattening them into 1/2-inch thick patties with the back of a spatula.', 'Fry the patties until they are golden, turning them once, about 4 minutes on each side. Transfer the patties to paper towels to drain off excess oil.']",5
854,Mashed Potatoes and Parsnips with Chives and Parsley Recipe,15,30,45,"['1 1/2 pounds parsnips', '1 1/2 pounds yukon gold potatoes', '2 teaspoons Salt', '4 1/2 cups water', '2 Tbsp unsalted butter', '1/2 teaspoon salt', '1 Tbsp chopped parsley', '1 Tbsp chopped chives', '1/8 teaspoon freshly ground black pepper']",9,"['1 Prep the parsnips and potatoes: Peel the parsnips. Cut them crosswise into 1/2-inch thick medallions. Peel the potatoes and cut them into 1 to 1 1/2-inch chunks.', '2 Simmer: Place into a medium saucepan, cover with water, add two teaspoons of salt. Bring to a simmer, reduce the heat, cover and let cook for 10 minutes, until a fork can pierce easily.', '3 Steam: Drain and return the parsnips and potatoes to the warm pan. Cover and let steam in the heat of the pan for 10 minutes.', ""4 Mash: Using a potato masher, mash the parsnips and potatoes until nicely mashed. Don't over mash or they will be gluey."", 'Add butter and salt (omit salt if using salted butter), and mash some more. Stir in the chopped parsley and chives. Add black pepper and more salt to taste.']",5
855,Green Mashed Potatoes Recipe,10,40,50,"['2 pounds russet potatoes (about 3 large or 5 medium sized potatoes), peeled and cut into 2 inch chunks', 'Salt', '3 sprigs of thyme (or a couple teaspoons dried thyme in a small boquet garni bag or tied up with cheesecloth', '1 bunch of fresh parsley, leaves chopped (about 1 cup)', '3 green onions (scallions), white and green parts chopped (about 1/2  cup)', '1/2 cup milk, divided', '1/4 cup cream', '3 Tbsp butter (more to taste)', '1 teaspoon freshly ground black pepper']",9,"['1 Boil the potatoes: Place the peeled and cut potatoes and the thyme in a medium (2 quart) saucepan and cover with cold water. Add two teaspoons of salt to the water.', 'Bring to a boil and reduce heat to maintain a low simmer. Simmer for 15 to 20 minutes until the potatoes are easily pierced with a fork.', '2 Pur\\xc3\\xa9e parsley and green onions with milk: While the potatoes are cooking, chop up the parsley and the green onions. Place the chopped green onions and parsley in a food processor. Add a teaspoon of salt and the 1/4 cup of the milk. Pulse until smooth.', '3 Drain potatoes, heat milk, cream, butter: When the potatoes are done, drain them in a colander and place them in a large bowl. Discard the thyme sprigs. Return the still hot, empty pot to the stove and add the remaining milk, cream, and butter. Heat on low heat until the butter is melted.', '4 Mash the potatoes: While the milk is heating, mash the cooked potatoes with a potato masher or use a potato ricer. (Do not over mix or the potatoes will turn gluey.)', '5 Stir mashed potatoes into heated milk and cream, stir in parsley pur\\xc3\\xa9e: Return the mashed potatoes to the pot with the milk mixture and stir to combine. Turn off the heat. Stir in the parsley green onion pur\\xc3\\xa9e. Add freshly ground black pepper, another teaspoon of salt, or more or less to taste.']",6
856,Fingerling Potatoes with Herb Vinaigrette Recipe,15,15,30,"['2 pounds fingerling potatoes, or small new potatoes, scrubbed and halved', '1/4 cup lemon juice', '1/3 cup extra virgin olive oil', '1 teaspoon minced fresh thyme leaves', '1 teaspoon minced fresh oregano leaves', '1/2 teaspoon of Dijon mustard', '1 teaspoon salt', '1/4 teaspoon freshly ground black pepper', '1/2 red onion, thinly sliced', '1/4 cup dry vermouth', '1/4 cup chopped fresh parsley']",11,"['1 Cook the potatoes: Place potatoes in a medium pot and cover with cold water by about an inch. Bring to a boil and add a teaspoon of salt to the water. Lower the heat to a simmer and let simmer until the potatoes are fork tender, about 6-8 minutes.', '2 Make the vinaigrette: While potatoes are cooking, prepare the herb vinaigrette. In a medium bowl, whisk together the lemon juice, thyme, oregano, mustard, salt, pepper, and olive oil.', '3 Add red onions to vinaigrette: Place the sliced red onions in the bowl with the vinaigrette. This will quickly ""pickle"" the red onion slices.', '4 Sprinkle strained potatoes with vermouth: Strain potatoes from the water and place them in a large bowl. Sprinkle on the vermouth and toss to coat. Let the potatoes sit for one minute to soak up the vermouth.', '5 Toss with onions, parsley and vinaigrette: Gently toss the potatoes with the onions, parsley, and the herb vinaigrette. Let sit for at least 10 minutes before serving.', 'Serve slightly warm, room temperature, or chilled.']",6
857,"Foil Packs with Sausage, Corn, Zucchini and Potatoes Recipe",15,20,35,"['4 fully cooked sausages (12 ounces), any kind, cut into 1-inch thick slices', '12 small potatoes (12 ounces), halved or quartered if large', '1 large red onion, cut into wedges through the root', '2 yellow or red bell peppers, seeded and cut into 1-inch wide strips', '1 zucchini, cut into 1/2-inch thick rounds', '1 yellow squash, cut into 1/2-inch thick rounds', '2 ears corn on the cob, husked and cut in half', '3 tablespoons olive oil', '1 teaspoon salt', '1/4 teaspoon black pepper', '1 teaspoon dried oregano', '4 thyme sprigs', '4 rosemary sprigs', 'Special equipment:', '18-inch wide roll of heavy-duty foil']",15,"['1 Preheat the grill: Build a charcoal fire or set a gas grill on medium high heat.', '2 Prepare the foil: Cut 4 pieces of heavy-duty foil into rectangles that are approximately 18x24 inches. Spray the centers with vegetable oil spray or brush with oil.', '3 Make the foil packets: In a large bowl, toss the sausages, potatoes, onion, peppers, zucchini, and corn with the oil. Add the salt, pepper, and dried oregano and toss again.', ""Divide the mixture between the four sheets of foil. Place a sprig of thyme and a sprig of rosemary on top of each pile. Fold the right side over the vegetables to cover them. Fold the opposite side over the first side so they're overlapping."", 'Fold the top and bottom ends in toward the center. Repeat the procedure with the remaining packets. (At this point, the packets can be refrigerated until ready to grill, up to 24 hours.)', 'Turn the packets so the folded side is on the bottom. With the tip of a paring knife, poke 4 or 5 steam vents in the foil.', '4 Grill the packets: Set the packets on the grill with the folded side down. Close the cover, and cook for 18 to 20 minutes, moving them once or twice during cooking to ensure they cook evenly. To test for doneness, remove a packet from the grill, turn it over, open the bottom and peek inside; be careful of steam.', '5 Serve the packets: Turn the packets so the vent sides are up. With a sharp knife, cut a large cross in the foil. Carefully peel back the foil to open the packets (hot steam releases immediately, so mind your fingers). Serve immediately.']",8
858,Colcannon Cakes Recipe,15,50,65,"['Colcannon:', '2 1/2 pounds of russet potatoes, peeled and cut into large chunks', 'Salt', '5 tablespoons unsalted butter', '3 lightly packed cups of chopped chard, kale, spinach, or cabbage', '1/2 cup of green onion greens, chopped', '1 cup milk or cream', 'Colcannon cakes:', 'About 3 cups of colcannon', '1 cup flour', '1 egg', '2-3 teaspoons salt', '4 tablespoons butter or vegetable oil', 'Lemon for garnish']",14,"['1 Make the colcannon: Make the colcannon first (see our colcannon recipe.) Put potatoes in a pot, cover with cold, well salted water by an inch, bring to a boil, and cook until fork tender, about 15 to 20 minutes.', 'Drain the potatoes and remove them from the pot. Melt the butter in the still warm pot, add the chopped greens, cook for 3-4 minutes until wilted, then add the green onions and cook for another minute.', 'Add the potatoes, milk or cream to the pot, mash until everything is well mixed.', '2 Mix with egg, flour, salt, and chill: Mix the egg, flour and salt in with the colcannon. You may want to chill the mixture for 15 minutes or longer to make it easier to shape the patties.', '3 Form into patties: Form into little cakes of whatever size you want, but make them flat so they will cook through without burning. If the mixture is too wet, add more flour until the mixture is easy to shape.', '4 Fry until golden: Heat the butter or vegetable oil in a large pan over medium-high heat. Working in batches, place the formed patties in the pan so they are not touching. Lower the heat to medium and gently fry until golden, about 3-4 minutes.', 'Turn and cook the other side. Let the cakes rest on a paper towel while you cook the others. Serve with slices of lemon.']",7
859,Smashed New Potatoes with Garlic and Chives Recipe,5,70,75,"['1-2 pounds new potatoes or Yukon Golds', '3 tablespoons unsalted butter', 'Salt', '1 minced garlic clove', '1-2 tablespoons minced chives or green onion greens']",5,"['1 Bake the potatoes: Preheat the oven to 350\\xc2\\xb0F. Put the potatoes in a medium oven-proof pot (with a cover) and add about 1 tablespoon of the butter, cut into pieces. Cover and bake in the oven for 20 minutes.', '2 Coat the potatoes with butter, sprinkle with salt, return to oven: Take the potatoes out and mix them so they\\xe2\\x80\\x99re coated with butter. Sprinkle the potatoes with salt. Return to the oven, cover, and cook for another 45 minutes to an hour, depending on how large the potatoes are.', ""3 Test for doneness: To test for doneness, poke a potato with a fork. If the fork penetrates easily, they're done."", '4 Crush with potato masher, toss with garlic and butter: When the potatoes are nice and soft, remove the pot from the oven and, using a potato masher, crush each potato. Don\\xe2\\x80\\x99t pound them into oblivion, just crush them. Toss with the garlic and remaining butter. Add more salt to taste.', 'Sprinkle chives on the potatoes to serve.']",5
860,Dinosaur Kale with Baby Potatoes Recipe,10,40,50,"['2 cups vegetable or chicken stock (use vegetable stock for vegan option)', '2 cups water', '1 pound baby potatoes of various colors', '3 tablespoons extra virgin olive oil, divided', '1 pound dinosaur kale or Swiss chard, chopped roughly', '3 garlic cloves, chopped', '1/4 teaspoon red pepper flakes', 'Salt and black pepper', 'Grated zest of a lemon', 'Lemon juice to taste']",10,"['1 Boil the potatoes: Bring the stock and water to a boil and add the potatoes. Turn the heat down to simmer gently until the potatoes are tender, about 20-30 minutes.', 'Drain (you can reserve the stock and water to cook rice or polenta with later) and coat the potatoes with 1 tablespoon olive oil. Salt well and set aside.', '2 Stir-fry kale, add garlic, red pepper flakes: Heat the remaining olive oil in a large saut\\xc3\\xa9 pan over medium-high heat for 1-2 minutes. Add the kale and turn to coat with the oil as it wilts.', 'Add the garlic and toss to combine, then add the red pepper flakes and some salt and black pepper. Stir-fry this for 2 minutes, then turn off the heat and cover the pan. Wait 2-4 minutes before uncovering.', '3 To serve, mix the lemon zest with the kale. Lay down a ""nest"" of kale on the plate and arrange the baby potatoes in the center. Squeeze some lemon juice over everything right as you serve.']",5
861,Pepper Jack Potatoes Recipe,10,20,30,"['1 1/2 pounds potatoes, peeled and cut into 1-inch chunks', 'Salt', '4 ounces pepper jack cheese, thinly sliced and cut into strips (or you can use shredded)', '1/2 cup cream']",4,"[""1 Boil the potatoes: Place peeled, cut potatoes into a 2 quart-sized pot. Cover with an inch of cold water. Add a tablespoon of salt to the water. Cover and bring to a boil. (Keep your eye on the potatoes, it's easy to overcook them.)"", 'As soon as the water is boiling, uncover and boil for 6 minutes, or until the potatoes are just tender enough so that you can insert a fork into them. The potatoes should be on the slightly underdone side.', '2 Drain potatoes, cover with cheese: Drain the potatoes and put them immediately into a serving bowl. Layer the cheese slices over them and put a plate over the bowl to cover, so that the steam from the potatoes melts the cheese.', 'Let sit for several minutes, then gently fold over with a spoon to spread the melted cheese around.', '3 Add cream: Pour cream over the potatoes and cover again until served.', 'If the potatoes are on the over-cooked side and fall apart as you toss them in the cheese, you can add the cream anyway and mash them for spicy, cheesy mashed potatoes. If the potatoes are still not quite cooked enough and the cheese is not quite melted enough, you can put them in a microwave for 20 seconds or so.']",6
862,Shaved Asparagus and Potato Pizza Recipe,20,40,60,"['2 1-pound balls pizza dough, homemade or store-bought', 'Cornmeal (for the baking sheets)', 'Flour (for rolling)', '1 1/2 pounds (about 16) baby red or yellow potatoes, thinly sliced', '3 tablespoons olive oil, plus more for drizzling', 'Salt and pepper, to taste', '16 thick asparagus stalks (about 1 pound)', '6 ounces gouda or fontina cheese, sliced']",8,"['1 Prepare and heat the oven: If you have one, place a pizza stone on a lower rack in your oven. Preheat the oven to 550F or as hot as it will go.', ""2 Pre-shape the pizza rounds and let them rest: Turn out the dough onto a generously floured counter  and cut it into 4 pieces. Working with 1 piece at a time, shape into a ball and then press flat into a 1-inch thick disk, dimpling with your fingertips as you flatten it. This isn't the final shaping; just a pre-shaping to help make the dough easier to work with later on."", 'Cover the first disk with a clean dishtowel, and repeat with the remaining pieces of dough. Let the disks of dough rest for 10 to 15 minutes while you prepare the vegetables. This gives the dough time to relax before shaping.', '3 Precook the potatoes: Mound the potato slices in the middle of a baking sheet. Sprinkle with 1 tablespoon of oil, and salt and pepper to taste. Toss together and spread in an even layer with no pieces overlapping.', 'Bake for 10 minutes, or until the potatoes are tender. Let cool briefly.', '4 Prepare the asparagus: Trim about 1/2 inch from the bottom of the asparagus spears. With a vegetable peeler, shave the spears into long, thin strips: hold a spear by the bud end and scrape down the length with the peeler. Turn the stalk often until you can no longer scrape it. Cut the remaining core of the spear into 1-inch pieces.', 'In a bowl, toss all of the asparagus with the remaining 2 tablespoons of oil, salt and pepper. Set aside.', ""5 Shape the pizza rounds: Sprinkle a layer of cornmeal over a pizza peel, a rimless baking sheet, or the back of a baking sheet. (If you don't have a pizza stone in your oven, just bake the pizza on the baking sheet.)"", 'Hold up one piece of dough at the edge and turn it as if you were holding a steering wheel, letting gravity pull the dough down (alternatively, roll with a rolling pin). Keep stretching it until the round is roughly a 12-by-8-inch oval or a 10-inch circle.', 'Place it on the pizza peel and shuffle the pan back and forth to ensure the dough is not sticking (sprinkle extra cornmeal underneath if it sticks.)', 'Leave the remaining rounds covered.', '6 Add the toppings and bake the pizza: Arrange one-fourth of the potatoes, one fourth of the cheese, and one fourth of the asparagus on top of the pizza round.', ""Slide the pizza onto the baking stone to bake (or bake on a baking sheet if you don't have a pizza stone)."", 'Bake for 10 to 12 minutes, or until the crust is golden and the cheese is bubbling. Use a pizza peel to remove the pizza from the oven and transfer it to a cooling rack.', 'Prepare and bake the other pizzas in the same manner. If your pizza stone is large enough, you can bake two pizzas side-by-side at the same time.', ""7 To serve: Pizzas are best served hot from the oven! Rather than waiting for all the pizzas to be done, slice and serve each pizza as it comes out of the oven. If you'd rather serve pizzas all at once, briefly re-warm any pizzas that cooled by placing them back in the oven for a minute or two.""]",16
863,Vegetable Samosas with Mint Cilantro Chutney Recipe,90,30,120,"['For the cilantro mint chutney:', '2 cups cilantro, coarsely chopped', '1 cup mint leaves', '1/4 cup lemon juice, from about 1 large lemon', '4-5 garlic cloves', '1-1 1/2 jalape\\xc3\\xb1os, chopped', '1-inch ginger root, peeled and chopped', '1 1/2 teaspoons salt', '1 1/2 teaspoons cumin seeds', 'For the dough:', '1 cup all-purpose flour', '1 teaspoon salt', '2 tablespoons melted ghee or vegetable oil', '1/4 cup cold water, added a tablespoon at a time', 'For the filling:', '2 medium russet potatoes, peeled, quartered', '1 tablespoon oil, plus more to wrap the samosas', '1/2 teaspoon cumin seeds', '1 medium onion, chopped', '1 1/2 teaspoons minced jalapeno', '1 teaspoon ground coriander', '1/2 teaspoon garam masala', '1/2 tsp ground turmeric', '1 teaspoon salt', '1/2 cup green peas, frozen and thawed', 'For frying:', '2 1/2 cups of vegetable oil']",27,"['1 Make the chutney: Combine cilantro, mint, lemon juice, garlic cloves, jalape\\xc3\\xb1os, ginger root, salt, and cumin seeds in a blender or food processor. It should be a thick enough to coat a samosa when dipped.', 'If you want it thinner, add 2 to 3 tablespoons of water. Transfer the chutney to a bowl, cover it, and wait until the samosas are ready.', '2 Begin making the samosa dough: In a large mixing bowl, combine all-purpose flour and salt.', '3 Drizzle in the ghee: Drizzle the melted ghee or vegetable oil around the flour mixture. Pick up a handful of the dough and rub it between your palms to mix the ghee as evenly into the flour as possible.', '4 Check the ratio of flour to ghee: To see if the flour to ghee ratio is good enough to make crispy pastry, hold a portion of mixture in your hand and make a tight fist, then open it. The mixture should hold its shape.', '5 Add water: Add water to the flour one to two tablespoons at a time while kneading. Knead into a smooth, firm dough. This should take about 5 minutes. Wrap the dough in cling wrap or cover with damp cloth until ready to fill the samosas.', '6 Make the filling: Set a medium pot filled with water over medium high heat. Add the peeled quartered potatoes, and bring them to a boil. Boil the potatoes until they are fork tender, about 15 minutes.', 'Set a large skillet over medium high heat and add the oil. Once the oil shimmers, add the cumin seeds to the skillet. Once they sputter, turn the heat down to medium and add the onion. Saut\\xc3\\xa9 for 3-4 minutes until the onion is softens. Add jalapeno, coriander, garam masala, ground turmeric, and salt. Give it a quick stir. Add the peas.', 'Drain the potatoes and add them to the skillet. Using the back of a wooden spoon or a potato masher, coarsely mash the mixture, leaving no large chunks of potatoes. Stir to combine. You want it mixed well. In the end, the filling should be relatively dry and thick.', 'Set aside to cool completely before filling the samosas.', '7 Knead the dough: While the filling is cooling, unwrap the dough, and knead it again for a couple minutes to make it smooth.', '8 Divide and shape the dough: Divide into 6 equal parts. Roll each into smooth balls, and cover with a damp cloth. Pick one ball, press between your palms to flatten, and lightly dab the surface of dough with oil or ghee. This prevents the rolling pin from sticking to the dough. Resist the urge to dust the countertop with flour, as the loose flour will burn when you drop the dough in the oil to fry, giving the samosa an off taste.', 'Use a rolling pin to flatten the dough into a circle 6 inches in diameter, 1 mm thickness. Cut in half so you have two half-moon shapes.', 'If you\\xe2\\x80\\x99re having a difficult time rolling out the dough, place the round between pieces of wax paper or parchment.', '9 Fill the samosa: Pick one half and brush the edges with water using your finger.', 'Pick one edge of the dough and place it on top of the other edge, making a cone shape. Gently pinch along the edges of the cone, making sure they are sealed.', ""Add 1 1/2 tablespoons of filling into the cone. This should fill it 3/4 of the way. Brush water on the edges of the cone's opening, and pinch the edges together to close the samosa."", 'Repeat with the rest of the dough. Cover sealed samosas with a damp cloth. In the end, you should have 12 samosas.', '10 Fry the samosas: In a deep pot, add the oil and heat to 200\\xc2\\xb0F over medium heat. Add the samosas to the oil and fry in batches; do not overcrowd the pot. Fry until the samosas begin to turn golden.', 'Once the samosas are golden, increase the heat to medium high, bringing the temperature up to 350\\xc2\\xb0F, and cook for another 5 minutes until the samosas have darkened to a deeper brown.', 'Take the samosas out of the oil and transfer them to plate lined with paper towels.', 'Reduce the heat back to medium or medium low, until the oil temperature drops back to 200\\xc2\\xb0F before going forward with the next batch of samosas. Getting this part right for a samosa is the trickiest part. If you start with high temperature oil, the pastry will turn soggy and oily. So, starting with warm oil and then increasing the heat is the way to go here.', '11 Serve: Serve immediately with a side of green cilantro mint chutney.']",23
864,Lemon Pound Cake Recipe,30,95,125,"['For the cake:', '2 1/2 cups (350 g) bread flour', '1/4 teaspoon baking soda', '1/8 teaspoon kosher salt', '1 3/4 cup granulated sugar', '1 cup (2 sticks) butter, room temperature', 'Zest from 3 lemons', '1/3 cup sour cream', '4 large eggs', '1 egg yolk', '1/4 cup lemon juice, from about 1 lemon', 'For the lemon syrup:', '1/2 cup granulated sugar', '1/4 cup lemon juice, about 1 lemon', '2 tablespoons water', 'For the icing:', '1 tablespoon butter', '1 1/4 cups powdered sugar', '2 tablespoons lemon juice', 'Special equipment:', 'Special Equipment', '9x5 inch loaf pan', 'Zester, such as a microplane', 'Parchment paper']",24,"['1 Preheat oven to 325\\xc2\\xb0F.', '2 Prep the pan: Butter the bottom of a loaf pan. Cut a piece of parchment paper so it covers the bottom of the pan and goes up the long sides of the pan like a sling. The short sides shouldn\\xe2\\x80\\x99t be covered. Leave enough parchment hanging over each side so that you can easily lift the loaf out of the pan.', '3 Whisk dry ingredients: Whisk together the flour, salt, and baking soda. Set aside.', '4 Begin making the batter: In the bowl of a stand mixer fitted with a paddle attachment, beat together the sugar, butter, and lemon zest on medium to medium high for 8 minutes. Stop occasionally to scrape down the bowl.', 'Add the sour cream and beat for one more minute, scraping down the sides of the bowl halfway through. One at a time, add the eggs and egg yolk, scraping down the bowl between additions.', 'Add the lemon juice and beat for 1 more minute scrape down the sides of the bowl halfway through, and once more before adding the flour.', '5 Add the flour to the batter: Set the stand mixer to stir (or the lowest setting) and add the flour mixture. Stir for about 1 minute or until the flour is just incorporated. Shut off the mixer and remove the bowl.', 'Use a spatula to scrape the sides and bottom of the bowl, and finish folding the ingredients together. The batter will be thick and velvety.', '6 Bake the pound cake: Scrape the batter into the prepared loaf pan. Smooth the top with a spatula.', 'Bake for 1 hour and 35 minutes, or until a skewer inserted into the center of the cake comes out clean.', '7 While the lemon cake bakes, make the lemon soaking syrup: In a small saucepan set over medium high heat, combine sugar, lemon juice, and water. Stir occasionally and bring to a low boil.', 'The syrup is ready when it looks transparent and is no longer cloudy. This should take about 5 minutes. Let the syrup cool.', '8 Soak the cake with syrup:  Once the cake has finished baking, remove it from the oven. It will have a slight crack down the center. That\\xe2\\x80\\x99s ok. Let the cake cool in the pan for 10 minutes.', 'With the cake still in the pan, pour half of the lemon syrup over the entire cake. Let it soak in. Then pour the remaining syrup over the cake. Let it continue cooling in the pan for another 15 minutes.', 'Run a knife along the ends to help release the cake. Use the parchment sling to lift the cake out of the pan, and set it on a baking rack to let it cool completely.', '9 While the cake cools, make the icing: In a medium microwave-safe bowl, melt the butter in the microwave for 10 to 20 seconds. Make sure you cover it so you don\\xe2\\x80\\x99t end up with splattered butter everywhere.', 'Add the powdered sugar. Whisk together while adding the lemon juice one tablespoon at a time.', '10 Frost the cake: Once the cake is completely cool, pour the icing over the lemon pound cake. Gently spread the icing so it completely covers the top. It should be white and thick. Slice and serve.']",18
865,Vanilla Pound Cake Recipe,20,70,90,"['For the cake:', '1 1/2 cups sugar', '1 cup unsalted butter', '1 tablespoon vanilla extract', '4 large eggs', '2 cups all-purpose flour', 'For the vanilla glaze', '3 tablespoons butter, melted', '1 cup powdered sugar', '2 teaspoons vanilla extract', '2 to 3 tablespoons milk', 'Special equipment:', '8x4 inch loaf pan']",13,"['1 Prep the oven and pan: Preheat oven to 350\\xc2\\xb0F. Butter and line an 8-inch loaf pan with parchment paper, creating a sling.', '2 Beat the butter and sugar: In a large bowl with an electric hand mixer or in the bowl of a stand mixer, beat sugar, butter, and vanilla extract on medium high speed until light and fluffy, about 8 minutes. Scrape down the bowl. Beat for another 30 seconds.', '3 Beat in the eggs: Add eggs one at a time, waiting until each egg is fully incorporated and scraping down the bowl before adding the next egg.', '4 Mix in the flour: With the mixer on low speed add in the flour and mix just until a batter is formed, but you still see some streaks of flour. Use a spatula to finish folding the dough together. It should be thick.', '5 Bake the cake: Scoop the batter into the prepared loaf pan and smooth the top. Bake for 60 to 70 minutes, or until a toothpick inserted in the center of the cake comes out clean.', '6 Cool the cake: Remove the cake from the oven. Run a thin knife around the edges while still warm, then cool for 15 minutes in the pan before unmolding. Allow to cool completely on a wire rack.', '7 While the cake cools, make the glaze: Whisk together the melted butter, sugar, and extract. Add the milk 1 tablespoon at a time until the glaze is a smooth, pourable consistency.', '8 Glaze and serve: Pour the glaze over cooled cake. The cake can be served immediately, or you can wait for the glaze to dry, then cover with plastic wrap and store on the counter for up to 5 days. The cake can also be tightly in plastic and frozen for up to three months.']",8
866,Eggnog Pound Cake Recipe,25,65,90,"['Cake:', '3/4 cup sweetened dried cranberries, chopped', '1 Tbsp orange zest', '4 Tbsp brandy (can sub orange juice or water)', '3 cups all-purpose flour', '2 teaspoons baking powder', '1/2 teaspoon salt', '1/2 teaspoon nutmeg', '1/4 teaspoon cinnamon', '1/4 teaspoon allspice', '1 cup (2 sticks) unsalted butter', '2 cups white granulated sugar', '5 large eggs, room temperature', '1 cup eggnog', '1 teaspoon vanilla extract', '2 to 4 Tbsp brandy for drizzling on the cake (optional)', 'Glaze:', '1 to 2 Tbsp orange juice', '1 Tbsp brandy or dark rum', '1 cup powdered sugar']",20,"['1 Soak the cranberries. Soak dried chopped cranberries and orange zest in brandy in a small bowl for 15 minutes.', '2 Preheat oven. Adjust rack to lower third of oven. Preheat the oven to 325\\xc2\\xb0F. Generously butter the inside of a 9 to 10 inch bundt pan.', '3 Mix dry ingredients. In a bowl, whisk together flour, baking powder, salt, nutmeg, cinnamon, and allspice.', '4 Cream the butter and sugar. Using an electric mixer on medium speed, beat butter until creamy, 30-45 seconds. Add sugar and beat until light and fluffy, about 5 minutes. Scrape bowl with a rubber spatula occasionally as needed. Add eggs one at a time, beating 1 minute after each addition. Add the vanilla extract.', '5 Add dry ingredients and eggnog to butter sugar mixture. Remove the mixing bowl from the mixer and use a rubber spatula to gently add the dry ingredients in 4 additions, alternating with eggnog (begin and end with dry ingredients). Gently fold in orange zest, dried cranberries and any remaining brandy.', ""6 Bake. Spoon the batter into the prepared bundt pan and spread evenly. Bake at 325\\xc2\\xb0F 55-60 minutes, or until cake springs back when touched lightly in the center and pulls away from the sides of the pan. You can also use a bamboo skewer and insert into the thickest part of the cake. If it comes out clean, it's done."", '7 Cool. Remove from oven and cool upright in the pan on a rack for 10 minutes. Invert cake onto a rack while the cake is still warm. Let cool completely.', '8 Prepare glaze. Once the cake has completely cooled, prepare glaze by whisking together powdered sugar, orange juice, and brandy. (You can sub the brandy with more orange juice or water if you want.)', 'Make the glaze thick if you would like a thick, pronounced drizzle, or make it more thin if you want a glaze that is somewhat translucent.', '9 Glaze cake. Place cake on serving platter. Poke a few holes in the top and drizzle with brandy if you want. Use a spoon to stream the glaze onto the cake in back and forth motions to create a striped pattern. Or, if the glaze is thin enough, you can use a pastry brush to brush on the glaze.']",10
867,Lemon Blueberry Ricotta Pound Cake Recipe,20,65,85,"['1 3/4 cups (250 g) all purpose flour', '2 teaspoons baking powder', '1/2 teaspoon salt', '3/4 cup (1 1/2 sticks) unsalted butter, room temperature', '1 cup (8 ounces, 230 g) ricotta cheese, left to stand at room temperature for a few minutes to take the chill off', '1 1/2 cups sugar (300 g)', '3 large eggs, room temperature', '1 teaspoon vanilla extract', '1 tablespoon lemon zest', '1 1/2 cups (140 g) blueberries']",10,"['1 Preheat oven to 325\\xc2\\xb0F (160\\xc2\\xb0C). Prepare a 9x5-inch loaf pan, smearing the inside with butter.', '2 Whisk the dry ingredients: In a medium bowl, vigorously whisk together the flour, baking powder and salt.', '2 Toss blueberries with flour: Rinse the blueberries and toss them with a little flour to lightly coat them (this will help keep them from sinking to the bottom of the cake).', '3 Mix wet ingredients and sugar for batter: Use an electric mixer (you can mix by hand but will get better results if you use an electric mixer) to beat together the butter, ricotta, and sugar, on high speed, for 3 minutes, until pale and fluffy.', 'Add the eggs one at a time, mixing on medium speed for one minute after each addition.', ""Mix in the lemon zest and vanilla extract. Don't worry if the batter looks a little curdled at this point. It isn't curdled; it just looks that way."", '4 Add dry ingredients, then blueberries: Remove the bowl from the mixer and stir in the dry ingredients in 3 or 4 additions, until just incorporated. Do not over mix. Stir in the blueberries.', '5 Pour the batter into the prepared loaf pan, smoothing out the top with a rubber spatula. Place on a baking sheet on the middle oven rack of the oven. (This will help moderate the temperature at the bottom of the pan.)', '6 Bake: Bake at 325\\xc2\\xb0F (160\\xc2\\xb0C) for 1 hour 10 minutes to 1 hour 20 minutes, or until a tester inserted into the center comes out mostly clean, or if you press on the center with your fingers and lift up, the cake surface gently bounces back.', 'After the first 40 minutes of baking you may want to put a sheet of aluminum foil over the top of the pan to keep it from browning further.', '7 Cool: Remove from oven and let cool for 15 minutes in the pan. Then run a dull knife around the edge of the cake to make sure it is separated from the pan.', 'Gently remove the cake from the pan and let cool completely on a wire rack. Let cook completely before slicing.']",12
868,Marmalade Pound Cake Recipe,15,70,85,"['1 1/2 cups (340 g) unsalted butter, at room temperature, plus more for pans', '3 cups (360 g) all-purpose flour, plus more for pans', '2 1/2 cups (495 g) granulated sugar', '2 tablespoons grated orange zest, from 2 large oranges', '8 large eggs, at room temperature', '1/3 cup (80 ml) marmalade', '1 tablespoon vanilla extract', '1 1/2 teaspoons baking powder', '1 teaspoon salt', 'For the glaze:', '3/4 cup (85 g) powdered sugar', '2/3 cup (160 ml) marmalade', '1/2 cup (120 ml) water', 'Special equipment:', 'Two 8x4 inch pans']",15,"['1 Preheat your oven to 325\\xc2\\xb0F. Butter and lightly flour two 8 x 4-inch loaf pans. (Alternatively, line your pans with a parchment paper sling and spray all sides with cooking spray.)', '2 Make the batter: Using a stand mixer fitted with the paddle attach\\xc2\\xadment, cream the butter, sugar, and orange zest together for 3 to 4 minutes, or until fluffy.', 'Break the eggs into a spouted measuring cup. With the mixer running on a moderate speed, add the eggs, one at a time. When the eggs are incorporated, add the marmalade and vanilla and beat them in.', 'In a medium mixing bowl, whisk together the flour, baking powder, and salt. Add the flour mixture to the batter and mix just until combined, stopping to scrape down the sides of the bowl with a silicone spatula, as needed. Remove the bowl from the mixer and stir a few times to ensure that the flour from the edges of the bowl and any runnier batter from the bottom are all blended in.', '3 Bake: Divide the batter evenly between the 2 prepared pans and smooth the tops. Place on a baking sheet (to make it easier to move them around). Bake the cakes for 35 minutes.', 'When the time is up, rotate the pans 180\\xc2\\xb0 so that the cakes bake evenly. Continue to bake until a cake tester comes out mostly clean from the center of a cake (a few crumbs are okay), another 30 to 35 minutes.', '4 While the cakes bake, prepare the glaze: In a small pan, combine the powdered sugar, marmalade, and water. Place over medium heat and warm until everything melts together.', '5 Cool and glaze the cakes: Remove the pans from the oven and place them on a wire rack set over a baking sheet. Let them cool for 10 to 15 minutes and then remove the cakes from the pans.', 'Set them, top-side up, on the rack and spoon the glaze over the warm cakes. Use a brush to glaze the sides of the cakes. Keep spooning and brushing until all the glaze has been distributed over the cakes.', 'Let them cool completely before serving.']",10
869,Chipotle Turkey Pozole Recipe,15,75,90,"['Soup:', '2 tablespoons extra virgin olive oil', '1 large onion, chopped (about 2 cups)', '3 large garlic cloves, minced', '1/4 cup to 1/2 cup minced chipotles in adobo (to taste)', '1 15-ounce can crushed or diced tomatoes', 'Salt', '4 to 5 cups leftover cooked turkey meat, shredded', '1 large (108 ounce, 6 lb 12 oz, 3 kg) can white hominy, rinsed and drained', '4 quarts of turkey stock or chicken stock', '3 bay leaves', '2 Tbsp dried oregano (Mexican if available)', '1/8 teaspoon ground cloves', '1/4 teaspoon cinnamon', 'Toppings', '1/2 head green cabbage, sliced thin', '3 avocados, diced', '1 bunch red radishes, sliced thin', '8 ounces Cotija cheese, crumbled', '1 large bunch cilantro, chopped (stems included)', '1 red onion, chopped', '4 limes, cut into wedges', 'A couple dozen tostada shells (can use tortilla chips or fried corn tortillas as well)']",23,"['1 Saut\\xc3\\xa9 onions, garlic, add chipotle: Heat olive oil on medium high heat in a large (12 quart) stockpot. Add the chopped onion and cook until translucent, about 4 minutes. Add the garlic.', 'Add the minced chipotles in adobo (start with 1/4 cup and add more later to desired heat). Cook for another 3 minutes.', '2 Add remaining soup ingredients and simmer: Add the tomatoes and cooked turkey meat to the pot, stirring to combine. Add the rinsed and drained hominy. Add the stock.', 'Taste and add salt (at least a tablespoon if you are using unsalted stock) to taste. Add the bay leaves, oregano, ground cloves, and cinnamon. Add more water if the soup is too thick with hominy for your preference.', 'Bring to a simmer. Taste and add more salt, herbs, or chipotle to taste. You may need more salt than you expect, if you are using homemade, unsalted stock. Simmer for 45 minutes.', '3 Set the table with toppings arranged in separate serving dishes. Spoon out the soup into bowls. Let people add the toppings they want to the soup.']",6
870,Chicken Pozole Salad Recipe,15,20,35,"['Chicken:', '2 boneless, skinless chicken breasts, about a pound total', '1/2 teaspoon chili powder', '1/2 teaspoon ground cumin', '1/4 teaspoon salt', '1/4 teaspoon ground black pepper', '1 tablespoon extra virgin olive oil', '1 15-ounce can hominy, drained', ' Vinaigrette:', '1 tablespoon minced red onion or shallot', '1 1/2 teaspoons chopped fresh oregano or 1/2 teaspoon dried oregano', '1 1/2 teaspoons lime zest', '3 tablespoons lime juice', '1/2 cup good quality light olive oil', '1 teaspoon sugar', '1/4 teaspoon salt', ' Salad:', '1 avocado', '2 green onions, thinly sliced, including green parts', '3 radishes, halved and sliced', '1/4 head green or red cabbage, thinly sliced', '1 small head of romaine lettuce, sliced crosswise into inch-wide pieces', '1/4 cup roughly chopped cilantro', '2 tablespoons crumbled cotija (can sub feta) cheese']",24,"['1 Coat the chicken breasts with spice rub and cook: Mix the chili powder, cumin, salt and pepper in a medium bowl. Add the boneless skinless chicken breasts and toss to coat well.', 'Heat the olive oil in a thick-bottomed saut\\xc3\\xa9 pan on medium high heat. Add the chicken breasts and cook for two minutes on each side.', 'Lower the heat to low and cover the pan and cook until the breasts are just cooked through, about 4 to 5 more minutes. Remove the chicken from the pan and let cool to touch.', '2 Saut\\xc3\\xa9 hominy in same pan: In the same pan that you used to cook the chicken, add the drained hominy. Toss with the remaining seasoning in the pan. Sprinkle with a little more salt, chili powder and ground cumin.', 'Cook on medium high heat for 1 to 2 minutes. Remove from heat.', '3 Make vinaigrette: Whisk together the vinaigrette ingredients\\xe2\\x80\\x94red onion, oregano, lime zest, lime juice, olive oil, salt, and sugar\\xe2\\x80\\x94in a small bowl. Set aside.', '4 Slice chicken and avocados: Slice the cooled chicken across the grain of the meat in 1/4-inch thick slices. Peel and slice the avocado.', '5 Toss salad with hominy and vinaigrette, top with chicken, avocado and cotija: Toss the romaine lettuce, cabbage, green onion, cilantro, radish, and hominy with half of the vinaigrette. Arrange on serving plates.', 'Place several slices of chicken and avocado on top of each plate of greens. Sprinkle with cotija cheese. Drizzle the remaining vinaigrette over the salads.']",9
871,How To Make Jam in the Microwave,5,15,20,"['2 to 3 cups berries or diced fruit', '1/4 to 1/2 cup sugar, honey, or other sweetener', '1 to 2 tablespoons lemon juice, to taste', 'Special equipment:', '8-cup glass measuring cup or microwave-safe mixing bowl', 'Heat-proof spatula', 'Oven mitts', 'Half-pint canning jars or other small refrigerator container, for storing']",8,"['1 Prepare the fruit: Remove all seeds, cores, pits, or other non-edible parts. Peels can be left or removed. Cut larger fruits like peaches and strawberries into small pieces. Berries can be left whole.', ""2 Macerate the fruit and sugar: Toss the prepared fruit with 1/4 to 1/2 cup of sugar or other sweetener and 1 to 2 tablespoons of lemon juice (to taste) in an 8-cup glass measuring cup or microwave-safe mixing bowl. If you're using berries, lightly mash them to release their juices. Let the fruit macerate for at least a half an hour, until the sugar is dissolved and the fruit looks syrupy."", '3 Microwave for 10 minutes, stirring halfway: Microwave the fruit, uncovered, at full power for 5 minutes. The fruit juices will bubble up as the fruit cooks, quadrupling in volume. Carefully remove the bowl using oven mitts (the glass will be hot), and stir the fruit. It will look quite loose and liquidy at this point. Return to the microwave and cook another 5 minutes.', ""4 Stir the fruit again: Remove the fruit from the microwave with oven mitts and stir it again.The jam will probably still look fairly syrupy at this point. Mash the fruit against the sides of the bowl if you'd like a smoother texture, or leave it as is for a chunkier texture."", ""5 Continue to microwave in 2 to 3 minute intervals. Stir the jam between each interval and continue cooking until the liquid concentrates to a sticky syrup that coats the back of the spatula and falls in heavy drips back into the bowl. Don't worry if the jam still seems a little loose at this point; it will set more firmly as it cools. Total cooking time is usually around 15 minutes for most fruits."", ""If you're unsure whether the jam ready, it's best to err on the side of caution. Over-cooking can cause the jam to crystallize and harden. If the jam still seems loose after it cools, return it to the measuring cup and cook it a few more minutes."", '6 Cool and store the jam: Transfer the jam to a canning jar or other storage container. Let it cool, uncovered, on the counter. Once cool, cover and store in the refrigerator for several weeks or freeze for up to 3 months.']",7
872,Pressure Cooker Moroccan Chicken Recipe,10,30,40,"['For the Ras el Hanout spice blend (or substitute 2 tablespoons store-bought blend):', '1 teaspoon paprika', '1 teaspoon ground ginger', '1 teaspoon ground cumin', '1 teaspoon ground coriander', '1/2 teaspoon ground turmeric', '1/2 teaspoon ground cinnamon', '1/2 teaspoon ground allspice', '1/2 teaspoon kosher salt', 'For the Chicken:', '1 tablespoon olive oil', '1 red onion, sliced', '3 cloves garlic, chopped', '1 cup low sodium chicken broth', '1 cup pitted green olives (with or without pimentos)', '1/2 cup raisins', '1/2 lemon, sliced thinly, seeds removed', '3 pounds boneless, skinless chicken thighs', 'To Serve:', '1/4 cup chopped cilantro and/or parsley', 'Special equipment:', '6-quart Instant Pot or other pressure cooker']",22,"['1 Make the spice blend: In a small bowl, stir together the spices and salt.', '2 Cook the onions, garlic, and spices: Select your pressure cooker\\xe2\\x80\\x99s \\xe2\\x80\\x9cSaut\\xc3\\xa9\\xe2\\x80\\x9d setting and heat the olive oil. Add the onion and garlic and cook until the onions are softened and the garlic is beginning to brown, about 5 minutes. Stir in the spices and cook for one more minute.', '3 Add the remaining ingredients and pressure cook: Pour in the chicken broth and scrape the bottom of the pot release any browned spices. Stir in the olives, raisins, lemon slices, and chicken thighs.', 'Secure the lid on the pressure cooker and make sure the pressure release valve is set to its \\xe2\\x80\\x9cSealing\\xe2\\x80\\x9d position. Select the \\xe2\\x80\\x9cPoultry,\\xe2\\x80\\x9d \\xe2\\x80\\x9cManual\\xe2\\x80\\x9d or \\xe2\\x80\\x9cPressure Cook\\xe2\\x80\\x9d setting, and set the time to 15 minutes at high pressure.', 'When the cooking program ends, either perform a quick pressure release by moving the pressure valve to its \\xe2\\x80\\x9cVenting\\xe2\\x80\\x9d position, or let the pressure release naturally and leave the chicken on your pressure cooker\\xe2\\x80\\x99s warming setting until ready to serve.', '  4 Serve: Sprinkle the chicken with chopped cilantro and/or parsley, and serve it with rice, couscous, riced cauliflower, or zucchini noodles.']",6
873,Chocolate-Covered Pretzels Recipe,15,0,15,"['12 ounces semi-sweet chocolate chips', '12 ounces white chocolate chips (see headnote above)', '4 ounces (72 individual) mini pretzel twists']",3,"['1 Line a baking sheet with parchment paper or silicon baking sheet.', '2 Melt the semi-sweet chocolate: Place the semi-sweet chocolate in a microwave-safe bowl. Microwave for 1 minute and 30 seconds at 50% power.', 'Stir the chips. Microwave for 30 seconds at 100% power. Stir until chocolate is melted and smooth.', 'If the chocolate still has lumps, microwave in 15-second intervals at 100% power, stirring between each interval until smooth.', '3 Dip half the pretzels in semi-sweet chocolate: Place a mini pretzel in the semi-sweet chocolate and push it below the surface with a fork to coat.', '4 Remove the excess chocolate: Use a fork to remove the pretzel from the chocolate. Then tap it gently against the sides of the bowl until most of the chocolate has dripped off.', 'Wipe the bottom of the fork on the edge of the bowl to remove any excess chocolate then slide the pretzel onto the lined baking sheet (use a second fork if needed).', 'Repeat until you have coated half the pretzels. You should still have a little melted chocolate left.', '4 Repeat with the white chocolate: Repeat the process for melting the chocolate using the white chocolate chips in a clean bowl. Repeat the coating process with the remaining pretzels in the white chocolate.', '5 Drizzle the pretzels using the remaining chocolate: Dip a fork the remaining semi-sweet chocolate and drizzle it over the white chocolate-coated pretzels; repeat with the remaining white chocolate.', 'If you want more control over the drizzle, scoop the chocolate into a quart size freezer re-sealable bag. Snip a very small corner of the bag (1/16-inch) to make a tiny hole. Squeeze the bag to drizzle the chocolate in a more controlled manner.', '6 Refrigerate all the pretzels until the chocolate is hard. Then remove from pan and store in an air-tight container in the fridge. The pretzels will keep for 7 to 10 days.']",12
874,Carrie Havranek\xe2\x80\x99s Amish-Style Soft Pretzels Recipe,50,10,60,"['2 1/2 cups (300 grams) all-purpose flour', '1 teaspoon salt', '1 tablespoon brown sugar', '2 1/4 teaspoons instant dry yeast (one packet)', 'Scant 1 cup warm water', '1/4 cup baking soda', 'Kosher or coarse sea salt, for sprinkling', '4 tablespoons unsalted butter, melted']",8,"['1 Make the dough: Place the flour, salt, brown sugar, yeast, and warm water in the bowl of a stand mixer with the hook attachment and beat until well combined. Knead the dough, by hand or machine, until it\\xe2\\x80\\x99s smooth and soft, 5 to 7 minutes.', '2 Rest the dough: Flour the dough a little, place on a floured surface, and cover. Let rest for 30 minutes.', '3 Prep the oven and baking sheets: Preheat the oven to 475\\xc2\\xb0F. Prepare a baking sheet with parchment or nonstick cooking spray.', '4 Divide the dough: Uncover the dough and divide it into eight equal pieces. Let them rest, uncovered, for another 5 minutes.', '4 Twist the pretzels: Using the palms of your hands, roll each piece into a thin rope approximately 25 to 30 inches long. Twist each rope into a pretzel shape by lifting the ends of the rope, crossing them to make a twist, and then folding them back down onto the bottom loop. Gently press the ends so they stay in place.', '5 Make the baking soda bath: Boil 6 to 8 cups water in a large stockpot over high heat and add the baking soda, stirring until it\\xe2\\x80\\x99s dissolved. Reduce to a simmer.', 'Working quickly and carefully, dip each pretzel into the water bath, and simmer for 30 seconds on each side, flipping them with a slotted spoon. They will puff up slightly in the water.', '6 Bake the pretzels: Transfer the pretzels to the prepared baking sheet and sprinkle with coarse sea salt. Bake pretzels until golden brown, 8 to 10 minutes.', '7 Brush with butter: Remove from the oven and brush with the melted butter, using up all the butter. These pretzels are best consumed while warm. They can be reheated in the oven, or frozen and defrosted later in a low oven. Top with your favorite mustard, if desired.']",9
875,Peanut Butter Pretzel Magic Bars Recipe,20,240,260,"['3 1/3 cups (5 oz) mini pretzels, for the crumb crust, plus additional whole pretzels for topping', '6 tablespoons melted butter', '3 tablespoons sugar', '1 (14-ounce) can sweetened condensed milk (397g), divided', '1/4 cup (57g) smooth peanut butter', '3/4 cups (100g) peanut butter chips', '1/2 cup (100g) mini chocolate chips', '1 1/2 cups (75g) unsweetened coconut flakes']",8,"['1 Prep pan: Preheat the oven to 350\\xc2\\xb0F. Line an 8x8-inch square baking pan with foil, allowing a couple inches to overhang down the side of the pan. Generously, coat with cooking spray or brush with melted butter. Set aside. If using a glass baking dish, lower the oven temperature to 325\\xe2\\x84\\x89.', '2 Warm the peanut butter: Pour 1/4 cup of sweetened condensed milk into a small bowl and set aside. In another bowl small bowl, add the peanut butter and remaining condensed milk. When combined you should have about 1 1/4 cups. Microwave for 30 seconds. Stir the mixture until smooth. Set aside to cool.', '3 Make the crust: In the bowl of a food processor, add 3 cups whole pretzels and process for 15 seconds until the largest pieces are the size of small peas. Measure out 1 1/4 cups (120 g) pretzel crumbs and return them to the food processor bowl. (If you have extra crumbs save them to sprinkle on ice cream!)', 'Add the sugar and melted butter and process continuously for 20 seconds. The mixture will look like wet sand.', 'Pour the pretzel mixture into the prepared pan. Use a measuring cup or glass to press the mixture firmly into an even layer in the bottom of the pan.', '4 Bake the crust: Bake the crust until it feels firm to the touch and is slightly golden around the edges, about 10 minutes.', '5 Assemble the first layer: Stir the peanut butter and condensed mixture again, then pour 3/4 cup of the peanut butter mixture over the baked crust. Use a towel, or oven mitts to gently tilt the pan from corner to corner so the peanut butter mixture completely covers the crust. Top with half of the shredded coconut, half of the peanut butter chips and half of the chocolate chips.', '6 Finish assembling: Pour remaining 1/2 cup peanut butter and condensed milk mixture over the entire layer. Top with remaining shredded coconut, peanut butter and chocolate chips. Arrange whole pretzels on top and use your hands to gently press the bars down to ensure the layers are compact. Drizzle with the reserved condensed milk.', '7 Bake the bars: Bake on the center rack of the oven for 30-35 minutes until the edges are turning golden and the center is just starting to take on color. The center might be a little soft but the bars will firm up as it cools.', '8 Cool: Remove the bars from the oven and cool on a cooling rack for 1 1/2 hours. Take out of the pan and remove foil. Continue cooling on rack for an additional 1 hour. Once bars reach room temperature, wrap in plastic wrap and chill in refrigerator for 2 hours or overnight. This will ensure that the bars slice cleanly with the least amount of crumbling. You can cut them once they\\xe2\\x80\\x99ve cooled to room temp, but the crust may crumble.', '9 Serve & store: Once the bars are chilled, slice into 16 squares and serve. Store leftover magic bars in an air-tight container in the refrigerator for 7 days or at room temperature for 5 days.']",11
876,Prosciutto-Wrapped Asparagus Recipe,10,10,20,"['1 pound asparagus, preferably thick spears', '3 to 3 1/2 ounces sliced prosciutto', '1 to 2 tablespoons olive oil', 'Ground black pepper', 'Lemon zest, optional', 'Freshly grated Parmesan cheese, optional']",6,"['1 Heat the oven to 400F. Line a large sheet pan with parchment paper and set aside.', '2 Prepare the asparagus: Rinse and pat dry the asparagus. Snap off the tough ends of the asparagus. Set asparagus spears aside. (Reserve the snapped ends for another meal, if you like.)', '3 Wrap the asparagus with prosciutto: Cut prosciutto slices in half down their length. Wrap each spear of asparagus with one strip of sliced prosciutto. Tug the prosciutto a little as you wrap it around the asparagus to give it tension. This helps to ensure that the prosciutto wraps around the asparagus tightly.', 'Lay the wrapped asparagus spears on the lined sheet pan.', '4 Drizzle the asparagus with 1 to 2 tablespoons of olive oil. Sprinkle a pinch of black pepper on top.', '5 Bake the asparagus for 8 to 10 minutes. When done, the asparagus will be bright green and easily pierced with a fork, and the prosciutto will be crisped around the edges.', '6 Serve the asparagus. Transfer the asparagus to a serving platter. Top with lemon zest and freshly grated parmesan cheese, if using. Serve immediately while hot.']",7
877,Chicken Prosciutto Recipe,15,25,40,"['2 lbs chicken cutlets', 'Freshly ground black pepper', '1 stick (1/2 cup) unsalted butter', '8-12 whole fresh sage leaves', '1/2 pound very thinly sliced prosciutto', '2 eggs, beaten', '8 thin slices Italian Fontina cheese (about 2 oz)', 'Sauce:', '1 cup dry white wine (like a Sauvignon blanc)', '1 Tbsp minced fresh sage', '1/2 stick unsalted butter, chilled']",11,"['1 Pound chicken cutlets to 1/8-inch thickness: Put the chicken cutlets between two sheets of plastic wrap or wax paper and pound to an even thickness of about 1/8-inch. Sprinkle with freshly ground black pepper.', '2 Fry sage leaves in butter: Melt butter in a large saut\\xc3\\xa9 pan on medium heat. Once the butter starts to foam, add the sage leaves to the pan and cook them for a minute or two, turning them half way through the cooking. Remove them from the pan.', '3 Place one or two fried sage leaves on each chicken cutlet and wrap with a thin layer of prosciutto.', '4 Dip cutlets in beaten egg, cook in pan: Prepare a shallow bowl with the beaten eggs. Check that the foaming butter in the pan is golden and not browned. (If it has browned too much, start over with new butter, melting it until it foams.)', ""Working in batches so that you don't crowd the pan, dip each prosciutto-wrapped chicken cutlet in beaten egg and place it in the pan."", 'Cook them for a couple minutes on each side, until just cooked through. Remove from the pan.', '5 Cover with slice of cheese, then broil: Preheat the oven broiler. Arrange the chicken cutlets on a baking sheet and cover each cutlet with a slice of cheese. Place under the broiler just until the cheese melts, about a minute.', '6 While the chicken is under the broiler make the sauce: Pour out the butter from the pan. Increase the heat to high and add the wine to the pan, deglazing the pan. Boil the wine until it has reduced almost by half.', 'Add the minced sage and cook for a minute longer. Stir in the chilled butter.', 'Pour the sauce around the chicken cutlets to serve.']",10
878,Zucchini Pasta Carbonara Recipe,20,25,45,"['Salt', '3/4 pound egg noodles', '2 tablespoons extra virgin olive oil', '1 teaspoon butter', '1/4 pound prosciutto, thinly sliced', '1 yellow onion, chopped', '3 cloves garlic, minced', '3-4 summer squash, yielding 4 cups chopped squash', 'Salt and pepper', '4 eggs', '1 cup grated Parmesan cheese (plus more for topping)', '1 teaspoon lemon zest', '1/2 cup basil leaves, sliced thin*']",13,"['1 Heat the pasta cooking water: To cook the pasta, bring a large pot of water to a boil. Salt the water (one tablespoon of salt for 2 quarts of water).', '2 Brown the prosciutto: As the water for the pasta is heating, prep your vegetables and heat olive oil and butter on medium high in a large saut\\xc3\\xa9 pan.', 'Working in batches, lay pieces of sliced prosciutto down in the pan. Fry gently on both sides until just lightly browned (no more than a minute, more likely 30 seconds each side, the prosciutto is very thin), remove from pan with tongs or a slotted spoon to a paper towel-lined plate to drain.', 'Once cool, tear into bite-sized pieces. Reserve oil in the pan.', ""3 Add the pasta to the boiling water to cook: Add pasta to boiling salted water. The pasta should take about 10-12 minutes to cook until al dente (cooked but still a bit firm), which is just about the right amount of time you\\'ll need to cook the vegetables. Cook with a rolling boil, uncovered."", '4 Saut\\xc3\\xa9 onions, garlic, summer squash: While the pasta is cooking, add the onions, garlic, and summer squash to the saut\\xc3\\xa9 pan that you had used to cook the prosciutto. The heat should be medium high.', 'Stir the vegetables so that they are all coated with oil from the pan, then spread them out in the pan, generously salt and pepper them. Cook until they are just lightly browned, stirring only occasionally. Remove from heat.', '5 Beat the eggs, add Parmesan and lemon zest: In a medium bowl, beat the eggs and mix in the grated Parmesan and lemon zest.', '6 Add cooked pasta to vegetables, stir in egg mixture: When the pasta is ready, reserve 1/2 cup of the cooking liquid, then drain the pasta. Add the pasta to the squash and onions (or add the veggies to the pasta, depending on the size of your pans).', 'Pour the egg, Parmesan, lemon zest mixture over the pasta mixture and quickly stir in with a wooden spoon. The heat from the pasta will sufficiently cook the eggs.', 'Add a little of the reserved pasta cooking water if it looks a little dry. Stir in the prosciutto and basil.', 'Garnish with more basil and grated Parmesan.']",12
879,"Bowtie Pasta with Peas, Prosciutto, and Arugula Recipe",15,15,30,"['1/2 pound (8 ounces) farfalle bowtie pasta', '3 tablespoons extra virgin olive oil (divided, 1 Tbsp and 2 Tbsp)', '2 ounces prosciutto, thin slices separated and roughly chopped', '1/2 cup fresh or frozen peas', '1/2 cup shredded Parmesan cheese', '1/2 teaspoon freshly ground black pepper', '1 cup reserved pasta water', '1 large handful baby arugula (about a cup and a half, packed)', '2 tablespoons thinly sliced fresh mint leaves']",9,"['1 Add pasta to boiling water to cook: Put 3 quarts of salted water (1/2 Tbsp of salt for every quart of water) onto a boil. Add the farfalle bowtie pasta and cook until al dente.', '2 Gently cook prosciutto: Coat the bottom of a stick-free pan with 1 Tbsp of olive oil. Lay out the pieces of prosciutto in the pan in a single layer. Put the heat on medium and gently cook while the pasta is cooking.', 'Turn the pieces over after a few minutes.', 'The intension is not to crisp, but to render some of the fat and firm up the prosciutto a little. When this has been accomplished, remove the pan from heat.', '3 Set aside some pasta cooking water, add peas to pasta and cook an additional minute: Once the pasta has been cooking for the correct timing for al dente, remove one cup of pasta cooking water from the pan and set aside.', 'Add the peas and cook a minute more.', '4 Add pasta, peas, Parmesan, black pepper to prosciutto, then add mint and arugula: Strain the pasta and peas and add to the pan with the prosciutto. Add the Parmesan cheese and toss to coat. Add the black pepper.', 'Add 1/2 cup of the pasta cooking water. Add the fresh baby arugula and mint and toss with the hot pasta to wilt the arugula.', 'Add more of the pasta water if the pasta seems dry.', '5 Drizzle with olive oil: Drizzle and toss with 2 Tbsp of olive oil to serve.']",10
880,Pasta with Roasted Cauliflower and Prosciutto Recipe,15,35,50,"['1/2 medium cauliflower, cored and broken up into 3/4-inch florets (4+ cups) (see How to Cut and Core Cauliflower)', '1 pint cherry tomatoes', 'Extra virgin olive oil', 'Salt', 'Freshly ground black pepper', '1 1/2 teaspoons dried sage', '4 large cloves garlic', '4 ounces of prosciutto', '8 ounces orecchiette pasta', '5 ounces baby arugula or spinach, cleaned and coarsely chopped', '1 cup grated Parmesan cheese']",11,"['1 Roast cauliflower and tomatoes: Preheat oven to 425\\xc2\\xb0F. Lay out cauliflower and tomatoes in a roasting pan, coat with olive oil and sprinkle with salt and pepper. Roast until just lightly browned and cooked through, about 15 minutes.', '2 Bring a large pot of salted water to a boil (1 teaspoon salt for every quart of water).', '3 Add prosciutto mixture to cauliflower, return to oven: While water is heating, pulse garlic, sage, and prosciutto together in a food processor until coarsely chopped. Once cauliflower has browned lightly, remove from oven, toss cauliflower with garlic prosciutto mixture, and return to oven to cook for 5-7 minutes more.', '4 Boil pasta uncovered (rolling boil) for 9-10 minutes until firm, but done (al dente). Reserve one cup of pasta liquid. Drain water from pot.', '5 Add cauliflower, tomatoes, arugula (or spinach), and Parmesan to the pasta. Stir in enough cooking water to moisten. Add salt and pepper to taste.']",5
881,Zucchini and Spinach Gratin Recipe,40,60,100,"['2 pounds zucchini', 'Kosher salt', '1 pound frozen spinach*', '3 slices of thick cut bacon (about 3 ounces), cut crosswise 1/4-inch pieces', '1 large onion', '1 handful of parsley (about 1/2 cup of leaves, lightly packed)', '3 cloves garlic, peeled, coarsely chopped', '1/2 cup freshly grated Parmesan cheese', 'Freshly ground black pepper', '3 eggs', 'Extra virgin olive oil', '* Or 6 packed cups of fresh chopped spinach leaves, blanched and drained']",12,"['1 Grate and drain zucchini: Grate the zucchini. Toss the grated zucchini with about a teaspoon of Kosher salt. Place the grated zucchini in a large sieve (or colander) placed over a bowl to catch the water as the salt helps the zucchini release its moisture.', 'Let sit for 30 minutes or so, then squeeze out the remaining excess moisture with paper towels or a clean tea towel.', '2 Thaw and squeeze the spinach: Thaw the spinach, let drain while the zucchini is draining. Then squeeze out the excess moisture with paper towels or a tea towel.', '3 Cook the bacon: Heat a large skillet on medium heat. Add the bacon and gently cook until lightly browned and most of the fat rendered out, about 10 minutes.', '4 Add onions: While the bacon is cooking, peel and finely chop the onion. Add the onions to the bacon and cook for an additional 10 minutes, until the onions have softened.', '5 Prepare parsley and garlic (persillade): While the bacon and onions are cooking, prepare the parsley and garlic. Place the parsley and garlic with a small pinch of salt into a food processor and pulse just a couple of times.', '6 Preheat the oven to 350\\xc2\\xb0F.', '7 Prepare the filling: Place the zucchini into a large bowl. With a wooden spoon, mix in the cooked onions and bacon. Mix in the spinach, parsley, and garlic. Mix in half of the Parmesan. Taste, and add black pepper and more salt to taste. Mix in the eggs.', '8 Fill gratin pan: Coat the bottom and sides of a 2 quart casserole or gratin dish with a tablespoon of olive oil. Put the zucchini spinach mixture into the dish and pack it down. Sprinkle the remaining Parmesan cheese over the top and drizzle with a little olive oil.', '9 Bake: Bake in a 350\\xc2\\xb0F oven for 40-45 minutes, until the top is nicely browned. Serve immediately. Reheats well.']",10
882,Cod Poached in Court Bouillon Recipe,5,15,20,"['Poached cod:', '2 quarts water', '1 tablespoon salt', '2 cloves garlic, crushed', '2 bay leaves', '1 tablespoons extra virgin olive oil', '2 pounds cod fillets (or other firm white fish, not sole), cut to fit the pan', 'Lemon for garnish', 'Optional side of saffron potatoes:', '1 pound of Yukon gold potatoes, cut into 1 1/2-inch chunks (peel on or off, your choice)', 'Salt', 'Pinch of saffron']",12,"['1 Make the court bouillon: Put water, salt, garlic, bay leaves, and olive oil into  4 to 5 quart pot and bring to a hard boil. Boil for several minutes, to infuse the water with the bay leaves and garlic. You should be able to smell the aroma of the garlic.', '2 Simmer the cod: Rinse the cod fillets and place them in the boiling water. Return the water to a simmer (this should take 2 to 3 minutes). Simmer for an additional 2 minutes, less or more depending on the thickness of the fillets.', '3 Remove cod, cover, and let rest: Using a slotted spoon, remove the fillets to a plate when they are almost cooked through. They should still be a little translucent in the center, because they will continue to cook in their residual heat as they sit on the plate.', 'Cover with foil. Let rest for 5 minutes before serving, or if you are making the optional potatoes, let rest until the potatoes are done.', '4 Cook potatoes (optional): Place a pinch of saffron in the water that was used to cook the fish. Add the potatoes and return the water to a simmer.', 'Simmer for 15 minutes or until the potatoes are easily pierced with a fork. Drain. Sprinkle potatoes with additional salt if desired.', 'Serve fish with a slice of lemon.']",7
883,Salmon Provencal Recipe,10,20,30,"['3 large plum tomatoes, coarsely chopped', '3 shallots, coarsely chopped', '1 tablespoon chopped fresh tarragon', '1 tablespoon chopped fresh basil', '1 tablespoon chopped fresh chives', '1 tablespoon fresh lemon juice', '1 tablespoon balsamic vinegar', 'Salt', '2 tablespoons extra virgin olive oil', '4 salmon fillets, about 5-6 ounces each', 'Freshly ground black pepper']",11,"['1 Preheat oven to 400\\xc2\\xb0F.', '2 Blanch the tomatoes, then peel, core and dice: Blanch the tomatoes by first scoring the ends with a sharp knife, and then plunging them into a pot of simmering salted water for 15-30 seconds.', 'Then put them into ice water for 1 minute. Drain the tomatoes and peel off and discard the skin.', 'Cut the tomatoes into quarters, remove the core and seeds, and dice the flesh.', '3 Combine tomatoes, herbs, olive oil, salt: In a large bowl combine the tomatoes, tarragon, basil, chives and olive oil. Add salt to taste.', '4 Whisk together lemon juice, vinegar, shallots: In another bowl, whisk together the lemon juice, vinegar, and shallots (the acid in the lemon juice and vinegar will help take the sharp edge off of the shallots).', '5 Bake the salmon fillets: Arrange salmon fillets on an oiled baking sheet without crowding. Drizzle with olive oil and season lightly with salt.', 'Bake until salmon is barely cooked through and lightly browned on the edges, 8-12 minutes, depending on the thickness of the salmon fillets.', '6 Mix dressing with tomato mixture, serve with salmon: To serve, mix the shallot mixture with the tomato mixture, and spoon a couple tablespoons around each fillet. Sprinkle the salmon with freshly ground black pepper. Serve immediately.']",9
884,Spinach Gratin with Hard Boiled Eggs Recipe,20,60,80,"['3 pounds of fresh spinach, cleaned (or 24 ounces of frozen spinach, thawed and drained)', '2 cups of milk', '2 tablespoons butter', '2 tablespoons flour', ""1/2 teaspoon freshly grated nutmeg, or 3/4 teaspoon of ground nutmeg if you aren't starting with a whole nutmeg"", '1/8 teaspoon freshly ground black pepper or more to taste', '1/4 cup grated Gruyere cheese (about 1 ounce)', '6 hard boiled eggs*', '3 to 4 Tbsp seasoned bread crumbs**', 'Extra virgin olive oil', '*To hard boil eggs, place eggs in a 2-quart saucepan and cover with at least an inch of cold water. Bring the water to a boil, remove the pan from heat, and cover. Let sit for 10-12 minutes, covered. Then run under cold water to keep from overcooking. Crack the shells while the eggs are still under water and let sit for a while to cool before peeling.', '**To make your own bread crumbs, take a few slices of day old bread and toast either in a toaster or in the oven until browned, then pulse in a food processor or blender until you have crumbs. Stir in a little herbes de Provence or Italian seasoning and a little salt to taste.']",12,"['  1 If working with fresh spinach, blanche the spinach in boiling water for 1 minute, drain and run cool water over it to cool it down. Press as much water as you can out of the spinach. (A good way to do this is to put the drained spinach in the center of a large, clean tea towel, wrap it with the towel, and wring the moisture out by wringing the towel.) Chop the spinach. Place in a large bowl. Season to taste with salt and set aside while you make the b\\xc3\\xa9chamel.', ' ', '  2 Heat milk in a medium saucepan until steamy, set aside. In a separate saucepan, melt 2 tablespoons of butter on medium heat. Sprinkle in the flour, whisking the mixture until smooth, about a minute or two. Remove from heat. Slowly pour in the hot milk, whisking the whole time so that the mixture is not lumpy. Continue to whisk until there are no lumps. Return the pan to heat and let heat to a simmer, continuing to whisk to keep the mixture from sticking to the bottom of the pan. The b\\xc3\\xa9chamel sauce will thicken as it cooks. Sprinkle in the ground nutmeg and black pepper.', '3 Stir the thickened b\\xc3\\xa9chamel sauce into the bowl of spinach.', ' ', '  4 Grease the inside of a 2-quart gratin pan or casserole all around with a little butter. Pour the spinach b\\xc3\\xa9chamel mixture into a gratin pan, and even out the surface. Sprinkle the surface with the grated Gruyere cheese. Slice the hard boiled eggs in half, and arrange, cut side up, on the surface of the spinach mixture. Press into the spinach mixture so that the cut side of the eggs are level with the spinach. Sprinkle with 3 to 4 tablespoons of seasoned bread crumbs. Drizzle the top with a tablespoon or so of olive oil. At this point you can make the gratin a day ahead and chill until ready to cook to serve.', '5 Bake, uncovered, in a 375\\xc2\\xb0F oven for 25-30 minutes, until nicely browned.']",7
885,Braised Rabbit with Prunes Recipe,10,75,85,"['One 3 to 3 1/2 pound rabbit, cut into six to eight serving parts', 'Salt', 'Extra virgin olive oil', '1 Tbsp butter', '3-4 large shallots, sliced, about 1 cup', '1 clove garlic, minced', '1 cup dry white wine (or chicken stock with a tablespoon of vinegar)', 'Freshly ground black pepper', '7 ounces (200 grams) pitted prunes (dried plums)', 'Several sprigs fresh thyme', '1 bay leaf', '1 rabbit liver (optional, should be sold with the rabbit)', '1 Tbsp vinegar (optional)']",13,"['1 Brown the rabbit pieces in butter: Heat 3 Tbsp olive oil in a large thick-bottomed Dutch oven (I used a 5 quart) on medium-high heat. Add a tablespoon of butter. Pat dry the rabbit pieces, sprinkle all over with salt, and working in batches, brown on all sides in the pan.', '2 Saut\\xc3\\xa9 shallots, garlic, deglaze with white wine: Remove the rabbit pieces from the pan. Add the sliced shallots, reduce the heat to medium, and cook for 2 minutes. Add the minced garlic clove and cook for 30 seconds more.', 'Add the white wine and increase the heat to high. Use a wooden spoon to scrape up the browned bits from the bottom of the pan. Let the wine boil, until reduced by at least a half.', '3 Place rabbit, prunes, thyme, bay leaf, on top of shallots in pan, cover and cook: Lower the heat to low (you may want to move the pot to the smallest burner on your stove). Arrange the rabbit pieces, prunes, thyme, and bay leaf in the pan. Sprinkle with black pepper to taste.', 'Cover tightly and let cook for 45 minutes. (Cooking time assumes you are starting with a rabbit that has been brought to near room temp before cooking. If you are using a rabbit straight from the fridge, it may take a few more minutes to cook through. Also, if you keep lifting up the lid to check on the rabbit, it will increase the needed cooking time.)', '4 Optional step using rabbit liver: After the rabbit is cooked through, if you want, you can intensify the flavor of the sauce using the rabbit\\\'s liver. The liver should have been included with the rabbit from your butcher, just like whole chickens come with the giblets. (Don\\\'t worry, the liver won\\\'t make your dish taste like liver. You can even try just a little amount to taste to make sure. The liver acts as a ""liaison"", thickening the sauce and making it richer.)', 'Pur\\xc3\\xa9e the rabbit liver with 1 Tbsp of vinegar (I used wine vinegar, but cider or white vinegar will do). Remove the rabbit pieces, prunes, thyme sprigs, and bay leaf from the pot (discard thyme and bay leaves) to a serving dish.', 'Whisk the pur\\xc3\\xa9ed liver vinegar mixture into the sauce in the pot and cook for another 10 minutes. (If the sauce is still too thin, you can thicken further with corn starch or flour.) Then drizzle the sauce over and around the rabbit and prunes.', 'Great served over egg noodles.']",9
886,Tapioca Pudding Recipe,0,30,30,"['1/2 cup small pearl tapioca (you can usually find it in the baking section of the grocery store, do not use instant tapioca)', '3 cups whole milk (or skim milk with cream added)', '1/4 teaspoon salt', '2 eggs', '1/2 cup of sugar', '1 teaspoon of vanilla extract']",6,"['1 Cook the tapioca in milk with salt, slowly adding sugar until the tapioca thickens: Combine tapioca, milk, and salt in 1 1/2 quart pan on medium high heat. Stir while bringing to a bare simmer. Lower the heat and cook uncovered, at the lowest possible heat, adding sugar gradually, until the tapioca pearls have plumped up and thickened.', ""Depending on the type or brand of tapioca you are using and if you've presoaked the tapioca as some brands call for, this could take anywhere from 5 minutes to 45 minutes of cooking at a very low temperature."", ""Stir occasionally so that the tapioca doesn't stick to the bottom of the pan."", '2 Temper the eggs with a little hot tapioca: Beat eggs in a separate bowl. Whisk in some of the hot tapioca very slowly to equalize the temperature of the two mixtures (to avoid curdling).', '3 Return eggs to pan with tapioca. Increase the heat to medium and stir for several minutes until you get a thick pudding consistency. Do not let the mixture boil or the tapioca egg custard will curdle. Cool 15 minutes. Stir in vanilla. Serve either warm or chilled.', 'Note: If you want to make a more light and fluffy, but still rich, tapioca pudding, separate the eggs. Use the egg yolks to stir in first to the pan with the tapioca. Once the pudding has become nice and thick, beat the egg whites in a separate bowl to soft peaks. Remove the pan of tapioca pudding from the stove, fold in the beaten egg whites into the pudding.']",6
887,Chocolate Pudding Recipe,5,0,5,"['1/4 cup sugar', '1/4 cup unsweetened cocoa powder', '2 Tbsp cornstarch', 'Pinch of salt', '2 cups whole milk', '1 large egg', '4 ounces semi-sweet chocolate chips', 'Four 6-ounce ramekins or custard cups']",8,"['1 Heat cocoa milk base: Whisk together the sugar, cocoa powder, cornstarch, and salt in a heavy 2-quart saucepan.', 'Gradually whisk in the milk.', 'Bring to a boil, whisking constantly, and boil, whisking, until pudding is thick, about 3 to 5 minutes. Remove from heat.', '2 Temper the egg: Immediately beat the egg lightly in a medium, heat-proof bowl, such as a hard plastic or ceramic mixing bowl.', 'Very gradually add the hot chocolate mixture to the egg, whisking constantly.', '3 Add the chocolate chips: Whisk in the chocolate chips until they are melted and the mixture is smooth.', '4 Pour into ramekins and chill: Pour the pudding into the ramekins or cups. If you want, cover the surface of each of the pudding cups with some cut out wax paper to prevent a skin from forming on the top of the pudding.', 'Refrigerate, covered, until cold, at least 2 hours.', 'Optional: Serve with whipped cream.']",9
888,Vegan Chocolate Pudding Recipe,10,250,260,"['1 (15-ounce) can full-fat coconut milk', '10 ounces dark chocolate (60-70%), finely chopped', '1 tablespoon vanilla extract (optional)', 'Optional garnishes: Whipped coconut cream, shaved chocolate, berries or other fresh fruit']",4,"['1 Warm the coconut milk: Shake the can of coconut milk vigorously before opening, then pour into a small saucepan. Heat the coconut milk to a simmer over medium heat. Stir often to avoid scorching. Warm for a couple of minutes, until the liquid almost comes to a boil. Immediately remove from heat.', '2 Add the chocolate: Add a third of the chopped chocolate to the hot coconut milk. Stir gently until the chocolate has completely melted and the mixture is smooth. Repeat with the remaining chocolate in two separate additions. Stir in the vanilla extract, if using.', '3 Pour the pudding into jars, glasses, or ramekins. Cover with cling film and refrigerate for at least 4 hours.', '4 To serve: Remove from the refrigerator about 30 minutes before serving. Top with garnishes of your choice or just serve with a spoon.']",4
889,Easy Chocolate Pudding in the Microwave Recipe,10,6,16,"['For the pudding', '1/2 cup sugar', '3 tablespoons cornstarch', '2 tablespoons Dutch-processed cocoa powder', '1/8 teaspoon salt', '2 1/2 cups whole milk', '3 egg yolks', '4 ounces (about 3/4 cup) 60 to 70% chocolate baking chips', '2 tablespoons unsalted butter, cut into chunks', '1 teaspoon vanilla extract', 'For the whipped cream (optional)', '1 cup heavy cream', '2 teaspoons sugar', '1/2 teaspoon vanilla extract']",14,"['1 Combine the ingredients: In a medium, microwave-safe bowl, whisk together the sugar, cornstarch, cocoa powder, and salt until blended. Stir in 1/2 cup of the milk and whisk until smooth. Whisk in the egg yolks. Gradually stir in the remaining milk.', 'Partially cover the bowl with plastic wrap, leaving a gap in one side so steam can escape. If you prefer not to use plastic wrap, cover with a paper towel or a plate that is set slightly askew.', '2 Microwave the pudding: In the microwave, cook the mixture for 3 minutes. Remove from the microwave, remove the plastic, and whisk the pudding to distribute the heat.', 'Partially cover again and microwave for 1 more minute. Stir again. Continue to microwave in 30 second increments, stirring the pudding between each increment, until you see the mixture bubbling around the edges and the pudding has thickened enough for the whisk to leave a light trail, or ribbon, through the pudding. The pudding will thicken further as it cools.', '3 Add the chocolate, butter and vanilla: With a whisk, stir the chocolate chips, butter and vanilla into the bowl. Stir constantly until the chocolate and butter have melted and the mixture is smooth.', '4 Transfer the pudding to serving dishes: Spoon the pudding into 4 small serving cups (5- to 6- ounce ramekins or tea cups work great). Chill in the refrigerator until cold.', '5 Make the whipped cream: In the bowl of an electric mixer on medium-high speed, beat the cream, sugar, and vanilla together until the cream forms soft peaks. Dollop a spoonful on top of each serving cup and serve immediately.']",7
890,Buttermilk Pudding Recipe,240,10,250,"['2 teaspoons of powdered gelatin', '1 cup of heavy whipping cream', '1/2 cup of sugar', '1 vanilla bean, seeded (or substitute 1/2 teaspoon of vanilla extract)', '2 cups of buttermilk', 'Jam or jelly to serve, optional']",6,"['1 Mix the gelatin with 2 tablespoons of water in a small bowl and set aside.', '2 Put the cream, sugar, and vanilla bean seeds and pod (or vanilla extract if using) into a small saucepan over medium heat. Once the sugar has dissolved remove from heat and add the gelatin to the warm cream mixture. Stir until the gelatin has dissolved.', '3 Once the cream has cooled to room temperature, add the buttermilk and stir. Strain through a fine mesh sieve to catch any bits of undissolved gelatin.', '4 Pour the mixture into ramekins, about 1/2 cup per ramekin (the pudding is very rich). Cover the ramekins with plastic wrap and chill to set for at least four hours. Serve with your favorite jam, jelly, marmalade, fruit, or straight up.']",4
891,Mint Chocolate Pudding Cakes Recipe,10,25,35,"['6 ounces bittersweet or semisweet chocolate, chopped', '1/2 cup (1 stick) unsalted butter', '3 large eggs', '3 large egg yolks', '1/3 cup sugar', '1/4 cup all purpose flour', '1 1/4 teaspoons peppermint extract', '1/4 teaspoon salt']",8,"['1 Preheat oven to 375\\xc2\\xb0F. Generously butter six 3/4-cup (6 ounce) ramekins.', '2 Melt chocolate and butter: Cut the butter into pieces and heat the chocolate with the butter in small, thick-bottomed saucepan over low heat, stirring, until melted and smooth.', 'Remove the pan from the burner and let cool slightly.', '3 Make filling: With an electric mixer, beat the eggs, egg yolks, and the sugar until slightly thickened, about 5 minutes.', 'Add the flour and beat until incorporated.', 'Add the chocolate mixture, the peppermint extract, and the salt. Beat just until incorporated.', '4 Pour the chocolate mixture into the prepared ramekins. Place the ramekins on a baking sheet.', '5 Bake: Bake the cakes at 375\\xc2\\xb0F  until the edges are set but the centers look shiny and still wiggle like jello when the ramekins are lightly shaken, 10-11 minutes. (Start checking at 9 minutes.)', 'Remove the cakes from oven; let cool for 5-10 minutes.', 'Either serve as is, in the ramekins, or run a knife around the edges of the cakes and invert on to individual dessert plates.', 'Serve with raspberries, mint leaves, vanilla or mint ice cream, or whipped cream.']",11
892,Creamy Chai-Spiced Vegan Rice Pudding Recipe,5,230,235,"['For the rice:', '1 1/2 cups water', '1 (3-inch) cinnamon stick', '1 whole star anise', '1 cup jasmine rice', 'For the pudding:', '1 1/4 teaspoon ground cinnamon, plus more to garnish', '1 teaspoon ground ginger', '3/4 teaspoon ground cardamom', '1/2 teaspoon kosher salt', 'Pinch ground black pepper', '1 teaspoon vanilla extract', '3 (13 1/2-ounce) cans full fat unsweetened coconut milk, divided', '1 cup packed brown sugar', 'Toasted coconut flakes, to garnish, optional']",15,"['1 Cook the rice: In a 4-quart pot, combine the water, cinnamon stick, and star anise, and bring the water to a boil over medium-high heat. Add the rice and reduce the heat to low. Cover the pot and steam it until it is no longer crunchy, about 15 minutes.', '2 Make the spice blend: In a small bowl, combine the spices. Add the vanilla extract and 1/4 cup of the coconut milk to the spices, and whisk to create a smooth paste. This prevents the spices from clumping together when you add them to the steamed rice.', '3 Combine the rice and coconut milk: Once the rice has finished cooking, add 4 cups of the coconut milk and the spice paste to the pot. Scrape the bottom of the pot to loosen any rice that may be stuck.', ""4 Simmer the rice pudding: Bring the mixture to a gentle simmer over low heat, uncovered, and cook without stirring for 15 minutes. The surface of the rice pudding should develop small bubbles; if large, rapidly moving bubbles break the surface of the milk, lower the temperature. Don\\xe2\\x80\\x99t stir it because you don\\xe2\\x80\\x99t want the rice to break up. A skin will form on the surface, but that's fine!"", ""After 15 minutes, add the brown sugar and stir the pudding (also stir any any skin that's formed). When you scrape the bottom of the pot, it will sound like rustling paper. Simmer for another 20 minutes, stirring frequently, or until the pudding has thickened to the consistency of mayonnaise."", '5 Transfer to a shallow dish and chill: Remove the cinnamon stick and star anise from the pudding and discard. Transfer the pudding to a shallow dish (like a pie plate or casserole dish) and refrigerate uncovered until cold, at least 3 hours, up to overnight.', '6 Finish with coconut milk and cinnamon: Just prior to serving, stir in the remaining coconut milk. Spoon the pudding into individual serving dishes and garnish with a sprinkle of ground cinnamon and toasted coconut flakes.', 'Store any leftovers in a covered container in the refrigerator for up to 3 days.']",8
893,Spicy Chicken Nuggets Recipe,5,60,65,"['1/4 cup dark rum', '1/4 cup lime juice', '1/4 cup soy sauce', '1 Tbsp sugar', '1 1/2 pounds boneless chicken thighs or breasts, cut into 1 1/2-inch pieces', 'Vegetable oil (canola oil, rice bran oil, peanut oil)', '1/2 cup flour', '1/2 teaspoon salt', '1/2 teaspoon paprika (hot or sweet)', 'Lime wedges', 'Hot sauce']",11,"['1 Make the marinade: Whisk together the lime juice, rum, soy sauce, and sugar in a bowl until sugar has dissolved.', '2 Marinate the chicken: Add the chicken to the marinade and let marinate for 30 minutes at room temperature (can marinate longer chilled, but allow to come to room temp for 30 minutes before cooking).', '3 Heat the oil for frying: Pour enough oil in a skillet so that it comes up the sides at least a half an inch. Heat oil on medium high until it is shimmering, and a little pinch of flour sizzles when you drop it in the pan.', '4 Dredge the chicken: While the oil is heating, whisk together the flour, paprika, and salt in a bowl. Remove the chicken pieces from the marinade and pat dry with paper towels. Dredge the chicken pieces in the flour mixture and move to a plate.', '5 Fry the chicken in batches (about 3), about 3 minutes on each side, until deep golden brown and the chicken is cooked through. (If the chicken is browning too quickly, reduce the heat a bit).', 'Remove to a plate lined with paper towels to soak up the excess oil.']",6
894,Asopao de Camarones y Gandules (Puerto Rican Rice Stew with Shrimp and Pigeon Peas) Recipe,45,45,90,"['1 (15-ounce) can pigeon peas (gandules), drained and liquid reserved', '6 1/2 cups water, for soaking the rice', '1 1/2 cups rice', '1 tablespoon olive oil', '4 ounces ham, diced', '1 medium white onion, diced (about 1 cup)', '1/2 large green bell pepper, diced (about 3/4 cup)', '1/2 large yellow bell pepper, diced (about 3/4 cup)', '1 medium Roma tomato, diced (about 3/4 cup)', '3 cloves garlic, minced', '2 tablespoons recaito flavor base, store-bought or homemade', '1/4 cup tomato sauce', '6 stuffed Spanish olives', '1/2 teaspoon capers', '1 1/2 teaspoons saz\\xc3\\xb3n seasoning, store-bought or homemade, optional', '1/2 teaspoon oregano', '1 tablespoon kosher salt', '1/2 teaspoon black pepper', '1 pound peeled and deveined shrimp, tails removed']",19,"['1 Rinse and soak the rice: Rinse the rise in a strainer under running water to remove the excess starch from the outside. In a large bowl, mix the reserved liquid from the pigeon peas with the water for soaking. Add the rice to the bowl and soak for 45 minutes.', ""When the rice has finished soaking, drain the water into a large pot on the stovetop, and turn the heat to medium-low. Keep it at a low simmer; you'll add this liquid to the asopao later."", '2 Cook the ham and the veggies: In a 3-quart Dutch oven or similar large pot, heat the olive oil over medium-high heat. Add the ham and brown it, about 3 minutes.', 'Reduce the heat to medium. Add the onion, peppers, tomato, garlic, and recaito to the pot and simmer, stirring occasionally, for 6 to 8 minutes; or until the vegetables have softened and begin to form a thick, chunky paste.', 'Stir the tomato sauce, olives, capers, saz\\xc3\\xb3n, oregano, salt, and pepper into the paste, and cook for 2 minutes.', '3 Add the rice to the pot: Add the rice into the pot and stir to thoroughly coat the grains in the sauce. Add the pigeon peas and the warmed, reserved soaking water.', '4 Simmer the stew: Bring the stew to a gentle simmer and continue to cook, uncovered, for 15 minutes.', 'After 15 minutes, stir the shrimp into the asopao and continue cooking, uncovered, for an additional 5 minutes.', '5 Serve the stew: Serve promptly, as the stew will thicken the longer it\\xe2\\x80\\x99s left to sit. Thin the stew as needed with hot water or with chicken stock to maintain consistency and flavor, especially when reheating leftovers.']",9
895,Chillo al Ajillo (Pan Fried Red Snapper in Garlic Sauce) Recipe,0,7,7,"['For the marinade:', '4 garlic cloves, crushed', '3/4 teaspoon salt', '1/2 teaspoon ground black pepper', '1/2 teaspoon dried oregano', '1 teaspoon extra virgin olive oil', '4 red snapper fillets, skin on', 'juice of 1 lime', 'For the al ajillo or garlic sauce:', '1/4 cup extra virgin olive oil', '3 tablespoons unsalted butter', '4 garlic cloves, crushed', '1 tablespoon white vinegar', '2 teaspoons lime juice, freshly squeezed from about half a lime', '1/2 teaspoon salt', 'pinch of ground black pepper', '1 tablespoon chopped cilantro, optional', 'To fry the fish:', '1/2 cup all-purpose flour, sifted, for dredging', '2 cups vegetable oil, for frying']",20,"['1 Score and marinate the red snapper: Score the skin of the red snapper with 1/4-inch diagonal cuts.', 'Using a mortar and pestle or a food processor, mash or pulse the garlic, salt, pepper, oregano, and olive oil until they form a paste.', 'Squeeze the lime juice onto both sides of each red snapper fillet. You don\\xe2\\x80\\x99t want to douse them with the lime juice; you\\xe2\\x80\\x99ll only need a thin layer of it. Divide the garlic paste equally among the fillets, then spread it onto both sides of each fillet.', 'Allow the fish to marinate for 20 minutes in the refrigerator while you make the al ajillo (garlic sauce).', '2 Prepare the al ajillo sauce: In a small saucepan, heat the olive oil, butter, and garlic together over medium heat. When the mixture begins to simmer, add the vinegar and lime juice to the pot. Reduce the heat to medium-low and simmer the sauce for 5 minutes.', 'Add the salt and pepper to the sauce and remove it from the stove. Allow it to cool for 10 minutes. Stir in the cilantro before transferring the sauce to a serving bowl. The sauce will separate as it sits, so be sure to stir it before serving.', 'If you plan to make this in advance, cover the bowl and store it in the refrigerator. The al ajillo sauce will keep for 2 days and may be served cold or warm.', '3 Preheat your frying oil: In a 14-inch, tall-sided skillet or pan, heat the vegetable oil over medium-high heat.', 'While you\\xe2\\x80\\x99re waiting for the oil to heat, dredge the fish fillets in the flour. Shake off any excess flour so all that remains is a light dusting.', '4 Fry the fish fillets: Once the oil begins to ripple in the pan, or when it reaches 365\\xc2\\xb0F, gently slide two snapper fillets into the hot oil, skin side down.', 'Fry the fillets for 3 minutes before carefully flipping to the other side. At this point the fish is delicate, so when flipping, take care not to break the fillets apart. Fry for an additional 4 minutes, or until the flesh takes on an opaque white color. Repeat the cooking process with the remaining fillets.', '5 Drain: Once the fillets have been fried, transfer them to a platter lined with paper towels to absorb any excess oil. Store the fried fish in a warm oven (set to 170\\xc2\\xb0F) while you fry the remaining pieces.', '6 Serve: Serve your snapper while hot with the garlic sauce on the side or spooned on top of the fish. Leftovers may be stored in the refrigerator for 2 days and reheated in a 300\\xc2\\xb0F oven, or microwaved until warmed through.']",13
896,Old Fashioned Pumpkin Pie Recipe,0,60,60,"['2 large eggs plus the yolk of a third egg', '1/2 cup packed dark brown sugar', '1/3 cup white sugar', '1/2 teaspoon salt', '2 teaspoons cinnamon', '1 teaspoon ground ginger', '1/4 teaspoon ground nutmeg', '1/4 teaspoon ground cloves', '1/8 teaspoon ground cardamom', '1/2 teaspoon lemon zest', '2 cups pumpkin pulp pur\\xc3\\xa9e from a sugar pumpkin (see Recipe Note) OR 1 15-ounce can of pumpkin pur\\xc3\\xa9e (can also use pur\\xc3\\xa9ed cooked butternut squash)', '1 1/2 cup heavy cream or one 12 oz. can of evaporated milk', '1 good pie crust, chilled or frozen (see p\\xc3\\xa2te bris\\xc3\\xa9e recipe or our no-fail flaky pie crust recipe)']",13,"['1 Preheat your oven to 425\\xc2\\xb0F.', '2 Make the filling: Beat the eggs in a large bowl. Mix in the brown sugar, white sugar, salt, spices\\xe2\\x80\\x94cinnamon, ground ginger, nutmeg, ground cloves, cardamom, and lemon zest.', 'Mix in the pumpkin pur\\xc3\\xa9e. Stir in the cream. Beat together until everything is well mixed.', '3 Pour into pie shell and bake: Pour the filling into an uncooked chilled or frozen pie shell. Bake at a high temperature of 425\\xc2\\xb0F for 15 minutes.', 'Then after 15 minutes, lower the temperature to 350\\xc2\\xb0F. Bake for 45 to 55 minutes more. The pie is done when a knife tip inserted in the center comes out wet but relatively clean. The center should be just barely jiggly.', '(About half-way through the baking, you may want to put foil around the edges or use a pie protector to keep the crust from getting too browned.)', '4 Cool on a rack: Cool the pumpkin pie on a wire rack for 2 hours. Note that the pumpkin pie will come out of the oven all puffed up (from the leavening of the eggs), and will deflate as it cools.', 'Serve with whipped cream.']",8
897,Pumpkin Gingerbread Recipe,15,60,75,"['1 1/2 cups (200 g) all purpose flour*', '1/2 teaspoon salt', '1 teaspoon baking soda', '2 teaspoons ground ginger', '1 1/2 teaspoon ground cinnamon', '1/4 teaspoon ground nutmeg', '1 cup (240 ml) pumpkin pur\\xc3\\xa9e (canned or homemade**)', '1/2 cup (1 stick, or 112 g) butter, melted', '1/2 cup dark brown sugar', '1/2 cup (120 ml) molasses', '1 Tbsp finely minced candied or fresh ginger (optional)', '2 eggs, beaten', '3 Tbsp water', '1/2 cup raisins (optional)', ""* I've also made this pumpkin gingerbread using gluten-free flour from King Arthur. Turned out great!"", '* * To make pumpkin pur\\xc3\\xa9e from pieces of leftover pumpkin, just roast or boil the pieces until tender, then remove the skin. Smash the cooked pumpkin with a fork. If using a whole pumpkin, sugar pumpkins work best. Cut in half, scoop out the strings and seeds, bake the pumpkin halves at 350\\xc2\\xb0F on a foil-lined baking pan until soft, about 45 minutes to an hour. When cool, scoop out the flesh and mash with a fork.']",16,"['1 Preheat oven and prepare pan: Preheat oven to 350\\xc2\\xb0F (180\\xc2\\xb0C). Prepare a 9x5x3-inch loaf pan with non-stick spray or butter to keep the pumpkin gingerbread from sticking to the pan.', '2 Mix dry ingredients: In a medium bowl, vigorously whisk together the flour, salt, baking soda, ginger, cinnamon, and nutmeg.', '3 Mix wet ingredients: In another bowl, use a wooden spoon to mix together the pumpkin pur\\xc3\\xa9e, melted butter, sugar, molasses, fresh or candied ginger, eggs, and water.', '4 Combine the wet and dry ingredients. Add the raisins if using. Stir only until incorporated.', '5 Bake: Place the batter into the prepared loaf pan and bake at 350\\xc2\\xb0F for 50-60 minutes, until a bamboo skewer inserted into the center of the loaf comes out clean.', '6 Cool: Remove from oven and let cool in the pan for 10 minutes. Then gently run a knife around the edge of the loaf and invert the loaf to remove it from the pan. Let it cool on a rack completely before slicing.', ""The loaf's flavor will improve with time. If you cut into it while it is still a bit warm, it may be crumbly. In which case you may want to make your slices with a bread knife.""]",7
898,Spicy Pumpkin Soup Recipe,10,30,40,"['1 Tbsp unsalted butter', '1 1/2 cups roughly chopped yellow onion', '2 cloves garlic, minced (about 2 teaspoons)', '2 teaspoons minced, peeled fresh ginger', '1 1/2 teaspoons yellow curry powder', '3/4 teaspoon ground cumin', '1/2 teaspoon ground coriander', 'Small pinch of cinnamon', '1 teaspoon of kosher salt plus more to taste', '4 cups low sodium chicken stock (or vegetable broth for vegetarian option)', '2 bay leaves', '2 (15 oz) cans 100 percent pumpkin or 3 1/2 cups of chopped roasted pumpkin pur\\xc3\\xa9e*', '1 cup water', '3 Tbsp heavy whipping cream', '1/8 teaspoon black pepper', 'Yogurt (for garnish)', 'Toasted pumpkin seeds (for garnish)', ""*To make pumpkin pur\\xc3\\xa9e, cut a sugar pumpkin in half, scoop out the seeds and stringy stuff, lay face down on a tin-foil lined baking pan. Bake at 350\\xc2\\xb0F until soft, about 45 min to an hour. Cool, scoop out the flesh. Pur\\xc3\\xa9e in food processor. Freeze whatever you don't use for future use.""]",18,"['1 Saut\\xc3\\xa9 onions in butter, add garlic, ginger, spices: Melt butter in a large (5 to 6 quart), thick-bottomed pot over medium heat. Add the onions and saut\\xc3\\xa9 until softened, about 5 to 6 minutes.', 'Add the minced garlic and ginger, cook another minute.', 'Add the curry powder, cumin, coriander, cinnamon, and salt. Cook for another 2 minutes.', '2 Add stock, bay leaves, and pumpkin pur\\xc3\\xa9e: Add the chicken stock and the bay leaves. Add the pumpkin pur\\xc3\\xa9e and the water. Stir to combine. If the soup is too thick for your taste, add more stock or water to thin it.', 'Increase heat to high. Bring to a boil and reduce heat to low, cover and simmer for 10 to 15 minutes.', '3 Pur\\xc3\\xa9e soup: Remove bay leaves. Use an immersion blender to pur\\xc3\\xa9e the soup.', '4 Stir in cream: Right before serving, stir in the cream. Add black pepper and adjust seasonings to taste. Add more salt if necessary.', 'Drizzle with plain yogurt that has been thinned with a little water and sprinkle with toasted pumpkin seeds to serve.']",8
899,Pumpkin Ricotta Gnocchi Recipe,30,30,60,"['1 cup of pur\\xc3\\xa9ed cooked pumpkin or winter squash (canned or homemade)*', '1 cup ricotta (use whole milk for best results)', '2 large eggs', '2 teaspoons kosher salt', '1/4 cup parmesan or pecorino cheese', '3-4 cups cake flour, Italian ""oo"" flour, or all-purpose flour', '2-3 teaspoons minced fresh sage', '1/4 cup unsalted butter', 'Black pepper to taste', 'Truffle salt to taste (optional)', ""To make your own pumpkin pur\\xc3\\xa9e, use a strong chef\\'s knife to cut a small sugar pumpkin (or other winter squash) in half. Scoop out the seeds and strings. Lay the pumpkin face down on a foil-lined baking sheet. Bake at 350\\xc2\\xb0F for 45 minutes to an hour, until soft. Allow to cool, then scoop out the flesh and mash with a fork. Alternatively, if you are working with leftover fresh pumpkin pieces, roast or boil them until tender, and then cut away and discard the skin.""]",11,"['1 Make the pumpkin ricotta gnocchi dough: Mix the pumpkin puree, ricotta, parmesan, eggs and salt together in a large bowl. Add 2 cups of the flour and mix well with your hands. The dough should be very sticky, impossible to work.', 'Add another half cup of flour and mix that in \\xe2\\x80\\x94 you want the dough to still be pretty sticky, but pliable enough to shape into a large log.', ' ', ""  If it\\'s not, keep adding a little flour at a time until you can get a soft dough that will be rollable. It should never require more than 4 cups of flour. Cover the dough with a damp towel."", '2 Bring a pot of salty water to a boil: Bring a large pot of water to a boil, then add enough salt to it so that the water tastes salty. Let this simmer while you make the gnocchi.', '3 Roll out the dough and cut the gnocchi: To make the gnocchi, spread some flour on a large work surface and have more flour ready. Cut the dough log into four equal pieces.', 'Take one piece and cut it in half. Roll the piece of dough into a snake about 1/2 inch thick, then cut it into pieces about the width of a fork.', ' ', '  4 Use the back of a fork to create indentations in the gnocchi: Dust the gnocchi with a little flour, then use one finger to push the dumpling up onto the tines of a fork. Let the gnocchi drop back to the work surface.', ' ', '  This does two things: It makes the dumpling a little thinner and lighter, and it creates depressions and ridges that sauce can hold onto.', ""If all this is too much bother for you, skip it. The gnocchi will not be quite as good, but they\\'ll still taste fine."", '5 Boil the gnocchi: Using a metal spatula, gently pick up a few gnocchi at a time and drop them into the water. Increase the heat to a rolling boil.', 'Boil these gnocchi until they float, then remove them with a slotted spoon or spider skimmer.', ""Lay the cooked gnocchi on a baking sheet and toss with a little olive oil so they don\\'t stick together."", ""6 Repeat! Now go back to the next big chunk of dough and repeat the process. it is important to boil gnocchi in small batches so they don\\'t stick to each other."", '7 Saut\\xc3\\xa9 gnocchi in butter: When all the gnocchi are made, heat the butter over medium-high heat until it stops frothing. Add enough gnocchi to the pan to cover it in one layer. Do not let them stack up on each other. Let them fry undisturbed for 90 seconds.', '  Sprinkle half the sage over the pan. Cook for another minute, then turn out onto plates. Repeat with the remaining gnocchi.', ""8 Keep warm in oven: If you have to do this in several batches, keep the finished gnocchi on baking sheet in the oven set on Warm. Serve as soon as they\\'re all done, dusted with black pepper and the truffle salt, if you have it.""]",19
900,Creamy Pumpkin Soup with Smoked Paprika Recipe,15,105,120,"['4-5 pounds of cooking pumpkins (see Recipe Note), or 3 (15-ounce) cans of pumpkin pur\\xc3\\xa9e', '4 tablespoons butter', '2 medium yellow onions, chopped, about 2 cups', '3 garlic cloves, minced', '2 to 3 teaspoons smoked paprika, more or less to taste', '1/2 teaspoon ground cumin', '1 pinch cayenne pepper', '1 large tart green apple (Granny Smith) peeled, cored, chopped (about 2 cups)', '4 cups chicken broth (or vegetable broth for vegetarian option, and gluten-free broth for gluten-free version)', '1 cup water', '1 teaspoon fresh thyme or 1/2 teaspoon dried thyme', '1/4 teaspoon ground sage', '1 cup milk', '1/2 cup cream', 'Salt and freshly ground pepper, to taste', 'Handful of toasted pepitas (shelled pumpkin seeds) for garnish']",16,"['1 Roast the squash: Preheat the oven to 350\\xc2\\xb0F. Cut your pumpkin(s) in half, and scoop out the seeds and stringy stuff (an ice cream scoop works well for this purpose). Lay the halves face down on a foil or silicone lined baking sheet and bake until soft, about 45 min to an hour.', ""Cool, remove the peel, scoop out the flesh. You'll need 6 cups roasted pumpkin for this recipe; freeze whatever you don't use for future use."", ""Don't throw away the seeds! Toast them for a healthy snack."", '2 Cook the onions with the seasonings: Melt butter in a 4-quart saucepan over medium-high heat. Add the onions and cook, stirring often, until softened, about 4 minutes.', 'Add the garlic and cook a minute more. Add smoked paprika, ground cumin, and cayenne and stir for a minute more.', '3 Add the remaining ingredients and simmer: Add the chopped apple, pumpkin, broth, water, thyme, and ground sage. Mix well with a wooden spoon. Season with a little salt and pepper.', 'Bring to a boil, then reduce heat to medium-low, partially cover, and simmer for 20 minutes or until the apples are cooked through.', '4 Pur\\xc3\\xa9e the soup: Working in batches, transfer soup to a blender or a food processor. Cover tightly and blend until smooth. Alternatively, use an immersion blender to pur\\xc3\\xa9e.', ""If you want extra smooth soup, pass the pur\\xc3\\xa9e through a food mill, after it's been through the blender."", '5 Stir in the milk and cream: Return the soup to the saucepan over low heat. Slowly add the milk and cream, stirring to incorporate.', 'Taste and add additional salt or other seasonings if needed. (Since I use unsalted homemade stock, I add about 2 teaspoons of salt to this soup.)', '6 Serve! Sprinkle with toasted pepitas (shelled pumpkin seeds) and a little more smoked paprika to serve.', 'This soup can be made a day ahead. Leftovers will keep refrigerated for about a week, or frozen for up to three months.']",13
901,Chocolate Pumpkin Pancakes Recipe,15,20,35,"['1 cup pumpkin puree', '1 large egg', '2 tablespoons melted butter', '2 cups all-purpose flour', '3 tablespoons sugar', '2 teaspoons baking powder', '1 teaspoon baking soda', '2 tablespoons cocoa powder', '1 teaspoon cinnamon', '1/2 teaspoon ground ginger', '2 cups chocolate milk', 'Chocolate chips, garnish', 'Chocolate syrup, garnish', 'Whipped cream, garnish']",14,"['1 Mix the ingredients: In a medium bowl, whisk together the pumpkin puree, egg, and melted butter.', 'In a smaller separate bowl, whisk together flour, baking powder, baking soda, cocoa powder, and spices.', '2 Make the batter: Stir the dry ingredients into the pumpkin mix and add the chocolate milk. Stir until just combined. Mixture should be thick, but pourable. If it is too thick (not pourable), then add more chocolate milk by the 1/4 cup.', '3 Cook the pancakes: On a greased or buttered griddle over medium-low heat, add 1/3 cup of batter.', 'Cook pancakes for 2-3 minutes on the first side until bubbles start to form on the pancake and the edges start to firm up. Flip and cook for another 2 minutes on the second side.', '4 Shape the pancakes: Remove pancakes and use a cookie cutter to shape pancakes (optional).', '5 Serve the pancakes: Chocolate pancakes are great with a drizzle of chocolate syrup, a sprinkle of chocolate chips, and even a little whipped cream. Enjoy with a glass of real milk! ']",7
902,Roasted Pumpkin Seeds Recipe,10,0,10,"['One medium sized pumpkin', 'Salt', 'Extra virgin olive oil']",3,"['1 Cut pumpkin, scrape out seeds, rinse: Cut open the pumpkin by cutting a circle around the stem end with a sharp knife (knife blade angled in), and pulling off the top.', 'Use a strong metal spoon to scrape the insides of the pumpkin and scoop out the seeds and strings.', 'Place the mass of pumpkin seeds in a colander and run under water to rinse and separate the seeds from everything else.', '2 Boil pumpkin seeds in salted water for 10 min: Measure the pumpkin seeds in a cup measure. Place the seeds in a medium saucepan. Add 2 cups of water and 1 tablespoon of salt to the pan for every half cup of pumpkin seeds. Add more salt if you would like your seeds to be saltier.', 'Bring the salted water and pumpkin seeds to a boil. Let simmer for 10 minutes. Remove from heat and drain.', '3 Bake seeds in 400\\xc2\\xb0F oven until browned: Preheat the oven to 400\\xc2\\xb0F. Coat the bottom of a roasting pan or thick baking sheet with olive oil, about a teaspoon or so.', 'Spread the seeds out over the roasting pan in a single layer, and toss them a bit to coat them with the oil on the pan.', 'Bake on the top rack until the seeds begin to brown, 5-20 minutes, depending on the size of the seeds.', ""Small pumpkin seeds may toast in around 5 minutes or so, large pumpkin seeds may take up to 20 minutes. Keep an eye on the pumpkin seeds so they don't get over toasted. When lightly browned, remove the pan from the oven and let cool on a rack. Let the pumpkin seeds cool all the way down before eating."", 'Either crack to remove the inner seed (a lot of work and in my opinion, unnecessary) or eat whole.']",10
903,Pumpkin Waffles Recipe,15,15,30,"['1 cup all-purpose flour', '1/4 cup yellow cornmeal, finely ground', '1 teaspoon baking powder', '1/2 teaspoon baking soda', '1/4 teaspoon salt', '1 1/2 teaspoons ground cinnamon', '1/2 teaspoon ground ginger', 'Pinch ground nutmeg', 'Pinch of ground cloves', '2 large eggs', '2 tablespoons brown sugar (packed)', '1 1/4 cup buttermilk', '1/2 cup fresh or canned pumpkin pur\\xc3\\xa9e', '4 tablespoons butter, melted (plus a little more for brushing the waffle iron)', 'Applesauce or apple butter for serving', 'Special equipment:', 'Waffle maker']",17,"['1 Preheat your waffle iron.', '2 Whisk dry ingredients: In a medium bowl, vigorously whisk together the flour, cornmeal, baking powder, baking soda, salt, and spices.', '3 Whisk sugar and wet ingredients: In a larger bowl, whisk together the eggs and brown sugar until there are no more brown sugar clumps.', 'Add the buttermilk, pumpkin pur\\xc3\\xa9e, melted butter and whisk until smooth.', '4 Add the dry ingredients to the wet ingredients and whisk until smooth.', '5 Cook in waffle iron: Brush a little melted butter over the wells of the hot waffle maker (to make it easier to remove the waffles.)', 'When your waffle maker is hot, working in batches, ladle the batter onto the center of the waffle iron wells, not all the way to the edge, and slowly lower the top lid of the waffle iron.', 'Cook until your waffle iron indicates that the waffles are ready, or until steam stops coming out of the sides of the waffle iron, about 4 to 5 minutes.', 'Open the waffle iron and carefully lift the edge of a waffle with a fork to remove the waffles from the waffle iron.', 'Serve with warmed maple syrup and a side of apple sauce or apple butter.']",10
904,Pumpkin Ginger Nut Muffins Recipe,15,25,40,"['1 1/2 cups flour', '1/2 teaspoon of salt', '1 teaspoon baking soda', '1 teaspoon ground ginger', '1/2 teaspoon ground cinnamon', '1/2 teaspoon ground allspice', '1/4 teaspoon ground nutmeg', '2 eggs, room temp', '1 cup brown sugar (dark or light, your choice)', '1 cup pumpkin pur\\xc3\\xa9e', '1/3 cup melted butter', '1/4 cup water', '1 cup chopped pecans or walnuts', '4 Tbsp well chopped candied ginger']",14,"['1 Preheat oven to 350\\xc2\\xb0F.', '2 Whisk together dry ingredients: In a medium sized bowl, whisk together the flour, salt, baking soda, and spices\\xe2\\x80\\x94ground ginger, cinnamon, allspice, nutmeg.', '3 Beat eggs, sugar, add pumpkin, butter, water: In a large bowl, beat the eggs and whisk in the brown sugar, making sure to break up any lumps of sugar. Stir in the pumpkin pur\\xc3\\xa9e, melted butter, and 1/4 cup of water until well combined.', '4 Add dry to wet ingredients, add ginger, nuts: Stir in the dry ingredients, a third at a time, until just incorporated. Do not over-mix. Fold in the candied ginger and chopped nuts.', ""5 Put into muffin tin and bake: Spoon mixture into a prepared muffin tin. Bake for 25 minutes at 350\\xc2\\xb0F. Check for doneness with a toothpick inserted into the center of a muffin. If it comes out clean, it's done. Cool on a rack.""]",5
905,Instant Pot Pumpkin Cheesecake Recipe,15,780,795,"['For the crust:', '1/4 cup pecans or pecan pieces', '8 graham cracker sheets', '1 tablespoon brown sugar or turbinado sugar', '1 tablespoon unsalted butter, melted and cooled', '1/4 teaspoon kosher salt', 'For the filling:', '12 ounces cream cheese, at room temperature', '1/4 cup heavy cream', '1/2 cup canned pumpkin puree', '1/2 cup brown sugar or turbinado sugar', '1 tablespoon all-purpose flour', '1 teaspoon vanilla extract', '3/4 teaspoon pumpkin pie spice', '2 large eggs plus 1 egg yolk, at room temperature', 'For the whipped cream:', '1 cup heavy cream', '1 tablespoon bourbon', '1 tablespoon powdered sugar', 'To garnish:', 'Sprinkling of ground cinnamon', '2 tablespoons chopped toasted pecans', 'Special equipment:', '7-inch round springform pan, or 7-inch by 3-inch push-pan', 'Food processor', '6-quart electric pressure cooker, such as the Instant Pot']",26,"['1 Prepare the pan: Line the base of a 7-inch round springform pan or 7-inch by 3-inch push-pan with parchment paper. Lightly grease the sides of the pan with butter or nonstick cooking spray.', '2 Toast the pecans: Toast the pecans in a dry skillet over medium heat on the stovetop for 4 to 5 minutes until they become fragrant; watch carefully to avoid burning. Alternatively, toast the pecans in a 350\\xc2\\xb0F oven for about 10 minutes, checking frequently, until toasted and fragrant.', 'Allow the nuts to cool.', '3 Process and prepare the crust: In a food processor, process the cooled pecans and graham crackers to fine crumbs. Add the brown sugar, melted butter, and salt. Using 1-second pulses, process until the mixture resembles damp sand.', 'Transfer the crumb mixture to the prepared pan and press firmly into an even layer on the bottom and about 1/2 inch up the sides of the pan. Use the bottom of a drinking glass to firmly press the crumbs into the bottom.', 'Place the pan in the freezer to allow the crust to firm up a bit while you make the filling.', '4 Make the filling: In the now-empty food processor, combine the cream cheese, heavy cream, pumpkin puree, brown sugar, flour, vanilla, and pumpkin pie spice. Process the mixture for about five 1-second pulses, just until smooth, stopping to scrape down the sides of the bowl as needed.', 'One at a time, add the eggs and the egg yolk, processing for two 1-second pulses after each addition until just barely combined. Using a rubber spatula, gently stir in any large streaks of egg yolk. It\\xe2\\x80\\x99s fine if a few small streaks remain. (Do not over-process the filling, or the batter may overflow the pan as it cooks and you will end up with an overly fluffy cheesecake, which may crack as it cools.)', '5 Pour the filling into the prepared crust. Remove the crust from the freezer and pour in the filling. Tap the pan firmly against the countertop a few times to remove any air bubbles from the filling. Place the pan on a long-handled silicone steam rack.', 'If you are using a tall push pan, you can cover it with aluminum foil to keep any condensation off of the cheesecake. If using a springform, do not cover.', '6 Pressure cook the cheesecake: Pour 1 1/2 cups water into the Instant Pot. Holding the handles of the steam rack, lower it into the pot.', 'Secure the lid and set the Pressure Release to \\xe2\\x80\\x9cSealing.\\xe2\\x80\\x9d Select the Cake, Pressure Cook, or Manual setting and set the cooking time for 32 minutes at high pressure. (The pot will take about 10 minutes to come up to pressure before the cooking program begins.)', '7 Release the pressure and cool: When the cooking program ends, leave the pot on its default \\xe2\\x80\\x9cKeep Warm\\xe2\\x80\\x9d setting for 20 minutes, letting the pressure release naturally.', 'After 20 minutes, open the pot, taking care not to drip condensation from the lid onto the cheesecake. Wearing heat-resistant mitts, grab the handles of the steam rack, lift it out of the pot, and transfer the cheesecake to a cooling rack.', 'If you have not covered the pan with foil, use a paper towel to dab up any moisture that may have settled on the top. If the pan is covered, remove the foil, taking care not to get burned from the steam.', 'The cake will be puffed up and jiggle a bit in the center when it comes out of the pot, but it will settle and set up as it cools.', '8 Cool and refrigerate the cheesecake: Let the cheesecake cool on the rack for about 1 hour, then cover (or re-cover) and refrigerate for at least 12 hours, or up to 24 hours.', '9 Prepare the whipped cream: The day you plan to serve the cheesecake, make the whipped cream. In a medium bowl or stand mixer, combine the heavy cream, bourbon, and powdered sugar. Using an electric mixer or whisk, beat the mixture vigorously (about 2 minutes on high) until fluffy and just stiff enough to hold its shape. Cover the bowl and refrigerate for up 12 hours.', '10 Serve the cheesecake: If using a springform pan, run a knife around the side of the pan, then unclasp the collar on the pan and lift it off to unmold it. Use the parchment border to tug the cheesecake off the base of the pan and onto a plate.', 'If you\\xe2\\x80\\x99re using a push pan, run a knife around the side of the pan, place a drinking glass under the pan, then gently slide the outside ring of the pan downwards.', 'Transfer the cheesecake to a serving plate. Cut into wedges and serve each piece topped with whipped cream, chopped nuts, and a sprinkle of cinnamon.']",21
906,Chipotle Pumpkin Soup Recipe,15,30,45,"['2 tablespoons extra virgin olive oil', '1 medium yellow onion, chopped', '3 garlic cloves, chopped', '1 teaspoon ground cumin', '1-2 chipotle peppers (canned in adobo, 1 for mild, 2 for spicy), chopped', '8 cups chopped, cooked pumpkin* (1 7-8 pound cooking pumpkin to yield 8 cups cooked pumpkin, or 3 15-ounce cans of canned pureed pumpkin)', '4 to 6 cups chicken stock, depending on desired thickness and how thick your pumpkin pur\\xc3\\xa9e is (use vegetable stock for vegetarian or vegan option, can sub water for some of the stock)', '1 teaspoon dried oregano or 1/2 teaspoon ground oregano', '2 teaspoons salt, more to taste', '2 tablespoons lime juice', 'Garnishes:', 'Toasted, shelled pumpkin seeds (pepitas)', 'Cilantro', ""Creme fresca, creme fraiche or sour cream thinned with a little water so that it's runny"", '*To cook fresh pumpkin, use a good cooking pumpkin (i.e. sugar pumpkin, fairytale pumpkin, hubbard, or kabocha pumpkin), cut in half, scoop out the seeds, place the pumpkin cut side down on a foil-lined, rimmed baking sheet. Bake at 350\\xc2\\xb0F for about an hour, or until soft. Scoop out the pumpkin flesh or cut away the skin. Let cool. Freeze for long term storage.']",15,"['1 Saut\\xc3\\xa9 onions, garlic, cumin, chipotle: Heat oil in a large pot (8-quart) on medium high heat. Add the onions and cook for 3-4 minutes, until softened. Add the garlic, cumin, and chipotle, cook for 1 minute more.', '2 Add pumpkin, stock, oregano, salt, then simmer: Add the pumpkin, chicken stock, oregano, and salt. Bring to a simmer, reduce the heat and simmer for 20 minutes, partially covered.', '3 Toast pumpkin seeds: If you are working with raw pumpkin seeds, now would be a good time to toast them. (If your pumpkin seeds are already toasted, skip this step.) Just spread them out in an even layer in a frying pan on medium high heat. Stir with a wooden spoon while toasting, until the pumpkin seeds are fragrant and are lightly browned. Remove to a bowl.', '4 Pur\\xc3\\xa9e soup: Remove the soup from heat. Working in batches of 2 cups each, pur\\xc3\\xa9e the soup in batches, holding down the lid the your blender tightly while pur\\xc3\\xa9eing, and starting on a slow speed. Return the pur\\xc3\\xa9ed soup to the pot.', '5 Add lime juice and more seasonings: Add lime juice. Adjust seasonings to taste, adding more salt, cumin, oregano, or chipotle to taste. If the soup is too thick, add more stock or water to desired consistency.', 'Serve with toasted pumpkin seeds (pepitas), crema fresca drizzled over the top, and chopped cilantro.']",6
907,Pumpkin Cookies Recipe,15,15,30,"['1 cup butter, room temperature', '1 cup packed brown sugar', '1 cup granulated sugar', '1 large egg', '1 teaspoon vanilla extract', '1 cup pumpkin pur\\xc3\\xa9e, canned or homemade', '2 cups all-purpose flour', '1 1/3 cups quick or old-fashioned oats', '1 teaspoon baking soda', '1 teaspoon ground cinnamon', '1 teaspoon ground cardamom', '1/2 teaspoon salt', '1 cup pumpkin seeds', '1 cup dried currants']",14,"['1 Preheat the oven to 350\\xc2\\xb0F.', '2 Beat the wet ingredients: Beat the butter, brown sugar, and white sugar together until light and fluffy, about 3 minutes. Add the egg, vanilla extract, and pumpkin pur\\xc3\\xa9e and beat for another 3 minutes.', '3 Combine the dry ingredients: In a separate bowl, combine the flour, oats, baking soda, salt, cardamom and cinnamon and whisk together.', '4 Make the cookie dough: Slowly add it to the butter mixture until just combined, being sure to scrape down the sides and bottom once or twice to ensure even mixing. Fold in the pumpkin seeds and currants.', '5 Bake the cookies: Drop spoonfuls of dough on cookie sheets lined with parchment paper. Bake for 13 to 15 minutes, until dry on top and slightly browned around the edges.', '6 Cool and serve: Allow to cool on the tray for a minute or two to set, then move to a wire rack to finish cooling. Cookies will keep in an airtight container for at least a week.']",6
908,Gluten-free Pumpkin Cupcakes Recipe,15,20,35,"['1 stick (1/2 cup) unsalted butter, room temperature (I only had 3/4 of a stick so I used that and added 2 Tbsp of olive oil. It worked fine.)', '1 cup brown sugar, packed', '1 Tbsp molasses', '1 Tbsp honey', '2 large eggs', '1 teaspoon vanilla extract', '1 cup pumpkin pur\\xc3\\xa9e', ""2 cups Red Mill's gluten-free flour"", '1/4 teaspoon baking powder', '1 teaspoon baking soda', '1/2 teaspoon salt', '1 1/2 teaspoon of pumpkin pie spice (1/2 teaspoon cinnamon, 1/4 teaspoon ground ginger, 1/4 teaspoon ground cloves, 1/4 teaspoon ground nutmeg, 1/4 teaspoon lemon zest)', '1/2 cup buttermilk*', '1/2 cup chopped pecans', '1 cup raisins', 'Frosting ingredients:', '8 oz. cream cheese, room temperature', '1/4 cup (1/2 stick) unsalted butter, room temperature', '1/4 cup maple syrup', ""1 cup confectioner's powdered sugar, sifted"", '*Note to make your own buttermilk, combine 1/2 cup of milk with 1/2 Tbsp of vinegar or lemon juice. Stir and let stand 10 minutes before using.']",21,"['1 Preheat the oven to 350\\xc2\\xb0F. Place an oven rack in the center of the oven.', '2 Beat sugar and wet ingredients, add eggs, then pumpkin: In a mixer, beat the butter, brown sugar, molasses, and honey together until light and fluffy, about 2-3 minutes. (Start on low speed and increase to high speed to get the mixture light and fluffy.)', 'Add the eggs, one by one, mixing well after each addition. Add the vanilla extract and pumpkin pur\\xc3\\xa9e. Beat until well mixed.', '3 In a separate bowl, whisk together the dry ingredients \\xe2\\x80\\x94 the gluten-free flour, baking soda, baking powder, salt and spices.', '4 Combine dry ingredients, wet ingredients, and buttermilk to make the cupcake batter: Add the flour mixture and buttermilk alternately to the pumpkin batter, in three additions, beginning and ending with the flour mixture.', '5 Add pecans and raisins: Use a wooden spoon to mix in the pecans and raisins.', '6 Portion out batter into muffin cups: Arrange paper cupcake holders in a muffin tin. Portion out the batter into the cupcake paper cups, filling them close to the top of the cups.', '7 Bake: Bake at 350\\xc2\\xb0F for about 18 minutes, or until a tester inserted in the middle comes out clean. Remove from oven to a rack. Let cool completely before frosting.', ""8 Make the frosting: In an electric mixer, beat together the cream cheese and butter until smooth. Add maple syrup and confectioners' sugar and mix to combine."", 'Once cupcakes have cooled, apply the frosting.']",10
909,Curried Squash and Pear Soup Recipe,15,45,60,"['6 cups cubed butternut squash (about 1 1/2 pounds)', '3 tablespoons extra virgin olive oil', '1 teaspoon butter', '1 medium onion, chopped (about 1 1/2 cups)', '2 1/2 teaspoons yellow curry powder', '1/2 teaspoon ground ginger', 'Pinch of nutmeg', '2 cups peeled, chopped Bartlett pear (about 1 pound, 3 pears)', '1 1/2  cups water', '1 cup pear nectar', '4 cups chicken or vegetable stock (use veg stock for vegetarian option)', '1/2 teaspoon salt', '1/8 teaspoon black pepper', '1/4 cup heavy whipping cream', '1 small Bartlett pear, cored and thinly sliced']",15,"['1 Saut\\xc3\\xa9 the butternut squash: Heat 2 Tbsp olive oil and 1 teaspoon butter in a large, thick-bottomed pot on high heat. Add half of the cubed butternut squash. Toss to coat with the oil. Let cook until lightly browned on several sides.', 'Remove with a slotted spoon to a bowl. Repeat with the remaining butternut squash. Remove to a bowl.', '2 Cook the onions and spices: Add 1 tablespoon of olive oil to the pot. Add the chopped onion. Lower the heat to medium and cook for a few minutes to soften.', 'Then add the curry powder, ground ginger, and nutmeg. Cook for a few minutes more.', '3 Add the chopped pear, and toss to coat. Cook for a minute more.', '4 Add water, stock, pear nectar, salt, pepper, then simmer: Add the browned butternut squash to the onion pear mixture. Add the water, stock, pear nectar, salt, and pepper. Bring to a boil on high heat; partially cover, reduce heat, and simmer 30 minutes.', '5 Pur\\xc3\\xa9e: Pur\\xc3\\xa9e using a stick blender or if using a standing blender, pur\\xc3\\xa9e a third of the soup at a time.', 'If the soup is too thick for you, add a little water to thin it. If it is too thin for you, bring it to a boil and let it boil down a bit.', '6 Add cream: Turn off heat. Stir in 1/4 cup of cream.', 'Ladle soup into bowls, and garnish with pear slices.']",10
910,Curried Butternut Squash Soup Recipe,15,60,75,"['1 2-pound butternut squash, peeled, seeded, diced into 1/2-inch to 3/4-inch cubes, yielding about 6 cups of cubed squash (see how to cut and peel a butternut squash)', 'Extra virgin olive oil', '1 teaspoon butter', 'Salt', '1 large yellow onion, chopped', '2 teaspoons yellow curry powder', '1 teaspoon whole mustard seeds (if you substitute ground mustard, only use 1/4 teaspoon)', 'A dash of ground cumin', '1 tablespoon minced fresh ginger', '4 cups chicken stock', '1 teaspoon salt', '1/2 cup sour cream (can substitute plain yogurt)', '1/4 cup chopped fresh cilantro (can substitute parsley)']",13,"['1 Saut\\xc3\\xa9 the cubed squash: Heat a tablespoon of olive oil in a large, thick-bottomed stock pot on medium heat. Add a dab of butter to the olive oil.', 'Working in two batches so as not to crowd the pan, add the cubed butternut squash to the pan. Toss to coat all sides with oil. Sprinkle a little salt over the squash. Then spread out in an even layer and let cook, stirring only occasionally, so that the edges and sides get lightly browned.', 'You may need to adjust the heat up to ensure browning, or down to prevent burning or drying out. Add more oil and butter for the additional batches. Remove from pan and set aside.', '2 Saut\\xc3\\xa9 the onions, spices, ginger: Heat another tablespoon of olive oil in the pot, on medium heat. Add the chopped onions and cook, stirring now and then, until softened. Add the curry powder, mustard seeds, cumin, and fresh ginger, and cook for a minute or so longer. Use a flat bottomed wooden or metal spatula to scrape up any browned bits.', '3 Add the squash, stock, salt, then simmer: Return the butternut squash to the pot. Add the chicken stock and a teaspoon of salt. Increase the heat to bring to a simmer, then lower the heat to maintain a low simmer, cover the pot. Cook for 40 minutes until squash is completely tender.', '4 Pur\\xc3\\xa9e the soup: Use an immersion blender (or a stand up blender in which case work in batches) to blend the soup smooth. Add more salt to taste if needed.', '5 Serve with sour cream and cilantro: Serve in individual bowls with a dollop of sour cream and some chopped cilantro.']",7
911,Baked Stuffed Clams Recipe,10,55,65,"['10-12 large chowder or quahog clams, rinsed, sand and grit removed', '3 tablespoons minced onion', '1/2 cup butter (1 stick)', '2 tablespoons chopped fresh parsley (or 2 teaspoons dried)', '1 clove garlic, minced', '1 tablespoon lemon juice', '1 cup breadcrumbs', '1 tablespoon clam juice (or cooking liquid from steaming the clams)', 'Salt and freshly ground pepper to taste', '1/4 cup grated Parmesan cheese']",10,"['1 Cook the clams: Fill a large pot with 1 1/2 to 2 inches of water. Bring water to a boil. Add the clams to the boiling water. Reduce the heat to a simmer and let the clams steam for approximately 6-10 minutes, until the shells open.', ""Remove clams from the pot and let cool enough to handle. Discard any clams that have not opened (if they haven't opened it means they were dead to begin with and should not be eaten)."", '2 Remove the clam meat from the clams (not the clam foot which is attached to the shell) and mince finely.', '3 Pick the best clam shells for serving: Break apart the clam shells from their hinges. Rinse. Pick 10-12 of the cleanest, nicest looking clam shells and set aside.', '4 Make the stuffing: Preheat oven to 350\\xc2\\xb0F. In a saut\\xc3\\xa9 pan, melt the butter on medium heat and add the minced onion. Once the onions have softened (2-3 minutes), add the garlic.', 'Cook the garlic for 1 minute, then add the parsley, bread crumbs, minced clams, lemon juice, and clam juice.', 'Stir until the stuffing mixture is completely moistened. (If too dry, add a bit more butter or clam juice; if too wet, add a bit more bread crumbs.', '4 Stuff clam shells with stuffing, sprinkle with Parmesan, bake: Lay clam shells on a baking dish. Scoop a little stuffing mixture onto each clam shell. Sprinkle with grated Parmesan.', 'Bake at 350\\xc2\\xb0F for approximately 20-25 minutes, until Parmesan is lightly browned on top.', 'Variations:', 'Cook a few strips of bacon until fat renders but not brown or crispy, chop and mix in with the stuffing.', 'Use crumbled up Ritz crackers for the breadcrumbs.', 'Put a little piece of cheddar cheese underneath the clam mixture in each clam, that way you get a little melted cheese with each bite!', 'Tip:', 'Save your biggest, prettiest clam shells to use for future stuffed clam dishes. To clean, just rinse them off and run them through the dishwasher with your dishes.']",15
912,Shrimp Quesadilla Recipe,15,10,25,"['1/4 pound of medium-small raw shrimp, peeled and deveined', '1/4 teaspoon chipotle powder or chili powder', 'Pinch of salt', 'Pinch of pepper', '1 Tbsp of lime or lemon juice', '2 1/2 teaspoons extra virgin olive oil (divided, 2 teaspoons and 1/2 teaspoon)', '1 Tbsp chopped red onion', '1 Tbsp chopped fresh cilantro, plus more for garnish', 'Salt and pepper', '2 medium-sized flour tortillas', '1/2 cup shredded Monterey Jack cheese', '1/4 avocado, sliced', 'Dollop of sour cream or crema fresca']",13,"['1 Marinate the shrimp: Toss the shrimp in a small bowl with 1/4 teaspoon of chipotle powder or chile powder, a pinch of salt, pinch of pepper, and a tablespoon of lime or lemon juice. Let sit for 10 minutes. Then drain out the juice.', '2 Cook the shrimp: Heat a couple teaspoons of olive oil in a relatively stick-free skillet (a cast iron skillet works well for this) on medium high heat.', 'Add the shrimp and cook for half a minute on each side, and remove to a bowl.', ""The shrimp shouldn't be completely cooked through; they will continue to cook during the next step."", '3 Heat the tortillas: Wipe out the skillet with paper towels. Add a small amount of olive oil (about 1/2 a teaspoon, you could use butter as well) and heat the pan on medium high.', 'Place one flour tortilla on the skillet. Flip the tortilla over a few times, 10 seconds between flips. Air pockets should begin to form within the tortilla.', 'Remove the tortilla and repeat with the second tortilla. Leave the second tortilla in the pan and reduce the heat to medium.', '4 Build the quesadilla: Sprinkle the tortilla with the grated cheese. Distribute the shrimp on top of the cheese. Add chopped onion and cilantro. Place the other tortilla on top.', 'Flip the quesadilla over when the bottom tortilla is nicely toasted and the cheese has begun to melt. Remove the quesadilla from the pan when the now bottom tortilla has toasted sufficiently.', 'You can also use just one tortilla instead of two, and fold the tortilla over itself like an omelette.', '5 Cut the quesadilla into triangles: Cut like a pie into six pieces (a pizza wheel works well for this). Place on a serving plate. Serve with avocado slices and sour cream. Garnish with chopped fresh cilantro. Squeeze a little lime juice over everything.']",11
913,Arizona Cheese Crisp Recipe,5,15,20,"['One large, burrito-size (13-inch diameter or larger) flour tortilla', '1 Tbsp butter', '1/2 cup of grated cheddar cheese', '1 or 2 roasted green chiles, peeled, seeded, cut into strips (optional)']",4,"['1 Preheat your oven to 350\\xc2\\xb0F with a rack in the middle.', ""2 Butter a flour tortilla all the way to the edges: Place the flour tortilla on a large baking sheet (a dark baking sheet or cookie sheet will work best. Spread the butter all over the top of the tortilla, all the way to the edges. The butter is important for the flavor of a cheese crisp, so don't leave it out!"", '3 Bake the tortilla until lightly toasted: Bake the plain buttered tortilla for about 6 minutes or until it begins to get lightly toasted. (Check on the timing for your particular oven.)', '4 Sprinkle with cheese, add green chile strips, return to oven: Remove the tortilla from the oven and sprinkle with the cheddar cheese, leaving about 1/2-inch from the edges. Add strips of green chiles in a star pattern if you want.', 'Return the tortilla to the oven and cook for 2 more minutes, or until all of the cheese has melted. Remove from oven and eat!', ""My mother will use her oven's convection setting when she makes these cheese crisps. For convection, she'll put the buttered tortilla into a cold oven and heat on convection at 375\\xc2\\xb0F for 7 to 10 minutes. Then she'll sprinkle the cheese and return the quesadilla to the oven for a couple more minutes.""]",6
914,Apple Chicken Quesadilla Recipe,5,5,10,"['4 Flour tortillas (approximately 8-inches wide)', '1 cup cooked, shredded or chopped, chicken meat', '1/4 lb cheddar or Monterey jack cheese, sliced or grated', '1 apple, sliced', '1/4 cup salsa']",5,"['1 Heat the tortilla until puffy: Heat a large skillet on medium high heat. Place one tortilla in the skillet.', 'Flip it a couple of times with a spatula, then let it sit in the pan heating up until air pockets form and parts of the tortilla begin to puff up. Flip it again.', '2 Add cheese and chicken, fold over: Place cheese slices on half of the tortilla, at least 1/2-inch from the edge of the tortilla. Add chicken pieces on top of the cheese. Fold the tortilla over like an omelette, and press down on the folded tortilla with the spatula. Lower the heat to medium.', 'At this point, if you have enough room in your skillet, you can add a second tortilla to the pan to begin to heat it up.', '3 Add apple slices and salsa, cut into triangles: When the cheese inside the quesadilla has melted, remove the quesadilla to a cutting board. Open it wide and layer on apple slices and salsa.', ""Fold the tortilla back again, and cut it into 3 triangles, as if you were cutting a pie. (You don't have to cut the quesadilla into triangles, it just makes it easier for kids to eat.)"", '4 Repeat with the remaining tortillas.']",7
915,Squash Blossom Quesadillas Recipe,10,15,25,"['2 tablespoons extra virgin olive oil', '1 cup chopped onion', '5 cloves of garlic, minced', '30 summer squash blossoms', '1 teaspoon butter', '12 white corn tortillas', '8 ounces Oaxaca cheese (a Mexican string cheese) or Monterey jack cheese, sliced', 'Chopped fresh cilantro for garnish']",8,"[""1 Prepare the squash blossoms: Check the insides of the blossoms for bugs (especially if you've picked the squash blossoms from your garden), rinse out if you find any or if the blossoms are dusty. Otherwise there should be no need to wash."", 'Cut away the stems. Roughly chop the blossoms, stamens and all.', '2 Saut\\xc3\\xa9 onions and garlic: Heat the oil in a large saut\\xc3\\xa9 pan on medium high heat. Add the chopped onion and saut\\xc3\\xa9  for 5 to 6 minutes. Add the garlic and saut\\xc3\\xa9 a minute more.', '3 Add the squash blossoms and toss to coat with the garlic and onions. Cook for a minute or two more, until the blossoms are just wilted. Remove from heat.', '4 Heat the tortilla until bubbles form: Heat a large cast iron pan or a large relatively stick-free skillet on medium heat. Rub a little butter in the pan (just enough to give the tortillas a little flavor). Place a corn tortilla in the pan and heat on both sides for half a minute or so, until bubbles begin to form in the tortilla.', '5 Add cheese and squash blossom mixture: Place a slice or two of the cheese on one side of the tortilla. Top with a tablespoon or two of the squash blossom mixture.', 'Use a spatula to fold the other side of the tortilla over the side with the cheese and squash blossoms. Press down with a spatula. Cook until the cheese has melted and the tortilla lightly browned.', 'While the quesadilla is cooking, if your pan is large enough, you can start heating another tortilla in the pan.', '6 Repeat then serve: When the cheese has melted, remove the quesadilla from the pan and continue to make the remaining quesadillas in the same manner. To serve, cut each quesadilla into triangles and serve with salsa, chopped fresh cilantro, avocado, black beans, Mexican queso crema (or diluted sour cream)']",9
916,Kimchi Avocado Quesadilla Recipe,5,10,15,"['2 tablespoons butter', '1 cup cabbage kimchi, drained and chopped', '2 flour tortillas', '1 1/2 cup grated Monterey jack and/or cheddar cheese', '1/2 avocado, peeled, pitted, sliced', 'A dash of lime juice', '1 tablespoon chopped fresh parsley or cilantro']",7,"['1 Saut\\xc3\\xa9 the kimchi: Melt 1 1/2 Tbsp of butter in a cast iron (or other relatively stick-free) pan on medium high heat. Add the kimchi and spread out in an even layer over the pan. Cook for 5 to 6 minutes, flipping half way. Remove from pan.', '2 Heat the flour tortilla: Add half of the remaining butter to the pan and swirl it around on the bottom. Add one of the flour tortillas and flip it to coat both sides with a little butter.', 'The let it heat in the pan to the point that you see a few bubbles welling up in the center of the tortilla.', '3 Add cheese and kimchi: Add half of the grated cheese and half of the saut\\xc3\\xa9d kimchi.', 'Fold the tortilla over (like an omelette) with a metal spatula. Press down with the spatula. After about 30 seconds or so, flip to the other side. The flour tortilla should be nicely browned.', 'When the cheese has clearly melted remove from pan and repeat with the other tortilla and the remaining cheese and kimchi.', '4 Add avocado, lime juice, parsley: Open up the quesadilla and lay slices of avocado over the kimchi. Sprinkle with a little lime juice and chopped fresh parsley or cilantro. Fold the quesadilla over again.', '5 Cut into wedges to serve.']",8
917,Crispy Cheese and Mushroom Quesadillas Recipe,10,10,20,"['2 tablespoons olive oil', '1 pound cremini, button, or wild mushrooms, or a combination, thickly sliced', '1 clove garlic, finely chopped', '1/2 bunch scallions, thinly sliced', '1/4 teaspoon salt', '1/8 teaspoon ground black pepper', '1 1/2 cups (about 6 ounces) grated cheddar or Monterey Jack, or a combination', 'A small handful of fresh cilantro leaves', '10 (6-inch) corn tortillas', 'To Serve', 'Salsa', 'Jalape\\xc3\\xb1o peppers']",12,"['3 Serve: Cut each quesadilla into quarters as they finish cooking and serve while hot.', 'Alternatively, if you\\xe2\\x80\\x99d like to cook and serve all the quesadillas at once: Transfer each quesadilla as it\\xe2\\x80\\x99s done to a baking sheet in a 300\\xc2\\xb0F oven to keep warm while you finish cooking the remainder. Serve the tortillas on a platter in the center of the table with salsa and some sliced jalape\\xc3\\xb1os, if you like.']",2
918,Easy Avocado and Black Bean Quesadillas Recipe,10,15,25,"['For the avocado mash:', '2 large or 3 small avocados', 'Juice of 1/2 lime', 'Pinch of kosher salt', 'For the quesadillas:', '2 tablespoons olive oil, divided', '1 cup red onion, sliced into 1/4-inch half moons', '1/2 teaspoon kosher salt', '1 1/2 teaspoons cumin', '1 1/2 teaspoons dried oregano', '3/4 teaspoon coriander', '1/2 yellow, red, or orange bell pepper, deseeded and chopped into 1/2-inch pieces', 'Juice of 1/2 lime', '1 (15.5-ounce) can black beans, drained and rinsed', '4 8-inch flour tortillas', '1 cup queso fresco, crumbled or grated', '1 cup sharp cheddar cheese, grated', 'To serve:', 'Sour cream', 'Pico de gallo or salsa']",20,"['1 Make the avocado mash: In a small bowl, mash the avocado with a fork, and add a dash of kosher salt and the juice of half a lime. You want it to reach a consistency that feels close to guacamole\\xe2\\x80\\x94a little chunky, but still spreadable. Set aside.', '2 Cook the veggies and beans: In a cast iron skillet or other large, heavy skillet, heat 1 tablespoon of olive oil over medium heat. Add the red onion and cook, stirring every minute or so, until the onion starts to soften, about 3 to 4 minutes. Add the salt, cumin, oregano, and coriander, stirring until the onions are completely coated.', 'Add the bell pepper and stir to combine. Cook for another 3 minutes, until the peppers just begin to soften. Add the lime juice and black beans and stir the whole mix together. Cook for about 2 minutes, just to warm the black beans through.', '3 Warm the tortillas: Heat the second tablespoon of olive oil in a separate skillet or grill pan over medium high heat. Add 1 flour tortilla and let it heat up for a minute or so. Using tongs, flip the tortilla over, and repeat the process for the other side, until you see a couple of bubbles welling up in the center of the tortilla.', '4 Assemble the quesadilla: Layer the filling, then the avocado, and then the cheese\\xe2\\x80\\x94about 1/4 cup of each, but if you want more cheese than that I\\xe2\\x80\\x99m not the cheese police, so go for it!', '5 Cook the quesadilla: Fold the tortilla over to seal the quesadilla. Cook for 2 to 3 minutes per side, until it\\xe2\\x80\\x99s crispy, and the cheese has melted. Repeat the process for the other quesadillas, although if your skillet is large enough you can make two at a time in the same skillet.', '6 Serve the quesadillas: Cut the quesadillas into triangular portions and serve with sour cream, avocado, and/or the pico de gallo, if desired. Quesadillas are best served and eaten immediately.']",7
919,Breakfast Quesadilla with Black Beans and Eggs Recipe,20,20,40,"['2 teaspoons butter', '1/4 cup chopped red onion', '6 large eggs, beaten in a bowl', '1/8 teaspoon salt, or to taste', 'Pinch black pepper', '1 (15-ounce) can black beans, rinsed and drained', '1 (4-ounce) can chopped mild green chiles, drained', '1/2 cup cilantro leaves', '6 (9-inch) flour tortillas', 'Pickled jalape\\xc3\\xb1o peppers from a jar (optional)', '1 1/2 cups grated sharp cheddar or Monterey jack cheese, or more, to taste', 'Vegetable oil, to reheat the quesadillas', 'To serve:', 'Salsa']",14,"['1 Scramble the eggs: In a nonstick skillet over medium heat, melt the butter. Add the onion and cook, stirring, for 30 to 40 seconds (just to soften them). Add the eggs, salt, and pepper, and cook and stir until they are set to your preference. Remove the pan from the heat.', '2 Make the filling: Stir the beans, mild green chiles, and cilantro into the eggs in the pan.', '3 Assemble the quesadillas: On one-half of each tortilla, spread about 1/2 cup of the filling. Top with a few jalapeno slices (if using) and 1/4 cup cheese. Fold and press together to flatten them.', '4 Cook the quesadillas: Spray or brush a skillet with vegetable oil, then place the skillet over medium heat. Cook the quesadillas for 1 to 2 minutes on each side, or until the cheese melts and the tortillas are lightly browned and crisp on the outside.', 'You can either cook all of the quesadillas, cool them, cut them in half then freeze them. Or just cook what you want to eat right now, and freeze the rest, uncooked for later (this just saves you a little cooking and cooling time now).', '5 To serve: Enjoy with salsa, if you like.', 'TO FREEZE: Line a baking sheet that will fit in your freezer with parchment paper or waxed paper. Spread as many assembled quesadillas as will fit on the baking sheet, top with a layer of paper, and add a second layer.', 'Cover loosely with plastic wrap, and freeze until firm, about 3 hours. Transfer the frozen quesadillas to plastic freezer bags, stacking them between small pieces of parchment or waxed paper. Store for up to 2 months.', 'TO REHEAT: Remove as many quesadillas as you like from the freezer. Spread on a microwave-safe plate and microwave for 2 minutes to partially defrost them. At this point, the tortillas can be a little soggy, but that can be remedied. Just follow the ""Cook the Quesadilla"" instructions in step 4.']",9
920,Sweet Corn and Goat Cheese Quesadillas Recipe,10,15,25,"['3 cups corn kernels, fresh, frozen, or canned', '1 tablespoon butter', '1 teaspoon kosher salt, divided', '1/2 teaspoon freshly cracked black pepper', '2 tablespoons olive oil', '2 cups zucchini, diced no more than 1/2-inch thick', '3 scallions, chopped, green parts included', '4 ounces goat cheese, slightly softened', '1/2 cup large basil leaves, packed loosely', '4 8-inch flour tortillas (or 6 to 8 6-inch corn tortillas)']",10,"['1 Brown the corn: Cook the corn over medium heat in dry pan until it starts to brown and smell a bit like popcorn\\xe2\\x80\\x94this should take about 5 to 7 minutes. Keep a close eye on it; you don\\xe2\\x80\\x99t want it to burn.', 'Transfer to a small bowl and toss with butter, 1/2 teaspoon salt, and 1/4 teaspoon freshly cracked black pepper to combine.', '2 Cook the zucchini: Still on medium heat, add olive oil to the pan, along with the zucchini, 1/2 teaspoon salt, and 1/4 teaspoon black pepper. Cook for 3 to 4 minutes until the zucchini softens a little bit.', 'Add the chopped scallions and cook for another minute or two, until they soften, too. Turn off the heat and add the corn back into the pan. Stir to combine.', '3 Assemble and cook the quesadilla: Heat a grill pan or cast iron skillet over medium heat. Add a teaspoon or so of olive oil and add the tortilla once the oil starts to shimmer a bit. (Alternately, you can remove the veggies to a bowl and then cook the quesadillas in the same skillet.)', 'Spread about a tablespoon or two of softened goat cheese on half of the tortilla. Add the zucchini, corn, and scallion mix evenly on top of the goat cheese, and top with a few basil leaves. Fold the tortilla over. Cook for a couple of minutes and then, using a spatula, gently flip it to the other side.', '4 Serve! Slice into thirds and serve. Repeat the process with the remaining tortillas. Quesadillas are best eaten immediately, while hot. Serve with fresh pico de gallo, chopped avocado, or other accompaniments of your choice.']",7
921,Mini Salmon Quiches Recipe,20,30,50,"['1 tablespoon olive oil', '1 large or 2 small bunches scallions, finely sliced', '2 tablespoons chopped parsley', '2 large eggs', '2/3 cup heavy cream', 'Black pepper, to taste', '1 package (14 ounces) frozen all-butter puff pastry, thawed', '6 ounces cream cheese, cut into small cubes', '6 ounces smoked salmon, torn into pieces', 'Fresh chopped dill (for garnish)', 'Special equipment:', '12-cup standard muffin tin', '3 1/2-inch round cookie or biscuit cutter']",13,"['1 Heat the oven to 375F. Brush a 12-cup muffin tin with vegetable oil. Have on hand a baking sheet and a 3 1/2-inch round cutter.', '2 Cook the scallions: In a small skillet over medium heat, heat the oil. Add the scallions and cook for 5 minutes, or until softened. Stir in the parsley. Remove from heat. ', '3 Mix the eggs and cream: In a bowl, whisk the eggs until the yolks and whites are combined. Whisk in the cream and pepper.', ' 4 Cut out the puff pastry rounds: On a lightly floured surface, open the sheet of puff pastry; if it starts to crack or still feels frozen, let it thaw for a few more minutes before proceeding. Gently roll it to an even thickness, and then cut it into 3 1/2-inch rounds. Stack the scraps on top of each other (do not gather them in a ball) and roll again. Cut out more rounds, until you have 12 rounds. Fit the rounds into the muffin tin, pushing them down into the cups with your fingers.', '5 Fill the tarts: Distribute the scallion and parsley mixture evenly between the muffin cups. Top with the cream cheese and salmon pieces. Pour about 2 tablespoons of the custard over the filling in each cup.', '6 Bake the tarts: Set the muffin tin on a baking sheet, and bake for 25 to 30 minutes, or until the filling puffs and starts to brown. Remove from the oven and cool for 10 minutes. Sprinkle with dill and serve.']",6
922,Zucchini Tomato Quiche Recipe,15,120,135,"['For the crust:', '1 recipe for all butter crust pie dough, rolled out and lining a 9 or 10-inch pie plate, frozen for at least 30 minutes.', 'For the filling:', '2 tablespoons extra virgin olive oil', '1 cup sliced shallots or spring onions', '1/2 pound zucchini (about 1 1/2 cups shredded)', '4 large eggs, room temperature', '1/2 cup milk', '1/3 cup sour cream', '1/3 cup cream', '1 teaspoon dried herbs de Provence (can substitute Italian herb blend)', '10 basil leaves, sliced', '1 tablespoon chopped fresh parsley', '1/2 teaspoon black pepper', '1/2 teaspoon salt', '1 cup (3 ounces) packed, shredded Parmesan cheese', '10 cherry tomatoes, halved or quartered']",17,"['1 Pre-bake the crust: Heat oven to 350\\xc2\\xb0F. If using a homemade pie crust, freeze it for at least 30 minutes.', 'Line the inside of the crust with heavy duty aluminum foil. Fill the pie crust to the top with pie weights\\xe2\\x80\\x94either sugar, dry rice, or dry beans. (I prefer to use sugar).', 'Bake for 50 minutes. Remove from oven, remove foil and pie weights from crust. (See my detailed instructions on blind baking a crust.)', ""Note: If you're using a store-bought crust, you can defrost it and skip the pre-baking, or partially-pre-bake it using the instructions for pre-baking on the package."", '2 Prep the zucchini: Grate the zucchini using the large holes of a box grater. Set the grated zucchini in a mesh sieve set over a bowl to drain off excess moisture.', '3 Cook the shallots: Heat olive oil in a skillet on medium heat. Add the sliced shallots or spring onions and toss to coat with the oil. Lower the heat to low and cook gently for several minutes, occasionally stirring.', 'Once softened and lightly browned, remove from heat.', '4 Make the filling: Beat the eggs in a large bowl. Whisk in the milk, cream, and sour cream. Whisk in the dried herbs de Provence, the fresh sliced basil leaves, chopped parsley, salt, and pepper.', 'Stir in the grated Parmesan cheese and the grated zucchini.', '5 Assemble the quiche: Spread cooked shallots over the bottom of the pre-baked shell. Pour the zucchini filling mixture on top. Arrange cut cherry tomatoes on the top of the filling, pushing each one in about half way.', '6 Bake: Bake for 45 to 55 minutes at 350\\xc2\\xb0F, until set in the center. If the edges of the crust look like they might get a too browned, tent them with foil or a pie protector. Note that if you are using a store-bought crust that is more shallow than a homemade crust, the quiche will cook more quickly.', 'Remove from oven when the center of the quiche has set and the top is lightly browned.', 'Let it cool completely before serving.']",13
923,Cheesy Crustless Quiche Recipe,15,60,75,"['1/2 stick of butter (1/4 cup)', '1/4 cup all-purpose flour', '3/4 cups milk', '1 cup cottage cheese', '1/2 teaspoon baking powder', '1/2 teaspoon salt', '1/2 teaspoon Dijon mustard', '5 eggs', '4 ounces cream cheese, softened', '6 ounces shredded Swiss cheese', '3 Tbsp grated Parmesan cheese', '1/4 cup chopped green onions', '3 slices of cooked bacon, crumbled', '6 cherry tomatoes, cut in half']",14,"['1 Make a roux: Melt the butter in a medium saucepan on medium heat. Stir in flour; cook, stirring until bubbly.', 'Gradually add the milk; cook over medium heat, stirring occasionally, until sauce thickens.', 'Remove from the heat; set aside to cool, about 15-20 minutes.', '2 Preheat oven to 350\\xc2\\xb0F. Combine cottage cheese, baking powder, salt and mustard; set aside.', '3 Make the filling: Beat the eggs in a large mixing bowl. Slowly add the cream cheese, the cottage cheese mixture and the milk/flour sauce.', 'Stir in the Swiss and Parmesan cheeses.', '4 Bake: Pour into a buttered 10"" pie plate. Sprinkle the top with chopped green onions and crumbled bacon. Arrange tomato halves, cut side up, around the top.', 'Bake at 350\\xc2\\xb0F for 40 minutes, until puffy and lightly browned. A knife inserted into the center of the quiche should come out clean. Let rest for 15 minutes, serve.']",8
924,Herbed Turkey Burger Recipe,15,15,30,"['2 tablespoons extra virgin olive oil', '1/2 medium red onion, minced', '4 minced garlic cloves', '2 pounds ground turkey meat, preferably from the legs and thighs', '1/2 teaspoon salt', '1 teaspoon black pepper', '1/2 cup loosely packed chopped parsley', '1 tablespoon minced fresh rosemary', '1 tablespoon minced fresh sage', '2 teaspoons chopped fresh thyme', 'To serve:', 'Burger buns', 'Toppings like sliced onions, lettuce, sliced tomatoes, bacon, mayonnaise, mustard, relish, and/or ketchup']",13,"['1 Saut\\xc3\\xa9 onions and garlic: Saut\\xc3\\xa9 the chopped onion in olive oil for 3 minutes over medium heat. Add the garlic and saut\\xc3\\xa9 for another 2 minutes, or until the garlic begins to brown. Remove from heat. Transfer the onions, garlic, and oil to a large bowl to cool down.', '2 Make the burger mix: Once the onions are cool to the touch, add the ground turkey, salt, pepper, and herbs into the bowl. Using your hands, gently mix everything until well combined. You want the herbs mixed in without overworking the meat (which would make the burgers tough).', '3 Form the meat into patties. Use your fingers to form a slight indentation in the middle of the patties. When burgers cook, the meat contracts from the edges. If the middle part is slightly thinner than the edges it will help the patties finish with a more even shape and less of a bulge in the middle.', '4 Cook the burgers: Cook on a hot grill or in a hot cast iron frying pan for 5 to 6 minutes per side, until cooked through (165\\xc2\\xb0F if using a meat thermometer).', 'If using a grill, first pre-heat the grill on high for 10 minutes and coat the grates with a little vegetable oil.', 'If using a frying pan, put a little oil in the pan first to help keep the burgers from sticking. A trick my mother uses when making burgers in a cast iron frying pan is to sprinkle the bottom of the pan with a little salt. The salt acts sort of like ball bearings, keeping the patties from sticking when you go to flip them.', '5 Serve the burgers: Toast the buns and serve the burgers with the accompaniments of your choice\\xe2\\x80\\x94sliced onions, lettuce, sliced tomatoes, bacon, mayonnaise (especially good with mayo), mustard, relish, and/or ketchup.']",7
925,Roasted Zucchini with Garlic Recipe,10,15,25,"['1 pound zucchini, each cut in half across the middle, then each half quartered lengthwise', '1 teaspoon fresh minced garlic cloves', '1 tablespoon extra virgin olive oil', 'Kosher salt', 'Freshly ground black pepper', '1/2 teaspoon Herbes de Provence or dried thyme, or 1 teaspoon of fresh chopped thyme']",6,"['1 Preheat oven: Preheat oven to 450\\xc2\\xb0F. Make sure there is a rack on the top rack spot in the oven.', '2 Prep the zucchini: Place the zucchini and garlic in a bowl and toss with olive oil.', 'Spread the zucchini out onto a foil or silicone-lined sheet pan, skin side down. Sprinkle with salt (1/4 to 1/2 a teaspoon).', '3 Roast zucchini: Roast the zucchini at 450\\xc2\\xb0F for 8-15 minutes, or until it begins to brown. (Start checking at about 7 minutes and keep checking every few minutes.)', '4 Toss with herbs, salt, pepper: Once the zucchini has started to brown at the edges, remove it from the oven and place the zucchini in a bowl. Gently mix in the herbs and salt and pepper to taste.']",5
926,Easy Saut\xc3\xa9ed Zucchini Recipe,5,25,30,"['6 medium zucchini (7-inches long, 2 1/2 pounds or 1.10 kg total)', '4 tablespoons olive oil', '1/2 teaspoon salt, plus more to taste', '1/4 teaspoon ground black pepper, plus more to taste', '2 tablespoons chopped fresh dill', 'Zest from one lemon', 'Special equipment:', 'Mandoline, or food processor with a slicing disc']",8,"['1 Prepare the zucchini: Cut away the stem from the zucchini and trim the bottom end. Slice the zucchini into 1/8-inch rounds using a mandolin, food processor, or your very best knife skills.', '2 Cook the zucchini in two batches: In a large skillet, heat 2 tablespoons of the olive oil over medium-high heat. Add half the zucchini. Cook without stirring for 4 minutes, or until some of the rounds are golden when you lift them with a spatula.', 'Sprinkle with 1/4 teaspoon of the salt and 1/8 teaspoon of the pepper. Turn and cook 2 minutes more without disturbing or until more rounds are brown. Do this two more times. Not all the rounds will be browned but a lot of them will be. Transfer to a bowl.', 'Cook the second batch of zucchini with the remaining 2 tablespoons oil in the same way. Return all the zucchini to the pan.', '3 Season the zucchini: Sprinkle the hot zucchini with the dill and lemon zest, and toss well. Taste for seasoning and add more salt and pepper, if you like.', '4 Serve hot or warm.']",6
927,The Easiest Way to Microwave Corn on the Cob,0,0,0,"['1 ear of corn, husk on']",1,"['1 Place the corn in the microwave, do not remove the husk. Microwave the corn on the high setting for 4 minutes. Note that every microwave is different. If this timing over-cooks the corn in your microwave, reduce it to 2 to 3 minutes the next time.', ""2 Use a kitchen towel or pot holder to remove corn from the microwave (it's hot!) Cut off the bottom of the corn, stem end, about one row of corn in from the stem."", '3 Slip off the husk and silk.', ""That's it!""]",4
928,Grilled Corn on the Cob,0,20,20,"['4 ears fresh corn, in their husks', 'Butter (or an herb butter) for serving']",2,"['1 Prepare your grill, gas or charcoal, for direct, high heat. (About 550\\xc2\\xb0F) You know the grill is hot enough if are able to hold your hand one inch above the grill for only 1 second.', '2 Grill corn in husks: The corn husks will protect the corn from burning or drying out while it is on the hot grill.', 'If you want a bit of char on your corn, peel off a few of the outer layers of the corn husks first, before grilling.', 'Place the corn in their husks on the hot grill.', 'Cover the grill. Turn the corn occasionally, until the husks are completely blackened and charred on all sides, about 15 to 20 minutes.', '3 Remove silks and charred husks: Remove the corn from the grill. Let them sit for 5 minutes or until cool enough to handle.', 'Remove the silks and charred husks from the corn. If you need to, use a damp towel to protect your hands from any sharp edges from the charred corn husks as you peel them off.', '4 Serve with butter. (Or you can sprinkle with a little chili powder, cotija cheese, and some lime juice for a Mexican twist.)']",8
929,Grilled Mexican Street Corn (Elote) Recipe,10,10,20,"['6 to 8 medium ears sweet corn, husks removed', '1/2 cup Mexican crema, or sour cream', '1/2 cup mayonnaise', '1/2 cup minced cilantro', '1 clove garlic, minced', '1/4 teaspoon ground chipotle pepper, to taste', '2 teaspoons lime zest, from one lime', '2 tablespoon lime juice, from one lime', '1/2 cup cotija cheese, crumbled', 'Lime wedges, to serve']",10,"['1 Heat a gas or charcoal grill to 400F. Clean the grates once it has heated.', '2 Whisk together the sauce: In a bowl, whisk together the crema, mayonnaise, cilantro, garlic, chipotle pepper, lime zest and lime juice. Taste and season the mixture with salt if needed. (Crema has a little salt already, so add extra judiciously.) Set aside.', '3 Grill the corn: Place the husked corn directly onto grill grates. Grill the corn for about 3 minutes, undisturbed, or until kernels begin to turn golden brown and look charred. Turn over and repeat. When all sides are browned, remove from the grill onto a plate.', '  4 Top the corn with sauce and cheese: Using a brush or a spoon, coat each ear of corn with the crema mixture. Sprinkle with crumbled cojita cheese. Sprinkle with additional chipotle pepper, if desired. Serve immediately with extra lime wedges.']",4
930,How to Grill Juicy Boneless Skinless Chicken Breasts,10,40,50,"['For the brine:', '4 cups water', ""1/4 cup Diamond Crystal kosher salt (or 3 tablespoons sea salt or Morton's kosher salt)"", 'For the chicken:', '1 1/2 to 2 pounds boneless skinless chicken breasts', '3 tablespoons extra virgin olive oil (plus more olive oil for the grill)', '1 1/2 teaspoons paprika']",7,"['1 Brine the chicken breast: In a large bowl, whisk the salt in the water to dissolve. Add the chicken breasts to the brine. Put in the refrigerator and chill for 30 minutes.', '2 Prepare your grill: Arrange your grill so that one side is for high direct heat, and the other side is cooler. Alternatively, you can use a grill pan, set over medium-high heat.', '3 Coat chicken with oil and paprika: Remove chicken breasts from brine and pat dry. Coat with olive oil, and sprinkle evenly with paprika.', '4 Grill the chicken breasts: Brush some olive oil on the grill grates. Place chicken breasts on the hot side of the grill (or on the grill pan). Let the chicken grill, undisturbed, until the pieces start getting some grill marks (you can lift up one to check).', 'When the chicken pieces have browned on one side, turn them over, and move them to the cooler side of the grill. Cover, and let them finish cooking.', 'Remove chicken from grill when the internal temperature of the chicken reaches 155\\xc2\\xb0F.', '5 Let the chicken breasts rest: Cover the breasts with foil. The chicken will continue to cook in its residual heat while it rests. Let it rest 5 to 10 minutes before cutting and serving.', 'Serve with grilled peppers, pineapple salsa, or just a squeeze of lime!']",8
931,Instant Pot Easy-Peel Hard Boiled Eggs Recipe,0,19,19,"['Large eggs, cold from the fridge -- at least 1 egg or as many as will fit in a single layer in your pressure cooker', '  Special equipment:', 'Stovetop or electric pressure cooker (I use a 6-quart Instant Pot)', 'Metal steamer basket or silicone steamer basket']",4,"['1 Prepare the pressure cooker: Place a steamer basket in the bottom of your pressure cooker. Add 1/2 to 1 inches of water (1 to 2 cups) to the pressure cooker (check your pressure cooker manual for minimal liquid amounts). The water level should be just below the steamer basket.', '2 Add all the eggs: Use cold eggs, straight from the fridge. You can cook as many eggs as you like at one time, but be careful of wedging eggs too firmly against one another or stacking eggs on top of each other since these can cause eggs to crack.', '3 Bring the pot up to pressure: Close the lid on the pressure cooker and make sure the steam valve is set to the ""sealed"" position. Set the pressure to high and set the timer for 4 minutes for electric pressure cookers (3 minutes for stovetop).', 'The pressure cooker will take 5 to 10 minutes to come to full pressure and then being cooking. Cooking time begins once the cooker has come to pressure.', '4 Let the pressure release naturally for 5 minutes. After cooking is done, let the pressure cooker sit for 5 minutes with the lid on and the steam vent ""sealed"" to allow steam to begin releasing naturally. (If you\\\'re using a stovetop pressure cooker, remove it from heat.)', '5 Quick-release the remaining pressure: After 5 minutes of natural release, flip the steam valve to ""venting"" and quick-release any remaining pressure.', ""6 Cool the eggs. Transfer the eggs to a bowl of cold water to cool (add ice for more rapid cooling, but ice isn\\'t necessarily for making easy-peel eggs). Change out the water as it warms until the eggs are cool, then refrigerate the eggs until needed.""]",7
932,Easy Salmon Foil Packets with Vegetables Recipe,15,20,35,"['For the Harissa Mayonnaise:', '1/4 cup mayonnaise', '1 teaspoon harissa paste', '1 teaspoon honey', '1 tablespoon lime juice', 'For the salmon packets:', '2 to 4 teaspoons olive oil', '1 yellow potato (6 ounces), very thinly sliced', '1/4 teaspoon salt', '1/8 teaspoon pepper', '2 handfuls (4 ounces) fresh sugar snap peas, ends trimmed', '12 to 16 cherry tomatoes, halved', '2 teaspoons lime juice', '2 (6-ounce) skinless salmon fillets', 'For garnish:', '1 lime, thinly sliced', 'Chopped parsley']",17,"['1 Preheat the oven to 375\\xc2\\xbaF.', '2 Make the harissa mayonnaise: In a small bowl, stir the mayonnaise, harissa paste, honey, and lime juice.', '3 Assemble the packets: On a work surface, place an 18-inch-long piece of foil, preferably non-stick, with the long side parallel to the countertop. Brush the face-up side of the foil with 1 teaspoon of oil. (Optional: Instead of oiling the foil, cut a piece of parchment that is 9- by 12-inches and place it over one half of the foil.)', 'Arrange half the potatoes on the oiled side of the foil and sprinkle with a pinch of salt and a pinch of pepper.', 'Place half the snap peas over the potatoes, followed by half the cherry tomatoes. Sprinkle lightly with salt and pepper, and drizzle with 1 teaspoon oil. Sprinkle with 1 teaspoon of lime juice. Place a salmon fillet over the vegetables and spread with half the harissa mayonnaise.', '4 Fold and seal the packet: Fold the foil over the fish so the ends meet. Fold all three open sides to make a border of about 1 inch, and crimp them to tightly seal the packet. Place on a baking sheet.', 'Repeat with the second sheet of foil, vegetables, and salmon.', '5 Bake the packets: Bake the packets for 20 to 22 minutes, or until the salmon and vegetables are cooked through.', 'Carefully open one of the packets to peek. The internal temperature of the thickest part of fish should register 140\\xc2\\xbaF on an instant-read thermometer.', '(Note that the fish will continue to cook for a few minutes once it is removed from the oven.)', '6 Serve the salmon: Open the packets carefully (be prepared for hot steam to escape.) Slide a large spatula under the potatoes and transfer the vegetables and fish to dinner plates. Garnish with the lime slices and a few sprinkles of chopped parsley. Serve with rice, if you like.']",11
933,Pan-Fried London Broil Steak Recipe,0,25,25,"['2 pounds top round cut of steak', 'Kosher salt', 'Dry mustard', 'Pepper', 'Butter, softened to room temperature']",5,"['You want to cook the steak only to medium rare, as cooking it further will make it more tough.', '5 Slice the steak thinly, across the grain.']",2
934,How to Make the Best Steel-Cut Oats Recipe,0,30,30,"['1 tablespoon unsalted butter', '1 cup steel-cut oats', '3 1/4 cup water', '1 cup  milk', '1/2 teaspoon kosher salt', 'To serve:', 'Brown sugar, honey, or other sweetener', 'Heavy cream or milk']",8,"['1 Toast the oats: Melt the butter in a large skillet over medium heat. Add the oats and toast, stirring occasionally, until they begin to smell fragrant and nutty, 5 to 7 minutes.', '2 Cook the oats: In a large, heavy-bottomed pot over medium heat, bring the water, milk, and salt to a low simmer. Add the toasted oats and gently stir a few times.', 'Bring the oats to a slow boil, then decrease the heat to low and partially cover. Cook, stirring occasionally to avoid sticking or clumping, until the oatmeal is thick and the oats are softened, 25 to 30 minutes.', 'The porridge may still be a little loose at this point, but will continue to soak up liquid as it sits.', '3 Let the oatmeal sit: Remove the pot from heat, and let sit for 3 to 5 minutes.', '4 Serve the oatmeal: Divide the oatmeal between bowls, top with brown sugar and cream, and serve.']",6
935,Quick and Easy Artichoke Dip Recipe,10,5,15,"['2 (14-ounce) cans water-packed artichokes, drained (not oil-packed!)', '8 ounces Parmesan cheese, freshly grated (about 2 cups)', '1 cup mayonnaise', 'Salt', 'Pepper', 'To serve:', 'Crackers', 'Toasted slices of baguette', 'Endive leaves']",9,"['1 Coarsely chop the drained artichokes.', '2 Mix ingredients in microwave-proof dish: In an oven or microwave-proof baking or serving dish, mix together the chopped drained artichokes, the grated Parmesan cheese, and the mayonnaise.', '3 Microwave or bake: Microwave on high heat for 5 minutes or bake in a 350\\xc2\\xb0F oven for 20 to 25 minutes. If microwaving, pause occasionally to stir so that the dip gets evenly heated.', '4 Serve: Add salt and freshly ground black pepper to taste. Serve with crackers, endive leaves, or toasted thinly slice bread or baguettes.']",4
936,How To Make French Cr\xc3\xaapes Recipe,5,20,25,"['3 large eggs', '2 1/3 cups milk', '1/4 cup sugar', '1 teaspoon vanilla', 'Pinch of salt', '2 1/3 cups (290g) flour', 'Butter for the pan', 'Special equipment:', '8- or 9-inch nonstick skillet or cr\\xc3\\xaape pan']",9,"['1 Make the cr\\xc3\\xaape batter: In a blender, pulse the eggs, milk, sugar, vanilla, salt and flour for 7 to 10 seconds, or until the batter is smooth. Pour into a bowl. (The batter can be refrigerated, covered, for up to 3 days. If the batter thickens too much, add additional milk before cooking to thin it to the consistency of heavy cream.)', '2 Heat and grease the pan: Heat an 8- or 10-inch non-stick skillet or well-seasoned cr\\xc3\\xaape pan over medium heat until hot. Using one end of a stick of butter, coat the bottom of the pan with a thin layer of melted butter.', '3 Start cooking the cr\\xc3\\xaapes: Pour 1/3 cup of batter into the center of the pan. Immediately pick up the pan and tilt and swirl it to spread the batter evenly over the bottom.', 'Cook for 1 to 2 minutes, or until the cr\\xc3\\xaape is golden on the bottom.', '4 Flip the cr\\xc3\\xaape: Use a rubber spatula to loosen the edge of the cr\\xc3\\xaape all around. Hold the edge with your fingertips and gently, but quickly, flip the cr\\xc3\\xaape to the other side (or use a spatula if that feels more comfortable).', '5 Cook for another 30 seconds, or until the cr\\xc3\\xaape is golden on the bottom. Slide the finished cr\\xc3\\xaape onto a plate.', '6 Repeat until all the batter is used, stacking the cr\\xc3\\xaapes on top of each other on the plate.', '7 Assemble the cr\\xc3\\xaapes: Place one cr\\xc3\\xaape on a plate and fill it with your filling of choice. Either roll the cr\\xc3\\xaape or fold it into quarters and top with additional toppings if desired. Serve warm.', ""If you're not eating them right away, let the cr\\xc3\\xaapes cool, then cover the stack with plastic wrap and refrigerate for up to 3 days. Reheat in a buttered skillet.""]",9
937,Roasted Curried Cauliflower Recipe,10,25,35,"['1 large (or 2 small) head(s) cauliflower, cored, broken into large-ish florets, florets sliced into 1/2-inch slices', '1/2 onion, peeled, thickly sliced, root to tip', '4 cloves garlic, sliced', '2 Tbsp lemon juice', '1/3 cup (80 ml) extra virgin olive oil', '1 1/2 teaspoons yellow curry powder', '1/4 teaspoon ground cinnamon', '1/2 teaspoon salt', '1/4 teaspoon ground black pepper']",9,"['1 Preheat oven, line baking pan with foil: Pre-heat oven to 425\\xc2\\xb0F (220\\xc2\\xb0C) with a rack on the top third of the oven. Line a large rimmed baking with foil.', '2 Whisk together garlic, lemon juice, oil, curry, cinnamon, salt: Put the garlic, lemon juice, olive oil, curry powder, cinnamon, salt, and pepper in a large bowl. Whisk vigorously until well combined.', '3 Coat floret slices with curry mixture:  Add the cauliflower and onion slices to the bowl with the curry and toss to coat. Spread the cauliflower and onion slices on the baking sheet in a single layer.', '4 Roast in oven: Roast in oven at 425\\xc2\\xb0F (220\\xc2\\xb0C) for 25 to 30 minutes until well browned. Check halfway through the cooking, and rotate the pan for more even cooking.', 'Serve immediately or at room temperature.']",5
938,Smoked Salmon Pasta Recipe,10,30,40,"['8 ounces spaghetti (or other) pasta', 'Salt', '1/4 cup pine nuts', '2 tablespoons extra virgin olive oil', '1/3 cup chopped shallots (can substitute onions)', '2 cloves garlic, minced', '1/3 cup dry white wine (can substitute pasta cooking water with a Tbsp of lemon juice)', '1/4 cup cream', '1 tablespoon lemon juice', '2 tablespoons lemon zest (divided into 1 Tbsp and 1 Tbsp)', '2 tablespoons chopped fresh parsley or dill', '4 ounces smoked salmon, cut into bite sized pieces', 'Fresh ground black pepper']",13,"['1 Put pasta water on to boil: Heat to boiling a large pot with at least 4 quarts of salted water in it. (2 Tbsp of salt for 4 quarts of water.)', '2 Toast the pine nuts: While the water is heating, brown the pine nuts. Put the pine nuts in a single layer in a large skillet. Heat on medium heat, stirring occasionally, until fragrant and lightly browned. Remove pine nuts from pan and set aside.', '3 Start cooking the pasta: Once the water is boiling, add the pasta to the pot. Cook uncovered on high heat at a rolling boil. Put the timer on for 8-10 minutes, or whatever your pasta package says is appropriate for al dente (cooked but still a little firm).', 'Once the pasta is done, and before draining the pasta, scoop out one cup of the pasta cooking liquid and reserve.', '4 Prepare the sauce: While the pasta is cooking, prepare the sauce. In a large skillet heat olive oil on medium heat. Add the shallots and garlic, cook for 2 minutes, then add white wine, lemon juice, and 1 Tbsp of lemon zest. Increase the heat and let boil down by half.', 'If you want a slightly creamy sauce, add the cream and let boil a minute more.', 'The sauce should be done about the same time the pasta is done. If you get done earlier with it than the pasta, take it off the heat.', '5 Add pasta, some pasta cooking liquid, smoked salmon, toasted pine nuts, parsley, zest to sauce: Drain the pasta and add it to the skillet with the sauce. Add back some of the pasta cooking liquid to the pasta if it is a little dry. Add the smoked salmon, toasted pine nuts, parsley, and the remaining lemon zest. Season with freshly ground black pepper.']",8
939,Quick and Easy Egg Drop Soup Recipe,7,13,20,"['3 large eggs, lightly beaten', '4 cups chicken stock, homemade preferred', '1 tablespoon cornstarch', 'Scant 1/2 teaspoon grated ginger', '1 tablespoon soy sauce (use gluten-free soy sauce if cooking gluten-free)', '3 green onions, chopped', '1/4 teaspoon white pepper', '3/4 cup enoki mushrooms or sliced shiitake mushrooms']",8,"['1 Make the cornstarch slurry: Measure out 1/2 cup of the stock and mix with the cornstarch until dissolved.', '2 Put stock, ginger, soy sauce, onions, mushrooms, white pepper in pot and bring to boil: Place the remaining chicken stock, ginger, soy sauce, green onions, mushrooms and white pepper in a pot and bring to a boil.', '3 Stir in the corn starch slurry and reduce heat to a simmer.', '4 Stir in beaten eggs: Slowly pour in the beaten eggs while stirring the soup while stirring slowly. The egg will spread out into ribbons.', '5 Serve: Turn off the heat and garnish with a few more chopped green onions. Serve immediately.']",5
940,EASY Baked Apple Slices Recipe,10,5,15,"['4 cups of peeled, sliced apples - use apples that cook up well, like Fuji or Jonagold', '3 Tbsp sugar', 'A sprinkle of cinnamon', '1 Tbsp maple syrup']",4,"['1 Sprinkle apples with cinnamon and sugar: Put apple slices in a glass bowl. Sprinkle on top the 3 Tbsp of sugar. Add a light sprinkle of cinnamon.', '2 Microwave on high for 5 minutes or more: Bake in microwave oven for 5 minutes on high heat. Adjust the time for your microwave and how many apples you are doing. Ours has a powerful high setting so 4 cups of apples only takes 5 minutes.', 'If you use more apples, you will probably need to cook it a little longer. I suggest starting with 5 minutes and testing for doneness with a fork. If it needs more cooking time, give it more.', '3 Add maple syrup to taste: When done, remove and mix so the sugar coats well all the apple pieces. Add maple syrup to taste, about 1 Tbsp.', 'Delicious with whipped cream on top, or with vanilla ice cream on the side.']",5
941,Salmon Fried Rice Recipe,10,15,25,"['3 tablespoons soy sauce', '1 teaspoon brown sugar', '1 tablespoon extra virgin olive oil', '2/3 cup diced red onion', '2/3 cup diced red bell pepper', '2 cloves garlic, minced', '1-inch piece of ginger, grated', '3 eggs, well beaten', '4 cups day old cooked white rice (from about 2 cups of raw rice)', '1 cup frozen peas, thawed', '2 cups cooked salmon in large chunks', '2 green onions, thinly sliced, including the greens', 'Cilantro (or parsley) for garnish']",13,"['1 Mix brown sugar with soy sauce: Dissolve the brown sugar in the soy sauce in a small bowl. Set aside.', '2 Saut\\xc3\\xa9 onion and and bell pepper, add garlic, ginger: Heat the olive oil in a large saut\\xc3\\xa9 pan or wok on medium high heat. Add the diced red onion and bell pepper and saut\\xc3\\xa9 until lightly browned, about 5 minutes.', 'Lower the heat to medium and stir in the garlic and grated ginger. Cook for a minute more.', '3 Add eggs, then rice: Add the beaten eggs and stir until just cooked. Add the cooked rice, increase the heat to medium high and cook for a couple minutes more, stirring often.', ""4 Add peas, salmon, green onions, soy sauce mixture: Add the peas, salmon, and green onions. (Be gentle with the salmon so you don't break it up too much.) Stir in the soy sauce mixture and remove from heat."", 'Garnish with cilantro to serve, serve immediately.']",6
942,Honey Mustard Baked Salmon Recipe,10,10,20,"['1 1/2 to 2 pounds (680 to 900g) salmon fillets', '3 tablespoons honey mustard (1 1/2 Tbsp honey plus 1 1/2 Tbsp Dijon mustard)', '3 cloves garlic, minced (about 3 teaspoons)', '3 tablespoons extra virgin olive oil (divided 2 T and 1 T)', '1 tablespoon lemon juice', '1 tablespoon chopped fresh dill', 'Pinch of salt']",7,"['1 Preheat the oven to 400\\xc2\\xb0F (205\\xc2\\xb0C).', '2 In a small bowl, whisk together the honey mustard, garlic, 2 Tbsp of olive oil, lemon juice, dill, and salt.', '3 Line a roasting pan with aluminum foil. Brush the salmon fillets on both sides with olive oil. Place fillets skin-side down (if your fillets have skin-on) on the foil-lined pan. Use a basting brush to coat the top side of the fillets with the honey mustard mixture.', ""4 Place in oven and bake at 400\\xc2\\xb0F (205\\xc2\\xb0C) for 8 to 10 minutes, until just barely cooked through (please don't overcook salmon!). It's okay if the salmon is still a little rare in the center, when you remove it from the oven, the residual heat will cook it through.""]",4
943,Chicken Larb Lettuce Wraps (Larb Gai) Recipe,10,15,25,"['2 tablespoons vegetable oil, plus more as needed', '1 clove garlic, finely chopped', '1 pound ground chicken or turkey', '2 shallots, thinly sliced', '1 to 2 Thai red or green chilies, thinly sliced, or to taste', 'Water, as needed', '2 tablespoons lime juice', '2 tablespoons fish sauce', '1 tablespoon sweet Thai chili sauce', '1 teaspoon brown sugar', '1 teaspoon Sriracha or sambal oelek', '1/4 cup coarsely chopped mint leaves', '1/4 cup coarsely chopped cilantro', '1 head of Boston lettuce or 2 small lettuce heads, separated into leaves', '2 limes, quartered, for serving', 'Cooked rice, for serving', 'Mint, cilantro or Thai basil sprigs, for serving', 'Extra sriracha or sambal oelek sauce, for serving']",18,"['1 Cook the chicken: In a skillet over medium heat, heat the oil. Add the garlic and stir for 30 seconds. Add the ground chicken and spread it over the bottom of the pan. Without stirring too much, cook for about 6 minutes or until it browns on the bottom. Turn and break it up with the edge of a spatula. Continue cooking for 6 to 8 minutes longer, or until the meat is browned.', 'Stir in the shallots and chilies and cook for 30 seconds. If the mixture looks dry, stir in some water, 1 tablespoon at a time. Remove the pan from the heat.', '2 Add the seasonings: In a small bowl, stir together the lime juice, fish sauce, chili sauce, and brown sugar. Stir the mixture into the meat, along with the chopped cilantro and mint.', '3 Serve the larb: Transfer the meat to a serving platter and place lettuce leaves, lime wedges, and more cilantro alongside. Set out a bowl of cooked rice and a bowl of chili sauce. Spoon some rice into each lettuce leaf and top with a spoonful of larb, a squeeze of lime juice, and chili sauce to taste.']",4
944,Fettuccine Alfredo Recipe,15,15,30,"['For the classic version:', '1/2 pound dry fettuccine pasta', '3 to 4 tablespoons unsalted butter', '2/3 cup finely grated Parmesan cheese', 'Black pepper', 'Additional ingredients for the creamy version:', '1/2 cup heavy cream', 'Ground nutmeg']",8,"['1 Start the pasta: Bring a large pot of salty water to a boil and drop in your fettuccine.', '2a For the classic version: Melt the butter in a large saut\\xc3\\xa9 pan set over low heat. Once the butter has melted, turn the heat off.', '2b For the creamy version: Melt the butter in a large saut\\xc3\\xa9 pan set over low heat. Add the cream to the butter as it melts. Stir often to combine the two, keeping the heat at its lowest setting while the pasta cooks.', '3 Swirl pasta in the pan with butter: When the fettuccine is al dente (cooked, but still a little firm) lift it out of the pot with tongs and move the pasta to the saut\\xc3\\xa9 pan. Do not drain the pasta. You want it dripping wet with the cooking water.', 'Turn on the heat under the saut\\xc3\\xa9 pan to medium and swirl the pasta and butter together to combine.', '4 Incorporate the cheese: Add half the cheese, then swirl and toss the pasta until it has incorporated into the sauce.', 'If needed, add a few spoonfuls more of the pasta cooking water. Add the rest of the cheese and repeat.', '5 Sprinkle with black pepper and/or nutmeg: Serve at once with either a little black pepper (for classic version) and/or ground nutmeg (for creamy version) over the pasta.', 'Leftovers keep for 3 to 5 days in the fridge, covered.']",9
945,Gingerbread Waffles Recipe,15,20,35,"['1 1/3 cups milk, warmed to room temperature', '3 tablespoons melted butter', '1/2 cup molasses', '1/2 cup dark brown sugar', '1 large egg', '1 3/4 cups (290g) all-purpose flour', '1 tablespoon ground ginger', '2 teaspoons baking powder', '1 teaspoon ground cinnamon', '1/2 teaspoon salt', '1/4 teaspoon freshly grated nutmeg', '1/8 teaspoon ground cloves', 'Melted butter or cooking spray for coating the waffle iron.', 'Powdered sugar for serving (optional)', 'Special Equipment:', 'Waffle iron']",16,"['1 Make the waffle batter: In a large bowl, whisk together the milk, melted butter, molasses, brown sugar, and egg until everything is well incorporated. In a separate bowl, mix the flour, ginger, cinnamon, nutmeg, cloves, baking powder and salt together.', 'Gradually mix the flour mixture into the wet ingredients. (I usually pour half of the flour into the wet ingredients and stir until the flour is absorbed before adding the rest of the flour.) Mix until you no longer see streaks of flour. Small lumps are okay.', '2 Let the batter rest as you preheat your Belgian waffle iron to medium-high. Warm the waffle iron for at least 5 minutes, or until a drop of water sizzles on contact with the griddle.', ""3 Make the waffles: Brush melted butter onto the waffle iron or coat with cooking spray. Scoop 2/3 to 3/4 cup of the batter into the waffle iron and use the bottom of the cup to spread the batter around into the edges. Cook for 3 to 4 minutes, or according to your waffle maker's instructions, until the waffles are golden brown on the outside. Remove the waffle from the iron with tongs or a fork and place on a cooling rack."", 'Cook the remaining waffles and serve immediately. Sprinkle waffles with powdered sugar, if you like, or serve with whipped cream and maple syrup.']",5
946,Creamy Ziti Florentine Recipe,5,15,20,"['1 pound dry ziti pasta', 'Salt and pepper, to taste', '2 tablespoons olive oil', '1 bunch scallions, whites and light green parts only, thinly sliced', '4 cups (about 4 ounces) baby spinach leaves', '1/2 cup freshly grated Parmesan or Pecorino Romano, plus more for garnish', 'Zest of one lemon', '1 cup (about 8 ounces) fresh ricotta', '1/2 cup loosely packed torn basil leaves', '1/4 cup chopped fresh parsley']",10,"['1 Cook the pasta: Bring a large pot of heavily salted water to a boil.', 'Add the ziti and cook for 7 to 8 minutes, or until al dente (firm to the bite). Scoop out and reserve 2 cups of the starchy pasta cooking water, and drain the pasta in a colander.', '2 Meanwhile, cook the scallions and spinach: In a large skillet over medium, heat the olive oil. Add the scallions and cook, stirring often, for 2 minutes, or until the scallions soften. Add the spinach and cook, turning with tongs, for 1 to 2 minutes, or just until it wilts.', '3 Finish the pasta: Add the cooked ziti to the skillet, along with 1/2 cup of the pasta cooking water. Add the Parmesan, lemon zest, ricotta, basil, and parsley. Stir vigorously until combined.', 'Add more pasta cooking water if the pasta seems dry. Taste and add more salt and pepper, if you like.', '4 Serve the pasta: Spoon the ziti into shallow bowls and sprinkle with more Parmesan.']",6
947,Quick & Easy Hamburger Soup Recipe,10,30,40,"['1 to 1 1/3 pound ground beef', '1 cup diced yellow onion (from 1 small onion or 1/2 large onion)', '2 stalks celery, diced', '2 large carrots, diced', '1 sweet bell pepper, seeded and diced', '3 cloves garlic, minced', '1 can (14.5 oz) diced tomatoes', '2 tablespoons tomato paste', '1 teaspoon dried oregano', '1/2 teaspoon salt', '1/2 teaspoon ground black pepper', '2 cups beef broth', '1/2 cup red wine, optional', '1 cup elbow macaroni, optional']",14,"['1 Brown the beef: In a large Dutch oven  or stock pot over medium heat, brown the ground beef, breaking it apart with a wooden spoon into large chunks.', 'When browned, use a slotted spoon to transfer the ground beef onto a paper towel-lined plate to drain. Set it aside.', ""2 Cook the vegetables: Pour off all but 1 tablespoon of the rendered fat from the ground beef (or add enough olive oil to make 1 tablespoon if there's not much fat)."", 'Add the diced onion, celery, carrot and bell pepper and cook over medium heat until softened, about 5 minutes.', '3 Add the seasonings, tomatoes, and broth: Stir in the tomato paste and garlic, and cook about 30 seconds, until fragrant. Add in the oregano, salt, and pepper, and stir to combine.', 'Stir in the diced tomatoes, beef broth, and red wine (if using). Lastly, add the cooked ground beef back to the pan. Taste and adjust seasonings as needed.', '4 Simmer the soup: Bring the soup to a rapid simmer. Reduce the heat to medium-low, cover the pot, and cook for about 20 minutes. If you are adding elbow macaroni, add it halfway through cooking, and cook until the pasta is tender.', '5 Serve immediately. Leftovers will keep up to 5 days refrigerated, or up to 3 months frozen.']",8
948,Sour Cream and Bacon Deviled Eggs Recipe,10,0,10,"['12 large eggs', '1/2 cup full-fat sour cream', '1 to 2 teaspoons Dijon mustard', '1/2 teaspoon kosher salt', '1/4 to 1/2 teaspoon granulated garlic', '3 to 4 strips of bacon', '1 1/2 tablespoons chopped chives', 'Ground paprika, to garnish']",8,"['1 Steam the eggs: Fill a pot with 1 to 1 1/2 inches of water. Place a steamer basket inside and bring water to a boil. Once the water boils, turn off the heat. Carefully place 6 eggs into the steamer basket. Cover the pot and return the heat to medium-high. Let the eggs steam for 15 minutes.', 'Using a slotted spoon, remove the eggs and place them in a bowl of ice cold water. Repeat with steaming the remaining 6 eggs. (Get the step-by-step tutorial for making steam-cooked eggs here.)', '2 Let the eggs sit in the ice water for 30 minutes: You may need to add more ice cubes if the heat from the first batch of cooked eggs melts the ice cubes and warms the water.', '3 Peel the eggs and slice each egg in half. Scoop out the egg yolks and place them in a bowl.', '4 Make the deviled egg filling: Using a fork, smash the yolks into small pieces. Add the sour cream, mustard, salt and granulated garlic and mix until you get a smooth mixture. Taste the filling and adjust the seasonings to your liking. Set the filling aside as you cook the bacon.', '5 Cook the bacon: Heat a frying pan over medium heat and cook the bacon to your desired level of crispiness. I usually cook mine for 5 to 6 minutes, until I see some browning on the bacon strips.', 'Use tongs to remove the bacon from pan and onto a plate lined with paper towels. Let the bacon cool for a few minutes. Once the bacon is cool enough to handle, chop or crumble bacon strips into small pieces.', '6 Fill the deviled eggs: Fill a zip-top sandwich bag with the egg yolk mixture. Snip off one of the bottom corners and pipe the egg yolk mixture into the egg white halves. If you don\\xe2\\x80\\x99t have a sandwich or piping bag on hand, you can also just spoon in the egg yolk mixture into the egg white halves.', '7 Sprinkle each egg with chives, paprika, and bacon bits. Serve immediately. Deviled eggs can also be refrigerated for a few hours before serving, but are best served the day they are made.']",9
949,Easy Make-Ahead Alfredo Sauce Recipe,0,10,10,"['1 1/2 cups whole milk, plus extra as needed', '2 tablespoons unsalted butter', '2 tablespoons all-purpose flour', '1 to 1 1/2 cup grated parmesan cheese (3 to 3 1/3 ounces, 85 to 128 grams)', 'Salt, to taste', 'Pepper, to taste']",6,"[""1 Warm the milk: In the microwave (30-second bursts) or on the stovetop, warm the milk until it's warm to the touch and a bit steamy. (It does not need to be boiling hot; just warm.) Set aside."", '2 Make the roux: Melt the butter over medium heat. Sprinkle the flour over top, then whisk together using a whisk.', ""Continue to cook the roux, whisking constantly, for 1 minute. This cooks off the raw flour flavor. It's ok if the roux turns a golden color, but continue immediately to the next step if it starts to brown significantly."", '3 Whisk in the warm milk: Add about 1/4 cup of the warm milk to the roux and whisk. Add another 1/4 cup and whisk some more. The roux will seize up into clumps.', 'Continue adding the milk in small 1/4-cup increments, whisking continuously. The clumps will eventually smooth out and look like mashed potatoes, then a thick puree, and then a sauce. Once it looks like a sauce, whisk in any remaining milk. This step should only take about a minute. You can move through the phases fairly quickly.', ""4 Cook the sauce: Once all the milk has been added, continue to cook the sauce over medium heat while whisking, for 3 to 5 minutes. It's ready when it looks like heavy cream -- slightly thickened and silky."", '5 Stir in the Parmesan: Add all of the cheese at once. Whisk until the cheese has melted into the sauce and is no longer visible. At this point, the sauce should look quite thick and creamy.', ""You can cook it a little longer, whisking occasionally, to let it thicken a little more if you like, but it's better to err on the side of a too-thin sauce at this point. It will thicken a bit more when you reheat it."", '6 Store the alfredo sauce: Transfer the sauce to storage containers and cool completely. A skin will form on the surface of the sauce and the sauce will thicken to a paste-like consistency; this is normal. Refrigerate for up to 5 days, or freeze for up to a month.', '7 Reheat the sauce: If your sauce was frozen, transfer it to the fridge to thaw overnight before reheating.', 'Transfer the sauce into a small saucepan or microwave-safe bowl. Gently warm over low heat, or in 30-second bursts in the microwave, until warmed. Stir occasionally, or between every 30-second burst in the microwave. It will start off very thick and paste-like, but will soften and return to a sauce as it warms.', 'If the sauce seems too thick, whisk in a splash of milk, broth, or water until the sauce is as thinned as you like.', '8 Use reheated sauce immediately: Toss with cooked pasta or pour over cooked vegetables, chicken, or fish.']",13
950,Easy Coconut Shrimp Curry Recipe,5,25,30,"['1 Tbsp olive oil', '1 cup finely chopped onion', '1/2 teaspoon mild yellow curry powder', 'Pinch of ground cardamom or the seeds from 1 cardamom pod, crushed', '1/2 teaspoon Kosher salt', '1 cup canned coconut milk (use regular coconut milk NOT light)', '1/4 cup water', '1 pound raw, peeled, deveined shrimp (with or without tail)', 'Cilantro for garnish']",9,"[""If you haven't already defrosted your shrimp, if using frozen, do that while you prepare the sauce. The shrimp will be thawed and ready to cook by the time the sauce is done."", '1 Saut\\xc3\\xa9 onion, curry, cardamom: Heat olive oil in a medium sized saut\\xc3\\xa9 pan on medium heat. Add the chopped onion. Cook until translucent, about 5 minutes. Add the curry powder, cardamom, and salt. Cook for two more minutes.', '2 Add coconut milk and water, simmer: Add the coconut milk and water, simmer for 5 to 10 minutes.', '3 Add shrimp: Add the shrimp to the curry sauce and spread out evenly in the pan. Simmer for 5 minutes, stirring occasionally, until the shrimp has turned from grey to pink and is just cooked through. Do not overcook or the shrimp will be rubbery.', 'Serve with cilantro for garnish. Serve with basmati rice or better yet, coconut basmati rice.']",5
951,Mussels in White Wine Sauce Recipe,20,15,35,"['2 pounds mussels, scrubbed clean under running water', '1/2 cup dry white wine', '2 tablespoons butter', '1/4 cup minced shallots', '1 tablespoon minced garlic', '2 teaspoons flour (optional, omit for gluten-free version)', '1/4 cup minced parsley']",7,"['1 Clean and prep mussels: Put the mussels in a bowl of salted water (1 Tbsp salt per quart of water) for 10-15 minutes. Throw out any that are wide open or refuse to close when you handle them as these ones are likely dead.', 'Looking over the closed mussels, see if any still have their beards (long hairy byssal threads which help anchor the mussel to surfaces) and pull them out, pulling slowly and strongly towards the hinge of the shell.', '2 Put wine, mussels in bottom of large pot, steam until mussels open: Put 1/2 cup of dry white wine in the bottom of a large pot (at least 4-quart). Add the mussels to the pot. Cover and bring to a boil and then reduce the heat to low. As the mussels cook, they will release their highly flavored water into the pot.', 'Cook until shells have opened, and the mussels are just cooked, looking steamed and soft, 5 to 7 minutes. Take care not to overcook, or the mussels will be rubbery and hard.', '3 Remove cooked mussels, save the cooking liquid: Once the mussels are cooked, carefully remove them from the pot to a bowl, one-by-one using tongs, including those that have broken loose from their shells. Do not discard the liquid in the pot!', ""Let the water in the pot settle for a minute. Any grit will settle to the bottom. Gently pour out the cooking water into a measuring cup, leaving the grit in the pot to discard of later. If the water you've measured out is still a little gritty, filter out the grit using a sieve."", '4 Saut\\xc3\\xa9 shallots and garlic in butter, add flour: Melt the butter in a medium-sized saucepan. Add the shallots and cook a couple minutes until translucent. Add the garlic and cook a minute more. If you want your sauce to be a little thick, add a teaspoon or two of flour to the pan, stir to combine. (Otherwise skip the flour.)', '5 Add mussel cooking water to create sauce: Slowly add about a cup of the filtered mussel cooking water to the saucepan, stirring to create a smooth sauce. Add the minced parsley to the sauce.', '6 Pour sauce over mussels to serve: Place mussels in serving bowls. Pour some sauce over each bowl of mussels.', 'Serve immediately. Serve with crusty bread for dipping in the sauce.']",10
952,How to Make the Best Scrambled Eggs,3,6,9,"['2 large eggs', '1 tablespoon whole milk', '1/2 tablespoon butter', '1/8 teaspoon salt', 'Fresh cracked pepper', 'Mix-ins, like leftover meat, cooked vegetables, cheese, or herbs']",6,"['1 Melt butter in a small skillet over medium heat.', '2 Whisk the eggs: Crack two eggs into a small mixing bowl. Add milk and salt. Aggressively whisk the mixture until it is uniform in color, texture, and slightly foamy. You want the whites and yolks fully combined.', '3 Scramble the eggs: Add the eggs to hot skillet and immediately reduce the heat to medium low. Use a rubber spatula to push the eggs from one end of the skillet to the other.', 'Continue doing this, gently and slowly, always pushing the cooked eggs from the bottom of the skillet and allowing the uncooked egg to take its place.', 'When the eggs are mostly cooked, but look fairly wet with what looks like thick liquidy egg around the curds, slowly fold the eggs into itself one or two times. You want to bring the eggs together, kind of like a loose ball of dough. Add any cheese, meat or vegetables at this time.', '4 Serve immediately: Remove eggs from pan when the eggs are set but still glisten with moisture, and transfer to a plate. Finish with freshly cracked pepper. Garnish with fresh herbs, if using.']",6
953,Buffalo Chicken Dip Recipe,10,30,40,"['1 8-ounce package cream cheese, softened', '2/3 cup sour cream', '2/3 cup mayonnaise', '2 cups shredded cheddar or mozzarella', ""1/2 cup hot sauce, Frank's Buffalo Wing Sauce or any other favorite hot sauce"", '1 tablespoon dried parsley', '1 teaspoon dried dill', '3 cloves garlic, minced', '1 1/2 teaspoon granulated onion', '1 teaspoon salt', '1 teaspoon black pepper', '1 pound cooked chicken breast, shredded', '1/2 cup blue cheese crumbles, to top (optional)', '1/4 cup cilantro, to top', 'Vegetable sticks, crackers, or sliced baguette, to serve', 'Special equipment:', '9-inch pie or tart pan, 9-inch square baking dish, or other similarly sized baking dish']",17,"['1 Warm the oven to 350F with a rack in the middle position.', '2 In the bowl of a stand mixer with a paddle attachment, combine the cream cheese, the sour cream, and mayonnaise. Mix them together until smooth, stopping the mixer to scrape down the sides if necessary. Mix in the cheese, hot sauce, dried herbs, garlic, granulated onion, salt, and pepper. Mix again until completely incorporated.', '3 Add the shredded chicken. Mix on low until combined.', '4 Bake until bubbly: Pour the mixture into a 9-inch pie pan, 9-inch square baking dish, or other baking dish. Bake for 30 minutes, or until the mixture is bubbling. Sprinkle the blue cheese crumbles and cilantro over the top, and serve with immediately with vegetable sticks, crackers, or sliced baguette.']",4
954,BBQ Pulled Jackfruit Tacos Recipe,15,10,25,"['2 (14-ounce) cans jackfruit in brine, drained and rinsed', '2 tablespoons extra virgin olive oil', '1 small yellow onion, finely chopped (about 1 1/2 cups)', '2 cloves minced garlic', '1 jalape\\xc3\\xb1o, seeded and finely chopped (optional)', '3/4 cup barbecue sauce, store-bought or homemade', '2 teaspoons ground cumin', '1 teaspoon dried oregano', '1 teaspoon ground coriander', '1/2 teaspoon smoked paprika', '1/2 teaspoon kosher salt', '1 teaspoon grated orange zest', 'To serve:', '10 to 12 (6-inch) corn tortillas', '1 ripe avocado, thinly sliced', '4 radishes, thinly sliced', '1/3 cup cilantro leaves, roughly chopped', '1/3 cup shredded red cabbage', '1/3 cup corn kernels, canned or fresh from the cob', '1/4 cup sour cream (optional)', '1 lime, cut into wedges']",21,"['1 Shred the jackfruit: Using your fingers or forks, break apart the chunks of jackfruit into shredded pieces.', '2 Cook the onions: In a large saucepan over medium heat, warm the olive oil. Add the onion and cook until translucent, about 5 minutes. Add the garlic and jalape\\xc3\\xb1o and cook for an additional 1 minute, until the garlic is fragrant.', ' 3 Cook the jackfruit: Add the shredded jackfruit to the pan with the onions and stir well. Add the barbecue sauce, cumin, oregano, coriander, smoked paprika and salt to the pan.', 'Stir to evenly distribute the spices and cook for another 4 to 5 minutes, or until the jackfruit is browned and slightly crisped around the edges. Fold in the orange zest.', '4 Assemble the tacos: Warm the tortillas and add a large spoonful of cooked jackfruit to the center of each. Top with avocado, radishes, cilantro, cabbage, corn, sour cream and a squeeze of lime.']",5
955,Zucchini Muffins Recipe,15,25,40,"['2 large eggs', '1 1/3 cup (280 g) sugar', '2 teaspoons vanilla extract', '3 cups (packed) grated fresh zucchini', '3/4 cup unsalted butter, melted', '2 3/4 cups (400 g) all-purpose flour', '1 teaspoon baking soda', '1 teaspoon baking powder', '1/4 teaspoon salt', '2 teaspoons cinnamon', '1 teaspoon ground ginger', '1/2 teaspoon nutmeg', '1 cup walnuts (optional)', '1 cup raisins or dried cranberries (optional)', 'Special equipment:', 'A muffin tin']",16,"[""You don't need a mixer for this recipe."", '1 Mix eggs, sugar, vanilla, then add zucchini and melted butter: Preheat the oven to 350\\xc2\\xb0F (175\\xc2\\xb0C). Beat the eggs in a large bowl. Mix in the  sugar and vanilla extract. Stir in the grated zucchini and the melted butter.', '2 Mix dry ingredients: In a separate bowl, mix together the flour, baking soda, baking powder, cinnamon, ground ginger, nutmeg, and salt.', '3 Combine to make batter: Stir these dry ingredients into the zucchini mixture. (Do not over-mix!) Stir in walnuts, raisins or cranberries if using.', '4 Fill muffin pan: Coat each muffin cup in your muffin pan with a little butter or vegetable oil spray. Use a spoon to distribute the muffin dough equally among the cups, filling the cups up completely, above the surface of the muffin tin.', '5 Bake: Bake at 350\\xc2\\xb0F on the middle rack until muffins are golden brown, and the top of the muffins bounce back when you press on them, about 20-30 minutes. Test with a long toothpick or a thin bamboo skewer to make sure the center of the muffins are done.', 'Set on wire rack to cool for 5 minutes. Remove muffins from the tin let cool another 20 minutes.']",7
956,Chocolate Banana Bread Recipe,15,60,75,"['3 large ripe bananas (easily mashable)', '1/3 cup melted butter', '3/4 cup brown sugar (packed, light or dark)', '1 teaspoon salt (1/2 a teaspoon if using salted butter)', '1 large egg, beaten', '1 teaspoon vanilla extract', '1 1/4 cup all purpose flour', '1/4 cup natural unsweetened cocoa powder', '1 teaspoon baking soda', '1/4 teaspoon ground allspice', '1/2 cup semi-sweet chocolate chips', 'Special equipment:', '1 5x9-inch loaf pan']",13,"['1 Prepare pan and preheat oven:  Butter or spray with cooking spray the inside of a 5x9-inch loaf pan. Preheat oven to 350\\xc2\\xb0F (175\\xc2\\xb0C) with a rack in the middle.', '2 Pur\\xc3\\xa9e bananas: Using a blender, food processor, or a fork, pur\\xc3\\xa9e the peeled ripe bananas until smooth. You should have 1 1/2 to 1 3/4 cups of banana pur\\xc3\\xa9e.', '3 Mix wet ingredients and sugar: Place the banana pur\\xc3\\xa9e into a large mixing bowl. Stir the melted butter. Stir in the brown sugar and salt. Whisk to break up any clumps of brown sugar. Stir in the beaten egg and vanilla extract.', '4 Mix dry ingredients: In a separate bowl, vigorously whisk together the flour, cocoa, baking soda, and allspice.', '5 Add the flour mixture to the banana mixture and stir until just incorporated.', 'Stir in the chocolate chips.', '6 Bake: Pour batter into a buttered loaf pan. Place in a 350\\xc2\\xb0F (175\\xc2\\xb0C) oven and bake for 1 hour.', ""Note that because of the chocolate chips that melt in the bread as it cooks, it's hard to check for doneness using a tester that you insert."", ""One way to test is to gently push the center top of the chocolate banana bread down with your finger. If it feels relatively firm and bounces back when you release your finger, that's a good sign that it's done."", '7 Let cool: Remove from oven and let cool for 10 minutes in the pan.', 'Gently remove the loaf from the pan and place on a rack to cool completely.', 'Slice with a serrated bread knife to serve.']",12
957,Applesauce Spice Cake Recipe,15,45,60,"['1/2 cup (1 stick) unsalted butter, room temperature', '2 cups all-purpose flour', '1 teaspoon baking soda', '1 teaspoon cinnamon', '1/2 teaspoon ground allspice', '1/2 teaspoon grated nutmeg', '1/4 teaspoon ground cloves', '1/2 teaspoon salt', '1 cup sugar', '3 large eggs', '1/2 teaspoon vanilla extract', '1 cup applesauce', '1/4 cup plain yogurt diluted a bit with milk, or 1/4 cup of buttermilk', '1/2 cup of chopped walnuts', '1/2 cup raisins']",15,"['1 Preheat oven, prepare pan: Preheat oven to 375\\xc2\\xb0F. Butter and flour an 8-in square baking pan, set aside.', '2 Combine dry ingredients: Vigorously whisk together the flour, baking soda, cinnamon, allspice, nutmeg, cloves, and salt. Set aside.', '3 Make batter: In an electric mixer, beat butter until light, add sugar and beat until fluffy. Add the eggs, one at a time, beating to incorporate after each addition. Add the vanilla and the applesauce and beat until smooth.', '4 Mix in half of the dry ingredients. Just before they are blended, add the thinned yogurt (or buttermilk). Then mix in the rest of the dry ingredients and the nuts and raisins, until completely incorporated. Do not over-mix.', '5 Bake: Pour out the batter into your prepared cake pan. Place in the middle rack of the 375\\xc2\\xb0F oven and bake for 25-35 minutes, until done.', 'The cake should spring back to the touch, and a tester or thin skewer should come out clean after being inserted in various spots in the middle of the cake.', 'Remove the cake from the oven. Let cool for 15 minutes. Then invert to cool completely on a rack.']",7
958,Oatmeal Soda Bread Recipe,15,40,55,"['2 cups (170 g) old fashioned rolled oats', '2 1/4 cups (290 g) all purpose flour plus more for dusting', '2 teaspoons baking soda', '1 teaspoon sugar', '1 teaspoon kosher salt', '1 1/2 cups (350 ml) buttermilk', '1 egg, lightly beaten', 'Butter for greasing the pan']",8,"['1 Preheat oven and grind the oats: Preheat oven to 450\\xc2\\xb0F.  Place oats in a food processor and pulse until finely ground.', '2 Whisk together dry ingredients: In a large bowl, vigorously whisk together the finely ground oats, flour, baking soda, sugar, and salt.', '3 Make the soda bread dough: Stir the buttermilk and egg together. Make a well in the middle of the flour mixture and pour in the buttermilk egg mixture.', 'Gently fold the surrounding flour over the buttermilk with a wooden spoon. Continue to gently fold until just combined. Do not over mix! The dough should look very shaggy. It should be on the moist side.', 'If it is too wet to handle, add a little more flour. If too dry, add a little more buttermilk.', ""4 Form into a mound, place in pan, score: Place dough on a lightly flour dusted surface. Knead one or two times only, and form into a mound shape. Grease a large cast iron frying pan with a little butter and place the dough in the center. (If you don't have a cast iron frying pan, just put on a greased baking sheet that can take high heat.)"", 'Score the center of the dough in a cross shape with a sharp knife, making 1 1/2 inch deep cuts.', '5 Bake: Place in the oven and bake for 15 minutes at 450\\xc2\\xb0F (230 \\xc2\\xb0C). Then lower the oven temperature to 400\\xc2\\xb0F (205\\xc2\\xb0C) and cook for 25 minutes more.', ""To test if the bread is done, take it out of the oven, turn it over and knock on the bottom. If it sounds hollow, it's done."", ""6 Remove from oven and let cool: Remove pan from oven and let sit for 10 minutes. Note, take care with the hot handles of the cast iron pan! I never leave this one to chance (after having burned myself pretty badly once picking up a hot pan), and I rub an ice cube over the hot handle to cool it down, so that someone doesn't inadvertently pick up the pan by the handle."", 'Remove bread from pan and let cool further on a wire rack for another 15 minutes or so. The bread is best if eaten within hours of baking. Serve with butter and jam. If saving for later, wrap in a slightly damp clean tea towel.']",11
959,Glazed Lemon Bread Recipe,15,60,75,"['4 ounces (1 stick, or 8 Tbsp) butter, softened*', '1 cup minus 1 tablespoon granulated sugar', '1 tablespoon honey', '2 eggs (room temp)', '1 tablespoon lemon zest', '1/2 cup whole milk', '1/2 teaspoon salt', '1 1/2 cups flour', '1/2 teaspoon ground cardamom', '1 teaspoon baking powder', 'Glaze', '1/4 cup lemon juice', '1/3 cup sugar', '1 tablespoon honey']",14,"['1 Preheat oven to 350\\xc2\\xb0F. Butter a 4x8-inch loaf pan.', '2 Beat the butter until fluffy, about 2 minutes. Add the sugar and honey, continue to beat until creamy, a few minutes more. Add eggs, one at a time, beating after each addition to incorporate. On low speed, slowly beat the milk in. Do not worry if the mixture looks a little curdled. Mix in lemon zest.', '3 Sift together the flour, salt, cardamom, baking powder. Add to the wet ingredients, beating until smooth.', '4 Place batter in prepared pan and bake for 1 hour at 350\\xc2\\xb0F.', '5 While the lemon bread is baking, prepare the glaze. Heat the glaze ingredients - lemon juice, sugar, honey - in a small saucepan until the sugar is completely dissolved.', '6 Once you have removed the bread from the oven, poke holes all over the top with a thin skewer (this will help the glaze penetrate). Spoon the glaze over it while the bread is still in the pan and is still hot. Let cool for 10 minutes before removing from pan and slicing to serve.']",6
960,Vegan Banana Bread Recipe,10,60,70,"['2 tablespoons flaxseed meal', '1/2 cup plus 2 tablespoons almond milk', '2 to 3 very ripe bananas, peeled', '1/3 cup walnut, coconut or avocado oil', '3/4 cup sugar (1/2 cup if you would like it less sweet, 1 cup if more sweet)', '1 teaspoon vanilla extract', '1 1/2 cups all-purpose flour', '1 teaspoon baking soda', 'Pinch of salt', 'Special equipment:', '4x8 inch loaf pan']",11,"['1 Preheat the oven to 350\\xc2\\xb0F. Line a 4x8-inch loaf pan with parchment paper, long enough so that it hangs over the edges and creates a sling. (This will help facilitate easy removal.)', '2 Make the flax egg: In a small bowl, combine the flaxseed meal with the almond milk. Let rest until thickened while you measure everything else.', '3 Make the batter: In a large mixing bowl, mash the ripe bananas with a fork until completely smooth. Stir the oil into the mashed bananas. Add the sugar, flax egg, and vanilla. Finally, stir in the flour, baking soda, and salt.', '4 Bake the bread: Pour the batter into your prepared loaf pan. Bake for 50 minutes to 1 hour, until a toothpick or cake tester inserted into the center comes out clean.', '5 Cool and serve: Remove the bread from the oven and let cool in the pan for a few minutes. Then, using the excess parchment hanging over the edges as handles, remove the banana bread from the pan, and let cool completely before serving. Slice and serve.']",5
961,Jamaican Banana Bread Recipe,10,55,65,"['1/2 cup raisins', '1/2 cup dark rum', '1 1/2 cup mashed overripe bananas, from 3 or 4 bananas', '1/3 cup salted butter, melted', '3/4 cup raw or turbinado sugar', '1 large egg, beaten', '1 teaspoon vanilla extract', '1 tablespoon raisin-infused dark rum (from soaking the raisins)', '1 teaspoon cinnamon', '1/4 teaspoon nutmeg', '1/8 teaspoon allspice', '1 teaspoon baking soda', '1/4 teaspoon salt', '1 1/2 cups all purpose flour', 'Special equipment:', '8x4-inch loaf pan']",16,"['1 Soak the raisins: Combine raisins and rum in a small container with a tight fitting lid. Let stand at room temperature at least overnight before straining and reserving the raisin-infused rum. (You may soak the raisins for much longer but will likely have to add more rum as the raisins absorb it.)', '2 Preheat oven to 350\\xc2\\xb0F.', '3 Prepare the loaf pan: Grease an 8x4-inch loaf pan generously with cooking spray. You can use butter to grease the pan too, but your loaf may turn out a little darker.', '4 Strain the raisins: Strain the raisins and reserve the liquid.', '5 Make the batter: In a large mixing bowl, add mashed bananas and stir in melted butter. Mix in the sugar, egg, vanilla, and 1 tablespoon of raisin-infused rum. Add the cinnamon, nutmeg, and allspice. Stir to combine.', 'Sprinkle the baking soda and salt over the mixture and stir to combine. Mix in the flour until fully combined. (Note that it will be slightly lumpy because of the pieces of mashed banana.)', 'Lastly, fold in the strained raisins.', '6 Bake: Pour batter into the prepared loaf pan, scraping the bowl to assist. Bake for 50 minutes to 1 hour, or until a tester comes out clean.', '7 Serve: Cool on a rack at least 15 minutes before removing the loaf from the pan. Cool completely before slicing and serving.']",9
962,Cream Cheese Banana Bread Recipe,10,60,70,"['For the banana bread:', '2 to 3 very ripe bananas, peeled (about 1 1/4 to 1 1/2 cups mashed)', '1/3 cup melted butter, unsalted or salted', '1 teaspoon baking soda', 'Pinch of salt', '3/4 cup sugar (1/2 cup if you would like it less sweet, 1 cup if you want it sweeter)', '1 large egg, beaten', '1 teaspoon vanilla extract', '1 1/2 cups of all-purpose flour', 'For the cream cheese filling:', '8 ounces cream cheese, at room temperature', '1 large egg', '1/4 cup sugar', '2 tablespoons flour']",14,"['1 Preheat the oven to 350\\xc2\\xb0F (175\\xc2\\xb0C), and grease a 4x8-inch loaf pan.', '2 Make the banana bread batter: In a mixing bowl, mash the ripe bananas with a fork until completely smooth. Stir the melted butter into the mashed bananas.', 'Mix in the baking soda and salt. Stir in the sugar, beaten egg, and vanilla extract. Mix in the flour.', '3 Make the cream cheese swirl: In another bowl, beat together all the ingredients for the cream cheese filling.', '4 Swirl the batters in the pan: Pour half of the banana bread batter in the loaf pan. Top the batter with half of the cream cheese filling -- one dollop at a time. Top with remaining batter. Top with the remaining cream cheese filling one dollop at a time. Insert a butter knife about halfway into the batter and run through the batter vertically and horizontally to swirl the cream cheese into the banana bread batter.', '5 Bake for 55-60 minutes or until toothpick comes out clean. If the top starts to brown too much before the middle is done, tent the top with foil.', '6 Cool and store: Cool the banana bread for a few minutes in the pan, then remove from pan and transfer to a cooling rack to cool completely. Store covered at room temperature.']",7
963,Roasted Sweet Potato Quinoa Bowls Recipe,10,30,40,"['For the sweet potatoes:', '1 pound sweet potatoes, peeled and cut into 1/4-inch cubes (roughly 1 large sweet potato)', '2 tablespoons olive oil', '1/2 teaspoon sea salt', '1/4 teaspoon black pepper', '1/2 teaspoon allspice', '1/2 teaspoon turmeric', '1/2 teaspoon garlic powder', '1/4 teaspoon ground ginger', 'Pinches of ground cloves, cinnamon, chili powder, and oregano', 'For the quinoa:', '1 cup quinoa (uncooked)', '1 cup water', '1 cup vegetable broth', 'For serving:', '1 large avocado, sliced', '1/2 cup hummus', '1/4 cup loosely packed flat-leaf parsley, chopped']",18,"['1 Roast the sweet potatoes: Preheat oven to 400\\xcb\\x9aF. Place the sweet potatoes on a rimmed baking sheet and toss with the olive oil.', 'In a small bowl or ramekin, combine the sea salt, black pepper, allspice, turmeric, garlic powder, ginger, and the pinches of cloves, cinnamon, chili powder, and oregano. Sprinkle the spices over the sweet potatoes and toss until they are well coated.', 'Spread into a single layer and roast until sweet potatoes are tender and starting to brown, 25 to 30 minutes. Remove from the oven and set aside. ', '2 Cook the quinoa: While the sweet potatoes are cooking, rinse the quinoa and place in a pot with the water and vegetable broth. Bring to a boil, cover, simmer, and cook for about 15 minutes, until nearly all the water is absorbed. Remove from heat and let the quinoa rest for 10 minutes. ', '3 Assemble the bowls: Divide the quinoa into four bowls. Top with the sweet potatoes, a dollop of hummus, and a quarter of the avocado. Sprinkle with fresh parsley before serving.']",5
964,Quinoa Greek Salad Recipe,0,25,25,"['1 cup dry quinoa', '1 teaspoon salt', '2 cups diced cucumbers, seeded if the cucumbers are very seedy, and peeled if the cucumbers have thick peels', '1/3 cup finely diced red onion', '2 cups cherry or sungold tomatoes, halved', '2 tablespoons finely diced red bell pepper', '1/2 cup chopped, pitted kalamata olives', '1 Tbsp thinly sliced fresh mint', '1 1/2 teaspoon chopped fresh oregano', '2 tablespoons chopped fresh parsley', '1/4 cup high quality extra virgin olive oil', '2 tablespoons red wine vinegar', '1 1/2 teaspoons salt', '1/2 cup crumbled feta cheese (omit for vegan option)']",14,"['1 Cook the quinoa: Cook quinoa in salted water (1 teaspoon salt for 2 cups water) according to quinoa box instructions. (Usually that means heating 1 cup of quinoa and 2 cups of water until simmering, then lowering the heat to low, covering and cooking for 15 minutes.)', 'Remove from heat and fluff with a fork. To cool quickly, spread out cooked quinoa on a baking sheet.', '2 Prep veggies and herbs: While the quinoa is cooking, prep the vegetables and herbs for the salad.', '3 Toss with olive oil, vinegar, salt, feta: Place cooled quinoa, cucumbers, onions, tomato, bell pepper, olives, and herbs (mint, oregano, parsley) in a large bowl.', 'Toss with olive oil to gently combine.', 'Sprinkle with vinegar, salt, and crumbled feta cheese, and gently toss to combine.', 'Serve immediately.']",7
965,Turkey Black Bean Quinoa Bake Recipe,15,30,45,"['1 cup uncooked quinoa', '2 cups water', 'Salt', '3 cups shredded, chopped cooked turkey', '2 Tbsp extra virgin olive oil', '2 cups onion, chopped', '2 bell peppers, seeded and chopped', '4 cloves garlic, minced', '1 cup frozen corn, defrosted', '1 teaspoon ground cumin', '1 teaspoon chili powder (chipotle chili powder if available), less or more to taste', '1 15-ounce can black beans, drained', '1/2 cup chopped cilantro', '3 cups grated cheddar cheese, divided 2 cups and 1 cup']",14,"['1 Cook the quinoa: Cook the quinoa according to package directions. Typically package directions ask you to put 1 cup of quinoa with 2 cups of water and a pinch of salt into a pot, bringing it to a boil, reduce to a very low simmer, cover and cook for 15 minutes. Then remove from heat and fluff with a fork.', '2 Cook peppers and onions: Heat olive oil in a large skillet on medium high heat. Add the onions and the bell peppers and cook until softened and browned at the edges, about 10 minutes.', '3 Add garlic, spices, corn: Add the garlic, cumin, chili powder, and corn, and cook a minute more. Remove from heat.', '4 Place the cooked quinoa, black beans, onion mixture, cilantro, 2 cups of grated cheddar cheese, and cooked turkey in a large bowl. Toss to combine.', '5 Top with cheese and bake: Place in a casserole dish. Sprinkle the top with remaining 1 cup of cheddar cheese, and bake at 350\\xc2\\xb0F uncovered for 15 minutes, until the cheese is melted and bubbly.']",5
966,Cheesy Quinoa Black Bean Stuffed Bell Peppers Recipe,10,70,80,"['1 cup uncooked quinoa (white or red or both)', 'Salt', '6 large bell peppers, any color', '1 15-ounce can black beans, drained', '4 cups grated sharp cheddar cheese, 2 cups for stuffing, 2 cups for topping', '3 to 4 green onions, finely sliced', '1 teaspoon ground cumin', '1/2 cup loosely packed chopped fresh cilantro (optional)']",8,"['1 Cook the quinoa: Place 1 cup of quinoa, 2 cups of water, and 1/2 teaspoon of salt in a medium saucepan. Bring to a boil, cover, reduce to a simmer and cook for 15 minutes.', 'Remove from heat and let sit for 10 minutes, covered. Spread cooked quinoa out in a baking dish to cool quickly.', ""2 Steam the bell peppers:  Cut the top 1/2 to 1 inch off of the bell peppers and remove the core and seeds inside. (If you want, you can finely chop the pieces of good bell pepper you've removed and include them in the stuffing, otherwise, save them for another use.)"", 'Fill a large pot with an inch of water. Place a steamer rack in the pot, place the pepper shells on the steamer rack, cut side up. Bring to a boil, cover and steam the peppers 5 to 10 minutes, until they begin to soften.', '3 Make the filling: In a large bowl mix the cooked quinoa, drained black beans, 2 cups of the grated cheddar cheese, most of the green onion (save some for topping), cumin, and cilantro if using.', ""4 Stuff the bell peppers with the stuffing you've prepared. You should have plenty of stuffing, you can pack it and mound the stuffing in the peppers. Place 1/4 cup of water at the base of the peppers."", '5 Bake: Cover with aluminum foil. Bake at 350\\xc2\\xb0F for 35 minutes. Then remove from oven, uncover, top with the remaining 2 cups of cheese, and return to the oven to cook, uncovered, until the cheese has melted about 5 to 10 minutes.', 'Sprinkle with remaining finely sliced green onions to serve.']",8
967,Stuffed Delicata Squash with Quinoa and Mushrooms Recipe,20,40,60,"['For the sauce:', '1 cup plain yogurt', '2 teaspoons grated orange zest', '1 tablespoon orange marmalade', 'For the squash:', '4 medium delicata squash (about 3 1/2 pounds)', '2 tablespoons olive oil', '1/2 teaspoon salt', '1/2 teaspoon pepper', '1 teaspoon ground cumin', '1 teaspoon ground coriander', 'For the filling:', '1/2 pound shiitake mushrooms, stems removed and caps thinly sliced', '2 tablespoons olive oil', '1 tablespoon soy sauce', '1 teaspoon grated orange zest', '1 cup red quinoa', '2 cups water', '1/4 teaspoon salt', '2 tablespoons chopped fresh parsley', 'Olive oil, to serve']",21,"['1 Make the orange-yogurt sauce: In a bowl, whisk the yogurt, orange rind, and orange marmalade; set aside.', '2 Prep the delicata squash: Heat the oven to 400\\xc2\\xb0F. Line a rimmed baking sheet with parchment paper. Cut each squash in half lengthwise and use a spoon to remove the seeds.', 'Set the squash on the baking sheet and brush the insides and cut surfaces with olive oil. Mix together the salt, pepper, cumin, and coriander in a bowl, and sprinkle evenly over the squash halves.', '3 Roast the delicata squash halves: Transfer to the oven and roast for 30 to 40 minutes, or until the halves are tender when pierced with a fork and golden brown at the edges.', 'If the halves have not browned, slide them under the broiler for 1 minute, and watch them carefully to avoid burning.', '4 Cook the mushrooms: In a small saucepan (you\\xe2\\x80\\x99ll use it later to cook the quinoa), heat 2 tablespoons of olive oil over medium-high heat. Add the mushrooms and cook, stirring often, for about 5 minutes, or until they are tender. Add the soy sauce and orange rind and stir well. Transfer the shiitakes to a bowl.', '5 Toast and cook the quinoa: In the same pot used to cook the mushrooms (no need to wash or add more oil), add the quinoa. Toast over medium heat, shaking the pan often, for for 3 to 4 minutes or until the quinoa starts to turn a darker shade.', 'Pour in the water \\xe2\\x80\\x93 stand back because it will splatter \\xe2\\x80\\x93 and immediately turn the heat to low. Add the remaining 1/4 teaspoon of salt. Cover the pan and cook for 15 minutes, or until the quinoa has absorbed all the water.', 'If there is water left in the pan, uncover it and continue cooking for a 2 to 3 minutes, or until the liquid has evaporated or been absorbed.', '6 Assemble the quinoa: With a fork, fluff the quinoa. Stir in the mushrooms, any liquid in the bowl, and 1 tablespoon of the parsley. Taste for seasoning and add more salt and pepper, if you like.', '7 Stuff the squash and serve: Fill each delicata half with some of the quinoa mixture. Sprinkle with a little olive oil (about 1 tablespoon) and the remaining parsley. Drizzle a few spoonfuls of the yogurt sauce over top and serve any extra alongside']",11
968,Cucumber Mint Quinoa Salad Recipe,10,20,30,"['1 cup quinoa (we prefer red quinoa)', '2 cups water', '1/2 teaspoon Kosher salt', '1 large cucumber, peeled if thick-skinned, unpeeled if thin-skinned (about 3/4 pound cucumber)', '1/4 cup thinly sliced mint', '1 tablespoon thinly sliced green onion or chopped chives', '3-4 tablespoons seasoned rice vinegar', '2 teaspoons extra virgin olive oil', '1 avocado, peeled and chopped (optional)']",9,"['1 Cook the quinoa: Check your package of quinoa. If it says to rinse it, then rinse it. If not, then skip. Place the quinoa in a 1 1/2 to 2 quart sized saucepan. Add the water. Add half a teaspoon of salt. Bring to a boil. Reduce to a simmer.', 'Cover and cook for 15 minutes, until the quinoa is cooked. Remove from heat.', '2 Cool the quinoa: Let the cooked quinoa cool to room temperature. You can help cool down the quinoa quickly by spreading it out on a sheet pan.', '3 Prep cucumbers: Cut the cucumber in half in the middle. Then cut each half lengthwise into quarters. Scoop out most of the seeds and discard. Cut the cucumber pieces again, this time crosswise in 1/4-inch to 1/2-inch thick slices.', '4 Assemble the salad: When the quinoa has cooled, place it in a large bowl and gently with the cucumber chunks, the mint, and green onion.', 'Sprinkle with seasoned rice vinegar and toss again. Sprinkle with olive oil and gently toss. Add more salt or seasoned rice vinegar to taste. Gently fold in chopped avocado if using.']",6
969,Quinoa with Tomatoes and Cheese Recipe,10,30,40,"['1 cup quinoa, well rinsed', '2 cups water', '1 tablespoon extra virgin olive oil', '1 tablespoon butter', '1 cup chopped onions', '1 teaspoon minced garlic', '1 large fresh tomato, cored, chopped (about 1 1/4 cups)', '1 roasted, peeled, seeded, and chopped large green chile, either Anaheim or Poblano (optional)*', '2 teaspoons tomato paste', 'Salt', 'Freshly ground black pepper', '1/4 teaspoon of dried oregano (or 1/2 teaspoon fresh, finely chopped)', ""1/4 pound (4 ounces) fresh farmer's cheese, or queso fresco, cut into small cubes"", '1 cup milk', 'Fresh basil, cilantro, or chives for garnish (optional)', '*See How to roast chile peppers over a gas flame.']",16,"['1 Cook the quinoa: Put 1 cup quinoa and 2 cups of water into a medium sized pot and bring to a boil. Reduce to a low simmer, cover and cook for 10 minutes. Remove from heat and let sit for 10 minutes.', '2 Prepare the sauce: While the quinoa is cooking, prepare the sauce. Heat olive oil and butter in a medium skillet on medium heat. Add the onions and cook for a couple minutes. Add the garlic, cook for a minute more.', 'Add the chopped tomato, about 1/2 teaspoon salt, dried oregano, and tomato paste. Add chopped green chiles (cooked) if using. Sprinkle with freshly ground black pepper. Stir until well combined.', 'Let cook until the tomatoes have cooked through and the sauce has cooked down a bit. Then stir in the cheese. Taste and add more salt or pepper if needed.', '3 Stir in milk and top with sauce: Stir 1 cup of milk into the now cooked quinoa. Serve the quinoa in bowls and top with sauce.', 'Garnish with chopped basil, parsley, cilantro, or chives.']",6
970,Quinoa Succotash Recipe,10,30,40,"['1 thick cut strip of bacon, cut in half (note you can sub out the bacon for another Tbsp of butter if you want)', '1 cup dry quinoa', '1/2 cup chopped onion', '2 Tbsp butter', '1 cup corn kernels, fresh or frozen', '1/2 cup baby lima beans (can sub edamame)', '1/2 cup chopped fresh tomatoes', '1/2 teaspoon dried thyme or 2 teaspoons fresh thyme, chopped', '1/2 cup plus 2 Tbsp water', '1 cup chicken or beef stock', '1/2 teaspoon salt (if using unsalted butter or unsalted stock)', '1/4 cup chopped green onions and/or chives', '2 teaspoons of lemon juice']",13,"['1 Cook the bacon: Place the bacon strip halves in a 3 to 4 quart, thick-bottomed pot. Heat on medium heat and gently cook the bacon, turning every so often, so that much of the fat renders out.', 'When the bacon is lightly browned, remove it from the pot and place it on paper towels. Keep the fat in the pan. Chop the bacon and set aside.', '2 Rinse the dry quinoa: While the bacon is cooking, place the quinoa in a fine mesh sieve and rinse until the water runs clear. Note that most quinoa packages suggest that you rinse before cooking. If you are using a quinoa brand that does not suggest rinsing, rinse anyway.', '3 Cook the onions: Add the chopped onion to the pot you used to cook the bacon, along with the butter. Cook on medium heat until the onions are translucent, about 3 or 4 minutes.', '4 Add the quinoa: Add the rinsed quinoa to the pot and increase the heat to medium high. Stir to combine the quinoa and onions. Let cook for a couple minutes on medium high to high heat, until the onions and the quinoa get a hint of color.', '5 Add veggies, thyme, bacon, water, stock: Add the corn, baby lima beans, chopped tomato, chopped bacon, and thyme to the pot, and stir to combine. Add the water and stock (and salt if using unsalted butter or stock).', 'Increase the heat to high and bring to a simmer. Reduce heat to low, cover, and simmer for 15 minutes. After 15 minutes, remove from the heat and let sit, covered, for another 5 minutes.', '6 Stir in the lemon juice and chopped chives and/or green onions and fluff up with a fork.']",8
971,Rabbit Stew with Mushrooms Recipe,45,105,150,"['1 ounce of dried porcini mushrooms', '2 heads of garlic', '1 tablespoon extra virgin olive oil', '1 1/2 pounds mixed mushrooms', '4 Tbsp butter', '1 rabbit', '3 large shallots, chopped', '1 cup sherry or white wine', '1-2 cups mushroom soaking water', '3 cups chicken stock', '1 tablespoon fresh thyme, or 2 teaspoons dried', '1 large parsnip, peeled and chopped into large pieces', 'Salt', '2 Tbsp chopped fresh parsley']",14,"['1 Soak the dried porcini in water: Soak the dried porcini mushrooms in 2 cups hot water.', '2 Cut rabbit into pieces and sprinkle with salt: Cut the rabbit into serving pieces and salt well. Let sit at room temperature for 30 minutes. Use all of the rabbit in this dish \\xe2\\x80\\x93 you can fish out the ribs and other parts that have little or no meat on them later; they will add vital flavor to your stew.', '3 Optional Step with rabbit liver: If you are going to make the cr\\xc3\\xa8me fraiche-liver thickener, mince the rabbit liver finely and move it to a small bowl. Vigorously mix in about 1 1/2 tablespoons cr\\xc3\\xa8me fraiche or sour cream. Now put the mixture into a fine-meshed sieve over a bowl and push it through with a rubber spatula. Reserve in the fridge.', '4 Roast garlic: Preheat the oven to 375\\xc2\\xb0F. Slice the top third off the heads of garlic and drizzle the olive oil over them. Wrap the heads loosely in foil and bake for 45 minutes to an hour, or until cloves are soft and brown. Set aside to cool.', '5 Prep fresh mushrooms, dice rehydrated porcini, save mushroom soaking liquid: Chop off the tough ends of the mushroom stems and either discard or save for stock. Roughly chop or slice the mushrooms and set aside. Dice the rehydrated porcini. Pour the porcini soaking water though a paper towel into another bowl. Reserve the liquid.', '6 Dry saut\\xc3\\xa9 fresh mushrooms: Heat a thick-bottomed large pot on high heat for 1 minute. Add the mushrooms and shake the pot. Stirring continuously, dry saut\\xc3\\xa9 the mushrooms until they release their water.', 'Turn the heat down to medium-high. Use a wooden spoon to scrape up any mushroom bits off the bottom of the pan. Salt the mushrooms lightly. When the mushroom liquid is mostly gone, remove them to a bowl.', '7 Brown rabbit in butter: Add the butter to the pot. When the butter melts, turn the heat down to medium. Pat the rabbit pieces dry and place in the pan.', 'Work in batches if you need to, do not crowd the pan. Brown the pieces well on all sides. Remove the rabbit pieces from the pot and set aside.', '8 Saut\\xc3\\xa9 shallots: Increase the the heat to medium-high and add the shallots to the pot. Saut\\xc3\\xa9 until the shallots are nicely wilted, about 3 minutes. Stir from time to time. Sprinkle salt over everything.', '9 Squeeze roasted garlic into mushroom soaking liquid: While the shallots are cooking, squeeze the roasted garlic into the mushroom soaking water you have strained, then whisk it together.', '10 Deglaze shallots with sherry: Add the sherry or white wine to the shallots in the pot. Use a wooden spoon to scrape off any browned bits on the bottom of the pot. Let the sherry boil down by half. Add the mushroom-roasted garlic mixture and the stock and stir to combine.', '11 Add thyme, mushrooms, rabbit, parsnips, bring to simmer and cook: Add the thyme, all the mushrooms, the rabbit and the parsnips and bring everything to a bare simmer.', 'Simmer gently for 90 minutes. You want the meat to be close to falling off the bone. If you want, you can fish out all the rabbit pieces and pull the meat off the bone \\xe2\\x80\\x93 it makes the dish less attractive, but it will be easier to eat. Taste for salt right before you serve and add if needed. Stir in the parsley.', '12 Add liver mixture if using: If you are using the cr\\xc3\\xa8me fraiche-liver mixture to thicken your stew, turn off the heat. When the stew stops bubbling, add the mixture and let it heat through for a minute before serving.', 'Serve with a crusty loaf of bread, a green salad and either a hearty white wine, a dry rose or a light red wine.']",16
972,Rabbit in Mustard Sauce Recipe,30,60,90,"['1 rabbit, cut into serving pieces (see How to cut up a rabbit)', 'Salt', '4 tablespoons butter', '2 large shallots, chopped', '1/2 cup white wine', '1/2 cup water', '1/2 cup grainy country mustard, like Dijon', '1 teaspoon dried thyme', '1/2 cup heavy cream', '4 tablespoons finely chopped parsley']",10,"['1 Sprinkle rabbit pieces with salt: Salt your rabbit pieces well and set aside at room temperature for 30 minutes to an hour.', '2 Brown the rabbit pieces in butter: Heat the butter over medium heat in a large saut\\xc3\\xa9 pan with a lid. Pat the rabbit pieces dry and brown them in the butter. Do this at a moderate pace \\xe2\\x80\\x93 you don\\xe2\\x80\\x99t want the butter to scorch \\xe2\\x80\\x93 and don\\xe2\\x80\\x99t let the rabbit pieces touch each other. Do it in batches if you need to.', 'Once the rabbit is browned, remove it to a bowl.', '3 Brown the chopped shallots: Add the shallots and brown them well. This will take 3-4 minutes.', '4 Make the sauce: Pour in the white wine and turn the heat to high. Scrape off any browned bits on the bottom of the pan with a wooden spoon. Add the mustard, thyme and water and bring to a rolling boil. Taste the sauce for salt and add some if needed.', '5 Coat rabbit with sauce, cover and simmer: Add the rabbit pieces, coat them with the sauce, then drop the heat to low. Cover and simmer gently for 45 minutes. You want the meat to be nearly falling off the bone. It might need more time, but should not need more than an hour total. Wild rabbits sometimes need more time.', '6 When the meat is ready, gently remove it to a platter.', '7 Reduce the sauce, add cream and parsley: Turn the heat to high and boil the sauce down by half. Turn off the heat and add the cream and parsley. Stir the sauce to combine.', '8 Serve:  Return the rabbit to the pan. Coat with the sauce and serve at once.', 'Serve this dish with crusty bread and a big white wine, such as a white Bordeaux, white Cotes du Rhone blend or a buttery California Chardonnay. If you prefer beer, try pairing this with an unfiltered wheat beer.']",10
973,"Roasted Butternut Squash, Radicchio, and Onion Recipe",15,45,60,"['1 medium butternut squash (about 2 pounds), peeled and cut into chunks', '1 large onion, peeled and cut into wedges through the root', '1 head radicchio, cut into wedges through the root', 'Extra virgin olive oil', 'Salt and black pepper', '1/2 cup pine nuts', '1/4 cup chopped parsley', 'Grated parmesan or pecorino cheese to taste, about 1/4 cup to 1/3 cup', 'Balsamic vinegar to taste, about a tablespoon']",9,"['1 Roast the vegetables: Preheat the oven to 400\\xc2\\xb0F. Toss the squash chunks, onion and radicchio wedges in olive oil and salt them well.', 'Arrange in one layer on baking sheets (you may need two) and put in the oven.', 'Roast the vegetables until their edges are nicely caramelized, turning the radicchio and onion wedges over about halfway through the roasting.', ""The radicchio, onion, and squash will roast at different speeds. So periodically you'll have to remove the finished vegetables and let the others remain in the oven to finish roasting. As a guideline, roast the radicchio for about 25 minutes, turning halfway."", 'Roast the onions about 35 minutes, again, turning halfway. Roast the squash pieces for 45 minutes, but do not turn.', 'In all cases do not remove from the oven until you see browning on the edges.', '2 Toast the pine nuts: While the vegetables are roasting, toast the pine nuts.  Heat a small pan on medium high heat.  Add the pine nuts in a single layer. Cook until lightly toasted. Remove from heat to a bowl to keep the nuts from burning.', '3 Chop roasted radicchio and onions: Once all the vegetables are cool enough to handle, roughly chop the radicchio and onion into manageable pieces.', '4 Toss with pine nuts, parsley, balsamic, black pepper: Place the radicchio, onion, and butternut squash in a large serving bowl. Add the pine nuts and parsley. Add black pepper to taste. Drizzle with balsamic vinegar. Stir gently to combine, taking care not to squish the soft roasted squash.', 'To serve, sprinkle with some grated Parmesan or pecorino cheese.']",10
974,Grilled Radicchio Salad Recipe,15,10,25,"['2 heads of radicchio, quartered, so that each quarter has a bit of the stem end holding it together', '1/2 cup extra virgin olive oil, plus more to coat radicchio', '1/4 cup balsamic vinegar', '1 teaspoon salt', '3 chopped garlic cloves', '1/2 teaspoon mustard', 'Salt and black pepper', 'Pecorino or parmesan cheese for garnish']",8,"['1 Make the dressing: Put the salt, garlic, mustard and balsamic vinegar into a food processor or blender and pulse to combine. With the motor running, drizzle in the olive oil slowly until the dressing comes together.', '2 Prepare your grill for high, direct heat.', '3 Coat quartered radicchio with olive oil and sprinkle with salt.', '4 Grill the radicchio over high heat, uncovered. Keep an eye on them, as they blacken quickly. You want a little blackening, but not a cinder.', 'When they\\xe2\\x80\\x99re done, move to a bowl and bring inside to chop.', '5 Chop the radicchio quarters into bite-sized pieces and toss with the dressing and some black pepper.', '6 Serve: Serve hot or at room temperature, garnished with grated pecorino or parmesan cheese.']",7
975,Farro with Swiss Chard and Radicchio Recipe,10,50,60,"['4 tablespoons extra virgin olive oil, divided 2 Tbsp and 2 Tbsp', '1 medium onion, diced, about 1 1/2 cups', '6 garlic cloves, peeled and lightly crushed', '1 teaspoon kosher salt', '2 cups (1/2 pound) pearled farro', '4 cups water', '1 teaspoon minced fresh thyme leaves, or 1/2 teaspoon dried thyme', '2 bay leaves', '2 cups sliced swiss chard (center ribs removed)', '2 cups sliced radicchio', '1 teaspoon minced fresh rosemary, or 1/2 teaspoon dried rosemary']",11,"['1 Saut\\xc3\\xa9 onions and garlic: Heat 2 Tbsp of olive oil in a thick-bottomed 5 to 6 quart pot on medium high heat. Add the onions, and saut\\xc3\\xa9 for 3 to 4 minutes until softened. Add garlic cloves, reduce heat to medium, and cook for another 3 minutes.', '2 Add farro, water, bay leaves, thyme salt, bring to simmer: Add farro and stir to coat. Add the water, bay leaves, thyme, and salt. Raise the heat to high to bring to a simmer, then lower the heat to maintain a low simmer, cover, and let cook for 20 to 25 minutes, until the farro is cooked through.', '3 Prep chard, radicchio: While the farro is cooking, prep the swiss chard and radicchio.', '4 Remove cooked farro to a sheet pan to cool: Once the farro is done, remove the lid and check the moisture level. If there is still water in the pot, increase the heat to high to make it boil away. Then scoop out the farro onto a sheet pan to cool. At this point you can either remove the garlic cloves and discard, or keep them with the farro if you love garlic. Remove the bay leaves.', ""5 Add olive oil, then chard, then radicchio: In the same pan that you've used to cook the farro, heat the remaining 2 tablespoons of olive oil on medium high heat."", 'Add the swiss chard to the pan and toss to coat with the olive oil. Cook for a minute or two until the chard just begins to wilt.', 'Then add the radicchio to the pot, sprinkle with a pinch of salt and the rosemary leaves, and toss to combine. Cook for a few minutes until the radicchio is wilted. Remove from heat.', '6 Stir cooked farro into wilted greens: Stir the farro back into the pot with the swiss chard and radicchio. Taste for seasoning, add more salt if needed, and serve.']",8
976,Radicchio Salad with Citrus Recipe,15,15,30,"['3 slices (about 2 cups) sourdough bread, torn into bite-sized pieces', '1/4 cup plus 3 tablespoons extra-virgin olive oil, divided', '3/4 teaspoon kosher salt', '1/4 teaspoon ground black pepper', '1/2 cup chopped walnuts', '2 citrus fruits, like orange, lemon, and/or grapefruit', '1 small head radicchio (about 4 cups), cored and cut into bite-sized pieces', '2 cups arugula', '1/4 cup crumbled feta cheese']",9,"['1 Make the croutons: Heat the oven to 350\\xcb\\x9aF. Place the bread pieces on a rimmed baking sheet and toss with 1/4 cup olive oil. Sprinkle with 1/2 teaspoon salt and bake, tossing the bread on the baking sheet partway through, until golden and crunchy, about 15 minutes; let cool.', '2 Toast the nuts: While the croutons are in the oven, toast the nuts in a medium-sized skillet set over medium heat on the stovetop until fragrant and toasted, about 8-10 minutes. Stay near the pan, and stir the nuts occasionally. They can go from toasted to burnt in a matter of seconds. Let cool.', '3 Peel and segment (a.k.a. supreme) the citrus : For each fruit, cut about an inch off the top and bottom just so some of the flesh is exposed. Set the fruit with the cut-side down on a cutting board.', 'Start at the top, and slice down the side of the fruit with a sharp knife, cutting away the peel and the pith, exposing the flesh. Then carefully cut out the citrus segments over a bowl to collect the juice. You should have about 1 cup of citrus segments.', ""4 Squeeze the juice: Once all of the segments have been removed, squeeze the juice from what's left of the fruit into the same bowl. Drain the juice from the segments and keep separate."", '5 Make the citrus vinaigrette: In a mason jar or small bowl, combine 3 tablespoons of the reserved citrus juice with the remaining 3 tablespoons olive oil. Add pepper and the remaining 1/4 teaspoon salt. Secure the lid if using a jar, and shake vigorously for a few seconds until emulsified. If using a bowl, whisk the ingredients together.', '6 Assemble the salad: Add the radicchio and arugula to a large bowl. Drizzle with the vinaigrette and toss until evenly coated. Taste and season with additional salt and pepper to suit your preferences. Add the croutons, walnuts, citrus segments, and feta cheese, and toss until evenly combined.', '7 To serve: Transfer to a large serving bowl for family-style eating, or divide among individual bowls for serving.']",8
977,Roasted Radish and Feta Salad Recipe,10,25,35,"['For the salad:', '2 pounds radishes', '1 1/2 tablespoons olive oil', 'Good pinch of salt', 'Freshly cracked pepper', '3 ounces feta, crumbled', '2 tablespoons chopped fresh tarragon', '1/3 cup chopped fresh parsley', 'For the Lemon Vinaigrette:', '1/4 cup lemon juice', '1 tablespoon lemon zest', '1/2 cup olive oil', '2 tablespoons Dijon mustard', '1/4 teaspoon salt', '1/8 teaspoon pepper', '1 tablespoon honey']",16,"['1 Roast the radishes: Preheat the oven to 400\\xc2\\xb0F. Trim the tops and tails from the radishes (reserve the greens for another use), and cut the the radishes into halves (or quarters if your radishes are exceptionally large).', 'Toss the radishes with the olive oil, salt, and pepper. Place in a large baking dish and roast for 20 to 25 minutes.', '2 Prepare the vinaigrette: While the radishes are roasting, make the vinaigrette by placing all of the ingredients together in bowl and whisking them together. Taste and add more salt or pepper if needed. Set aside.', 'Note: This vinaigrette makes more than you\\xe2\\x80\\x99ll need for the salad. It will keep in the fridge for a few days. Just bring it to room temperature and whisk back together before serving.', '3 Assemble the salad: Once the radishes are cooked, allow them to cool for a few minutes before assembling the salad. (At this point, the radishes can also be cooled completely and refrigerated for up to 5 days.)', 'Combine the roasted radishes and crumbled feta in a salad bowl, and toss with a tablespoon or two of the vinaigrette. Taste and toss with additional dressing as needed. Scatter the herbs over the salad and toss to combine. If your radishes are still warm, the herbs will wilt; this is fine.', 'Serve warm or room temperature. Leftovers will keep for a few days in the fridge.']",7
978,Spring Vegetable Salad with Mint Pesto Recipe,15,15,30,"['1/4 cup whole almonds with skins', '6 ounces green beans, ends trimmed', '6 ounces sugar snap peas, halved on the diagonal', '1 1/2 cups fresh or frozen peas', '4 radishes, thinly sliced', '1 tablespoon olive oil', '1 1/2 tablespoons sherry vinegar or red wine vinegar', '1/4 teaspoon salt', '1/8 teaspoon ground black pepper', '1/3 cup mint pesto', '1/2 cup fresh mint leaves', '2 ounces (1/2 cup) crumbled feta, or to taste']",12,"['1 Toast the almonds: Preheat the oven to 350\\xc2\\xbaF. Spread the almonds on a baking sheet and toast in the oven for 8 to 10 minutes, or until they are fragrant. Let cool and coarsely chop or crush them.', '2 Blanch the beans, snap peas, and peas: Bring a large saucepan of salted water to a boil. Prepare a bowl of ice water. Add the beans to the boiling water and cook for 3 minutes. Add the sugar snap peas, and let peas cook for 2 minutes, or until crisp tender. (Total cooking time is 5 minutes.)', 'With a slotted spoon, transfer the vegetables to the bowl of ice water. Swish them around for about 1 minute. Drain them in a colander, and spread them on a paper towel-lined baking sheet. Pat dry.', '3 Dress and serve the salad: In a large bowl, toss the beans, snap peas, peas, and radishes with the oil, vinegar, salt, and pepper. Add the mint pesto and toss again.', 'Taste and add more salt, pepper, or vinegar, if you like. Transfer to a bowl or platter. Sprinkle with the almonds, feta, and mint leaves.']",5
979,Oatmeal Raisin Cookies Recipe,20,12,32,"['1 cup (1/2 pound or 2 sticks) unsalted butter, softened, OR 1 cup shortening', '1 cup brown sugar, packed', '1/2 cup plus 2 tablespoons granulated sugar', '2 large eggs', '1 tablespoon vanilla extract', '1 1/2 cups all-purpose flour', '3/4 teaspoon salt', '1 teaspoon baking soda', '1 teaspoon ground cinnamon', '1/2 teaspoon freshly grated nutmeg', '1 1/2 cups raisins', '1/2 cup chopped walnuts (optional)', '3 cups rolled oats (We use Quaker Old Fashioned or Quick. Do NOT use instant.)']",13,"['1 Preheat and prep: Preheat oven to 350\\xc2\\xb0F. Grease two large cookie sheets or line with Silpat or parchment paper.', '2 Combine the butter, sugar and eggs: In a large mixing bowl, beat butter until creamy. Add the brown sugar and white sugar, beat until fluffy, about 3 minutes. Beat in eggs, one at a time. Add the vanilla extract.', '3 Add the dry ingredients: Mix flour, salt, baking soda, cinnamon, and nutmeg together in medium bowl. Stir the dry ingredients into the butter-sugar mixture. Stir in the raisins and nuts. Stir in the oats.', '4 Scoop out the dough onto sheets: Spoon out the dough by large tablespoonfuls onto the prepared cookie sheets, leaving at least 2 inches between each cookie.', ""5 Bake the cookies: Bake until the edges of the cookies turn golden brown, about 10 to 12 minutes. Note that the cookies will seem underdone and lightly colored everywhere but the edges. That's okay, they will firm up as they cool."", '6 Cool, transfer, and store: Cool 1 minute on cookie sheets. Then carefully remove them, using a metal spatula, to a wire rack. Cool completely. They will be quite soft until completely cooled. Store tightly covered.']",6
980,"Oatmeal Muffins with Raisins, Dates, and Walnuts Recipe",20,20,40,"['1 cup of rolled oats', '1 cup of all-purpose flour', '1/2 cup brown sugar, packed', '1/2 teaspoon of salt', '1 teaspoon baking powder', '1/2 teaspoon baking soda', '1/2 teaspoon of cinnamon', '1/4 cup of finely chopped walnuts, toasted', '1/3 cup of raisins', '1/3 cup of chopped dates', '1 stick of butter (1/2 cup), melted and cooled', '1 cup of buttermilk', '1/2 teaspoon vanilla extract', '1 large egg, beaten']",14,"['1 Preheat the oven to 400\\xc2\\xb0F and grease a twelve-slot muffin tin or line the slots with paper baking cups.', '2 Mix together the rolled oats, flour, brown sugar, salt, baking soda, baking powder, cinnamon, walnuts, dates, and raisins. In a separate bowl mix together the buttermilk, egg, vanilla extract, and butter.', '3 Pour the wet ingredients into the dry mixture and stir together. Be sure not to over-stir as that will cause the muffins to develop too many gluten bonds. It should be thick and gloppy. About 10 seconds of stirring should do; just enough to barely bring the ingredients together.', '4 Scoop into prepared muffin tray and bake at 400\\xc2\\xb0F for 20 minutes or until a toothpick comes out clean. Cool in the tray for a minute or two before transferring to a wire rack to cool completely.']",4
981,Saut\xc3\xa9ed Greens with Pine Nuts and Raisins Recipe,10,10,20,"['1/4 cup pine nuts', '2 tablespoons extra virgin olive oil', '2 garlic cloves, minced', '1/4 cup golden raisins', '1 bunch kale, chard, collards, or turnip greens, etc., about 1 pound, tough stem centers removed (if any) and discarded, greens chopped', '1/2 to 1 teaspoon red pepper flakes', 'Roughly 1/4 cup dry white wine (can sub water with a splash of balsamic vinegar or lemon juice)', 'Salt and pepper to taste']",8,"['1 Toast the pine nuts: Heat a large saut\\xc3\\xa9 pan hot on medium-high heat and add the pine nuts. Toast them until they are fragrant and begin to brown. Pay attention as pine nuts burn easily. Stir or toss the nuts frequently. Once they are toasted, remove from pan and set aside.', ""2 Saut\\xc3\\xa9 garlic in olive oil: Add the olive oil to the pan and swirl it around. Add the garlic and saut\\xc3\\xa9 for 30 seconds; the pan should already be hot, so it won't take long for the garlic to begin to brown."", '3 Wilt the greens: Add the greens and mix well. Saut\\xc3\\xa9, stirring often, until the greens wilt and begin to give up some of their water, anywhere from 1-2 minutes for spinach to 4-5 minutes for collards or kale.', '4 Add the nuts, raisins, salt, and red pepper flakes: Stir in the nuts and raisins, and sprinkle with salt and red pepper flakes.', '5 Add the white wine: Use a little more wine if you are cooking collards, and less if you are cooking spinach. Toss to combine and let the liquid boil away. Once the liquid boils off, remove from heat. Add salt and pepper to taste.']",5
982,Carrot Cake Pancakes Recipe,20,25,45,"['For the Cream Cheese Topping (makes 1 1/2 cups):', '8 ounces cream cheese, room temperature', '1/4 cup (60ml) heavy whipping cream', '1/2 cup (81g) golden brown sugar, packed', '1 teaspoon vanilla extract', '1/2 teaspoon cinnamon', 'For the Carrot Cake Pancakes:', '2 cups (284g) all-purpose flour', '2 tablespoons (24g) brown sugar, packed', '1 teaspoon (3g) baking powder', '1/2 teaspoon (2g) baking soda', '1/2 teaspoon (3g) kosher salt', '1 teaspoon (3g) ground cinnamon', '1/4 teaspoon ground nutmeg', '1/4 teaspoon ground ginger', '1/8 teaspoon ground cloves', '2 cups (480ml) buttermilk', '2 large eggs', '3 tablespoons (44g) unsalted butter, melted and cooled', '1 teaspoon vanilla extract', '1 cup (116g) carrots, peeled and finely grated', '1/2 cup (57g) pecan halves, finely chopped plus more for topping', '1/4 cup (37g) raisins roughly chopped', 'Vegetable oil, as needed for cooking', 'To serve:', 'Pure maple syrup, as needed for topping']",26,"['1 Make the cream cheese topping: Add cream cheese, heavy cream, brown sugar, vanilla, and cinnamon to the bowl of a stand mixer or use a hand mixer. Beat the ingredients together on medium speed until fully combined and smooth, scraping down the sides of the bowl as needed, 45 to 60 seconds. Set it aside, and make the pancakes.', '2 Combine the dry ingredients: In a large bowl, whisk together flour, brown sugar, baking powder, baking soda, salt, cinnamon, nutmeg, ginger, and cloves.', '3 Combine the wet ingredients: In a medium bowl, whisk together buttermilk, eggs, cooled melted butter, and vanilla until smooth. Stir in the finely grated carrots, chopped pecans, and chopped raisins.', ""4 Make the batter: Gently stir in the wet ingredients into the dry ingredients, there should be a few flour streaks and batter should be lumpy. Let the batter rest for 10 minutes before cooking. The unmixed flour should hydrate while the batter sits; if it doesn't, stir the batter once or twice and let it sit a few more minutes. "", '5 Prepare the pan: Heat a large 12-inch nonstick skillet over medium heat. Add 1 teaspoon of vegetable oil, use a paper towel to wipe a thin layer of oil over the surface.', '6 Cook the pancakes: Add 1/4 cup of pancake batter into the pan. Use the back of a spoon to form into a circle. Cook three pancakes at a time, if your pan allows.', 'Cook until the pancakes are golden brown, edges are set, and a few small bubbles appear on the surface, about 2 to 3 minutes. Carefully flip the pancakes and cook until golden brown, about 1 to 2 minutes. Repeat the process with the remaining batter, greasing the pan as needed.', '7 Serve: Serve pancakes with cream cheese topping, chopped pecans, and maple syrup.']",8
983,Easy Weeknight Chicken Ramen Recipe,15,15,30,"['For the broth:', '2 tablespoons toasted sesame oil', '4 scallions, thinly sliced, including some of the green part', '1 clove garlic, minced', '1 small carrot, peeled and thinly sliced', '4 ounces button, cremini, or shiitake mushrooms, thinly sliced', '1 1/2 cups thinly shredded Napa cabbage, spinach, kale, or other greens', '1-inch piece fresh ginger, minced', '6 cups low-sodium chicken broth, store-bought or homemade', '1 tablespoon brown sugar, optional', 'Lime wedges, optional', 'For the soup:', '4 large eggs', '20 ounces fresh ramen noodles, or 12 ounces dried noodles', '2 medium cooked chicken breast halves, sliced (see Recipe Note)', 'For the garnish:', 'Soy sauce', 'Sriracha or other hot sauce', 'Handful fresh cilantro, leaves removed from stems', 'Lime wedges']",20,"['1 Make the broth: In a large saucepan over medium heat, heat the oil. Add the scallions, garlic, carrot, mushrooms, and cabbage. Cook, stirring often, for 3 minutes, or until the vegetables soften.', 'Stir in the ginger and brown sugar (if using) and cook for 30 seconds. Finally add the chicken broth and bring to a simmer. Simmer for 10 minutes.', '  2 Cook the eggs: While the broth is simmering, bring a pot of water to a boil. Set a bowl of cold ice water nearby.', 'Use a slotted spoon to gently lower the eggs, still in the shell, into the water. Simmer for 7 minutes for eggs that are soft and a little runny in the center, or 9 minutes for hard-boiled eggs.', 'Transfer the eggs to the bowl of cold water and set aside until ready to serve.', '3 Cook the noodles: Return the pot of water to a boil. Add the noodles and cook for 3 minutes, or according to the package directions, until tender. Drain in a colander.', '4 Assemble the soup: Divide the noodles among 4 large bowls. Ladle the broth and vegetables over the noodles.', 'Remove the eggs from the ice water. Tap the shells with a spoon to crack and then peel off the shells. Pat the eggs dry and cut them in half.', 'Top each bowl with the egg halves and the sliced chicken. Serve with soy sauce, hot sauce, cilantro leaves and lime wedges.']",9
984,Instant Pot Chicken Wing Ramen Recipe,15,60,75,"['1 to 1-1/2 pounds (about 4 to 6 cups) leftover cooked chicken wings', '4 cups low-sodium chicken stock', '1 cup water', '2 tablespoons soy sauce', '2 tablespoons mirin rice wine vinegar', '1/2 teaspoon sugar', '2 to 4 large eggs', 'One 7.1-ounce package fresh egg noodles, or 2 packages instant ramen, seasoning packets discarded', '2 scallions, thinly sliced', 'Special equipment:', '6-quart Instant Pot or other electric pressure cooker']",11,"['4 Prepare an ice bath: As the eggs cook, prepare an ice water bath in a small bowl. When the Instant Pot beeps, release the pressure using the quick release valve.', 'Use a skimmer or slotted spoon to lift the eggs from the pot. Plunge them into the ice water. (They\\xe2\\x80\\x99ll be a tad greasy, but you\\xe2\\x80\\x99ll be peeling them soon anyway.)', '5 Add the noodles and meat: Add the noodles and reserved meat to the Instant Pot. Leave the lid off, switch to the saut\\xc3\\xa9 setting, and cook 2 minutes, or until the noodles are cooked through.', 'As the ramen cooks, peel the eggs. Set aside.', '6 Adjust the seasonings and serve: Taste the broth. It may need more salt or soy sauce, depending on how seasoned your leftover wings were. Season as needed.', 'Divide the broth, meat, and noodles between bowls. Halve the eggs and nestle the halves in the broth; they should warm from the heat of the broth. Garnish with scallions and serve.']",6
985,Raspberry Jam Sweet Rolls Recipe,20,90,110,"['For the dough:', '2 teaspoons active dry yeast', '3/4 cup warm milk', '1/4 cup (50g) sugar', '2 large eggs', '4 cups (480 grams) all-purpose flour', '1 1/2 teaspoons kosher salt', '6 tablespoons (3 ounces) room temperature unsalted butter', 'For the filling:', '2 tablespoons (1 ounce) unsalted butter, softened', '1/2 cup raspberry jam', '6 ounces (about 1 heaping cup) fresh or frozen raspberries', '1 teaspoon cornstarch', '2 tablespoons sugar', '1 teaspoon lemon zest', 'For the icing:', '4 ounces softened cream cheese', '1/4 cup (4 tablespoons) unsalted butter, softened', '2 cups (227 grams) powdered sugar', '1 tablespoon whole milk', '1 teaspoon lemon zest', 'Pinch of kosher salt']",22,"['1 Dissolve the yeast: In the bowl of a stand mixer fitted with the dough hook, combine the yeast, warm milk, and sugar. Let the mixture stand until foamy, about five minutes.', ' 2 Make the dough: Add the eggs, flour, and salt to the bowl and mix on medium speed until a shaggy dough is formed. Beat in the butter, 2 tablespoons at a time, waiting until the butter is incorporated before adding the next batch.', '3 Knead the dough and let it rise: Once all the butter is incorporated, knead the dough on medium speed or by hand for 10 minutes until smooth. Shape the dough into a ball, place in a lightly oiled bowl, and cover with plastic wrap.', 'Let the dough rise in the refrigerator overnight, at least 8 hours, where it should slowly double in size. ', '4 Roll out the dough: In the morning, remove the dough from the refrigerator and roll out into a rectangle approximately 12x16 inches in size.', 'Spread the dough with butter, leaving a 1-inch border on one of the longer (16-inch) edges. Spread the raspberry jam over the butter, maintaining the border along the edge.', 'Toss the fresh berries with the cornstarch, 2 tablespoons of sugar, and 1 teaspoon of lemon zest. Scatter the berries over the jam layer. ', '5 Roll up the dough: Starting with the long (16-inch) edge of the dough, roll up the dough toward the unbuttered edge. Roll it into a tight spiral and pinch the unbuttered edge closed to create a tight seam.', 'Cut the roll into thirds with a sharp, serrated knife. Cut each third into three rolls to create nine individual rolls.', '6 Let the rolls rise: Fit the rolls into a lightly buttered 9x13-inch baking dish, cover with plastic wrap, and allow to rise until doubled in size, about 1 hour in a warm room.', '7 Bake the rolls: Preheat the oven to 350\\xc2\\xb0F. Remove the plastic wrap from the rolls and bake in the center of the oven for 25 to 30 minutes, or until the rolls are puffy and golden on top.', 'Remove from the oven and cool on a rack for 5 minutes before icing.', '8 Make the icing and frost the rolls: Beat the cream cheese in a mixing bowl until smooth. Beat in the butter until combined and gradually beat in the powdered sugar. Beat in the milk, followed by the lemon zest and salt. Spread the icing over the rolls while they are still warm.', '9 Serve! These are best eaten the day they are made. Be sure to eat them while they are warm for the best texture.', 'You can store any leftover rolls by wrapping them individually in plastic wrap.']",15
986,Raspberry Salmon Cakes with Chipotle Aioli Recipe,30,20,50,"['For raspberry salmon cakes:', '3/4 pound fresh salmon fillet, deboned', '3 tablespoons extra virgin olive oil, divided', '1 cup fresh Well\\xe2\\x80\\xa2Pict raspberries', '1/4 cup all-purpose flour', '1/4 cup Panko bread crumbs', '3 green onions, white and light green parts only, chopped', '2 cloves garlic, minced', '1 tablespoon Dijon mustard', '1/2 teaspoon salt', '1 large egg, beaten', 'For the chipotle aioli:', '3/4 cup mayonnaise', '2 garlic cloves, finely minced', '1 tablespoon chipotle chili powder', '1/2 teaspoon onion powder', '1/4 teaspoon dried oregano', '1/4 teaspoon cumin', '1/4 teaspoon kosher salt, or more to taste', '1 tablespoon fresh lime juice']",20,"['1 Cook the salmon: Preheat the oven to 350\\xc2\\xb0F and line a large rimmed baking pan with parchment paper.', 'Drizzle 1/2 tablespoon of olive oil on each side of the salmon and season generously with salt and pepper. Lay salmon on the prepared baking sheet and bake in the oven for about 15 minutes, or until the fish is firm and flakes away easily with a fork.', 'Allow salmon to cool and then flake using a fork or your hands. You should have 1 1/2 cups of salmon.', '2 Make the patties: In a large mixing bowl, place the flaked salmon with the raspberries, flour, bread crumbs, green onions, garlic, mustard, salt and egg. Mix thoroughly, breaking up the raspberries as you mix, until well combined.', '3 Shape the patties: Form 4 small patties, using roughly 3 tablespoons of the mixture, with the palm of your hands. The patties should be about 3-inches wide and 1/2-inch thick.', '4 Cook the patties: Heat a large skillet on medium heat with 1 tablespoon of the olive oil. Carefully place the patties in the hot pan and cook for about 2 to 3 minutes per side, or until each side is golden brown. Remove to a serving dish and repeat with the remaining olive oil and salmon mixture.', '5 Make the aioli: Place mayonnaise, garlic, chipotle chili powder, onion powder, oregano, cumin, salt and lime juice in a large bowl and stir together. Taste and add any additional salt as needed.', '6 Serve: Serve the salmon cakes with the aioli on the side. Or put a dollop on each salmon cake when serving, and sprinkle with some of the chopped green part of the green onions. Serve with lime slices as garnish.', 'Store leftover aioli in a mason jar or airtight container in the fridge for up to 5 days.']",9
987,Dad\xe2\x80\x99s Ratatouille Recipe,20,90,110,"['1 pound yellow onions, chopped', '1/2 cup extra virgin olive oil (more or less)', '3 cloves garlic, crushed', '1 pound zucchini, cubed', '1 pound yellow squash, cubed', '1 pound green bell peppers, seeds removed, chopped into 1/2-inch square pieces', '1/2 pound red bell peppers, seeds removed, chopped into 1/2-inch square pieces', '1/2 pound yellow bell peppers, seeds removed, chopped into 1/2-inch square pieces', '1 pound eggplant, 1/2-inch cubes', 'Salt to taste', '2 sprigs thyme', '1 bay leaf', '1-inch sprig rosemary', '3/4 cup vegetable stock (or thin tomato juice)', '1 pound fresh ripe tomatoes (or equal amount of high quality canned tomatoes, chopped)', 'Fresh ground pepper to taste']",16,"['1 Preheat oven to 400\\xc2\\xb0 F.', '2 Saut\\xc3\\xa9 onions and garlic: Using a large oven-proof pan over medium high heat, saut\\xc3\\xa9 onions in 2 tablespoons of olive oil until they begin to soften, about 5 minutes. Add garlic and reduce heat to low.', '3 Saut\\xc3\\xa9 zucchini: While the onions and garlic are cooking over low heat, heat 2 tablespoons of olive oil in another frying pan over high heat. As soon as oil starts to smoke, quickly add enough zucchini cubes all at once to cover the bottom of the pan.', 'Keep on cooking over high heat, stirring, until zucchini is lightly browned on all sides. Remove zucchini cubes, and add them to pan with the onions.', 'Working in batches, repeat this process until all of the zucchini cubes have been cooked.', '4 Saut\\xc3\\xa9 the remaining veggies: Cook the yellow squash in the same manner as the zucchini. Make sure to add a little olive oil between each new batch.', 'Continue with the bell peppers, then the eggplant cubes, adding the browned vegetables to the onion pan as soon as they are cooked.', ""5 Season: When all the vegetables (except the tomatoes) are browned and in the pan with the onions, increase the heat to high and stir, making sure they don\\'t stick to the bottom of the pan."", 'Add salt to taste, along with thyme, bay leaf, rosemary, and the vegetable stock. Stir well.', '6 Cook the veggies in the oven: Place the pan in a 400\\xc2\\xb0F oven, and cook, uncovered, for 30 minutes. Alternatively, you can cook them on the stovetop on low heat for 30 minutes.', '7 Prep the tomatoes: If using fresh tomatoes, boil water in a saucepan. Remove the stems from tomatoes, and crisscross the bottoms with a knife. Plunge the tomatoes into boiling water for a minute or two, until skin starts to fall away. Rinse in cold water and remove the skin.', 'Cut tomatoes in half lengthwise, remove seeds, chop coarsely, and set aside.', '8 Make a glaze: After the vegetables have been in the oven for a half hour, remove from oven, drain vegetables in a colander set over a bowl to catch the juices. Clean browned bits (if any) off the bottom of pan with a paper towel.', 'Return any liquid to the pan and reduce to a thick glaze over medium-high heat. Keep on adding juices to the pan as they run out of the vegetables into the bowl.', '9 Combine cooked vegetables with chopped tomatoes: When all the juices have been reduced, return vegetables to the heavy pan. At this point the ratatouille should be moist and shiny, with very little liquid. Turn heat off. Add the chopped tomatoes and cover.', '10 Serve: Remove the bay leaf, and season to taste with salt and pepper. If serving as a warm side dish, let the ratatouille stand for 10 minutes, just enough to ""cook"" the tomatoes. The ratatouille can be served at room temperature or refrigerated and reheated the next day.']",16
988,Blue Corn Chicken Nachos Recipe,10,20,30,"['1/2 pound boneless, skinless chicken breast', '1 teaspon salt', '14 ounces blue corn tortilla chips', '1 pound pepper jack or monterey jack (or a mix), shredded', '1 Tbsp cornstarch', '1/2 cup heavy cream', '1/2 cup milk', '1 cup fresh tomato salsa (pico de gallo)', '1/2 cup chopped fresh cilantro']",9,"['1 Poach the chicken breast: Place chicken breast(s) in a medium saucepan and cover with 2 inches of water. Add the salt. Cover. Bring to a boil. Turn off the heat. Let sit covered for 10 minutes in the hot salted water to gently poach. Drain. Remove from pan.', '2 Preheat oven to 350\\xc2\\xb0F.', '3 Make the cheese sauce: If you have a double boiler, use it. Otherwise put an inch of water in a small pot and place a medium metal bowl on top of it to create a double boiler effect.', 'Put the shredded cheese in the bowl and toss to coat with the cornstarch. Pour in the heavy cream and milk.', 'Turn on the heat and bring the water in the pot to a boil. Slowly heat up the milk cream cheese mixture until eventually the cheese melts, stirring occasionally until smooth.', '4 Heat tortilla chips in oven: While the cheese is heating, spread the tortilla chips out in a large baking sheet and put in the oven at 350\\xc2\\xb0F. Heat for 5 minutes. Then remove from the oven.', '5 Cut the cooked chicken into 1/4 to 1/2-inch cubes.', '6 Top tortilla chips with cheese sauce, chicken, and salsa: When the cheese sauce is melty and smooth, put the heated tortilla chips on a platter and pour the cheese sauce over it. Top with cooked chicken and pico de gallo tomato salsa.']",8
989,American Flag Pie Recipe,60,130,190,"['Crust:', '3 1/2 cups flour', '3 1/2 teaspoons sugar', '1 1/2 teaspoons salt', '14 ounces butter (3 1/2 sticks), cut into cubes', ""7/8 cup sour cream (that's 3/4 cup plus 2 Tbsp)"", 'Strawberry filling:', '3 1/2 pounds strawberries, hulled, quartered', '1/2 cup sugar', '2 teaspoons orange zest', '4 Tbsp cornstarch, flour, or minute tapioca', 'Blueberry filling:', '1 pint blueberries (about 0.6 lbs, 280 g)', '3 Tbsp sugar', '1/4 teaspoon cinnamon', '1 teaspoon lemon zest', '2 teaspoons lemon juice', '2 Tbsp cornstarch, flour, or minute tapioca', 'Egg wash:', '1 egg white', '1 teaspoon of milk or cream', 'Special equipment:', 'One 13 x 18-inch rimmed sheet pan', 'Star-shaped cookie cutter']",24,"['1 Make the pie dough: Cut the butter into cubes and let sit out for a 10 minutes to take the chill off. Whisk together the flour, sugar, and salt in a large mixing bowl.', 'Add the butter and toss to coat with the flour. Using your (clean) hands, work the butter into the flour until the mixture resembles a coarse meal.', 'Add the sour cream and mix with a fork until well incorporated.', 'Knead with your hands until the mixture comes together as a ball. Divide into 3 equal sized balls of dough (it helps to use a kitchen scale).', 'Form the balls into rectangular discs. Sprinkle with a little flour and wrap individually with plastic wrap.', 'Chill for 1 to 2 hours or overnight (can freeze this point if making several days ahead).', '2 Make berry fillings: Put the quartered strawberries in a large bowl and toss with sugar, cornstarch (or flour, or minute tapioca), and orange zest.', 'In a separate smaller bowl, put the blueberries, sugar, cinnamon, lemon zest, lemon juice, and cornstarch (or flour or minute tapioca), and toss to combine.', '3 Roll out the dough for the bottom crust: Line the bottom of a 13 x 18-inch rimmed sheet pan with parchment paper.', 'Remove two dough discs from the refrigerator and let sit for 10 minutes to soften a bit. On a clean, lightly floured surface, roll out one disk to 11 x 17-inches and arrange on half of the sheet pan, with an inch of edge over the sides of the sheet pan.', 'Roll out the second disc and cover the other half of the sheet pan.', 'Fold the dough over along the edges and crimp.', ""Remove any excess dough from center. Form into a ball, then use your hands to roll into a long rope. Crimp that rope of dough and form a rectangle in one corner of the sheet pan. This is where your berries and stars will go. The dough will help keep the blueberries from running into the strawberries. (If you don't have excess dough at this point, no worries, you will later when you cut away the stars and stripes.)"", 'Put in the refrigerator to chill.', '4 Make egg wash: In a small bowl, whisk together the egg white and milk or cream.', '5 Roll out dough for stars and stripes: Remove third rectangular disc of dough from the fridge and let sit for 10 minutes to soften a bit. Roll out so that the longest point is 18-inches.', ""Use a dinner knife (blunt) or a pizza wheel to cut out stripes. You'll need 2 stripes that are about 18 inches long and 1 1/2 inches wide, and 2 stripes that are about 10 inches long and 1 1/2 inches wide."", 'Use a star shaped cookie cutter to cut out stars.', 'Place stars and stripes on a cookie sheet, sheet pan, or large plate. Brush with egg wash. Chill.', '6 Preheat oven to 450\\xc2\\xb0F.', '7 Fill the pie and top with stars and stripes: Spread the strawberries over the part of the sheet pan where the red and white stripes should be. Scoop the blueberries into the corner where the stars should be.', 'Arrange the stars and strips of dough on top of the berries to form the flag. Chill for 10-15 minutes before baking.', '8 Bake: Bake at 450\\xc2\\xb0F for 15 minutes. Then tent with foil and lower the heat to 375\\xc2\\xb0F and bake for another 45 to 55 minutes or longer, until the filling is bubbling.', 'Remove from oven and let cool at least an hour before serving.']",24
990,Fourth of July Buttermilk Pie Recipe,20,50,70,"['4 eggs', '1 cup white sugar', '1 teaspoon lemon zest', '1 Tbsp flour', '1/4 cup butter, melted (half a stick)', '1 cup buttermilk', '1 teaspoon vanilla extract', '1 unbaked 9-inch pie crust', '1 cup cold, heavy whipping cream', '20-30 raspberries (or half as many strawberries, halved)', 'A handful of blueberries']",11,"['1 Preheat oven to 325\\xc2\\xb0F.', '2 Beat eggs, sugar, zest. Then flour and butter. Then vanilla and buttermilk: In a mixing bowl, beat the eggs, then beat in the sugar and lemon zest until well combined. Beat in the flour and melted butter. Beat in the vanilla and buttermilk.', '3 Fill pie shell and bake: Pour filling batter into an uncooked pie shell (frozen is fine). Bake at 325\\xc2\\xb0F for approximately 50 minutes, or until the center of the custard has just set (can still be a little wiggly).', 'Remove from oven and let cool. The custard may puff up a bit in the oven; it will deflate as it cools.', '4 Top with whipped cream and berries: Whip the chilled cream until it holds stiff peaks. Once the pie has cooled to room temperature, spread the whipping cream over the top of the pie.', 'Arrange the raspberries and blueberries in a decorative pattern on top of the whipping cream.', 'Serve immediately or chill until ready to serve.']",7
991,Mexican Tostada Recipe,15,25,40,"['For the tostadas:', 'Corn oil or extra virgin olive oil', '12 corn tortillas', 'Salt', 'For the toppings:', '3 1/2 cups refried beans, homemade or from 2 15-ounce cans', '1/2 head iceberg lettuce, sliced thin and seasoned with salt and vinegar (no oil)', '2 medium tomatoes, chopped', '1 to 2 avocados, chopped peeled and pitted, or guacamole', '8 ounces grated Monterrey Jack, Cheddar, or crumbled queso fresco and/or cotija cheese', '1 cup of salsa, or 1/2 cup sliced pickled jalape\\xc3\\xb1os', 'A handful chopped fresh cilantro']",12,"['1 Warm the refried beans: Warm the refried beans in a frying pan on medium heat, until warm. If you are using regular canned beans, drain them, then add them to the pan with a little water, mash them as you heat them.', 'For extra flavor for the beans you can stir in a tablespoon of bacon fat to them and/or a big slice of cheddar cheese.', 'Keep the beans on warm while you prepare the tortillas, adding water to them as necessary to keep a creamy consistency.', '2 Dry the tortillas in oven: To help the tortillas fry up better, dry them in the oven by laying them out on an oven rack and cooking them at 250\\xc2\\xb0F for 10 minutes or so.', '3 Fry the tortillas: Pour enough oil into a frying pan so that you have a quarter inch layer of oil. Heat the oil on medium high heat until sizzling hot, but not smoking.', 'One at a time, fry the tortillas in the oil. Bubbles should form in the tortilla immediately as you put the tortilla in the oil, otherwise the oil is not hot enough.', 'Fry until golden brown on both sides, cooking about 30 seconds to a minute per side. Use metal tongs or a spatula to push the tortilla down in the oil, and to turn and lift the tortilla out of the pan, draining the excess oil as you do so. (The tortilla should be fairly stiff and crisp. If not, the oil is not hot enough.)', 'Place the tortilla on a paper towel-lined plate, to absorb the excess oil. Sprinkle with a little salt.', 'Put the cooked tortillas on a rimmed baking sheet and place in a 250\\xc2\\xb0F oven to keep warm.', 'Add more oil to the pan as needed, taking care that the oil heats sufficiently before adding a tortilla to the pan.', '4 Serve with toppings: To serve, place toppings in separate bowls, with a larger serving dish for the beans. Bring out the tostada shells in batches, keeping those unused warm in the oven.', 'To prepare a tostada, spread a large spoonful of mashed beans over a tostada shell. Sprinkle on cheese and other toppings (sliced lettuce, avocados, salsa, etc.)', ""Don't load the tostada too much or you'll find it difficult to eat. Eat by picking up the tostada with both hands (like a pizza slice).""]",13
992,7 Layer Bean Dip Recipe,10,10,20,"['2 cups refried beans, from one 15-ounce can or homemade', '1 teaspoon (or more) of bacon fat (or 1 strip of bacon, cooked and minced), optional', '1 teaspoon chipotle powder, Tabasco chipotle sauce, or adobo sauce, more to taste (or plain chili powder to taste)', '1/4 to 1/2 teaspoon ground cumin', 'Salt', '1 cup shredded cheddar or Monterey Jack cheese', '1/4 cup chopped green Anaheim chiles (canned) OR 1 tablespoon chopped pickled jalape\\xc3\\xb1os (more to taste)', '1 avocado, peeled and chopped', '1 hot house tomato, cut in half horizontally, seeds and juice gently squeezed out and discarded, chopped', '1/3 cup sour cream, or if you can get it Crema Mexicana (Mexican sour cream)', '1 cup sliced ripe black olives, from a 15-ounce can', 'Corn tortilla chips, to serve']",12,"['1 Prepare the refried beans: Heat the refried beans in a medium saut\\xc3\\xa9 pan or cast iron skillet. Stir in enough water to get a creamy, easily dip-able consistency, about 1/4 of a cup.', ""The taste of refried beans is greatly enhanced by bacon fat; we'll add a teaspoon to canned beans or a tablespoon or more to taste if we are making the beans from scratch."", ""If you don't have bacon fat, you can cook up a strip of bacon, chop it up fine and add that to the beans."", 'If you are trying to avoid pork, note that most canned refried beans are made with added lard, so check the ingredients. You can use olive oil instead, to help the consistency of the beans.', 'Mix in the chipotle chili powder (or Tabasco, or adobo, or regular chili powder) and cumin to taste. Note that the avocados and the sour cream will cool down the spiciness of the beans considerably, so you can afford to be a bit more spicy than you might think.', 'Stir in salt to taste, depending on how salted your refried beans are to begin with, and depending on how salty the tortilla chips are that you are serving with the dip.', '2 Spread on serving dish, top with cheese: Once the beans are hot and bubbly, spread them over the bottom of a warmed serving dish. Immediately add the shredded cheese so that the heat from the beans helps melt the cheese.', ""(The cheese doesn't need to be completely melted, but even if it is just a little, it will help the dip stay on the chip.)"", '3 Layer on toppings: Layer on the chopped green chilies, chopped avocado, chopped tomato. Spoon on the sour cream (or crema Mexicana, crema fresca, or even cream fraiche).', 'Top with sliced green onions and olives.', 'Serve immediately with tortilla chips.']",11
993,Shrimp Po Boy Sandwich Recipe,20,15,35,"['1 pound medium shrimp, shelled, deveined and with tails removed', '3/4 cup fine cornmeal', '3/4 cup flour', '1 Tbsp Cajun seasoning', '1 teaspoon salt', '2 eggs, beaten', 'Peanut oil for frying', '1/2 head iceberg lettuce, shredded', '2-3 tomatoes, sliced about 1/4 inch thick', '4 small French sandwich rolls', 'Remoulade', '1/4 cup mustard, preferably Creole mustard', '1 1/4 cups mayo', '2 teaspoons prepared horseradish', '1 teaspoon pickle juice or vinegar', '1 teaspoon hot sauce (Crystal, Tabasco, etc)', '1 large garlic clove, minced and smashed', '1 Tbsp sweet paprika', '1-2 teaspoons Cajun seasoning']",19,"[""1 Make the remoulade sauce: If you are making your own remoulade, mix all the ingredients together in a bowl and set aside for 30 minutes or so; you don't have to wait that long, but the sauce will be better over time."", '2 Heat oil in pan: Pour enough peanut oil in a large frying pan to come up about 1/4 inch, and set the pan over medium-high heat until a small amount of flour sizzles immediately when you drop some in.', '3 Dredge shrimp: Mix the cornmeal, flour, Cajun seasoning and salt in a large bowl. Working with a few at a time, dredge the shrimp in the egg, then in the cornmeal-flour mixture.', '4 Fry shrimp: Shake off any excess breading and fry the shrimp until golden on both sides, about 2 minutes total. Set the fried shrimp aside on paper towels to drain.', '5 Assemble sandwiches: To assemble the sandwiches, slice the sandwich loaves almost all the way through and smear remoulade on both the top and bottom.', 'Lay down a layer of shredded lettuce on the bottom of the sandwich, then arrange the shrimp on top.', 'Lay 3-4 slices of tomato on the shrimp and press the top of the bread down on the bottom, compressing the sandwich a little.', 'Serve at once with hot sauce and a beer.']",8
994,How to Make Homemade Tortilla Chips,10,15,25,"['About 3/4 to 1 cup extra virgin olive oil, peanut oil, canola oil, or vegetable oil, more or less depending on how many chips you are making', 'Corn tortillas (get the standard kind, not the super fancy kind), each tortilla will make 6 chips, 12 tortillas will yield 72 chips, a good snack for 2 to 3 people', 'Kosher salt (or other coarse salt)']",3,"['FRIED TORTILLA CHIPS', '1 Dry the tortillas in the oven: The tortilla chips will fry better if they are a bit dried out first. Either leave the whole tortillas out overnight, exposed to air so they are stale the next day, or dry them out a bit in the oven or microwave.', 'To dry them in the oven, lay them out in a single layer on a baking sheet and put them in a 350\\xc2\\xb0F for 5 minutes or a 200\\xc2\\xb0F oven for 10 minutes.', 'Or lay them out in a single layer (working in batches) on a paper towel in a microwave oven and microwave them for 20 to 60 seconds, depending on how strong your microwave is and how many tortillas you are drying.', ""You don't want them crisp at this point, just as dry as they would be if you left them out overnight."", '2 Cut each tortilla into 6 triangle shaped wedges.', '3 Heat the oil in the pan: Pour oil into a medium skillet to a depth of 1/8 to 1/4 of an inch. (Make sure you are working with a completely dry pan or the oil will sputter as it heats.)', 'Heat the oil on medium high heat until a small piece of tortilla placed in the oil sizzles, about 350\\xc2\\xb0F. (This is where an infrared thermometer comes in handy!) If a small tester piece of tortilla browns too quickly, the oil is too hot. Remove the pan from heat to let the oil cool a bit before continuing.', '4 Fry the tortilla chips: Place a paper towel onto a large plate and have several other paper towels ready. Place a handful of tortilla triangles into the hot oil, in a single layer.', ""Use metal tongs or a metal slotted spoon to distribute the tortilla triangles so that they aren't overlapping and so that all sides get coated with oil."", 'Fry for approximately 2 minutes until the chips just begin to color and they are firm, no longer pliable.', '5 Move chips to a paper-towel-lined plate: Use tongs or a slotted spoon remove the chips from the oil to the paper-towel-lined plate.', 'Sprinkle with salt.', 'Place another paper towel over the top of the chips to be ready for the next batch.', ""Note that as soon as you put the tortilla triangles into the hot oil, because you are working with such a small volume of oil, the oil temperature will lower. Usually I compensate for this by increasing the heat to high. And as soon as the chips begin to color, I reduce the heat to low, so the oil doesn't overheat in between batches of chips."", 'Continue to cook the chips, working in batches, placing the freshly fried chips over a new layer of paper towel each time, and sprinkling with salt.', 'When the chips are all fried, pat any excess oil from them with a fresh paper towel, and eat! These chips are best freshly made.', '  BAKED TORTILLA CHIPS', '1 Pre-heat oven to 350\\xc2\\xb0F. Cut the tortillas into wedges.', '2 Spread the tortilla wedges out on a baking sheet in a single layer.', '3 Bake: Bake the tortilla wedges for about 6 minutes, then use tongs to turn the wedges over.', 'Sprinkle with a little salt, and bake for another 6 to 9 minutes, until they are just beginning to color.  Remove from the oven and let cool. Sprinkle with more salt to serve.', '  MICROWAVED TORTILLA CHIPS', '1 Cut the tortillas into wedges.', '2 Line your microwave oven with a paper towel.', '3 Microwave the chips: Working in batches if necessary, spread the tortilla wedges over the paper towel in a single layer, with an inch or so between the wedges.  Microwave until the tortilla chips are crispy, but not burnt.', ""The time will vary depending on the strength of your microwave and how many tortillas you are cooking. In our microwave, it's about a little less than 1 minute per tortilla. But I would start at half of that and add time as needed."", 'Sprinkle with salt to serve.  Great with guacamole.']",28
995,Easy Duck Confit Recipe,20,0,20,"['Duck legs (at least one per person)', 'Salt']",2,"['1 Pat the duck legs dry with paper towels.', '2 Prick the skin of the duck all over: Find a needle or a very pointy knife and prick the skin of the duck all over. Focus on the skin that covers fat. Do your best to avoid piercing the meat itself by pricking the skin at an angle over the drumstick and the center of the thigh.', 'You are doing this to give the fat that lies under the skin a place to seep out. If you don\\xe2\\x80\\x99t do this, it will be far more difficult to get crispy skin.', '3 Salt the duck legs and let rest at room temp: Salt your duck legs well, more than you think you ought to, actually. Let them rest at room temperature for at least 20 minutes and up to an hour. Don\\xe2\\x80\\x99t worry, they\\xe2\\x80\\x99ll be fine.', '4 Put the duck legs in a small casserole, skin side up. How small? You want it just big enough to hold the legs. Put a thin sheen of oil or melted duck fat on the bottom of the casserole, then place the duck legs in close together but not overlapping.', '5 Slowly heat the duck in the oven: Put the casserole in the oven and heat it to 300\\xc2\\xb0F (150\\xc2\\xb0C); if you have a digital oven, you could even go down to 285\\xc2\\xb0F (140\\xc2\\xb0C). Do not preheat the oven. You want to cook the duck as gently as possible.', 'Walk away and watch football, go shopping, read a book or something. How long? Every duck has a different level of fat, so I can\\xe2\\x80\\x99t tell you exactly. But it will be at least 90 minutes, and two hours is better. After 90 minutes, check the duck: It should be partly submerged in melted fat and the skin should be getting crispy.', '6 Turn up the oven heat to brown the skin: When the skin is starting to look crispy, turn up the heat to 375\\xc2\\xb0F (190\\xc2\\xb0C). Check after 15 minutes. You\\xe2\\x80\\x99re looking for a light golden brown. If you missed some spots with the needle and there are places where the skin won\\xe2\\x80\\x99t crisp that\\xe2\\x80\\x99s OK\\xe2\\x80\\x94better that than burnt skin elsewhere.', '7 Let cool and strain the fat: Remove from the oven and let cool for 10-15 minutes before eating. Save the accumulated fat for cooking vegetables, other meats or for keeping your skin shiny. I strain the fat through cheesecloth, but you really only need to do this if you are saving the fat for several weeks or months; strained, it will keep for 6 months tightly covered in the fridge. Well wrapped, the duck meat itself will last up to 2 weeks in the fridge.', 'What to do with your lovely duck legs? Why eat them. You can just gnaw on the legs and let the luscious fat dribble down your chin, or pick off the skin and eat it\\xe2\\x80\\x94it is hard to re-crisp it later\\xe2\\x80\\x94and then strip the meat from the bones and use it in a salad, with beans or rice, or in with pasta.']",10
996,Easy Chicken Lo Mein Recipe,15,20,35,"['DAD ADD: Sriracha Roasted Veggies', '8 ounces cremini mushrooms, quartered', '1/2 red pepper, sliced', '1 tablespoon sesame oil', '1 to 2 teaspoons sriracha hot sauce', 'For the sauce:', '3 tablespoons soy sauce', '1 tablespoon hoisin sauce', '2 teaspoons sesame oil', '2 tablespoons hot water', 'For the lo mein:', '8 ounces lo mein noodles, fresh or dried', '1 teaspoon sesame oil', '1 tablespoon vegetable oil', '1 pound boneless chicken breast, sliced thin', '1/2 head green cabbage, shredded (about 3 cups)', '1 large carrot, grated', 'For the garnish:', 'Fresh scallions, chopped', 'Sesame seeds', 'Special equipment:', 'Wok or large skillet']",22,"['1 If making the Sriracha Roasted Vegetables: Heat the oven to 400\\xc2\\xb0F. In a small bowl, toss quartered mushrooms and red peppers with the sesame oil and sriracha. Spread out on a baking sheet.', 'While you make the Chicken Lo Mein, bake for 15 minutes until tender and blistered in spots.', '2 Stir the sauce ingredients together and set near the stove.', '3 Cook the lo mein noodles: Bring a large amount of salted water to a boil. Add the noodles and cook until tender, usually around 4 minutes, but check the package directions for the noodles you are using.', 'Drain the noodles and toss with sesame oil to prevent sticking.', ""4 Cook the chicken: Heat a wok or large skillet over medium-high heat. Once hot, add the vegetable oil once that's hot, add the chicken. Cook until the chicken is just barely cooked through, 5 to 6 minutes, stirring frequently. (The chicken will continue to cook with the vegetables, so it's ok if it seems a little undercooked right now.)"", '5 Add the vegetables: When chicken is cooked, add cabbage and carrots, and continue to stir and cook until the veggies wilt and the liquid they release is mostly evaporated, 2 to 3 minutes.', '6 Add the noodles and sauce: Add noodles along with sauce and stir with the chicken and veggies to combine. The sauce should coat the noodles and other ingredients. If the dish seems too dry, add more water.', 'Taste and adjust the flavor to your liking. It might need another dash of soy sauce, for example.', '7 Serve: Serve the Chicken Lo Mein topped with scallions, sesame seeds, and roasted veggies (optional).', 'Leftovers can be stored in the fridge for 3 to 4 days and will reheat beautifully in the microwave.']",11
997,Moo Goo Gai Pan (Chinese Chicken and Mushroom Stir Fry) Recipe,20,15,35,"['For the chicken:', '1 1/2 pounds boneless, skinless chicken breast', '1 large egg', '1 tablespoon cornstarch', 'For the stir fry sauce:', '1 1/2 cups chicken stock', '3 tablespoons soy sauce', '2 tablespoons corn starch', '1 tablespoon hoisin sauce', '1 tablespoon oyster sauce', '1/2 teaspoon Chinese five spice powder', 'Pinch of ground white pepper', 'For the vegetables:', '1 tablespoon vegetable oil', '3 carrots, peeled and sliced thinly on a diagonal', '3/4  cup (3 ounces) snow peas', '2 teaspoons grated fresh garlic', '1 teaspoons grated fresh ginger', '2 cups (5 ounces) shiitake (or white button) mushrooms, sliced', '1/3 cup (4 ounces) canned water chestnuts, drained', '1/3 cup (4 ounces) canned bamboo shoots, drained', 'Kosher salt, to taste', 'To serve:', '6 cups cooked jasmine rice', 'Special equipment:', 'Wok, or large skillet']",26,"['1 Prep the chicken: Using a sharp knife, slice each chicken breast in half lengthwise from the thin tip to the wider end, creating into two long strips. Thinly slice each strip against the grain into bite-sized pieces.', ""The goal here is to create bite-sized pieces of chicken that are all about the same size and shape. However you end up with that, you're good to go!"", '2 Mix the cornstarch and soak the chicken: In a large mixing bowl, whisk together the egg and 1 tablespoon of the cornstarch until smooth. Toss the sliced chicken breast in the egg mixture to coat thoroughly. Allow the chicken to soak in the mixture while you prepare your sauce.', '3 Make the stir fry sauce: In a separate bowl, combine the chicken stock, 2 tablespoons cornstarch, soy, hoisin, and oyster sauces, the five spice powder, and white pepper. Whisk the mixture together and set aside.', '4 Preheat the wok and arrange your ingredients: Begin preheating your wok, or a large, deep skillet, over high heat and turn on your stovetop\\xe2\\x80\\x99s ventilation fan. Drain the chicken of any excess egg mixture and return the chicken to its bowl.', 'Arrange your ingredients next to the stove in the following order: vegetable oil, chicken, carrots and snow peas, garlic and ginger, mushrooms, water chestnuts and bamboo shoots, and mixed sauce. This will help things go quickly once you\\xe2\\x80\\x99ve begun cooking.', '5 Cook the chicken: When the wok has heated (a flick of water should evaporate on contact), carefully add the vegetable oil, quickly followed by the chicken. Stir fry the chicken for 4 minutes, tossing occasionally with a wooden spoon.', '6 Stir fry the veggies: Add the carrots and snow peas and cook for an additional 4 minutes, stirring often. Make a well in the center of the pan and add the garlic and ginger. Cook in the center of the pan until fragrant, for about 1 minute, and then mix them in with the rest of the ingredients.', 'Add the mushrooms, chestnuts, and bamboo shoots. Cook, stirring occasionally, for 3 minutes.', '7 Add the sauce: Make another well in the center of the pan and add the sauce. Cook for 2 minutes, or until the sauce starts to bubble and thicken slightly.', 'Fold the stir fry ingredients into the sauce to coat completely. Bring the sauce up to a simmer, and then reduce the heat to low. Cook for a minute longer.', '8 Serve: Remove from heat and immediately serve spooned over the jasmine rice with extra hoisin sauce on the side.', 'Leftovers are best stored apart from the rice in an airtight container in the fridge for two days. Reheat in the microwave or in a skillet on the stovetop.']",13
998,How to Make Pad Thai Recipe,0,1450,1450,"['For the pad Thai:', '1 (14-ounce) package of flat, wide rice noodles', '6 to 8 tablespoons fish sauce', '3/4 cup rice vinegar', '1 to 2 teaspoons tamarind paste (also sometimes called concentrate)', '1 cup granulated sugar', 'Pinch of paprika (or cayenne powder)', '10 to 12 tablespoons canola or vegetable oil, divided', '4 large eggs', '1 pound shrimp, peeled, deveined, and defrosted', '1/3 cup roasted unsalted peanuts, chopped roughly', '1 cup bean sprouts', 'For garnish (optional):', '1 lime, cut into quarters', '2 tablespoons roasted unsalted peanuts, chopped roughly', 'Chopped cilantro, for garnish', 'Red pepper flakes, for garnish']",17,"['1 Soak the rice noodles: In a large container, preferably one with a lid, soak the noodles in cold water, enough to cover so that no noodle is poking out. Soak for at least 2 hours, or up to 12 hours. (You can soak for longer, but the noodles have a tendency to break apart more easily during cooking.) It can be refrigerated, or not\\xe2\\x80\\x94it doesn\\xe2\\x80\\x99t matter.', '2 Make the sauce: In a shallow bowl, whisk together the fish sauce, vinegar, tamarind concentrate, and sugar until smooth. Taste. Adjust the sauce as needed. Add a pinch of paprika or cayenne powder for color.', '3 Bring a large pot of water to boil.', '4 Divide all of your ingredients into two batches. Arrange them near your stove. You\\xe2\\x80\\x99ll prepare each batch completely, one after the next.', 'WORKING ONE BATCH AT A TIME:', '5 Cook the eggs: Heat a wok or other large pan with high sides over high heat, which you will maintain throughout cooking the pad Thai. Add 2 to 3 tablespoons of oil. When the oil starts to shimmer a bit, it\\xe2\\x80\\x99s ready.', 'Crack the eggs for this batch into the pan and, using the tip of a wooden spoon, gently loosen and break the yolk. You want to have enough oil in the pan so it looks as though the egg is floating, or suspended, in the oil. This gives you more surface area to cook the egg without it burning or turning it into scrambled eggs.', 'Gently shake and flip the egg around in the pan. Break it up a bit with the spoon, but don\\xe2\\x80\\x99t scramble it by any means. This should take about a minute.', '6 Cook the shrimp: Add 1 to 2 more tablespoons of oil to the pan if the pan seems too dry, and add the shrimp for this batch. Toss them gently in the pan and move them around with the wooden spoon to get some color on them, about a minute.', '7 Soften the noodles: Take several handfuls of your noodles (about half the total amount) out of the water they\\xe2\\x80\\x99re soaking in, and transfer to a fine mesh sieve. Hold the sieve over the pot of hot water and gently dip the noodles up and down, in and out of the water, to soften them but not cook per se. (Using the sieve saves you from having to cook it and then strain it, enables you to use the pot of water more than once, and it makes the whole process move more quickly.)', 'Shake out the excess hot water and taste to make sure the noodles have softened but still have a little give to them.', '8 Add the noodles to the pan: Transfer the noodles to the hot pan with the shrimp. Keep the noodles long; don\\xe2\\x80\\x99t chop them up in the pan (long noodles mean long life, Chef Peter says). Taste to make sure they have softened; the noodles don\\xe2\\x80\\x99t need to be completely cooked at this point because they will continue to cook in the wok.', 'Toss them gently in the pan and stir them briefly to keep them from sticking together. When the noodles look shiny, it\\xe2\\x80\\x99s time for the sauce.', '9 Add the sauce: Quickly whisk the sauce if the sugar seems to have settled, and add about 1/4 cup to the pan. Gently toss and flip the noodles in the pan.', ""Again, stir them quickly to integrate the sauce; when you can\\xe2\\x80\\x99t see any more sauce in the pan, you'll know it's ready and that the noodles have absorbed the sauce."", '10 Add the peanuts and bean sprouts: Add the peanuts and the sprouts, and toss all ingredients together quickly. Cook for 2 to 3 minutes until everything is heated through. The noodles will soften and look more translucent.', '11 Taste and serve: Turn the heat off the pan and taste to make sure there is enough sauce to flavor the dish. Serve immediately in individual bowls with wedges of lime, additional peanuts, chopped cilantro, and/or chili flakes, if desired.', '12 Repeat steps 5 through 11 for making the second batch of pad Thai.']",18
999,Indian Style Rice Recipe,5,55,60,"['2 cups long-grain basmati rice', '8 cups water', '2 teaspoons salt', '2 cloves', '2 cardamom pods (green)', 'One 2-inch piece of cinnamon', '3 Tbsp vegetable oil (or ghee if you have it)', '1/2 teaspoon dark mustard seeds', '1/2 teaspoon cumin seeds', '1/4 teaspoon chili flakes', '1 medium onion, chopped', '3 chopped garlic cloves', '1/4 teaspoon turmeric']",13,"['1 Rinse and soak rice: Place rice in a sieve and run cool water through it to rinse it until the water runs clear. Soak the rice in cool water for 30 minutes. Drain.', '2 Boil rice with cloves, cardamom, cinnamon: Bring 8 cups of water and the salt to a boil in a large pot. Add the rice and stir. Add the cloves, cardamom and cinnamon and simmer for 8 to 10 minutes.', 'Note that not all of the water will be absorbed!', 'After 8 minutes, taste the rice, and test if it is done to your taste; rice can take more or less time to cook depending on how old it is. If still too firm, cook a few minutes longer.', '3 Drain rice and rinse with cold water, remove spices: When the rice is cooked to your liking, drain the rice into a colander and rinse with cold water to stop if from cooking.', 'Remove the cloves, cardamom and cinnamon and discard. Set the rice aside to drain.', '4 Saut\\xc3\\xa9 mustard seeds, cumin, chili flakes, then onion: In a pan large enough to hold the rice, heat the oil over medium heat. Add the mustard and cumin seeds and the chili flakes.', 'Cook until the mustard seeds start popping, then add the chopped onion. Cook until the onions begin to brown, about 5-7 minutes.', '5 Add garlic, then rice and turmeric: Add the garlic and cook another 2-3 minutes. Add the rice and mix well. Sprinkle the turmeric over the rice and mix well. Cook for another 3-4 minutes, stirring often.']",9
1000,Chicken Tortilla Soup Recipe,10,20,30,"['6 (6-inch) corn tortillas, preferably a little old and dried out', '1/4 cup corn oil, peanut oil, or extra virgin olive oil', '1/2 cup chopped onion', '2 cloves garlic, minced', '1 medium Anaheim, poblano or jalape\\xc3\\xb1o chile, seeded, veins removed, chopped (Depending on the hotness and flavor desired. You can also mix chiles - 1 Anaheim and a half jalape\\xc3\\xb1o.)', '4 cups chicken broth or homemade chicken stock', '1 can (14.5 oz) crushed tomatoes (preferably fire-roasted)', '1/2 teaspoon coarse salt (kosher or sea salt)', '1 1/2 cups shredded cooked chicken', '1 ripe avocado', '1/2 cup (2 oz) shredded Monterey Jack cheese (or mild cheddar)', 'Chopped fresh cilantro', '1 lime, cut into wedges']",13,"[""1 Fry tortilla strips: If you are starting with somewhat old, dried out tortillas, great. If not and you are starting with relatively fresh tortillas, put them on a baking sheet and put them in the oven at 200\\xc2\\xb0F for 10 to 15 minutes to dry them out a bit. It is best to start with tortillas that don't have a lot of moisture in them."", 'Cut the tortillas in half, and then cut the halves into 1/4-inch wide strips.', 'Heat the oil over medium-high heat in a 3-quart pot. Working in three batches, fry the tortilla strips in the oil, until lightly browned and crisp. Remove the tortilla strips from the pan and let drain on a paper-towel-lined plate.', '2 Saut\\xc3\\xa9 onions, chile, garlic: Add the chopped onions to the pan, cook 2 minutes, stirring frequently. Add the chopped chile and cook for 2-3 minutes more, until the onions and chiles have softened. Add the garlic and cook for 30 seconds more.', '3 Add broth, tomatoes, salt, chicken: Add the broth, tomatoes, and salt. Increase the heat to high, heat until the soup begins to boil, then reduce the heat to a low simmer, cover and simmer for 15 minutes. Add the shredded chicken and cook until heated through.', '4 Serve with tortilla strips and garnishes: To serve, pit, peel, and cut the avocado into 1-inch pieces. Divide half of the tortilla strips among 4 individual serving bowls; ladle in soup. Top with avocado and cheese; garnish with remaining tortilla strips and cilantro. Serve with lime wedges.']",6
1001,Red Chili Chicken Enchiladas Recipe,15,35,50,"['For the enchiladas:', 'Extra virgin olive oil, corn oil, or peanut oil', '12 corn tortillas (thick and sturdy)', '2 14-ounce cans red chile enchilada sauce, or 3 cups homemade enchilada sauce', '2 cups cooked chicken, shredded or chopped', '2 cups grated cheese (about 1/3 pound)', 'For the homemade enchilada sauce (if using):', '1 tablespoon extra virgin olive oil', '5 tablespoons chili powder', '1/2 teaspoon of cayenne', '1/2 cup tomato paste', '3 cups water', '1 teaspoon garlic powder', '1 teaspoon onion powder', '1/2 teaspoon ground cumin', '1/2 teaspoon ground oregano', '1 teaspoon salt', '1 tablespoon of cornstarch mixed in with 3 tablespoons of water to form a slurry', 'Garnishes:', '1 medium red onion, chopped, soaked in a mixture of half seasoned rice vinegar and half water', 'Chopped fresh cilantro', 'Thinly sliced iceberg lettuce seasoned with salt and vinegar, no oil', 'Sour cream', 'Sliced avocados or guacamole']",24,"['Heat a tablespoon of oil in a small saucepan to coat the pan. Place a tortilla in the skillet and heat for a few seconds, until the tortilla begin to show some air bubbles.', 'Use a metal spatula to flip to the other side for a few more seconds. Then add another tortilla on top of the first to soak up some of the excess oil. Flip them both together and add yet another tortilla.', 'Keep adding them wherever there seems to be some excess oil. The idea is to heat the tortillas and soften them with the minimum amount of oil.', 'As the tortillas become soft and heated, remove them to a paper towel to soak up even more excess oil. When you find you need more oil in the pan, add it.', '4 Assemble the enchiladas: Preheat the oven to 350\\xc2\\xb0F. One by one, dip a tortilla in the enchilada sauce and place in a 9x13 Pyrex baking dish.', 'Place 2 to 3 tablespoons of chopped chicken in each tortilla. Sprinkle with a little cheese.', 'Roll up the tortilla. Place in the baking dish and repeat until all dozen of your tortillas are neatly placed in rows in the casserole dish.', 'Cover the tortillas rolls with the remaining sauce. Sprinkle with the remaining grated cheese.', ""I recall often eating these chicken enchiladas with very little cheese on them. (My mom, bless her soul, has no recollection of the chicken enchiladas without the sprinkled cheese. But she's in her 80s and sometimes doesn't remember these things. Or she remembers later and doesn't remember that she ever forgot them in the first place. But heck, I'm in my 50s and my memory isn't what it used to be either.)"", '5 Bake: Place in the oven and bake at 350\\xc2\\xb0F for 10 minutes, or until cheese is bubbly.', 'Use a metal spatula to serve.', 'Serve with thinly sliced iceberg lettuce that has been seasoned with vinegar and salt (no oil), chopped red onions that have soaked for at least half an hour in vinegar and water, guacamole or avocado slices, and sour cream. Garnish with cilantro.']",12
1002,Croque Monsieur Ham and Cheese Sandwich Recipe,5,20,25,"['2 Tbsp butter', '2 Tbsp flour', '1 1/2 cups milk', 'A pinch each of salt, freshly ground pepper, nutmeg, or more to taste', '6 ounces Gruy\\xc3\\xa8re cheese, grated (about 1 1/2 cups grated)', '1/4 cup grated Parmesan cheese (packed)', '8 slices of French or Italian loaf bread', '12 ounces ham, sliced', 'Dijon mustard']",9,"['1 Preheat oven to 400\\xc2\\xb0F.', '2 Make the b\\xc3\\xa9chamel sauce: Melt butter in a small saucepan on medium/low heat until it just starts to bubble. Add the flour and cook, stirring until smooth, about 2 minutes.', 'Slowly add the milk, whisking continuously, cooking until thick. Remove from heat. Add the salt, pepper, and nutmeg.', 'Stir in the Parmesan and 1/4 cup of the grated Gruy\\xc3\\xa8re. Set aside.', '3 Toast bread slices in oven: Lay out the bread slices on a baking sheet and toast them in the 400\\xc2\\xb0F oven, a few minutes each side, until lightly toasted. For extra flavor you can spread some butter on the bread slices before you toast them if you want.', '(Alternatively, you can assemble the sandwiches as follows in step four and grill them on a skillet, finishing them in the broiler with the bechamel sauce.)', '4 Build the sandwiches: Lightly brush half of the toasted slices with mustard. Add the ham slices and about 1 cup of the remaining Gruy\\xc3\\xa8re cheese. Top with the other toasted bread slices.', '5 Add bechamel, more Gruyere: Spoon on the b\\xc3\\xa9chamel sauce to the tops of the sandwiches. Sprinkle with the remaining Gruy\\xc3\\xa8re cheese.', '6 Broil till bubbly: Place on a broiling pan. Bake in the oven for 5 minutes, then turn on the broiler and broil for an additional 3 to 5 minutes, until the cheese topping is bubbly and lightly browned.', 'If you top this sandwich with a fried egg it becomes a Croque Madame.']",10
1003,Chicken Fried Rice Recipe,10,15,25,"['3/4 pound boneless skinless chicken thighs', '1 teaspoon salt, divided', '3 tablespoons canola oil (or any high heat oil), divided', '3 large eggs, whisked', '2/3 cup yellow onions, diced', '2 cloves garlic, minced', '2 teaspoons minced ginger', '1 large carrot, peeled and diced', '2/3 cup frozen peas, rinsed under warm tap water for a few seconds thaw', '4 cups cooked jasmine rice (preferably leftover from at least a day before, see Recipe Note)', '2 scallions, sliced (separate the white and light green parts from the dark green part)', '1/2 teaspoon Chinese five-spice powder (optional)', '2 1/2 tablespoons soy sauce or tamari', '1 teaspoon sesame oil', 'Special equipment:', 'Wok, or large skillet']",16,"['1 Prepare the chicken: Chop the chicken into small 1/4-inch to 1/2-inch cubes. Sprinkle 1/2 teaspoon of salt over the chicken and mix to combine. Set the chicken aside for about 10 minutes (I usually use this time to chop all the vegetables).', '2 Scramble the egg: Heat a wok or large saut\\xc3\\xa9 pan over medium-high heat. Swirl in a tablespoon of oil and add the whisked eggs. Use a spatula to quickly scramble the eggs, breaking the curds into smaller pieces as they come together. Transfer the eggs to a plate.', '3 Cook the chicken: Add another tablespoon of oil in the wok or pan. Add the chicken and cook for 4 to 5 minutes, stirring occasionally. Turn off the heat and transfer the cooked chicken to a plate.', ""Using your spatula, scrape off any chicken bits that are still stuck to the wok so they don't burn during the next step. You can also use paper towels to wipe down your wok or pan."", '4 Cook the vegetables: Swirl 1 tablespoon of oil into the wok over medium-high heat. Add the diced onions and cook them for 1 minute, until they start to soften. Mix in the minced garlic and ginger and cook until fragrant, about 30 seconds. Add the diced carrots and cook for 2 minutes, stirring frequently. Add 1/2 teaspoon salt and the peas, and stir to incorporate.', '5 Cook the rice: Add the rice to the wok or pan on top of the vegetables and stir to combine. Using the back of your spatula, smash any large chunks of rice to break them apart. Add the white and green parts of the sliced scallions (save the dark green parts) and five-spice powder. Stir to incorporate. If the rice starts to stick to the pan, stir in a little more oil.', 'Drizzle the soy sauce and sesame oil over the rice and stir to incorporate. Stir in the cooked chicken, scrambled eggs, and the dark parts of the scallions. Stir briefly to bring it together, and cook for another 1 to 2 minutes. Taste, and add more soy sauce if necessary.', '6 Serve immediately while hot.']",8
1004,How to Make Cr\xc3\xa8me Br\xc3\xbbl\xc3\xa9e,30,280,310,"['For the custard:', '2 cups heavy cream', '10 tablespoons sugar, divided', '1 vanilla bean (or 1 teaspoon vanilla extract)', '4 large egg yolks', '1/2 teaspoon vanilla extract', '1/4 teaspoon kosher salt', 'For the Br\\xc3\\xbbl\\xc3\\xa9e topping:', '4 tablespoons sugar (2 teaspoons per ramekin)', 'Special equipment:', '9x13 baking pan', '6 4-ounce ramekins', 'Fine mesh strainer', 'Whisk', 'Two mixing bowls', 'Cr\\xc3\\xa8me br\\xc3\\xbbl\\xc3\\xa9e torch']",16,"['1 Preheat oven to 325\\xc2\\xb0F with a rack in the middle position. Arrange six 4-ounce ramekins in a 9x13 baking dish and set aside.', '2 Prepare the vanilla bean: Split the vanilla bean in half and scrape out the seeds with the dull (non-cutting) side of a paring knife.', '3 Warm the cream: In a medium saucepan, combine heavy cream, 4 tablespoons of the sugar, vanilla bean pod, vanilla bean seeds, and salt. Cook over medium heat, until it begins to simmer.', '4 Infuse the cream: Once the cream begins to simmer, remove the pan from heat, cover, and let stand for 15 minutes to allow the vanilla bean to infuse into the cream. (If you\\xe2\\x80\\x99re replacing the vanilla bean with vanilla extract, skip this step.)', '5 Separate the eggs and whisk with sugar: When your cream is almost done infusing, separate your eggs. Place the yolks in a medium-sized mixing bowl; save the whites for another purpose.', ""Whisk the remaining 6 tablespoons of sugar into the yolks. (Don\\'t combine the eggs and sugar too soon before you mix it with the warm cream because the sugar binds with the water in egg yolks, which constricts the proteins in yolks and creates eggy lumps. And you don\\'t want eggy lumps in your custard!)"", '6 Temper the yolks and mix with the cream: While whisking the yolks continuously, slowly add one ladle (about 1/4 or 1/3 cup) of hot cream in a thin stream. Do this two or three more times.', 'While whisking, slowly add the remaining cream to the egg mixture, followed by the vanilla extract.', 'Strain the mixture through a fine mesh sieve into a second mixing bowl and discard the vanilla bean pod (this also helps strain out any small bits of egg that may have curdled).', 'At this point, the custard can be cooled and stored for up to 5 days. If you choose to bake them right from the fridge, you will probably need to add a couple of extra minutes.', '7 Fill the ramekins: Divide the custard between the ramekins, filling each one just up to the inner rim, or about three-quarters of the way full.', '8 Fill the hot water bath: Bring a kettle or pot of water to a boil. Fill the pan with the hot water until the water comes about two-thirds of the way up the side of the ramekins. Avoid splashing water into the custards.', '9 Bake the custards: Transfer the pan with the custards to the oven and bake for 38 to 40 minutes. When ready, the cr\\xc3\\xa8me br\\xc3\\xbbl\\xc3\\xa9e should have a uniform jiggle in the middle; when you touch the center, it should spring back just a bit. If the sides hold firm but the center sloshes, they aren\\xe2\\x80\\x99t quite done yet.', 'If they are set like Jell-O, they\\xe2\\x80\\x99ve overbaked, although they will still be delicious! Chill them, br\\xc3\\xbbl\\xc3\\xa9e them, eat them, love them and celebrate your efforts. If they have overbaked to the point that they look risen in the center, toss them, start again, and celebrate your efforts!', '10 Cool and chill the custards: Remove the baking dish with the finished custards from the oven and set on a wire cooling rack. Let the custards cool in the water until you can safely pick up the ramekins by the rim with your fingers. This should take about 15 minutes, depending on how tender your fingers are. (Mine are like asbestos, so I tend to go in rather quickly.)', 'Once removed from the water bath, let each custard rest on the cooling rack for about 15 more minutes. Use a spoon to skim any bubbles off the top, then cover each ramekin with plastic wrap and store in the fridge. Chill for at least 4 hours, or up to 4 days, before serving.', '11 Br\\xc3\\xbbl\\xc3\\xa9e the custards: When ready to serve, remove the custards from fridge. Sprinkle the surface of each custard evenly with about 1 teaspoon of granulated sugar. Rotate the custard as you sprinkle to make sure the sugar evenly coats the surface.', 'Ignite your torch. Hold the flame about 4 inches from the surface of the sugar. Using a circular motion, move the flame across the surface. The sugar will at first begin to bead up, and then will eventually solidify into a hard sugar crust.', 'You want to make sure all the sugar granules have melted, and the sugar has at least a tint of caramel color. The longer you torch the surface, the darker it will become and the more bitter the sugar crust will be.', 'Each of the custards with an additional teaspoon of sugar and br\\xc3\\xbbl\\xc3\\xa9e the surface again.', '12 Serve the cr\\xc3\\xa8me br\\xc3\\xbbl\\xc3\\xa9e: Cool for at 2 minutes, and serve within 20 minutes.', 'After about 20 minutes, the sugar will begin to soften, but if it takes you longer to get them to the table, don\\xe2\\x80\\x99t fret. You\\\'ll get less of a hard ""crack!"" when breaking up the surface of the cr\\xc3\\xa8me br\\xc3\\xbbl\\xc3\\xa9e, but it will still be good.', 'To eat, use the edge of your spoon to gently crack the hard sugar surface and scoop up some custard. Be sure to get both the brittle topping and the creamy custard in each bite.']",23
1005,Pasta Puttanesca Recipe,10,30,40,"['2 tablespoons extra virgin olive oil', '1/2 cup finely chopped onion', '3 cloves garlic, finely chopped', '3-4 canned anchovies, chopped', '2 tablespoons tomato paste', '1/2 teaspoon red pepper flakes', '1 (28-ounce) can crushed tomatoes', '2 teaspoons dried oregano', '2 tablespoons small (non-pariel) capers', '3/4 cup (95 g) pitted olives (black or green), roughly chopped', '1 pound spaghetti, linguine, or fettuccine', 'Salt', 'Extra virgin olive oil for drizzling', '1/4 cup chopped fresh parsley']",14,"['1 Heat pasta water: Bring a large pot of salted water to a boil (1 Tbsp of salt for every 2 quarts of water). While the water is heating, start making the sauce.', ""2 Cook onions, anchovies, garlic: Heat the olive oil over medium heat in a large, deep saut\\xc3\\xa9 pan. When the oil is hot, cook the onions until they're soft and translucent, about 4-5 minutes."", 'While the onions are cooking, stir in the chopped anchovies along with some of the oil from the can.', 'Add the finely chopped garlic and cook another minute.', '3 Make the sauce: Mix in the tomato paste and cook it for 2 minutes, stirring occasionally.Add the crushed tomatoes, oregano, chili pepper flakes, olives, and capers. Bring the sauce to a simmer, then lower the heat to low to maintain a gentle simmer, 10 to 15 minutes.', '4 Cook the spaghetti: When the salted pasta water is at a rolling boil, add the pasta. Cook the pasta according to the package instructions, to al dente, cooked but still slightly firm.', '5 Finish the sauce: Stir the parsley into the pasta sauce. Add some pasta water into the sauce to thin it if it has become too thick.', ""6 Serve: Drain the pasta and put in a large bowl. If you want, mix a little olive oil into the pasta so the pasta doesn't stick together."", ""Add a ladle's worth of sauce to the pasta and mix to combine. Serve in shallow bowls with more sauce on top.""]",9
1006,Baked Vegetable and Cream Cheese Wontons Recipe,45,30,75,"['For the wontons:', '4 1/2 tablespoons vegetable oil, divided', '2 cloves garlic, minced', '1 tablespoon minced ginger (from a 1-inch piece of ginger)', '5 cups thinly sliced Napa cabbage (green cabbage is also ok)', '1 large carrot, grated (about 1 1/3 cups grated)', '3/4 cup frozen peas, thawed', '2 scallions, thinly sliced', '3/4 teaspoon salt', '1/2 teaspoon toasted sesame oil', '1 large egg', '48 to 50 square wonton wrappers', '4 1/2 to 5 ounces cream cheese', 'For the dipping sauce (optional):', '3 tablespoons soy sauce', '4 tablespoons rice vinegar', '3/4 teaspoon toasted sesame oil']",17,"['1 Prepare the filling: Heat 1 1/2 tablespoons of the vegetable oil in a wok or large skillet over medium-high heat. When the pan is hot, add the garlic and ginger and cook until fragrant, 30 to 60 seconds.', 'Add the cabbage and cook, stirring frequently to prevent burning, until it starts to wilt, about 2 to 3 minutes. Add the grated carrot, peas, scallions, salt and sesame oil and cook for another minute.', 'Turn off the heat and dish the vegetables onto a plate to cool for 10 minutes.', ""2 Preheat oven to 400\\xc2\\xbaF. Position an oven rack in the center position. Brush 2 large baking sheets with oil (1 tablespoon per pan), spray with cooking spray, or line with parchment. (Wontons baked on parchment won't get quite as crispy on the bottoms.)"", 'Lightly beat an egg for the egg wash and set aside.', '3 Fold the wontons: Lay 4 wonton wrappers on a work surface. Place about a tablespoon of vegetable filling in the center of each wrapper. Place about 1/2 teaspoon of cream cheese on top of the vegetables.', 'Using your fingers, brush the egg wash along the edges of the wonton wrappers. Lift 2 opposite corners of the wrapper and pinch them together at the top. Lift the other two corners towards the top and pinch them against the first two corners to form a pyramid. Pinch edges of the wrapper together to seal the wonton closed.', 'Repeat with the other three wontons. Transfer the sealed wontons onto one of the sheet pans and cover loosely with plastic wrap to keep them from drying out.', 'Repeat filling and folding the wontons until you have filled a baking sheet with 24 to 25 sealed wontons. Remove the plastic wrap and brush a thin layer of oil on all of the wontons or spray with cooking spray.', '4 Bake for 11 to 12 minutes, or until the edges of the wontons are a deep golden brown color.', '5 While the first batch of wontons is baking, prepare a second batch of wontons using the remaining filling. Once the first batch is done baking, bake the second batch.', '6 To serve: Let the wontons cool for a few minutes before serving. Whisk together the ingredients for the dipping sauce and serve with the warm wontons. These baked wontons are best consumed in the same day.']",12
1007,Spaghetti and Meatballs Recipe,20,40,60,"['For the sauce:', '2 tablespoons extra virgin olive oil', '1/2 chopped sweet yellow onion', '3 cloves chopped garlic', '1 cup very finely chopped carrots', '1 cup chopped cremini brown mushrooms', '2 (28-ounce) cans Italian plum tomatoes (San Marzano, if possible)', '1/4 cup chopped fresh Italian parsley', '1/4 cup chopped fresh basil', '3 tablespoons tomato paste', '1/4 cup grated Parmesan-Romano cheese blend', 'Salt to taste (about 1 teaspoon)', '1/4 cup red wine', 'For the meatballs:', '1 pound ground beef (at least 16% fat)', '1/2 pound fresh bulk Italian style pork sausage', '2 tablespoons finely chopped basil', '2 tablespoons finely chopped Italian parsley', '1/2 cup finely chopped cremini brown mushrooms', '2 large eggs', '3/4 cup unseasoned breadcrumbs', '1/4 cup grated Parmesan-Romano cheese blend', '2 teaspoons sea salt', '2 teaspoons fresh ground black pepper', '1 tablespoon extra virgin olive oil', 'Red wine', 'For the pasta:', '1 1/2 pounds dry 100% semolina spaghetti, thin spaghetti, or bucatini']",28,"['1 Prepare the sauce: Heat olive oil in 4 to 5 quart pot on medium-high heat. Add onions and cook for 2 minutes. Add garlic and cook for 30 seconds longer or until fragrant.', 'Add the carrots and mushrooms, and cook for 2 minutes. Add the tomato paste concentrate, stir to blend, and cook for a minute longer.', 'Add the canned tomatoes, basil, and parsley. Mash and stir the tomatoes with a potato masher until the sauce starts to thicken, about 5 minutes over medium high heat.', 'Reduce heat to low and simmer gently while preparing meatballs, stirring occasionally.', '2 Form the meatballs: In a large bowl, mix by hand the beef, Italian sausage, basil, parsley, mushrooms, eggs, breadcrumbs, cheese, salt, and pepper. Do not over-mix or the meatballs will be tough.', 'Use small melon baller (or teaspoon) to form 1-inch round meatballs. Roll and compress into tight balls.', '3 Brown the meatballs: In a separate wide, shallow pan, heat the olive oil on medium high heat. Brown meat balls on all sides, about 2 to 3 minutes.', 'Depending on pan size you may need to brown two batches of the meatballs. Cook them in a single layer; do not crowd the pan by stacking them.', 'Do not overcook the meatballs; they will continue to cook in the sauce. You just want to brown them on all sides. Towards the end of browning the meatballs, add a little bit of red wine to deglaze the pan.', '4 Finish and simmer the sauce: Add the red wine to the sauce and stir in the cheese. Add salt to taste. Add meatballs and gently stir. Simmer the sauce and meatballs for 30 to 45 minutes, stirring occasionally.', '5 Cook the spaghetti: While the sauce is simmering, bring a large pot with 4 quarts of salted water in it to a boil (1 tablespoon of salt for every 2 quarts of water). When the water returns to a boil add the pasta to the pot.', 'Leave the pot uncovered while you cook the pasta on high heat with a vigorous boil. Put a timer on for 8 to 10 minutes, or according to package directions for al dente pasta (cooked but still a little firm). Drain.', '6 Serve: To serve, place thin layer of sauce on plate, add pasta, add sauce and meatballs, and then sprinkle with grated Parmesan-Romano cheese.']",13
1008,Linguine with Clam Sauce Recipe,10,40,50,"['2 pounds small clams in the shell, scrubbed clean', '1 15-ounce can of whole baby clams', '4 tablespoons extra virgin olive oil', '1 medium yellow or white onion, chopped (about 1 cup)', '1 small or 1/2 large fennel bulb, chopped (about 1 cup)', '4 garlic cloves, chopped (4 teaspoons)', '1/3 cup ouzo, Sambuca, Pernod or other anise-flavored liqueur (optional)', '1 tablespoon tomato paste', '1 28-ounce can of crushed tomatoes', '1-2 teaspoons sugar', 'Salt', 'Fronds from the fennel bulb, minced', 'Linguine (can sub any long shaped pasta, like spaghetti or fettuccine)']",13,"['1 Separate clams from juices: Open the can of clams and strain the juice through a paper-towel-lined fine-meshed sieve into a bowl. Set both the juice and the clams aside.', ""2 Cook onion, fennel, garlic: Heat the olive oil in a large pot or saut\\xc3\\xa9 pan over medium-high heat. Add the chopped onion and fennel bulb and sprinkle with a little salt. Stir well and saut\\xc3\\xa9 until translucent, about 4-5 minutes. Don't brown them. Add the chopped garlic and saut\\xc3\\xa9 for another minute."", ""3 Add ouzo, boil down, add tomato paste: Add the ouzo (if you're using) to the pan and let it boil down until it's almost completely evaporated. Add the tomato paste and stir well to coat the vegetables. Cook for a minute or two."", '4 Add tomatoes, clam juice, salt, sugar, then simmer: Add the crushed tomatoes and the clam juice (strained from the can of clams) to the pot, along with a sprinkling of salt and the sugar. Stir well, turn the heat to a slow simmer and cook for 20 minutes. While the tomato sauce is cooking, heat a large pot of salted water for the pasta.', 'If you would like a smooth sauce instead of chunky, ladle the sauce into a blender and pur\\xc3\\xa9e it until smooth, then return to the pot.', '5 When the pasta water comes to a boil, start cooking the linguine pasta.', ""6 Cook clams in sauce: Add the clams in the shell to the sauce pot. Submerge the clams in the sauce. Increase the sauce pot's temperature up to a low boil or a strong simmer. It should take 3-5 minutes for all the clams to open."", 'As the clams open, remove them to a bowl. Remove the clam meat from all but a few of the shells which you will want to save for a garnish. (Or keep the clam meat in the shells, your choice, we just find the dish easier to eat if most of the clams are already out of the shells.)', '7 When the pasta is ready, drain it and put it in a large bowl.', '8 Add clams, fennel fronds to sauce: Add the canned clams to the pasta sauce and return the formerly live clams to the sauce as well. Add the chopped fennel fronds and stir to combine.', 'To serve, ladle some sauce into the bowl with the pasta and mix well to combine. Use tongs to put some pasta on each plate, add a small spoonful of clam sauce on top and garnish with a few of the clams that are still in the shell. Serve at once.']",11
1009,Vietnamese-Style Sticky Chicken Skewers Recipe,20,10,30,"['1/2 cup palm sugar (or substitute brown sugar)', '1/2 cup unseasoned rice wine vinegar', '1/4 cup fish sauce', '1/3 to 1/2 cup chili sauce, like Sriracha, to taste', '1 clove garlic, minced', '2 tablespoons minced peeled fresh ginger', '1 1/2 pounds skinless, boneless chicken thighs, cut into 2-inch pieces', 'Vegetable oil (for the baking sheet)', 'Leaves from 1/4 bunch cilantro, for garnish', '2 to 3 scallions, thinly sliced for garnish', 'Cooked rice or rice noodles, for serving', 'Special equipment:', 'Skewers']",13,"['1 Soak the skewers: If using bamboo skewers, soak them in warm water for 30 minutes.', '2 Marinate the chicken: In a bowl, stir together the sugar, vinegar, fish sauce, chili sauce, garlic, and ginger. Add the chicken pieces and toss to coat. Marinate for at least 10 minutes at room temperature but no more than 30\\xe2\\x80\\x94otherwise the flavors become too pungent.', '3 Heat the broiler: Set an oven rack 4 inches from the broiler element and turn on the broiler to high.', 'Line a rimmed baking sheet with foil. Lightly oil or spray it with vegetable oil. (This is important\\xe2\\x80\\x94the marinade tends to burn on the pan, but not on the chicken, and you will save yourself from a tedious cleaning job.)', ""4 Thread the chicken on the skewers: Place 3 to 5 pieces of chicken on each skewer, depending on whether you're using small or large skewers. Don't crowd the chicken pieces too close together; they will brown better if there's a little bit of space in between each piece."", 'Transfer the skewers to the baking sheet. Pour the excess marinade into a small skillet.', '5 Cook the excess marinade: In a small skillet over medium heat, bring the excess marinade to a boil and cook for 2 to 3 minutes, or until slightly thickened.', 'Brush the chicken all over with the reduced marinade.', '6 Broil the chicken skewers: Broil for 3 to 4 minutes, or until browned on top. With tongs, turn skewers over and brush with more marinade.', 'Broil for another 3 to 4 minutes, or until browned on the other side and cooked all the way through. Exact time will depend on the heat of your particular broiler; when done, the chicken should no longer be pink in the middle.', '7 Serve the skewers: Transfer the skewers to a platter, or remove the chicken from the skewers and serve the pieces on a platter without the skewers, whichever you prefer. Sprinkle with cilantro and scallions and serve with rice or rice noodles.']",11
1010,Chinese Hot and Sour Soup Recipe,25,15,40,"['6 dried Chinese black fungus', '6 dried wood ear, black, cloud, straw, or shiitake mushrooms, or one bunch of fresh enoki mushrooms', '5 dried lily buds', '1 (8-ounce) can bamboo shoots', '2 tablespoons red wine vinegar', '1 tablespoon white vinegar or rice vinegar', '1 1/2 tablespoons of soy sauce', '1 tablespoon cornstarch', '4 cups chicken broth', '1/2 block firm tofu, diced into small cubes', '1 large egg, beaten', '1 teaspoon of sesame oil', '3 scallions, diced', '1/4 teaspoon salt', '1 1/2 teaspoons finely ground white pepper', '1/4 teaspoon chili oil (optional)', 'Cilantro (optional)']",17,"['1 Prepare the dried mushrooms: Pour boiling water over the mushrooms to cover and allow them to soak for 20 minutes, turning the mushrooms over occasionally. It may not seem like a lot but they will grow quite a bit.', 'After soaking remove any woody ends with a knife. Cut mushrooms into strips. Reserve 1/4 cup of the liquid and mix with the cornstarch. (If using fresh enoki mushrooms set aside as they do not need to soak).', '2 Prepare the lily buds: Pour boiling water over the lily buds to cover and allow to sit for 15 minutes. Cut the buds crosswise, then tear them up into a few bunches.', '3 Prepare the remaining ingredients: Mix the vinegars and soy sauce together and set aside. Open the can of bamboo shoots, drain well, and cut the shoots lengthwise into strips.', '4 Build the soup: Place the chicken broth into a bot and bring to a boil over high heat. Add the tofu, mushrooms, lily buds, bamboo shoots, vinegar mixture, and cornstarch mixture. Mix and bring back to a boil. Once it comes to a boil remove from heat.', '5 While stirring the soup slowly pour the egg into the broth in a small steam while stirring the soup allowing the egg to instantly cook and feather into the soup.', '6 Add the scallions, white pepper, sesame oil, and chili oil if using. Taste and adjust white pepper, vinegar, and salt to taste. Add cilantro to garnish and for added flavor. Serve immediately.']",7
1011,Kung Pao Chicken Recipe,15,10,25,"['For the marinade:', '2 teaspoons soy sauce', '1 1/2 teaspoons sherry, or Shaoxing rice wine', '1 tablespoon water', '2 teaspoons cornstarch', 'For the sauce:', '3 teaspoons Chinkiang vinegar, or 2 teaspoons of apple cider vinegar', '2 teaspoons soy sauce', '1 teaspoon sesame oil', '1 tablespoon water', '3 teaspoons sugar', '1 teaspoon cornstarch', 'For the chicken:', '2 large boneless, skinless chicken breasts', '8 dried chili red peppers (preferably Tien Tsin variety)', '2 1/2 tablespoons sesame oil', '1 teaspoon whole Szechwan peppercorns (optional)', '1 tablespoon freshly grated ginger', '3 cloves garlic, thinly sliced', '6 green onions, chopped', '2/3 cup roasted, unsalted peanuts']",21,"['1 Marinate chicken: Mix together the marinade ingredients. Chop the chicken into bite sized pieces, toss them in the marinade, and set aside.', '2 Whisk together sauce ingredients: Combine all the ingredients for the sauce, whisking well to ensure the cornstarch is fully incorporated. Set aside.', '3 Prep the seasonings: Break the chilies open and discard the seeds inside, then cut them into a few large pieces (the dish will already be very hot, keeping the seeds will make it near inedible).', '4 Stir-fry chilies and peppercorns: Place the 2 1/2 tablespoons of sesame oil in a wok or large saut\\xc3\\xa9 pan and place over medium-high heat. Add the chilies and Szechwan peppercorns, if using. Stir-fry for a few second until they become fragrant being careful not to burn them.', '5 Add the chicken and aromatics: Add the chicken. As soon as the pieces have separated, add the ginger, garlic, and green onions. Stir-fry for a few minutes until the chicken is cooked through.', '6 Finish the stir fry: Add the sauce and toss. When the sauce becomes thick, add the peanuts, toss, and serve.']",6
1012,Easy Grilled Steak Fajitas Recipe,10,10,20,"['Fajita Spice Mix:', '1 teaspoon kosher salt', '1/2 teaspoon black pepper', '1/2 teaspoon garlic powder', '1/2 teaspoon onion powder', '1/2 teaspoon ground cumin', '1/2 teaspoon chili powder', 'For the fajitas:', '1 1/2 pounds steak, skirt, flank, or strip (no more than 1-inch thick)', '1 large green pepper, sliced thin', '1 large red pepper, sliced thin', '1 medium sweet onion, sliced thin', '4 teaspoons olive oil', '10-12 medium flour tortillas', 'DAD ADD \\xe2\\x80\\x94 Lime Cumin Sour Cream:', '1 cup sour cream', '1 lime, zest and juice', '1/2 teaspoon ground cumin', 'Pinch of salt', 'To serve:', 'Avocado', 'Salsa', 'Hot sauce']",23,"['1 Make the fajita spice mix: In a small bowl combine kosher salt, black pepper, garlic powder, onion powder, cumin, and chili powder.', '2 Make the vegetable foil pack: Fold a large piece of foil in half so you have a double layer. Add the sliced peppers and onions. Season the vegetables with 1 tablespoon of olive oil and sprinkle with 1 teaspoon fajita seasoning.', 'Fold the sides of the foil up and crimp it tightly on top to make a packet.', '3 Season the steak: Season the steak liberally with the seasoning mix (about 3/4 teaspoon per side).', '4 Preheat your grill to 450\\xc2\\xb0F for high heat grilling.', '5 Grill the packet and the steak: Once the grill is hot, transfer the veggie packet and the steak to the grill. Grill over steak over high, direct heat. After 4 minutes, flip the steak and grill for 5 to 7 additional minutes.', 'This will finish cooking the steak to about a medium to medium-rare temperature and soften the veggies. Remove both the foil packet and the steak from the grill and let cool for a few minutes.', '6 Make the Dad Add Lime Sour Cream (optional): In a small bowl, combine sour cream, zest, juice from 1 lime, cumin, and salt. Serve alongside the fajitas.', '7 Slice the steak: Slice the steak thinly against the grain.', '8 Serve: You can add the steak to the veggies and serve the fajitas right out of the foil packet alongside a stack of flour tortillas. The foil should be strong enough, but if yours seems unstable, you can also transfer the ingredients to a serving platter.']",10
1013,Cauliflower Gnocchi (Trader Joe\xe2\x80\x99s Copycat!),30,25,55,"['4 cups cauliflower florets (14 ounces)', '1/2 teaspoon sea salt', '3 tablespoons olive oil, divided', '1/2 cup cassava flour ( 2 3/4 ounce, 78g)', '1/4 cup potato starch (1 1/4 ounce, 39g)', 'Suggested Toppings:', 'Parmesan cheese (omit for vegan version)', 'Fresh chopped parsley', 'Fried sage leaves', 'Special equipment:', 'Food processor']",11,"['1 Steam the cauliflower: Fill a medium pot with 2 inches of water. Place a steamer basket into the pot, cover, and bring water to a simmer over high heat.', 'Add the cauliflower florets and steam until fork tender, 10 to 13 minutes.', '2 Squeeze the cauliflower: Cool the steamed cauliflower slightly and transfer to a cheesecloth or kitchen towel. Squeeze out as much moisture as possible, about 3/4 cup of water. This should yield about 1 1/4 cup of squeezed cauliflower.', '3 Puree the cauliflower: Add the cauliflower, sea salt, and 2 tablespoons olive oil to a food processor. Process on high speed until the puree feels smooth in between your fingers, scraping down the sides as needed, 30 seconds. Then pulse for another 5 seconds.', '4 Make the dough: Whisk together potato starch and cassava flour in a medium-sized bowl. Add the pureed cauliflower and use a fork to mix the dough, just until the starches are combined. Lightly knead the dough until it comes together and can be rolled.', ""Once combined, use your hands to gently knead the dough 3 or 4 times and then turn out onto cutting board. The dough will be smooth, soft and slightly tacky to the touch. Don't overwork."", '5 Shape the gnocchi: Using a bench scraper, divide dough into 8 equal parts. Gently roll each piece into a 2 1/2 inch log that is 3/4 inch thick. Cut each log into 3/4 inch pieces', 'For a ribbed pattern, roll the gnocchi over the back of the tines of a fork or gnocchi board.', '6 Boil the gnocchi: Bring lightly salted water to a boil in a medium pot. Carefully add the gnocchi and cook until they float to the surface, about 3 minutes. Use a slotted spoon to scoop out and drain the gnocchi, and then transfer to a lightly oiled sheet pan.', 'Boiled gnocchi can be transferred directly to a soup or sauce.', '7 Saut\\xc3\\xa9 the gnocchi (optional for crispy gnocchi): Heat a tablespoon of olive oil in a large nonstick saut\\xc3\\xa9 pan over medium heat. Cook the gnocchi in a single layer, keeping them from touching each other.', 'Saut\\xc3\\xa9 until both sides are golden brown, 5 to 7 minutes. Repeat until all the gnocchi are cooked.', '8 Serve: Transfer crispy gnocchi to a bowl and season with salt and pepper, and any other toppings such as Parmesan cheese and sage leaves.']",13
1014,Steamed Mussels in Tomato Sauce Recipe,10,20,30,"['4 strips bacon, chopped', '1/2 small white onion, chopped', '3 cloves garlic, sliced', '1/2 teaspoon red pepper flakes', '1/4 teaspoon salt', '1/4 teaspoon black pepper', '1/2 cup white wine (optional)', '3 to 4 cups marinara sauce, store-bought or homemade', '1 1/2 to 2 pounds mussels, scrubbed, debearded, rinsed and drained', 'For serving (optional):', '1 pound spaghetti, drained, if serving as a main course', 'Crusty bread, if serving as an appetizer', 'Fresh parsley']",13,"['1 Make the tomato sauce: Add chopped bacon to a large, deep skillet over medium-low heat. Cook bacon until it renders out fat and starts to get crispy, 5 to 6 minutes. Then add onion, garlic, red pepper flakes, salt, and black pepper, and cook until onions soften and become translucent, about 3 to 4 minutes.', 'Cook for another minute or two to soften the garlic and combine flavors. Then pour in the wine to deglaze the pan\\xe2\\x80\\x94this will release any stuck bits on the pan and help combine flavors. Cook for a minute and then pour in marinara sauce and stir. Bring the mixture to a simmer, turn heat down to low and simmer, partially covered, for 5 minutes.', '2 Add the mussels and cook: Remove the lid and add all the mussels. Cover and shake the skillet gently. Cook mussels for 4 to 5 minutes, until they open. Discard any that do not open.', '3 Serve: Serve with crusty bread as an appetizer or over cooked pasta as a main course.', 'Leftover mussels and sauce: Mussels, like most seafood, don\\xe2\\x80\\x99t keep well for long as leftovers. The sauce and mussels are fine in the fridge for a day or two. Reheat them gently on the stove with a splash of water. I would not freeze this dish.']",5
1015,Tres Leches Cake Recipe,15,1455,1470,"['For the sponge cake:', '1 tablespoon melted unsalted butter, for brushing the cake pan', '3/4 cup + 1 tablespoon  (178g) granulated sugar', '6 large eggs, whites and yolks separated', '1 teaspoon vanilla extract', '1/2 teaspoon kosher salt', '1 1/2 cups (173g) cake flour, sifted', 'For the milk mixture:', '1 1/2 cups whole milk', '1 (12-ounce) can evaporated milk', '1 (14-ounce) can sweetened condensed milk', '1 tablespoon brandy (optional)', '1 teaspoon vanilla extract', 'For the whipped cream topping:', '3 cups heavy cream', '1/2 teaspoon vanilla extract', '1 cup powdered sugar', 'Ground cinnamon']",18,"['1 Preheat the oven and prep your pans: Preheat your oven to 400\\xc2\\xb0F. Brush the inside of a 9x13x3-inch cake pan with a thin layer of the melted butter.', 'Place 1/2 cup of the granulated sugar into an oven-safe container and let the sugar warm in the oven as it\\xe2\\x80\\x99s heating up. Warm sugar helps give the egg yolks more volume when you whip them.', '2 Whip the yolks: Using a hand or stand mixer, whip the egg yolks, the warmed sugar, and the vanilla extract together on medium-high speed until the egg yolks have doubled in volume and are a very pale yellow color. This should take about 5 minutes. Set the bowl aside.', '3 Whip the egg whites: In a separate, very clean bowl with clean beaters, whip together the egg whites and the salt on medium-high speed until the whites are foamy.', 'Once the whites look foamy, gradually add the remaining 1/4 cup plus 1 tablespoon of sugar to the egg whites. Continue whipping until the whites are stiff and glossy, about 4 1/2 minutes. The whites should stand up with a peak that folds over just slightly when the beaters are pulled from their surface.', '4 Make the batter: Working quickly to prevent the eggs from deflating, sift half of the cake flour into the bowl with the yolks. Use a wide rubber spatula to gently fold the flour into the yolks. Once the flour has been incorporated, fold in half of the egg whites gently so as not to deflate the eggs. Repeat again with the remaining flour and whites.', '5 Fill the pans: Fill the prepared cake pan with the cake batter and use an offset spatula to spread the batter evenly into the pan. Gently tap the pan against the countertop a couple of times to release any air bubbles that may be trapped in the batter.', '6 Bake the cake for 15 minutes, or until the top is golden brown and springs back quickly when pressed with your fingertip. Allow the cake to cool completely in the pan, or turn it out onto a deep, rimmed serving platter.', '7 Make the milk mixture: In a large pitcher or bowl, combine the three milks, the brandy (if using), and the vanilla extract. Whisk together until combined.', '8 Soak the cake: Once the cake has cooled, use a toothpick or the tines of a fork to poke small holes all over the cake. Pour the milk mixture over the cake, covering it entirely. Don\\xe2\\x80\\x99t worry if it seems to be a lot; the cake will soak up virtually all of the milk as it sits.', 'Cover the cake with plastic wrap and refrigerate for 3 hours or up to 24 hours.', '9 Whip the cream: In a large mixing bowl, whip the heavy cream with an electric hand mixer on medium-high speed. Once the beaters begin to leave ribbons in the cream, stop the mixer and then add the vanilla extract and the powdered sugar.', 'Increase the speed to high, and whip until the cream is thick and holds its shape when the beaters are removed (this should take anywhere from 5 to 7 minutes).', '10 Finish the cake: Spread the whipped cream in an even layer over the top of the cake using an offset spatula. Sprinkle with a liberal dusting of ground cinnamon.', '11 Serve the cake: Refrigerate the cake up to three hours until ready to serve. Cut into 12 squares. Enjoy up to 3 days after preparation\\xe2\\x80\\x94keep it refrigerated.']",15
1016,Easy Wok-Kissed Beef Pho Recipe,10,45,55,"['For the broth:', 'Chubby 1-inch (1 ounce) section ginger', '3 medium-large green onions', '1 1/2 to 2 star anise (12 to 16 robust points total; use the max if you like spice)', 'Slender 3-inch cinnamon stick, broken in half', '3 whole cloves', '4 cups low-sodium beef broth, preferably Swanson', '4 cups low-sodium chicken broth, preferably Swanson', '2 cups water', '1 teaspoon fine sea salt', '1 1/2 tablespoons fish sauce', '1 teaspoon organic sugar, or 2 teaspoons maple syrup (optional)', 'For the pho:', '10 ounces dried medium flat rice noodles (aka pad Thai noodles)', '2 tablespoons canola or other neutral oil, plus more as needed', '12 ounces well-trimmed beef steak (such as top sirloin, tri-tip, or flank steak), cut across the grain into bite-size strips a scant 1\\xe2\\x81\\x844 inch thick (chopstickable pieces, about 1\\xe2\\x80\\x9d x 3\\xe2\\x80\\x9d x scant 1/4\\xe2\\x80\\x9d thick)', '1/4 teaspoon recently ground black pepper, plus more as needed', '3/4 teaspoon white or brown sugar', '1 teaspoon cornstarch', '2 teaspoons fish sauce', '2 teaspoons soy sauce', '2 cloves garlic, finely chopped', '1/2 small (2 ounce) yellow or red onion, cut along the grain into narrow wedges', '1/4 cup chopped fresh cilantro, leafy tops only', 'Optional add-ins (choose none, some, or all):', '4 handfuls bean sprouts', '1 or 2 Thai or serrano chiles, or 1 sliced jalape\\xc3\\xb1o or Fresno, thinly sliced with seeds intact', '4 to 6 sprigs mint', '4 to 6 sprigs Thai basil', '4 to 6 lime wedges', 'Hoisin sauce', 'Sriracha sauce']",32,"['1 Make the quick broth: Peel then slice the ginger into 6 to 8 coins. Smack the coins with the flat side of a knife to slightly crush, then set aside.', 'Thinly slice the green parts of the green onion to yield 1/4 cup; set aside for garnish. Cut the leftover sections into pinkie-finger lengths, smack with the flat side of the knife, then add to the ginger.', 'In a 4-quart pot, toast the star anise, cinnamon, and cloves over medium heat until fragrant, 1 to 2 minutes. Add the ginger and green onion sections. Stir for 30 seconds, until aromatic. Slide the pot off the heat, wait about 15 seconds to cool a bit, then pour in the beef and chicken broths.', 'Return the pot to the burner, then add the water and salt. Bring to a boil over high, then lower the heat to gently simmer, uncovered, for 30 minutes.', '2 Strain the broth: When the broth is done, pour it through a fine-mesh strainer positioned over a 3-quart pot; discard the solids. You should have about 8 cups; if your yield is way off, add water to dilute or boil down to concentrate.', 'Season the broth with fish sauce and sugar to create a strong savory-sweet note. Keep the broth warm over medium heat. If it comes to a boil, lower the heat and cover.', '3 Cook the noodles: While the broth simmers, boil the noodles in a large pot of water for 5 to 7 minutes, until tender and chewy (or use package directions, if available). Drain, rinse under cold water to remove any lingering starch, then let drain well before dividing among 4 noodle soup bowls.', '4 Prep the beef and add-ins: In a bowl, combine the beef with the pepper, sugar, cornstarch, fish sauce, and soy sauce. Set the beef by the stove with the garlic, onion, green onion tops, and cilantro. Have any optional add-ins at the table.', '5 Cook the beef: Heat a large nonstick skillet over medium-high heat. Swirl in the 2 tablespoons oil. Add the garlic and onion. Once aromatic, about 30 seconds, push the aromatics to one side of the pan.', 'Increase the heat to high and add the beef, spreading it out into a single layer. Let it cook, undisturbed, for about 1 minute. When the beef begins browning, use a spatula to flip and stir for 1 to 2 minutes, until it is still slightly rare.', '6 Serve the pho: Divide the beef among the bowls. Garnish with green onion and cilantro. Sprinkle on some pepper. Re-taste the broth, make any adjustments, then bring to a boil and ladle into the bowls. Serve immediately.', 'Invite guests to enjoy this like other pho noodle soup\\xe2\\x80\\x94using a two-handed approach to wield chopsticks and a soup spoon. They should include as many add-ins as they wish!']",12
1017,New Orleans Beignets Recipe,15,20,35,"['3 cups (415g) all-purpose flour, plus more for dusting', '3/4 teaspoon kosher salt', '3 tablespoons sugar, divided', '1 cup warm whole milk', '2 teaspoons active dry yeast', '1 large egg', '3 tablespoons butter, melted', '1 1/2 to 2 quarts vegetable oil', 'For the topping:', '3 cups powdered sugar']",10,"['1 Start the dough: In the bowl of a stand mixer fitted with the paddle attachment, combine 3 cups of flour, salt, and 2 tablespoons of sugar.', '2 Bloom the yeast: In a 4-cup measuring glass or medium bowl, combine the warm milk (it should be about 100\\xc2\\xb0F), remaining tablespoon of sugar, and yeast, and allow it to sit until foamy, about 5 minutes.', '3 Make the dough: Beat the egg into the foamy milk mixture and add the mixture to the mixing bowl of flour. Mix by hand or using the paddle attachment with your stand mixer set to low or medium low, until you get a wet dough with shaggy dry bits throughout. This can take anywhere from 30 seconds to 1 1/2 minutes depending on how you\\xe2\\x80\\x99re mixing.', 'Swap out the paddle attachment for the dough hook. Add the melted butter. Set the mixer to medium-low until the butter is incorporated, about 1 minute.', '4 Knead the dough: Turn the mixer up to medium or medium-high (depending on the size and weight of your mixer) and knead on the hook for about 6 minutes. The dough should be tacky to the touch but not so wet that you can\\xe2\\x80\\x99t handle it.', '5 Shape the dough and let it rise: Shape the dough into a ball and place it in a greased bowl. Cover with plastic and allow it to rise until doubled in size, 1-2 hours depending on the temperature of the room.', '6 Set up your frying and dusting stations: Fill a large 4-quart pot with a few inches of vegetable oil (about 2 quarts). Set a cooling rack over a baking sheet and place it next to the pot of oil along with tongs.', 'Sift 3 cups of powdered sugar into a medium-sized mixing bowl and set next to the rack and a sheet pan.', '7 Cut the dough and heat the oil: Once the dough has risen, turn it out onto a floured surface and roll it out into an oblong shape (about 10 inches by 14 inches and 1/4 inch thick). Cut the dough into 12 rough rectangles and cover with a flour-dusted tea towel to rest while you heat the oil.', '8 Fry the beignets: Heat the frying oil to 325\\xe2\\x84\\x89. Fry the beignets in batches until golden, about 1 1/2 to 2 minutes per side.', '9 Drain and coat the beignets in sugar: Use your tongs or a frying spider to lift the beignets out of the frying oil and place them on the baking rack.', 'Let some of the fat drain off for about a minute before covering in powdered sugar. You want to coat them with sugar while the beignets are still hot, but not straight out of the fryer dripping in oil. Drop the drained beignets into the bowl with the powdered sugar. Turn to coat. Repeat with the remaining beignets.', '10 Serve: Serve warm with another generous dusting of powdered sugar and hot coffee on the side.']",13
1018,Air Fryer Crab Rangoon Recipe,15,25,40,"['30 square wonton wrappers', '8 ounces cream cheese, at room temperature', '4 ounces lump crab meat or imitation crab', '2 tablespoons minced scallions', '2 teaspoons soy sauce', 'Nonstick spray for air fryer', 'For the dipping sauce:', '1/4 cup soy sauce', '1 tablespoon sesame oil', '1 tablespoon rice wine vinegar', 'Sesame seeds, for garnish', 'Red pepper flakes, for garnish']",12,"['1 Make the filling: In a small bowl, stir together cream cheese, crab, scallion, and soy sauce. Mix well so the filling is a single consistency, and the crab is evenly distributed.', '2 Make the wontons: Working with one square wrapper at a time, add a 1/2 tablespoon of filling to the direct center of the wonton. Use your finger to paint the edges of the wonton with warm water, and then crimp the corners up to meet in the center, forming a dumpling. Use your fingers to press out as much air as you can along the edges as you seal the dumpling.', 'I typically make 6-7 dumplings at a time, and then make the rest while those are frying. You can also make them all in advance and keep them in the fridge for up to a day.', '3 Fry the wontons: Spray the air fryer basket with nonstick spray. Place as many wontons as possible, without touching, into the air fryer basket. You should be able to fit 7-8 wontons. Air fry the wontons at 350\\xcb\\x9aF for 6 minutes until they are crispy and golden brown.', '4 Serve the wontons: Let the wontons cool briefly, then serve with the dipping sauce. Cooked wontons don\\xe2\\x80\\x99t keep very well (they get soggy), so cook only as many as you intend to eat right away!']",5
1019,Baked Chicken Samosas with Mint Yogurt Dip Recipe,50,10,60,"['For the tikka masala spice mix:', '1 tablespoon coriander seeds', '1 tablespoon cumin seeds', '1 tablespoon paprika or 8-10 kashmiri lal mirch chilies', '1 tablespoon garlic powder', '1 1/2 teaspoons dry mango powder or lemon zest', '1/2 tablespoon ground ginger', '1/2 teaspoon ground cinnamon', '1/2 teaspoon ground cloves', '1/2 teaspoon dry mint leaves', 'For the samosas:', '1 1/2 tablespoons cooking oil', '1 cup chopped red onion', '1 tablespoon minced jalapeno', '1 pound ground chicken', '1 teaspoon salt', '1 tablespoon tikka masala spice mix', '1 cup cilantro', '2 pounds phyllo sheets (about 2 boxes)', '1/4 cup melted butter or oil for brushing the phyllo sheets', 'For the mint yogurt dip:', '3/4 cup plain yogurt', '1/3 cup fresh mint leaves, chopped', '1 teaspoon ground sumac or lemon juice', '1 teaspoon olive oil', '1/4 teaspoon ground black pepper', '1/8 teaspoon salt or to taste']",27,"['1 Make the spice mix: In a small skillet set over medium high heat, add the cumin and coriander seeds. Dry toast the seeds for 5 minutes or until the spices become fragrant. Turn off the heat. Allow the seeds to cool down completely.', 'In a spice grinder (or mortar and pestle) add the toasted seeds, paprika, garlic powder, mango powder, ground ginger, ground cinnamon, ground cloves, and mint leaves, and grind everything together until it\\xe2\\x80\\x99s a uniform fine powder.', 'Transfer to an airtight container. Store in a cool dry place.', '2 Make the samosa filling: In a large skillet set over medium heat, add the oil. Once the oil shimmers, add the onion and jalape\\xc3\\xb1o. Saut\\xc3\\xa9 for 5 minutes until the onion softens.', 'Turn the heat to medium high and add the chicken, 1 tablespoon of the tikka masala spice, and salt. Break the ground chicken into pieces, stirring a little while you do it to combine the chicken with the onion and jalape\\xc3\\xb1o. The chicken is ready when it is browned and all of the liquid has cooked off. Stir in the cilantro.', 'Turn off the heat. Let it cool completely.', '3 Preheat the oven to 375\\xc2\\xb0F.', '4 Assemble the samosas:  Place a stack of thawed phyllo sheets on your workstation. Work with 2 full sheets at a time, and cover the rest with damp, but not wet, cloth. Some of your phyllo might be broken or brittle. Try to use complete sheets.', 'Stack the two sheets on top of each other, and brush the phyllo gently with butter or oil. Fold the sheets in half lengthwise.', 'Place 1 1/2 to 2 tablespoons of filling on one corner of the phyllo sheet. Fold the corner with filling over to make a triangle. Now lift the bottom side of the loose end, and fold it over the longer edge of the samosa to make a triangular shaped parcel. Tuck the loose ends underneath. Brush the top with butter or oil. Place the samosa on a baking sheet lined with parchment paper.', 'Repeat with the rest of the filling and phyllo sheets.', '4 Bake the samosas: Bake for 10-15 minutes until the edges of the samosas begin to turn golden.', '5 Make the dip: While the samosas are baking, make the dip. In a medium-sized bowl, combine yogurt, mint, sumac, olive oil, pepper, and salt. Stir it together.', '6 Eat samosas! Pull the samosas out of the oven, transfer to a serving platter, serve alongside the mint dip, and enjoy hot!']",14
1020,Chicken Pad Thai Recipe,10,732,742,"['For the pad Thai:', '1 (14-ounce) package flat, wide rice noodles', '6 to 8 tablespoons fish sauce', '3/4 cup rice vinegar', '1 to 2 teaspoons tamarind paste/concentrate', '1 cup granulated sugar', 'Pinch of paprika (or cayenne powder)', '10 to 12 tablespoons canola or vegetable oil, divided', '4 large eggs', '1 pound chicken tenders, cut into bite-sized pieces', '1/3 cup roasted, unsalted peanuts, chopped roughly', '1 cup bean sprouts', 'For garnish (optional):', '1 lime, cut into quarters', '2 tablespoons roasted, unsalted peanuts, chopped roughly', 'Chopped cilantro', 'Red pepper flakes']",17,"['1 Soak the rice noodles: In a large container, preferably one with a lid, soak the noodles in cold water, enough to cover so that no noodle is poking out. Soak for at least 2 hours or up to 12 hours. It can be refrigerated, or not\\xe2\\x80\\x94it doesn\\xe2\\x80\\x99t matter.', '2 Make the sauce: In a shallow bowl, whisk together the fish sauce, rice vinegar, tamarind concentrate, and sugar until smooth. Taste. Adjust the sauce as needed. Add a pinch of paprika or cayenne powder for color.', 'You\\xe2\\x80\\x99ll only need about 1/2 cup of sauce for this recipe (1/4 cup per batch). Any extra sauce can be stored in the fridge for up to three months\\xe2\\x80\\x94and/or used on leftovers to spruce them up during reheating.', '3 Bring a large pot of water to boil.', '4 Divide all of your ingredients into two batches: Arrange them near your stove. You\\xe2\\x80\\x99ll prepare each batch completely, one after the next.', 'WORKING ONE BATCH AT A TIME: ', '5 Cook the eggs: Heat a wok or other large pan with high sides over high heat, which you will maintain throughout cooking the pad Thai. Add 2 to 3 tablespoons of oil. When the oil starts to shimmer a bit, it\\xe2\\x80\\x99s ready.', 'Crack the eggs for this batch into the pan, and using the tip of a wooden spoon, gently loosen the yolk. You want to have enough oil in the pan so it looks as though the egg is floating, or suspended, in the oil. This gives you more surface area to cook the egg without it burning.', 'Gently shake and flip the egg around in the pan. Break it up a bit with the spoon, but don\\xe2\\x80\\x99t scramble it by any means. This should take about a minute. Push the eggs off to the side of the pan to make room for the chicken.', '6 Cook the chicken: If the pan seems too dry because the eggs have absorbed all of the oil (not likely, but possible), add 1 to 2 more tablespoons of oil to the pan. Add the chicken for this batch. Cook the chicken for 4 to 5 minutes, turning to make sure it cooks most of the way through.', '7 Soften the noodles: Take several handfuls of your noodles (about half the total amount) out of the water they\\xe2\\x80\\x99re soaking in, and transfer to a fine mesh sieve. Hold the sieve over the pot of hot water and gently dip the noodles up and down, in and out of the water, to soften them but not cook them per se. (Using the sieve saves you from having to cook and then strain the noodles\\xe2\\x80\\x94and makes the process move more quickly.)', 'Shake out the excess hot water and taste to make sure the noodles have softened but still have a little give.', '8 Add the noodles to the pan: Transfer the noodles to the hot pan; they don\\xe2\\x80\\x99t need to be completely cooked at this point, because they will continue to cook in the wok.', 'Toss them gently in the pan and stir them briefly to keep them from sticking together. When the noodles look shiny, it\\xe2\\x80\\x99s time for the sauce.', '9 Add the sauce: Add about 1/4 cup of the sauce to the pan, and gently toss and flip the noodles in the pan. Stir them quickly to integrate the sauce; you\\xe2\\x80\\x99ll know it\\xe2\\x80\\x99s ready when you can\\xe2\\x80\\x99t see any more sauce in the pan because the noodles have absorbed it. If it seems like it needs more, add a little more, and cook until it\\xe2\\x80\\x99s absorbed. Taste.', '10 Add the peanuts and bean sprouts: Add the peanuts and the sprouts, and toss all ingredients together quickly. Cook for 2 to 3 minutes altogether until everything is heated through. The noodles will begin to soften and look more translucent.', '11 Taste and serve: Turn the heat off the pan and taste the to make sure there is enough sauce to flavor the dish. Serve immediately in individual bowls with wedges of lime, along with additional peanuts, chopped cilantro, and/or red pepper flakes, if desired.', '12 Repeat steps 5 through 11 for making the second batch of pad Thai.']",18
1021,Vegetarian Pad Thai with Tofu Recipe,10,1452,1462,"['For the pad Thai:', '1 (14-ounce) package flat, wide rice noodles', '2 to 3 teaspoons salt', '3/4 cup rice vinegar', '1 to 2 teaspoons tamarind paste or concentrate', '1 cup granulated sugar', 'Pinch of paprika (or cayenne powder)', '10 to 12 tablespoons canola or vegetable oil, divided', '1 pound tofu, extra firm, drained and cubed', '4 large eggs', '1/3 cup roasted, unsalted peanuts, chopped roughly', '1 cup bean sprouts', 'For garnish (optional):', '1 lime, cut into quarters', '2 tablespoons roasted, unsalted peanuts, chopped roughly', 'Chopped cilantro, for garnish', 'Red pepper flakes, for garnish']",17,"['1 Soak the rice noodles: In a large container, preferably one with a lid, soak the noodles in cold water, enough to cover so that no noodle is poking out. Soak for at least 2 hours or up to 24 hours. It can be refrigerated, or not\\xe2\\x80\\x94it doesn\\xe2\\x80\\x99t matter.', '2 Make the sauce: In a shallow bowl, whisk together 2 teaspoons of salt, vinegar, tamarind concentrate, and sugar until smooth. Taste. Adjust the sauce as needed; you may need to add more salt depending on the other ingredients. Add a pinch of paprika or cayenne powder for color.', 'You\\xe2\\x80\\x99ll only need about 1/2 cup of sauce for this recipe (1/4 cup per batch). Any extra sauce can be stored in the fridge for up to 3 months or used on leftovers.', '3 Bring a large pot of water to boil.', '4 Divide all of your ingredients into two batches. Arrange them near your stove. You\\xe2\\x80\\x99ll prepare each batch completely, one after the next.', 'WORKING ONE BATCH AT A TIME:', '5 Cook the tofu: Heat a wok or other large pan with high sides over high heat, which you will maintain throughout cooking the pad Thai. Add 2 tablespoons of oil. When it starts to shimmer a bit, it\\xe2\\x80\\x99s ready.', 'Add the tofu for your first batch to the pan and let it get some color on it, about 2 to 3 minutes. Toss it frequently once you\\xe2\\x80\\x99ve got some browning on one side. You won\\xe2\\x80\\x99t get browning on all sides. Cook for another 2 to 3 minutes, and then remove the tofu to a plate. Set aside.', '6 Cook the eggs: Add 2 to 3 tablespoons of oil to the pan. When the oil starts to shimmer a bit, it\\xe2\\x80\\x99s ready.', 'Crack the eggs for this batch into the pan and, using the tip of a wooden spoon, gently loosen the yolk. There should be enough oil in the pan so it looks as though the egg is floating, or suspended, in the oil. This gives you more surface area to cook the egg without it burning.', 'Gently shake and flip the egg around in the pan. Break it up a bit with the spoon, but don\\xe2\\x80\\x99t scramble it by any means. This should take about a minute.', 'Push the eggs off to the side of the pan to make room for the tofu. Add the tofu back to the pan.', '7 Soften the noodles: Take several handfuls of your noodles (about half the total amount) out of the water they\\xe2\\x80\\x99re soaking in, and transfer to a fine mesh sieve. Using the sieve saves you from having to cook and then strain the noodles\\xe2\\x80\\x94and makes the process move more quickly.', 'Hold the sieve over the pot of hot water and gently dip the noodles up and down, in and out of the water, to soften them but not cook them per se. They don\\xe2\\x80\\x99t need to be completely cooked at this point, because they will continue to cook in the wok.', 'Shake out the excess hot water and taste to make sure the noodles have softened but still have a little give.', '8 Add the noodles to the pan: Transfer the noodles to the hot pan. Toss them gently in the pan and stir them briefly to keep them from sticking together. When the noodles look shiny, after about a minute or so, it\\xe2\\x80\\x99s time for the sauce.', '9 Add the sauce: Add about 1/4 cup of the sauce to the pan and gently toss and flip the noodles in the pan. Stir them quickly to integrate the sauce; you\\xe2\\x80\\x99ll know it\\xe2\\x80\\x99s ready when you can\\xe2\\x80\\x99t see any more sauce in the pan because the noodles have absorbed it.', 'If it seems like it needs more, add a little more, and cook until it\\xe2\\x80\\x99s absorbed. Taste. (Pad Thai is very much an intuitive, taste-as-you-go kind of dish.) This shouldn\\xe2\\x80\\x99t take more than a minute or two.', '10 Add the peanuts and bean sprouts: Add the peanuts and the sprouts, and toss all ingredients together quickly. Cook for 2 to 3 minutes all together until everything is heated through. The noodles will begin to soften and look more translucent.', '11 Taste and serve: Turn the heat off the pan and taste to make sure there is enough sauce to flavor the dish. Serve immediately in individual bowls with wedges of lime, along with additional peanuts, chopped cilantro, and chili flakes, if desired.', '12 Repeat steps 5 through 11 for making the second batch of pad Thai.']",21
1022,Indian Chicken Biryani Recipe,60,60,120,"['For the chicken:', '2 teaspoons ginger garlic paste, divided', '1 teaspoon turmeric powder', '2 to 3 whole chilis, sliced (jalapeno, serrano or cayenne)', '1/4 cup plain whole milk yogurt', '1 teaspoon olive oil', '1 1/2 pounds bone-in chicken pieces (drumsticks or whole thighs)', '1 tablespoon ghee (clarified butter) or unsalted butter', '1/3 cup finely chopped red onion (about 1/4 of a large onion)', 'For the rice:', '2 cups long grain basmati rice', '3 to 4 whole black cardamom pods', '3 to 4 whole green cardamom pods', '2-inch cinnamon stick', '1 teaspoon whole peppercorns', '1 to 2 bay leaves', 'Salt to taste', 'For the saffron milk:', '1/2 teaspoon saffron threads', '1/3 cup milk, cold or room temperature', 'For the fried onions:', '1 cup cooking oil', '1 cup thinly sliced red onion (about 3/4 of a large onion)', 'To assemble the biryani:', '1 teaspoon ghee (clarified butter) or unsalted butter', '1/4 cup cilantro, coarsely chopped', '1/4 cup mint, coarsely chopped', '1/4 cup whole milk plain yogurt', '1 1/2 teaspoons garam masala', '2 to 3 tablespoons pomegranate arils (seeds)']",30,"['1 Marinate the chicken: Combine 1 teaspoon of the ginger garlic paste, turmeric, sliced chilis, yogurt, olive oil, and salt in a medium bowl. Add the chicken and massage well to coat with marinade.', 'Cover and pop in the refrigerator to marinate for at least 30 minutes or up to 1 hour.', '2 Prepare the rice: Wash rice in 2 to 3 batches of water. Drain and set aside.', 'In a large pot, add the salt, the whole spices, and lots of water. There should be enough water for the rice to float around freely when boiling (see How to Boil Rice). Bring it to a rolling boil.', 'Add the rice to the pot. Cook until the rice is 90 percent done and still slightly crunchy in the middle; the rice will finish cooking in the dish.', 'Drain the rice through a sieve, then spread it on a baking sheet or a large plate to cool. Set aside for later. Do not discard whole spices in the rice.', '3 Make the saffron milk: Stir the saffron strands into the milk. Cover and set aside for 30 minutes or until ready to layer the biryani.', '4 Fry the onions: Heat the oil in a frying pan over high heat. Drop a strand of onion into the hot oil. If it sizzles loudly, then the oil is hot enough. The pan should be wide enough to accommodate all the onion slices without crowding. Set a plate lined with a paper towel nearby for draining the finished onions.', 'Carefully drop the onions into hot oil (be careful as the oil might splatter). Cook for 2 to 3 minutes or until the onions are brown and crispy. It\\xe2\\x80\\x99s easy to overcook and burn the onion so keep a constant eye on the pan.', 'Carefully remove all the onions with a slotted spoon or spider (that\\xe2\\x80\\x99s a ladle with a skimmer on it, like this one) and transfer to the paper-towel lined plate.', '5 Cook the chicken: Once the chicken has finished marinating, melt 1 tablespoon ghee in a medium-sized pot or pan on medium heat. Add the remaining 1 teaspoon of ginger garlic paste. Cook for a minute or until the paste begins to turn golden brown.', 'Add the finely chopped red onion. Cook for 3 to 5 minutes on medium heat until the onion softens and begins to turn golden.', 'Add marinated chicken and the marinade. Stir well. Cover and cook on medium-low heat for 8 to 10 minutes or until the chicken is about 90 percent cooked. The chicken will finish cooking in the oven after being layered with other components of the biryani.', '6 Preheat the oven to 350\\xc2\\xbaF.', '7 Assemble the biryani: Grease a 3-quart oval baking dish with 1 teaspoon ghee. Spread half of the rice in an even layer on the bottom of the baking dish. Press down gently with your hand to pack the rice layer.', 'Arrange the chicken and its sauce in a single layer on top of the rice, then top with the cilantro, mint, half of the fried onions, the yogurt, and 1/2 teaspoon garam masala.', 'Follow with the rest of the rice. Press down again gently to pack everything. Spread the rest of the fried onion over the top and sprinkle with the remaining 1 teaspoon of garam masala. Evenly pour the saffron milk over everything.', '8 Bake the biryani: Tightly cover the dish with 2 to 3 layers of aluminum foil. Place in the oven and bake for 40 to 50 minutes, or until the rice and rest of the ingredients are cooked through. The foil creates steam for the rice; just uncover a corner and check for doneness by pressing rice between your thumb and index finger.', '9 Rest the biryani: Transfer the biryani to a cooling rack and let it rest (covered) 10 to 15 minutes before uncovering the dish.', '10 Serve the biryani: Gently use a fork to mix all the layers together before serving with a side raita and/or a simple salad. Garnish with the pomegranate arils (seeds).']",20
1023,Strawberry Rhubarb Pie Recipe,25,60,85,"['3 1/2 cups rhubarb stalks cut into 1/2 inch pieces (Trim away and discard the leaves which are poisonous; trim ends.)', '2 cups stemmed and sliced strawberries', '3/4 cup to 1 cup sugar (depending on how tart/sweet you like your pie)', '4 tablespoons of quick cooking (""minute"") tapioca', '1/4 teaspoon of salt', '1 teaspoon of orange zest', '1 double-crust 9-inch pie dough recipe, like this one or your favorite pie crust recipe']",7,"['1 Preheat oven to 400\\xc2\\xb0F. ', '2 Assemble the pie filling: In a large bowl, gently combine the rhubarb and the strawberries with the sugar, tapioca, salt, and orange zest. Let sit for 10 minutes.', '3 Roll out the bottom crust and fill the pie: Roll out one disk of pastry dough and line the bottom of a pie dish with it. Trim to 1/2 inch from the edge. Transfer the filling into the crust and spread out evenly.', '4 Top the pie: Roll out the second disk of pastry dough and place over the pie. Trim the edges to an inch from the edge of the pie dish. Tuck the top crust edges over the bottom crust edges and use your fingers or a fork to crimp the top and bottom edges together. Cut slits in the top for the steam to escape.', '(If you want, for a nice glaze on your pie, use a pastry brush to brush a thin layer of egg white or cream over the top of the pie.)', '5 Bake: Place pie on the middle rack of the 400\\xc2\\xb0F oven with a baking sheet on a lower rack to catch any juices that might spill over.', 'Bake for 20 minutes at 400\\xc2\\xb0F, then reduce heat to 350\\xc2\\xb0F and bake an additional 40-50 minutes longer (50 to 60 minutes longer if doing a 10-inch pie). The pie is done when the crust is nicely browned and the filling (that you can see through the venting holes) thick and bubbly.', '6 Cool and serve: Remove from oven and let cool on a rack.', 'Serve warm or cold. If you do cool to room temperature, the juices will have more time to thicken. Pie can also be covered and stored at room temperature for up to 2 days or refrigerated for 5 days.']",9
1024,Rhubarb Crumble Recipe,10,90,100,"['Filling:', '2 lbs rhubarb, cut into 1-inch pieces', '1 1/4 cups white sugar', '1/4 cup all purpose flour', '1 teaspoon vanilla extract', '1/4 teaspoon ground cardamom', 'Crumble Topping:', '1 cup all purpose flour', '1/2 teaspoon salt', '1 cup light brown sugar', '1/2 cup of butter (1 stick or 4 ounces), cut into cubes']",11,"['1 Preheat oven to 375\\xc2\\xb0F.', '2 Toss rhubarb with sugar, flour, vanilla, cardamom: In a medium sized bowl, mix together the rhubarb, white sugar, 1/4 cup of flour, the vanilla extract, and the ground cardamom.', 'Spoon into a 9x13-inch baking dish.', '3 Make topping: In a food processor, pulse together 1 cup of flour, the salt, and the brown sugar. Add the butter and pulse until the pieces of butter are pea-sized. (Alternatively, mix the dry ingredients together and cut the butter in with two knives or a pastry cutter.)', 'Spread topping mixture over rhubarb mixture.', '4 Bake: Place in oven and bake at 375\\xc2\\xb0F for 35-45 minutes, until the filling is bubbly and the topping is lightly browned. Let cool for at least a half an hour before serving.', 'Serve with vanilla ice cream or whipped cream.']",7
1025,Rhubarb Meringue Pie Recipe,15,60,75,"['1 frozen pie crust (see pie crust recipe for instructions to make your own)', 'Filling:', '3 1/2 to 4 cups chopped rhubarb stalks (about 1 lb)', '3/4 cup white granulated sugar', '1 Tbsp orange zest', '1/4 teaspoon cinnamon', '1/4 teaspoon ground ginger', '3 Tbsp instant tapioca or 2 Tbsp tapioca flour/starch (can sub 2 Tbsp corn starch)', 'Meringue:', '1 Tbsp cornstarch', '1/3 cup cold water', '1/4 teaspoon cream of tartar (can use vinegar instead of cream of tartar, see method instructions)', '1/2 cup white granulated sugar', '4 large egg whites (room temperature)', '1/2 teaspoon vanilla extract']",15,"['1 Pre-bake the pie shell: Heat the oven to 350\\xc2\\xb0F. Line the frozen pie shell with aluminum foil. Fill two-thirds of the way with pie weights (dry beans work well for this).', 'Bake for 20 minutes. Remove the crust from the oven. Lift up the edges of the aluminum foil to remove the foil and pie weights from the crust. Poke the bottom of the crust all over with the tines of a fork.', 'Return the pie crust to the oven, bake for an additional 10 to 15 minutes, or until it is nicely and lightly browned all over. Remove from oven and set aside.', '2 Prepare the filling: Gently mix the cut rhubarb, sugar, orange zest, cinnamon, and ground ginger in a medium saucepan. Let sit for 15 minutes so the sugar macerates the rhubarb and liquid is released.', ""Put the pan on the stove on medium heat. Stir in the instant tapioca or tapioca starch. (By the way, if you are using instant tapioca and you don't like seeing anything that might resemble tapioca, just run it through a blender to pulverize it into tapioca flour.)"", 'Slowly heat up the rhubarb until steamy. If you heat the rhubarb too quickly, the pieces will disintegrate into mush. The mush will still work in the pie, and taste good, but will look like pink oatmeal. You want to gently cook the rhubarb until it is a little tender, but not yet falling apart.', '3 Preheat oven to 325\\xc2\\xb0F.', '4 Start making the meringue topping: While the rhubarb is cooking, get started on the meringue. In a small bowl, whisk together the sugar and cream of tartar and set aside.', ""(Note that the cream of tartar is not absolutely required, but as a dry acid, it will help the meringue keep its structure. If you don't have cream of tartar you can alternatively support the meringue by adding a teaspoon of white vinegar to the egg whites when you start to whip them.)"", 'In a small saucepan, whisk the cornstarch and cold water together until the cornstarch is dissolved. Heat on the stovetop and stir with a whisk until the mixture gets bubbly and forms a gel. Remove from heat.', '5 Beat egg whites, add sugar and cream of tartar mixture, add cornstarch mixture Make sure that the egg whites you are using have absolutely no pieces of egg yolk or shell in them. Make sure that your mixer bowl for whipping the egg whites is spotlessly clean.', 'Any residual fat from another baking project in the bowl will make it difficult for the egg whites to whip up into a meringue.', 'Place the egg whites and vanilla in the bowl of an electric mixer. Start the speed on low and gradually increase the speed to medium.', 'Once the egg whites are frothy, slowly add the sugar and cream of tartar mixture, one tablespoon at a time. Beat until the sugar is incorporated an the mixture forms soft peaks.', 'Then add the cornstarch mixture, one tablespoon at a time. Increase the mixer speed to high, and beat until the mixture forms stiff peaks. Be careful not to over beat.', '6 Fill pie shell with rhubarb filling: The filling needs to be piping hot when the meringue goes on it, so if it has been allowed to cool, reheat it until it is steamy.', 'Pour the rhubarb mixture into the pre-baked pie shell, spreading it evenly along the bottom of the shell.', '7 Spread meringue mixture on top of rhubarb filling: Use a rubber spatula and immediately spread the meringue mixture evenly around the edge and then the center of the pie to keep it from sinking into the filling.', 'Make sure the meringue attaches to the pie crust to prevent shrinking. Use the back of a spoon to create peaks all over the meringue.', '8 Bake: Bake the pie at 325\\xc2\\xb0F until the meringue is golden brown, about 20 minutes. Transfer to a wire rack and let cool to room temperature. The pie can be refrigerated, but it is best served the same day.']",20
1026,Strawberry Rhubarb Crisp Recipe,10,70,80,"['For the topping:', '1 1/2 cups (190 g) rolled oats', '1 cup (140 g) all-purpose flour', '1/2 cup (110 g) packed dark brown sugar', '1/2 cup (100 g) white granulated sugar', '1/2 teaspoon ground cinnamon', '1/4 teaspoon kosher salt', '12 tablespoons (175 g or 1 1/2 sticks) unsalted butter, melted and cooled', 'For the filling:', '4 cups (620 g) strawberries, stemmed, hulled and, cut in half if large', '3/4 cup (250 g) white granulated sugar, divided', '1 tablespoon chopped candied ginger', '2 tablespoon cornstarch', 'Zest from 1 medium orange', '4 cups (500 g or a little bit over 1 pound) sliced rhubarb (1-inch chunks) from about 5 to 6 thick stalks or 10 to 12 skinny stalks', 'To serve:', 'Vanilla ice cream, store-bought or homemade', 'Special equipment:', '10-inch cast iron skillet']",19,"['1 Preheat the oven to 350\\xc2\\xb0F.', '2 Make the topping: Combine the oats, flour, both sugars, cinnamon, and salt in a medium-sized bowl. Mix with a balloon whisk until consistent in color and all the ingredients are evenly distributed. Use your fingers to break up any chunks of brown sugar.', 'Drizzle the melted butter over the dry ingredients, tossing with a fork until the topping starts to clump together and the dry ingredients are moist. Place the bowl in the refrigerator to chill while you prepare the fruit.', '  3 Macerate the strawberries: Combine the strawberries, 1/2 cup of the sugar, candied ginger, cornstarch and orange zest in a large bowl, tossing to make sure the strawberries are coated with the dry ingredients. Set aside.', '  4 Cook the rhubarb: Spray a 10-inch cast iron skillet with cooking oil, and add the rhubarb and the remaining 1/4 cup of sugar. Cook over medium-high heat, stirring constantly, for 5 to 7 minutes, or until the sugar has dissolved and the rhubarb juice starts to thicken. You want to cook off some of the liquid, but you don\\xe2\\x80\\x99t want the rhubarb to get mushy or break down.', '  5 Add the strawberries and bake in the oven: Add the strawberry mixture to the hot pan with the rhubarb, covering the rhubarb evenly. Bake in the oven for 30 to 35 minutes.', '6 Add the topping and continue baking: Take the pan out of the oven and sprinkle the crisp topping over the fruit filling. Return to the oven for an additional 15 to 20 minutes, or until the top of the crisp is golden brown and the fruit filling is bubbling hot.', '  7 Cool and serve: Let the crisp cool at least 15 to 20 minutes before serving, to allow the filling to thicken a bit. Serve with your favorite vanilla ice cream.', 'This crisp is best eaten the same day but you can store it in the fridge after it has completely cooled, covered with plastic wrap, for up to 2 days (the crisp topping will soften, but still be delicious). Warm up in a 350\\xc2\\xb0F oven for 10 to 15 minutes before serving.']",9
1027,Strawberry-Rhubarb Crumble Bars Recipe,15,40,55,"['For the crust and crumble dough', '3 cups (420 g) all-purpose flour', '1 cup (200 g) white granulated sugar', '1 teaspoon baking powder', '1/2 teaspoon ground cinnamon', '1/4 teaspoon kosher salt', '1 cup (225 g or 2 sticks) unsalted butter, cold', '1 large egg', 'For the fruit filling', '2 cups (250 g) diced 1/4-inch chunks) rhubarb (2 to 3 thick stalks or 5 to 6 thin stalks or a little over 1/2 pounds)', '2 cups (310 g) diced (1/4-inch chunks) strawberries (3/4 pounds)', '3 tablespoons white granulated sugar', '1 tablespoon cornstarch', '1 tablespoon lemon juice']",14,"['1 Preheat the oven to 375\\xc2\\xb0F. Spray a 9x13-inch pan with cooking oil. Line the pan with parchment paper with the one inch of extra parchment paper hanging over the sides.', '  2 Make the dough: Combine the flour, sugar, baking powder, cinnamon, and salt in a medium-sized bowl. Cut the butter into 1/2-inch chunks and sprinkle over the dry ingredients. Using your fingers, squish the butter, breaking it down into small bits and mixing the dry ingredients together. The butter should be the size of small peas, but flat, not in chunks.', 'Add the egg and toss together with a fork at first, then massage into the dough with your hand. The dough will be crumbly.', '   3 Divide the dough and shape the crust: Scoop 1 cup (about 170 g) of the crumbly dough and set it aside.', 'Dump the remaining dough into the bottom of the lined pan and press down on it firmly with your hands or with the flat bottom of a cup, to form an even layer of dough at the bottom.', '  4 Make the filling and add to the pan: Combine all the ingredients in a bowl (you can use the same bowl you made the dough if you\\xe2\\x80\\x99d like, no need to clean it). Spread it out evenly over the bottom crust.', '  5 Top with crumbles and bake: Sprinkle the reserved crumbly dough over the fruit filling. Bake in the oven 40 to 45 minutes, or until the top of the fruit is bubbling and the crumb topping is golden brown. Cool completely in the pan until it reaches room temperature.', '6 Cool and cut the bars: Use the side of the parchment paper to lift up and move the entire block carefully to a cutting board. Cut into bars. Serve at room temperature. Store in the refrigerator in an airtight container for 2 to 3 days.']",8
1028,Rhubarb Custard Pie Recipe,20,50,70,"['1 9-inch pie crust', 'For the filling:', '3 1/4 cups rhubarb (about 1 lb), cut in 1/2-inch pieces', '3 tablespoons all-purpose flour', '3/4 cup sugar', 'Zest from 1 large orange', '1/4 teaspoon ground cinnamon', '1/4 teaspoon ground nutmeg', '1/4 teaspoon salt', '2 large eggs, room temperature', '1/3 cup heavy whipping cream', '1 teaspoon vanilla extract']",12,"['1 When ready to assemble pie: Preheat oven to 375\\xc2\\xb0F.', '2 Roll out your pastry: Roll your pie crust into a 12- inch circle. Drape it over a 9-inch pie plate. Tuck the edges under and crimp it, so it looks pretty. Return it to the fridge.', '3 Prepare filling: Whisk flour, sugar, orange zest, cinnamon, nutmeg, and salt in a large bowl. Whisk eggs, heavy cream, and vanilla in another medium bowl. Add the wet ingredients to the dry ingredients and whisk to combine. Add the rhubarb and fold together with a spatula.', '4 Assemble the pie: Pour the filling into the crust. Smooth the top with a spatula.', '5 Bake the pie: Put the pie on a cookie sheet to protect your oven from spillovers. Fold aluminum foil in half and create a cover just around the edges of the pie crust, leaving the filling exposed.', 'Place the pie in the oven. Remove the foil halfway through the baking time. Bake until the custard is fully set, without a jiggle, and the crust is golden brown, about 45 minutes.', '6 Cool: Let cool on a wire rack to room temperature, about 45-50 min.', '7 Serve: Serve this pie slightly warm, cold, or at room temperature. Dust with powdered sugar just before serving. Store leftovers covered and in the refrigerator for up to 3 days.']",8
1029,Rhubarb Almond Skillet Cake Recipe,15,50,65,"['Butter (for the skillet)', '2/3 cup whole almonds with skins or 3/4 cup almond flour', '3/4 cup granulated sugar, divided', 'Zest of 1 medium orange', '1 cup all-purpose flour', '1 1/4 teaspoons baking powder', '1/8 teaspoon salt', '1/2 cup (1 stick) room temperature unsalted butter, cut into slices', '3 large eggs', '1 teaspoon vanilla extract', '2 to 3 stalks rhubarb (8 ounces), leaves removed, cut into 1-inch slices (about 2 cups)', 'Powdered sugar (for sprinkling)', 'Special equipment:', 'Food processor', '10-inch ovenproof skillet']",15,"['1 Heat the oven and prep the skillet: Preheat the oven to 350\\xc2\\xbaF. Generously butter a 10-inch ovenproof skillet with a heatproof handle.', '2 Toast the almonds: Spread the almonds on a baking sheet and bake for 8 to 10 minutes, or until they smell toasty. Cool briefly.', '3 Grind the almonds: In a food processor, add the almonds, 1/4 cup of granulated sugar, and orange zest. Process until the mixture looks like coarse sand. Transfer the mixture to a bowl. Remove 1/4 cup of the almond-sugar mixture for the topping and set aside.', '4 Combine the almonds and flour: Add the flour, baking powder, and salt to the almond-sugar mixture in the bowl. Whisk to combine.', '5 Make the batter: In the food processor, process the butter and the remaining 1/2 cup granulated sugar for 1 minute, or until light and fluffy. One at a time, add the eggs, processing for about 30 seconds after each addition and scraping down the sides of the food processor with a spatula. Add the vanilla and pulse to mix it.', 'Add the flour mixture to the food processor and briefly pulse the machine 4 to 5 times, just until the batter is smooth. It will be thick.', '5 Transfer to the skillet and top: Scrape the batter into the skillet, spreading it evenly in the pan with the back of a spoon or small spatula.', 'Sprinkle about half of the reserved almond-sugar mixture over the batter in the pan. Distribute the rhubarb over the top of the batter. Sprinkle with the remaining almond-sugar mixture.', '6 Bake the cake: Bake the cake for 50 minutes, or until a toothpick inserted into the middle of the cake comes out clean. Set the skillet on a wire rack to cool to room temperature. Sprinkle with powdered sugar and cut into wedges. Serve from the pan.']",9
1030,Peppercorn Steak Recipe,5,55,60,"['4 good-sized steaks (1/2 pound to a pound each, allow for 1/2 pound per person)', 'Salt', '2 tablespoons extra virgin olive oil or canola oil', '3 tablespoons black peppercorns, cracked', '1/4 cup finely chopped shallots or onions', '1/4 cup cognac or other brandy', '1 cup beef broth or stock (for gluten-free version use gluten-free stock)', '1/4 cup heavy cream', '1/4 cup finely chopped parsley']",9,"['1 Salt the steak and let sit at room temp: Sprinkle salt generously over both sides of the steaks and let them come to room temperature, about 30 minutes.', '2 Sear the steaks: Heat the oil in a large saut\\xc3\\xa9 pan over high heat. (Use a pan that can handle high heat. Cast iron works well for this, or hard anodized aluminum.) When the oil begins to smoke, take the pan off the heat.', 'Pat the steaks dry with paper towels (steaks brown better if they are patted dry first) and place in the hot pan. Return the pan to the heat and turn the heat down to medium-high.', 'Sear, without moving the steaks, for at least 4 minutes. Try to pick up a steak with tongs, and if it comes clean, flip it and turn the heat down to medium. If it sticks to the pan, let it cook for another minute or two on that side.', 'For this recipe, we sear on one side on high heat, and cook on lower heat on the other side. This way you get great flavor from the seared side, and better control over how done you want your steak by cooking the other side more slowly.', '3 When done, remove steaks from pan, sprinkle with crushed peppercorns: Use the finger test for doneness or a meat thermometer. For rare, remove the meat from the pan when the inside reaches 120\\xc2\\xb0F, for medium rare 125-130\\xc2\\xb0F, for medium 140\\xc2\\xb0F, and medium well 155\\xc2\\xb0F.', 'Once the steak is done to your liking remove the meat to a baking sheet and sprinkle on a generous portion of crushed black peppercorns on both sides of each steak. Tent with aluminum foil and let the steak rest while you are preparing the sauce.', '4 Make the sauce: Add the shallots to the pan and saut\\xc3\\xa9 for 2 minutes.', 'Add the brandy and as it boils, deglaze the pan by scraping the bottom of the pan with a wooden spoon (helps to have one with a straight edge) to dislodge all the browned bits.', ""Once the brandy is almost cooked away, add the beef stock and turn the heat to high. Boil the sauce down until there's a noticeable trail when you drag a wooden spoon through the center of it (4-5 minutes)."", 'Pour in the heavy cream and resume boiling. Again, boil down until you can make that telltale trail from the wooden spoon.', 'Turn off the heat and add the parsley and any remaining black pepper (no more than 1 Tbsp, the rest should have already been used to pepper the steaks). Taste for salt and add if needed.', '5 Serve: Pour the sauce over the steaks right when you serve.']",13
1031,How to Grill the Best Steak,65,15,80,"['For the steak:', '1 1/2-inch thick ribeye, bone in or out (about 1 1/2 lbs. without the bone)', '3/4 teaspoon coarse sea salt or kosher salt', '1 teaspoon freshly ground pepper', 'For the herb butter sauce:', '4 tablespoons butter', 'Leaves from 4 sprigs of thyme', '1 tablespoon minced fresh rosemary', '1 clove garlic, minced', '1 shallot, about half the size of a golf ball, minced']",10,"['1 Trim the fat: Remove the outer layer of fat from the ribeye. The interior marbling will flavor the meat, whereas the outer fat layer will produce flare ups on the grill, which can add a burnt (not charred) flavor to the steak.', '2 Season the steak and refrigerate: Pat the steak dry with a paper towel. This removes surface moisture and will help you achieve a good sear.', 'Season each side with salt and pepper and rub them in a bit. Put the steak in the fridge, uncovered, for at least an hour and up to 48 hours.', '3 Make the herbed butter: In a small saucepan, add butter, herbs, garlic, and shallots. Melt over low heat. Do this at least 10 minutes before you are ready to put the steak on the grill. The longer the herbs sit in the butter, the longer the flavors will infuse.', 'You can also make this butter up to 2 hours beforehand; if so, cover and refrigerate. Gently reheat the butter to melt it again before you put the steaks on the grill.', '4 Preheat the grill: Prepare a charcoal grill for two-zone grilling, so half is hot and one half is warm. The grill is hot when you can only hold your hand over the hot zone for a second or two.', 'On a gas grill, heat the grill to 450\\xc2\\xb0F with two burners going, which should only take about 10 minutes, then turn one of the burners down to medium to create two cooking zones.', '5 Cook and baste the steak: Add the steak to the hottest side of the grill. Close the lid and sear for 2 minutes. Open the lid, flip the steak, and baste it with the melted herb butter and herbs. Close the lid. Cook for 2 additional minutes.', 'Flip the steak again and move it to a lower heat side. Baste it again with butter. Continue flipping and basting every two minutes for the next 6 minutes, closing the lid between each flip.', 'After the steak has been on the grill for a total of 10 minutes (for medium-rare steak), transfer it to a clean platter; it should read 137\\xc2\\xb0F to 140\\xc2\\xb0F internally. Baste it again with butter. (Continue cooking for longer if you prefer your steak more well-done.)', '   6 Let the steak rest:  Let it rest for 5 minutes; it will climb another few degrees as it sits and the juices will redistribute.', '7 Slice and serve the steak: Slice the steak against the grain. Pour any remaining herb butter sauce over top and serve.']",12
1032,Shrimp Fried Rice Recipe,15,15,30,"['8 ounces small raw shrimp, shelled and deveined', '1/2 teaspoon kosher salt', 'freshly ground black pepper', '1/2 teaspoon cornstarch', '3 tablespoons peanut oil, canola oil, or rice bran oil', '3 eggs, beaten', '2 stalks green onion, minced', '4 cups leftover rice, grains separated well', '3/4 cup frozen peas and carrots, defrosted', '1 tablespoon soy sauce (use gluten-free soy sauce if you are making a gluten-free version), plus more to taste', '1 teaspoon dark toasted sesame oil']",11,"['1 Toss shrimp with salt, pepper, cornstarch: In a medium bowl, sprinkle the shrimp with salt, pepper, and cornstarch, and toss to coat. Set aside to sit for ten minutes at room temperature.', ""2 Heat pan on high heat: Heat a large saut\\xc3\\xa9 pan or wok (a seasoned cast iron pan or hard anodized aluminum works well, they're relatively stick free and can take the heat) on high heat."", 'When the pan is very hot (a drop of water instantly sizzles when it hits the pan), swirl in one tablespoon of the cooking oil to coat the pan.', '3 Sear shrimp on both sides: Add the shrimp to the hot pan, spreading them out quickly in a single layer. Let them fry in the pan without moving them, for 30 seconds.', 'Flip the shrimp over and let them fry on the other side for another 30 seconds or until they are mostly cooked through. (Do not cook them all the way!)', 'Use a slotted spoon to scoop the shrimp out of the pan to a bowl.', '4 Cook beaten eggs, slightly runny: Return the pan to the burner and lower the heat to medium. Add a little more oil if the pan needs it. Add the beaten eggs and stir them quickly to scramble them while they cook.', 'When the eggs are not quite cooked through, still a bit runny, transfer them from the pan to the bowl with the cooked shrimp.', '5 Saut\\xc3\\xa9 green onions, add rice: Clean out the pan or wok with paper towels and return it to the burner. Heat the pan on high and when it is hot, swirl in the remaining tablespoon or two of oil. When the oil is shimmering hot (almost smoking), add the green onions and saut\\xc3\\xa9 for 15 seconds.', 'Then add the leftover cooked rice to the pan and stir with the green onions to mix well.', 'Spread the rice onion mixture over the surface of the pan and let it fry, without moving it. You should hear the rice sizzle. Cook for about 1 to 2 minutes.', 'Use a spatula to turn over the rice, and spread it over the pan again. Let cook for a minute longer.', '6 Add soy sauce, carrots, peas, shrimp, eggs, sesame oil: Sprinkle soy sauce on the rice and stir to combine.', 'Add the carrots, peas, shrimp, eggs, and sesame oil, stirring to combine well.', 'Heat everything until sizzling hot. Add more soy sauce to taste.']",15
1033,Jeweled Rice Salad Recipe,20,45,65,"['For the salad:', '1 1/2 cups wild rice', '8 cups water', '1 1/4 teaspoons salt, divided', '1 half butternut squash, peeled (about 1 pound), cut into 3/4-inch cubes', '3 tablespoons Filippo Berio Delicato Extra Virgin Olive Oil, divided', '1/8 teaspoon ground black pepper', '1/3 cup blanched slivered almonds', '1/3 cup shelled pistachios', '1/2 red onion, finely chopped', '1/2 teaspoon ground cinnamon', '1/2 teaspoon ground coriander seed', '1/2 teaspoon ground turmeric', '1/8 teaspoon ground cloves', '1/3 cup dried cranberries', '1/3 cup golden raisins', '1/3 cup finely diced apricots', 'Finely grated zest of 1 orange', '1/2 cup pomegranate seeds (from about 1/2 pomegranate)', '1 handful of torn mint leaves', 'For the dressing:', '1/3 cup freshly squeezed orange juice', '2 tablespoons white wine vinegar', '1 teaspoon honey', '1/4 teaspoon salt', '1/8 teaspoon ground black pepper', '1/3 cup Filippo Berio Delicato Extra Virgin Olive Oil']",27,"['1 Cook the rice: In a large pot, bring 8 cups water and 1 teaspoon of the salt to a boil. Add the rice, return the water to a boil, and immediately reduce the heat to a gentle simmer. Simmer for 45 minutes, or until the rice is tender.', 'Drain in a sieve or fine-mesh colander. Transfer to a large bowl.', '2 Roast the squash: Preheat the oven to 450\\xc2\\xbaF. On a rimmed baking sheet, mound the squash in the center. Sprinkle with 2 tablespoons of the olive oil, remaining 1/4 teaspoon salt, and pepper. Toss to coat the squash, massaging the olive oil into the cubes to coat them.', 'Spread in one layer and roast for 20 to 25 minutes, or until tender. Remove and cool on the baking sheet.', ' 3 Toast the nuts: In a medium skillet over medium heat, toast the almonds and pistachios until the almonds are golden and the nuts are fragrant, about 4 minutes. Transfer to a plate. ', '4 Cook the onions and bloom the spices: Add the remaining 1 tablespoon olive oil to the skillet. Over medium heat, cook the onions, stirring occasionally, for 4 to 5 minutes or until softened. Add the ground cinnamon, ground coriander, turmeric, and ground cloves. Stir for 30 seconds.', 'Fold in the cranberries, raisins, and apricots and remove from heat.', ' 5 Make the dressing: In a small bowl, combine the orange juice, vinegar, honey, salt, and pepper. Whisk in the olive oil until emulsified. Taste and add more salt or pepper, as desired.', '6 Assemble the salad: Add the squash, toasted nuts, onions, spices, dried fruits, and orange zest to the bowl of rice. Toss with half the dressing (you will have more than you need). Taste and add more salt, pepper, or dressing as desired.', ' 7 Serve: Mound the rice on a platter or in a serving bowl, and garnish with the pomegranate seeds and mint leaves. Serve at room temperature.']",10
1034,Mushroom Risotto Recipe,10,45,55,"['2 Tbsp butter', '2 cups flavorful mushrooms such as shiitake, chanterelle, or oyster mushrooms, cleaned, trimmed, and cut into half inch to inch pieces', '2/3 cup brandy, vermouth, or dry white wine', '5-6 cups chicken stock* (use vegetable stock for vegetarian option)', '1/3 cup of peeled and minced shallots (OR 1/3 cup of yellow or white onion, finely chopped)', '1 3/4 cups arborio rice or other risotto rice', '1/3 cup freshly grated Parmesan cheese', 'Salt and freshly ground black pepper', '2 Tbsp chopped fresh parsley or chives', '*If cooking gluten-free, use homemade stock or gluten-free packaged stock.']",10,"['1 Bring stock to a simmer in a saucepan.', '2 Saut\\xc3\\xa9 the mushrooms: Melt the butter in a wide saucepan over medium-high heat. Add mushrooms and shallots and saut\\xc3\\xa9 about 5 minutes (if using chanterelles, dry saut\\xc3\\xa9 first for a minute or two and let the mushrooms cook in their own juices before adding the butter).', '3 Add rice and brandy: Add the rice and stir to combine. Add brandy, bring to a boil, and reduce liquid by half, about 3-4 minutes.', ""4 Add simmering stock, 1/2 cup at a time, stirring enough to keep the rice from sticking to the edges of the pan. Stir the rice almost constantly \\xe2\\x80\\x94 stirring sloughs off the starch from the rice, making the creamy sauce you're looking for in a risotto."", 'Wait until the stock is almost completely absorbed before adding the next 1/2 cup.', 'This process will take about 25 minutes. The rice should be just cooked and slightly chewy.', '5 Stir in the Parmesan cheese and season to taste with salt and pepper. Garnish with chopped fresh parsley or chives.']",7
1035,Coconut Rice and Beans Recipe,5,25,30,"['2 Tbsp vegetable oil', '1/2 yellow onion, chopped', '4 garlic cloves, chopped', '2 cups long-grain rice', '1 teaspoon salt', '1 teaspoon grated fresh ginger', '1 cup water', '1 cup chicken stock (or vegetable stock for vegetarian option)', '2 cups coconut milk', '1 15-ounce can kidney beans, rinsed and drained, or 1 1/2 cups cooked kidney beans', '2 teaspoons dried thyme', '1 whole Scotch bonnet chile (can substitute a whole habanero)', 'Lime (optional)']",13,"['1 Saut\\xc3\\xa9 onions: Heat the oil in a medium pot over medium-high heat. Add the onions and saut\\xc3\\xa9 for 4-5 minutes, until they begin to brown on the edges.', '2 Add garlic and rice: Add the garlic and rice, stir well and cook for another 2-3 minutes, stirring often.', '3 Add remaining ingredients: Add the grated ginger, salt, water, stock and coconut milk and stir well. Add the kidney beans and sprinkle the thyme over everything. Add the whole Scotch bonnet chile (or habanero); it will season the rice much like a bay leaf would.', '4 Cook: Bring to a simmer, then turn the heat to low and cover. The rice should be done in about 15-20 minutes, depending on the type of rice you are using (some long grained rice takes longer to cook). Check after 15 minutes.', '5 Remove from heat, cover: Once done, remove from heat and cover for 10 minutes.', '6 Serve: Fluff with a fork. Sprinkle with a little lime juice if you want. Discard the habanero (or eat it, if you dare!)']",6
1036,Slow Cooker Chicken and Rice Casserole Recipe,10,150,160,"['2 pounds bone-in, skin-on chicken thighs (or 1 1/2 pounds boneless, skin-on chicken thighs)', 'Kosher salt', '2 tablespoons extra virgin olive oil', '4 cups sliced yellow onion, 1/4-inch thick slices, sliced root to tip (about 2 large onions)', '1 teaspoon ground cumin', '1/4 teaspoon ground cinnamon', '4 teaspoons finely chopped garlic (about 4 cloves)', '2 cups raw basmati long grain rice', '1 cup diced canned (or fresh) tomatoes', '1/2 cup frozen peas (optional)', '1 1/2 cups chicken stock', '3/4 teaspoon black pepper', '2 bay leaves', 'Special equipment:', '6-quart slow cooker, preferably with a metal insert']",15,"['1 Salt the chicken: Sprinkle salt (about 2 teaspoons) on both side of the chicken thighs, and let them sit while you prep and cook the onions.', '2 Saut\\xc3\\xa9 the onions, garlic, spices: Heat 2 tablespoons of olive oil in a large saut\\xc3\\xa9 pan on high heat. When the oil is shimmery hot, but not smoking, add the sliced onions and cook until lightly browned, stirring frequently, about 6 minutes.', 'Lower the heat to medium and stir in the ground cumin and cinnamon. Let cook for a minute. Add the garlic and cook for half a minute more. Place cooked onions and garlic into the bowl of a slow cooker. (Do not wipe down the saut\\xc3\\xa9 pan.)', '3 Brown the chicken thighs: Heat the saut\\xc3\\xa9 pan on medium. Add the chicken thighs, skin-side-down in the pan. Let cook on medium heat until the skin is well-browned and much of the chicken fat from the skin has rendered out (about 10 to 12 minutes).', 'Turn the chicken pieces over and brown the skinless side for 4 to 5 minutes more.', '4 Combine everything in the slow cooker: While the chicken is cooking, add the raw long grain rice into the slow cooker with the onions, stir to combine. Stir in the diced tomatoes, peas (if using), stock, pepper, bay leaves. Stir in 1 1/2 teaspoons of salt.', 'When the chicken has finished browning, place the chicken pieces skin-side up in the pot.', '5 Slow cook for 2 to 3 hours on the high setting of your slow cooker. The timing depends on your particular slow cooker. My All-Clad model with a metal bowl heats up very quickly and only takes 2 hours to cook this dish. Slow cooker models with a ceramic bowl heat up much more slowly and probably would take 3 hours to cook.', ""I suggest checking about halfway through the cooking time to see how the rice is cooking. If it is drying out (could be your lid isn't tight fitting, or the rice just needs more water), add another half cup to cup of water."", 'Fluff the rice with a fork to serve. Add more salt to taste.']",10
1037,Wild Rice Salad with Cranberries and Pecans Recipe,0,60,60,"['1 cup brown rice wild rice mix', '2 1/3 cups water (see package instructions)', '1/2 teaspoon salt', '1/2 cup dried cranberries', '1/2 cup chopped pecans (toasted or un-toasted, your choice)', '1/4 cup sliced green onions', '1 tablespoon lemon juice', '2 tablespoons extra virgin olive oil', '1 teaspoon grated orange peel', 'Salt and freshly ground pepper']",10,"['1 Make the rice: Use the amount of water for the rice according to instructions on the rice package. Typically straight brown rice is a 1:2 ratio of rice to water. Straight wild rice is a ratio of 1:3 of wild rice to water. For this brown rice wild rice mix that I got from a bin (no package) I used a ratio of 1 cup of rice to 2 1/3 cups of water.', 'Bring rice, 1/2 teaspoon salt, and water to a boil, reduce heat to low, cover and cook for 50 minutes. Do not stir. Do not uncover.', 'Remove from stove and let sit, covered for 10 minutes.', 'Then uncover, fluff up with a fork, and let cool to almost room temperature.', '2 Mix the rice with the dried cranberries, pecans, green onions: In a medium sized serving bowl, mix the rice, cranberries, pecans, and green onions together.', '3 Make the dressing: In a separate jar, mix the lemon juice, olive oil, orange peel, and salt and pepper to taste.', 'Just before serving, mix dressing in with the rice mixture. Serve warm, chilled, or room temperature.']",7
1038,Weeknight Chicken Biryani Recipe,20,40,60,"['1 1/2 cups (150g) long-grain white rice, like basmati', '4 bone-in, skin-on chicken thighs (about 1 1/2 pounds)', '1 teaspoon salt, or more to taste', '1/2 teaspoon black pepper, or more to taste', '2 tablespoons vegetable oil', '1 large yellow onion, coarsely chopped', '1 piece (2 inches) fresh ginger, peeled and finely chopped', '1 teaspoon ground turmeric', '1/2 teaspoon ground cardamom, plus more to taste', '1 stick cinnamon', '1 bay leaf', '1/2 cup golden raisins', '2 1/2 cups chicken stock or water', '1/4 cup skinned or unskinned whole almonds, or sliced almonds', '2 tablespoons chopped fresh cilantro']",15,"['1 Rinse the rice: In a bowl of water, swirl the rice with your hands several times. Tip the rice into a fine-mesh strainer. Refill the bowl with water, then add the rice back in and swirl again -- the water should be clear now. If so, tip the rice back into the strainer and leave to drain until needed. If the water was not clear, repeat rinsing with fresh water until the water is clear.', '2 Prepare the chicken: Cut each thigh in half along the bone; the pieces will be uneven in size with the bone in one half. Sprinkle the chicken all over with salt and pepper.', '3 Sear the chicken: In a large Dutch oven or heavy pot over medium heat, heat the oil. When it is hot, add the chicken, skin side down. Cook for 5 minutes without disturbing. Turn the chicken and cook the other side for 4 minutes. Transfer to a bowl. Discard all but 2 tablespoons fat from the pan.', '4 Cook the onion and spices: Add the onion and ginger to the pot and turn the heat to medium-low. Cook, stirring often, for 8 minutes, or until they soften. Add the turmeric and cardamom. Cook, stirring, for 1 minute more.', '5 Add the rice and seared chicken: Add the rice to the pan and stir it into the onion and spices.', 'Return the seared chicken to the pan, along with any juices that have accumulated in the bowl. Turn the chicken in the spices so the pieces are coated all over.', 'Add the cinnamon, bay leaf, raisins, and water.', '6 Cook the biryani: Bring the water to a boil, then lower the heat and cover the pan. Simmer for 18 minutes, or until the rice is tender and the chicken is cooked through. Remove the pan from the heat; set aside for 5 minutes.', '7 Toast the almonds: In a dry skillet over medium heat, toast the almonds, shaking the pan often, for 5 minutes or until they are aromatic. Chop coarsely.', '8 Serve the biryani: Remove the bay leaf and cinnamon stick from the rice. Taste and add additional salt, pepper, or cardamom to suit your taste. Sprinkle the dish with almonds and cilantro.']",10
1039,Ginger-Soy Steamed Salmon with Spicy Maple Sauce Recipe,10,20,30,"['1 to 1 1/2 pounds fresh salmon, skin on', '1-inch piece fresh ginger, sliced', '1 lemon, sliced', '1 large head bok choy', '1 red pepper, sliced', '1 tablespoon soy sauce', 'Salt and pepper', 'To serve:', 'Cooked long grain white rice', 'Roasted sesame seeds, garnish', 'DAD ADD: Spicy Maple Sauce', '1/2 cup maple syrup', '2 tablespoons soy sauce', '1/2 teaspoon red pepper flakes', '1/2 teaspoon toasted sesame oil', 'Special equipment:', 'Bamboo steamer']",17,"['1 Prep the salmon: If you have a large side of salmon, cut it into 4-ounce to 6-ounce portions and remove the pin bones using tweezers. (You can also ask your fishmonger to remove them if he or she is a good one.) Season the fish with salt and pepper.', '2 Assemble the ingredients in the steamer: Take some of the larger bok choy leaves and place them on the top tray of the bamboo steamer. Set the salmon filets on the leaves, skin side down, and place sliced ginger and lemon on top.', '3 Add the rest of the veggies: In the bottom steamer tray, add the rest of the bok choy leaves (chopped roughly) and a sliced red pepper. Sprinkle a tablespoon of soy sauce over the veggies.', '4 Steam the salmon: Stack the steamer baskets on top of each other. The the basket with veggies should be on bottom with the salmon basket should be on top, and then add the bamboo lid. You are ready to steam!', 'Bring a pot of water to boil and place the steamer tray over the pot. The steamer should sit on top of the pot and overlap slightly. It should not fit inside the pot.', ""Steam the fish and veggies for 16 to 20 minutes. That should be enough to cook the fish through and tenderize the veggies without making them mushy. Check the fish to make sure it's cooked through (it will flake easily with a fork) and continue steaming if needed."", '5 Make the spicy maple sauce: In a small saucepan, combine all the ingredients. Bring to a simmer and turn heat down to low. Simmer for 4 to 5 minutes, stirring occasionally, until the sauce coats the back of a spoon.', 'Watch it closely as it can boil over. Remove and let cool and it will continue to thicken as it cools.', '6 Cool slightly before serving: Remove the steaming tray using oven mitts (it will be very hot). Let cool for a few minutes before serving.', '7 Serve. Season with extra soy sauce, if desired, and sprinkle with sesame seeds as a garnish. Spoon Maple Sauce over the top of the fish, optionally. Serve with cooked rice.']",10
1040,Saffron Rice Pilaf Recipe,10,40,50,"['1/2 teaspoon saffron threads', '2 tablespoons ghee or clarified butter (see Recipe Note)', '4 cardamom pods', '1 small (2-inch) cinnamon stick', '4 whole cloves', '10 black peppercorns', '2 1/2 cups long grain white rice', '2 teaspoons Kosher salt', 'Zest from one orange (about 1 1/2 teaspoons, packed)', '2 tablespoons pistachios', '2 tablespoons blanched slivered or sliced almonds', '2 tablespoons golden raisins']",12,"['1 Soak saffron in hot water: Heat a large kettle of water (a little more than a quart) to boiling. Place saffron in a small bowl, cover with 2 tablespoons of the hot water, set aside.', '2 Fry the spices: Heat 2 tablespoons of ghee or clarified butter in a 2 quart, thick-bottomed saucepan on medium-high heat until hot. Add the cardamom pods, cinnamon stick, cloves, and peppercorns to the pan. Gently fry the spices for 2 minutes.', '3 Brown the rice: Add rice, and fry for 3 more minutes, stirring after a minute or two. Some of the rice should brown at the bottom of the pan.', '4 Add water and seasonings, and cook: Remove the pan from heat. Add four cups of the hot water you prepared in step one to the pan, taking care to add slowly as it may bubble up and splatter. Add two teaspoons of salt. Add the saffron threads and their soaking liquid. Add the orange zest.', 'Stir, bring quickly to a boil, reduce the heat to the lowest setting. Cover tightly and cook for 20 minutes.', '4 Toast pistachios and almonds: While the rice is cooking, in a small frying pan, heat on medium high heat and add the pistachios and slivered almonds. Toast until lightly browned, about 3 or 4 minutes, remove from pan into a bowl.', '5 Remove spices, add raisins: After 20 minutes, remove the lid from the rice, pick out the spices that have floated to the top of the rice - the cinnamon stick, any whole cardamom pods, black peppercorns or cloves.', 'Scatter golden raisins over the top of the rice. Replace the lid and cook for 5 more minutes.', '6 Stir in the toasted almonds and pistachios and serve.']",9
1041,Mediterranean Chickpea Bowls with Tahini Sauce Recipe,20,5,25,"['For the tahini dressing:', '1/4 cup tahini (at room temperature)', '1/4 cup warm water', 'Juice 1/2 to 1 lemon (1 to 2 tablespoons)', '1 teaspoon honey, agave, or maple syrup', '1 clove garlic, finely minced', '1/4 cup finely minced parsley', '1/4 teaspoon salt', '1/4 teaspoon pepper', 'For the chickpeas:', '1 16-ounce can chickpeas (or 2 cups homemade chickpeas)', '1/2 tablespoon paprika (either sweet or hot)', '1/2 tablespoon ground cumin', '1 teaspoon ground coriander', '1/4 teaspoon salt', '1/4 teaspoon pepper', '1 tablespoon olive oil, divided', '1 clove garlic, minced', '1 teaspoon finely minced fresh chili (optional)', '1/2 cup finely chopped fresh herbs (I like the combination of parsley, mint, and cilantro)', 'For the bowls:', '6 cups baby spinach', '2 cups cooked brown rice', '1 pint cherry or grape tomatoes, halved', '1 English cucumber, diced', '1/4 red onion, finely diced (about 2 tablespoons)', 'Fresh mint leaves']",27,"['1 Make the tahini dressing: In a small bowl, whisk tahini with 2 tablespoons of the warm water, 1 tablespoon of the lemon juice, honey, minced garlic, parsley, salt, and pepper.', 'Give the dressing a taste. Add salt if needed. If it needs more acid or tastes slightly bitter, add more lemon juice one teaspoon at a time. If the dressing is too thick, add more water a tablespoon at a time.', 'Dressing can be made several days ahead and kept refrigerated. You may need to allow it to warm slightly at room temperature (or very briefly in the microwave) to loosen it up before using.', '2 Warm the chickpeas: Drain chickpeas and rinse well in a colander. Rub the chickpeas gently with a clean, lint-free towel to dry, or let them air dry for about 10 minutes. When dry, toss the chickpeas in a mixing bowl with the paprika, cumin, coriander, salt, pepper. Add 1/2 tablespoon of the olive oil and mix until well-coated.', 'Warm a large skillet over medium-high heat until hot enough that a drop of water sizzles on contact. Add the remaining 1/2 tablespoon of olive oil and tilt the pan to evenly coat.', 'Immediately add the chickpeas. Stir constantly until they are warmed through, 3 to 5 minute). Turn off heat, then add garlic and chili (if using), and mix well.', 'Toss with fresh herbs just before serving. (The chickpeas are best if served while still warm, but are also good if you make them ahead and serve cold.)', '3 Assemble the bowls: Divide the spinach evenly between four bowls. Top each bowl with 1/2 cup of the brown rice, 1/2 cup warm chickpeas, a quarter of the tomatoes, a quarter of the cucumber, and a quarter of the red onion. Drizzle with tahini dressing, and top with fresh mint leaves.']",8
1042,Rice Pilaf with Mushrooms and Pine Nuts Recipe,0,60,60,"['Up to 4 cups of chicken or vegetable stock (vegetable stock for vegetarian option, gluten-free stock for gluten-free version), depending on the type of rice you are using, or a mixture of water and stock*', '1/2 cup pine nuts', '5 ounces shiitake, cremini, or button mushrooms, roughly chopped', '1 tablespoon extra virgin olive oil', '2 cups long grain white rice', '1/2 cup chopped green onions or yellow onions', '2 teaspoons salt, plus more to taste', '1/2 teaspoon ground black pepper, plus more to taste', '2 tablespoons butter', '1 cup (loosely packed) chopped arugula, watercress, or 1/2 cup chopped fresh parsley', '* The amount of stock you use for this recipe is dependent on the type of rice you are using, and the cooking directions on the package of rice. For example, if your rice calls for 1 3/4 cups of liquid for 1 cup of rice, then use 3 1/2 cups of stock/water for the 2 cups of rice that this recipe calls for.']",11,"['1 Heat the stock: Measure out the stock according to the liquid requirements on your package of rice for 2 cups of rice. Place in a 2 quart sauce pan and bring to a simmer. While the stock is heating, prepare the pine nuts, mushrooms, and rice in the next three steps.', '2 Toast the pine nuts: Heat a large saut\\xc3\\xa9 pan on medium high heat. Add the pine nuts. Toast, stirring occasionally until lightly browned and fragrant. Remove the pine nuts from the hot pan to a bowl, set aside.', '3 Saut\\xc3\\xa9 the mushrooms: Return the pan to the heat. Add the chopped mushrooms. Dry saut\\xc3\\xa9 the mushrooms (using no fat), stirring occasionally, until the mushrooms give off much of their moisture and begin to brown slightly. Remove the mushrooms from the pan, set aside (can add to the same bowl as the pine nuts.)', '4 Brown the rice: Add olive oil to the pan and increase the heat to high. Add the white rice, spreading the rice out in the pan and stirring to coat with the oil. Cook for a couple of minutes, stirring occasionally, until the rice begins to brown.', '5 Add the onions, then the pine nuts and mushrooms: Mix in the onions, and cook for a couple minutes more, until the onions soften and turn translucent. Add the pine nuts and mushrooms to the rice and remove from heat.', '6 Combine rice mixture and stock: Carefully add the rice mixture to the saucepan with the hot stock. Mix in the salt and pepper. Bring to a simmer, reduce the heat, and cover the pan.', 'Cook according the the rice package instructions, anywhere from 15 to 45 minutes, depending on the type of rice. Remove from heat and let sit covered for 10 minutes.', '7 Stir in butter and greens: Stir in the butter and and chopped arugula, watercress, or parsley. Fluff up with a fork. Add more salt and pepper to taste.']",8
1043,Wild Rice Stuffing Recipe,10,75,85,"['2 cups wild rice', 'Salt', '3/4 pound mushrooms, sliced', '3 celery stalks, chopped', '1 medium yellow or white onion, chopped', '5 Tbsp unsalted butter', '1 cup walnuts', '1 1/2 cups dried cranberries', '1-2 Tbsp fresh sage, minced', '4 cups bread croutons', '2 cups chicken, vegetable or turkey stock']",11,"['1 Cook the wild rice: Bring a large pot of salted water to a boil, then add the wild rice. Cover, turn the heat to low and simmer until the rice is tender, about 25 minutes or so.', '2 Preheat the oven to 350\\xc2\\xb0F.', ""3 Saut\\xc3\\xa9 the mushrooms, add celery, onion: As the rice is cooking, heat a large saut\\xc3\\xa9 pan on high for 1 minute. Add the mushrooms and shake the pan a little so they don't stick. Dry saut\\xc3\\xa9 the mushrooms, stirring often, until the release their water."", 'When most of the water has burned off, sprinkle salt over the mushrooms, add 3 Tbsp of the butter, onion and celery and toss to combine. Saut\\xc3\\xa9 for 4-5 minutes, stirring often.', '4 Add cooked rice, sage, croutons, dried cranberries, walnuts, salt: Drain the rice when it is tender (most of the grains will have split by then) and add the rice to the saut\\xc3\\xa9 pan. Turn off the heat and add the sage, croutons, dried cranberries and walnuts. Sprinkle a little more salt over everything. Stir to combine.', '5 Add chicken stock, butter then bake: Put the dressing into a large, oven-proof pot with a lid and dot with the remaining butter.', 'Add the chicken stock, cover and bake for 45 minutes. If you want, take the cover off for the last 15 minutes to brown the top.']",7
1044,BBQ Chicken Burrito Bowl Recipe,15,10,25,"['For the BBQ sauce (or substitute 3/4 to 1 cup bottled sauce):', '1 cup ketchup', '1/2 cup tomato sauce', '2 tablespoons distilled white vinegar (apple cider vinegar also works)', '2 tablespoons Worcestershire sauce', '1 tablespoon honey (light brown sugar or maple syrup also works)', '2 1/2 teaspoons paprika', '1/2 teaspoon granulated garlic', '1/2 teaspoon salt', '1/4 teaspoon ground cumin', 'For the burrito bowls:', '1 pound (450g) chicken breasts (or substitute 2 cups cooked, shredded chicken)', '4 cups chicken broth or water, for cooking the chicken', '1 cup uncooked brown rice (or substitute 3 cups cooked rice)', '1 1/4 cup fresh or frozen corn kernels', '1 15-ounce (425g) can black beans, drained and rinsed', '6 to 8 romaine lettuce leaves, chopped into strips', '1 cup pico de gallo or your favorite salsa', '1 cup shredded cheddar or monterey jack cheese, optional', 'Crushed tortilla chips, for topping']",20,"['Do-ahead steps:', '1 Make the barbecue sauce (or substitute 3/4 to 1 cup bottled sauce): Mix all of the ingredients for the BBQ sauce (ketchup through cumin) in a saucepan and heat over medium heat. When the sauce starts bubbling, reduce the heat to low and simmer for 5 minutes, stirring frequently. (This sauce splatters everywhere once it heats up. Be prepared to wipe down your stovetop and countertops after making this!) Remove from heat.', 'You should have about 1 2/3 cups of sauce.  The sauce will keep for 1 to 2 weeks refrigerated.', '2 Cook the chicken (or substitute 2 cups shredded cooked chicken): Place the chicken breasts in a 4-quart or larger pot with a lid and pour the chicken broth over top. The chicken should be covered by about an inch; add additional broth or water if needed. Place over high heat and bring to a boil. Reduce heat to low, cover, and cook for 10 minutes. Check that the chicken is cooked through and registers 165F in the thickest part. Cook another few minutes if needed. Use tongs to transfer the cooked chicken breasts to a cutting board to cool briefly.', 'When the chicken is cool, shred the meat into bite-sized pieces. Refrigerate in an air-tight container for up to 5 days.', '3 Cook the rice (or substitute 3 cups cooked rice): Combine the rice with 1/2 teaspoon of salt and 2 cups of water (or enough to cover by about an inch). Bring to a simmer over medium heat, then lower the heat and cover. Cook until the rice is tender, 35 to 45 minutes (or according to package instructions). Check occasionally and add more water if the pan seems dry before the rice is cooked.', 'Cool the cooked rice, and then transfer to a storage container. Refrigerate for up to 5 days.', '  To assemble the burrito bowls:', '1 Mix the chicken with the barbecue sauce: Warm the barbecue sauce for a few minutes in a small pan or skillet over medium-high heat. Add the shredded chicken and stir to coat with the barbecue sauce. Leave the chicken in the pan until it has warmed through, about 2 to 3 minutes. Turn off heat.', '2 Warm the corn and beans: Heat the corn and black beans together or separately in a pan or skillet over medium-high heat for 2 to 3 minutes. Add a pinch of salt to your corn and beans and turn off heat.', '3 Warm the rice in the microwave or on a pan. If you are using the microwave, pour the rice into a large bowl and cover it with a damp paper towel. Microwave the rice on high for about 1 minute. Check to see if the rice has warmed through. If it is still cold in some spots, give everything a stir and continue microwaving at 15-second intervals, until the rice is heated to your liking.', '4 Assemble the burrito bowls: Divide the rice, chicken, corn, beans, romaine lettuce, and pico de gallo into 4 bowls. Top with cheese, if using, and then crush a few tortilla chips on top of each bowl for extra crunch.']",12
1045,"Basmati Rice Salad with Peas, Mint, and Lemon Recipe",15,45,60,"['Rice:', '2 cups uncooked basmati rice (which will yield 5 to 6 cups cooked rice)', '3 cups water (or more, depending on the package instructions)', '1/2 teaspoon salt', '2 2-inch strips of fresh lemon zest (use a vegetable peeler to take just the zest, not the whole peel, off of a fresh lemon)', 'Mix-ins:', '2 cups shelled English peas (from about 1 1/2 to 2 pounds of shell-on peas), or 2 cups of frozen peas', 'Salted water for blanching (1 quart water, 1 1/2 teaspoons salt)', '1/4 cup golden raisins or currants, plumped in enough water to cover the raisins for 5 to 10 minutes, then drained', '1/2 cup minced green onions, including the greens (about 2 green onions)', '1 1/2 teaspoons finely grated lemon zest', '1 teaspoon finely minced fresh mint leaves (spearmint)', '2 Tbsp lemon juice', '1/4 cup extra virgin olive oil', '1/2 teaspoon salt']",15,"['1 Cook the rice: Put 2 cups of basmati rice in a medium thick-bottomed pot. Add 3 cups of water (less or more depending on package instructions), 1 teaspoon of salt and 2 strips of lemon zest. Bring to a boil, lower the heat to a low simmer, cover the pot and let cook for 15 minutes (again check your package instructions).', 'Remove from heat, keep covered, and let steam for 10 minutes.', '2 Prepare peas: If using fresh peas, blanch them in boiling salted water for 3 to 4 minutes, depending on the size and freshness of the peas (larger older peas will take longer than smaller fresher peas). Strain peas from blanching water and place in a bowl of ice water to shock them and stop the cooking, then strain.', 'If using frozen peas, they are already blanched, so defrost them by placing them in a strainer and running lukewarm water over them for a minute.', '3 Cool the rice to room temp: Once the rice is cooked, spread the rice out on a large baking sheet pan to cool quickly. Let cool for 10 minutes, or until room temperature. Place in a large serving bowl.', '4 Combine rice with mix-in ingredients to serve: To the rice add the peas, raisins, green onions, mint, lemon zest, lemon juice, olive oil, and salt. Toss to combine and serve.']",6
1046,How to Make Rice in the Instant Pot,0,25,25,"['2 cups rice (any variety)', '2 cups water', '1/2 teaspoon salt', 'Special equipment:', '6-quart pressure cooker']",5,"[""1 Rinse the rice: In a fine wire mesh colander, rinse the rice under cold running water for about 30 seconds, until the water is less cloudy (it won't be quite clear). Drain off the excess water for a minute or so, until water is no longer dripping from the colander. (Note: If you\\xe2\\x80\\x99re using brown rice, you can skip this rinsing step.)"", '2 Add the rice and water to the cooker: Add the rice to the pressure cooker, along with the 2 cups of water and salt. Swivel the inner pot in the housing a little bit so that the rice settles into an even layer in the pot. Secure the lid with the release valve in its \\xe2\\x80\\x9cSealing\\xe2\\x80\\x9d position.', '3 Cook the rice on low pressure: If using white rice, select the \\xe2\\x80\\x9cRice\\xe2\\x80\\x9d cooking program on its low pressure setting. (If your pressure cooker doesn\\xe2\\x80\\x99t have high and low pressure settings, just use the default \\xe2\\x80\\x9crice\\xe2\\x80\\x9d setting.) The pressure cooker will adjust the cooking time automatically. For manual instructions, set the cooking time for 15 minutes on low pressure.', 'If using brown rice, select the \\xe2\\x80\\x9cMultigrain,\\xe2\\x80\\x9d \\xe2\\x80\\x9cPressure Cook,\\xe2\\x80\\x9d or \\xe2\\x80\\x9cManual\\xe2\\x80\\x9d setting and set the cooking time for 20 minutes at high pressure for chewy, separate grains of rice. For slightly softer rice, increase the cooking time to 22 minutes.', '4 Let the pressure naturally release for 10 minutes: When the cooking program ends, let the pressure release naturally for 10 minutes, then move the pressure release valve to its \\xe2\\x80\\x9cVenting\\xe2\\x80\\x9d position to release the remaining steam.', 'Open the pot, fluff the rice with a fork, and serve. (Leftover rice? Freeze it!)']",6
1047,Black Rice Bowls with Tofu and Veggies Recipe,30,35,65,"['For the miso ginger salad dressing', '1 piece (1-inch) fresh ginger, peeled and thinly sliced', '1/2 clove garlic, thinly sliced', '1/4 cup water', '2 tablespoons rice vinegar', '2 tablespoons red miso (See recipe note)', '1 tablespoon low-sodium soy sauce', '1 tablespoon honey', '1/4 cup olive oil', '1 tablespoon toasted sesame oil', 'For the baked tofu', '1 block (14 ounces) extra-firm tofu', 'Olive oil spray', '3 scallions, white and light green parts, thinly sliced', 'For the rice', '1 cup black rice or forbidden rice', '6 cups water', '1 teaspoon salt', 'For the pickles:', '1 cup unseasoned rice vinegar', '3 teaspoon salt, divided', '2 tablespoons sugar', '1/2 cup water', '1/2 small head of cauliflower, cut into small florets', '3 Persian (small) cucumbers', '1 tablespoon low-sodium soy sauce', '1 teaspoon sesame oil', ' For the kale', '1 bunch kale (any kind), washed, dried and stems removed', '2 tablespoons olive oil', 'Salt to taste', 'To serve', 'Toasted almonds, for garnish', 'Cilantro leaves or Thai basil, for garnish', '1/4 cup currants, for garnish']",35,"['1 Make the salad dressing: In a blender, finely chop the ginger and garlic.', 'Add the water, vinegar, miso, soy sauce, honey, olive oil and sesame oil and blend until smooth. (Dressing will keep for at least a week in the refrigerator.)', '2 Bake the tofu: Preheat the oven to 475\\xc2\\xbaF. Coat a baking dish or baking sheet with nonstick cooking spray. Cut the tofu into 1-inch cubes and thoroughly pat dry with paper towels.', 'Place the tofu in a bowl and add 3 tablespoons of the miso dressing. Toss to coat and transfer to the baking dish. Bake for 25 to 30 minutes, or until golden brown. Toss with the scallions and an additional 2 tablespoons of the miso dressing. Set aside.', 'The tofu can be baked up to three days ahead; wait to toss with scallions and the additional miso dressing until ready to serve.', '3 Cook the rice: In a large saucepan over high heat, bring 6 cups of salted water to a boil. Add the rice and cook for 25 to 30 minutes, or until tender (taste a few grains to test). Drain in a fine meshed sieve and transfer to a bowl until ready to use. (The rice will keep for about a week in the refrigerator.)', '4 Make the pickle brine: In a bowl, stir together the vinegar, 1 teaspoon of the salt and sugar until the salt and sugar dissolve. Stir in the water.', '5 Make the cauliflower pickles: Place the cauliflower in a bowl and cover with 1 cup of the pickle brine. Let sit at room temperature for about 30 minutes. (Store in the brine, covered, in the refrigerator for up to 1 week.)', '6 Make the smashed cucumber pickles: With a mallet or heavy pan, gently whack the cucumbers to crack the skin. Cut them in half lengthwise and then into 1-inch pieces. Sprinkle with the remaining 2 teaspoons of salt. Set a colander over a bowl, add the cucumbers and allow them to drain for 15 minutes.', 'Discard the liquid in the bowl. To the now-empty bowl, add the cucumbers (the cucumbers do not need to be rinsed). Toss with the remaining pickle brine (about 3 tablespoons), soy sauce, and sesame oil.', 'Cucumbers can be stored for a few hours before serving, but get mushy if stored for longer.', '7 Massage the kale: In a large bowl, toss the kale with the oil. Using your fingers, gently massage the oil into the leaves for about 1 minute. Tear them into bite size pieces as you work. Sprinkle lightly with salt to taste.', 'The kale can be massaged a few hours before serving, but become wilted if stored for longer.', '8 Assemble the bowls: Divide the rice between four bowls and top with tofu, cauliflower pickles, smashed cucumbers, and kale. Sprinkle with toasted almonds and currants. Serve with extra dressing on the side.']",14
1048,Ginger Pineapple Fried Rice Recipe,10,15,25,"['5 cups leftover cooked basmati rice (from 2 cups of raw rice)*', '3 Tbsp peanut oil, rice bran oil, canola oil, or cooking oil', '3 tablespoons finely minced fresh peeled ginger', '5 green onions, separated white and light green parts and dark green parts, thinly sliced', '1/2 teaspoon kosher salt', '3/4 cup diced (1/4 inch cubes) fresh pineapple (see How to Cut Pineapple)', '2 teaspoons soy sauce (use gluten-free soy sauce if cooking gluten-free)', '1 teaspoon toasted sesame oil', '*If making rice from scratch, cook the raw rice according to the package instructions. Spread the hot, cooked rice out in a rimmed baking sheet to cool off and air dry. Let the rice dry out for a couple of hours and then proceed with the recipe, or put in a bowl, cover with plastic wrap, and chill in the refrigerator overnight and proceed the next day.']",9,"['1 Saut\\xc3\\xa9 onions and ginger: Heat a large saut\\xc3\\xa9 pan on medium high heat. Swirl in a tablespoon of oil to coat the pan.', 'When the oil is shimmering hot, add the ginger and the white and pale greens parts of the green onions.', 'Sprinkle with salt and stir fry until fragrant, about a minute.', '2 Brown the rice: Add the remaining 2 tablespoons of oil to the pan. When the oil is hot, add the cooked, leftover rice to the pan, breaking it up with your fingers as you sprinkle it into the pan.', 'Let the rice fry in the pan without moving it for a minute or two, until it starts to brown. Then stir it so that it turns over in the pan, and let it cook for a minute or two more.', '3 Stir in pineapple, more green onions, soy sauce, sesame oil: Remove the pan from the heat and stir in the chopped pineapple, sliced green onion greens, soy sauce, and sesame oil.', 'Add salt to taste and serve.']",7
1049,Balsamic Risotto with Tomatoes and Basil Recipe,10,35,45,"['4 cups of stock (I use homemade vegetable stock or Better Than Bouillon)', '1 Tbsp butter', '1/2 cup chopped shallots', '1 clove garlic, minced', '1 cup (200 g) risotto rice (arborio, carnaroli, or vialone nano)', '1/3 cup dry white wine (I recommend a New Zealand Sauvignon Blanc)', '1/2 cup grated or shredded Parmesan cheese', '1 to 2 Tbsp balsamic vinegar', 'White pepper', '1/4 teaspoon fresh thyme or a pinch of dried thyme', '1 1/2 cups cherry tomatoes, halved', '4 basil leaves, thinly sliced']",12,"['1 Heat the stock: Bring 4 cups of stock to a low simmer in a small pot. Keep the stock warm while making the risotto.', '2 Cook shallots and garlic: Melt a tablespoon of butter in a wide saucepan on medium heat. Add the chopped shallots and cook until translucent, a couple of minutes.', 'Add the minced garlic and cook until fragrant, a half minute more.', '3 Lightly brown the rice: Add the risotto rice to the pan and toss to coat with the shallots. Increase the heat to medium high and let the rice start to brown.', '4 Add the white wine: Stir in the white wine. The pan will steam up. Let the rice absorb the wine.', '5 Start adding the stock, 1/2 cup at a time: Here is the real process of making risotto. Add the stock, a half cup or ladleful at a time, slowly stirring the rice, and allowing the rice to absorb the stock for a minute or two, before adding another ladleful of stock.', 'You\\\'ll want to stop adding the stock when the rice is cooked through, but still a little firm to the bite, ""al dente"". Note that you may not need all of the stock you have heated for this recipe.', '6 Add balsamic, tomatoes, thyme with last 1/2 cup of stock: When it comes time for that last 1/2 cup of stock to add to the risotto, add it, as well as the balsamic vinegar. Balsamic vinegar can vary in its acidity and intensity. So, add 1 tablespoon to start, and add another tablespoon if you want more of the balsamic flavor.', 'Add half of the cherry tomatoes and add the thyme. Let the tomatoes soften with the cooking of the risotto in those last few minutes.', '7 Remove from heat, stir in Parm: When the risotto has reached it\\\'s ""al dente"" stage, remove it from heat. Stir in the shredded Parmesan cheese. Sprinkle with pepper.', '8 Serve: Serve with remaining halved fresh cherry tomatoes and thinly sliced basil on top.']",11
1050,Meyer Lemon Risotto Recipe,5,35,40,"['Kosher salt', '1 1/2 quarts (6 cups) water', '3 tablespoons extra virgin olive oil', '1 tablespoon butter', '3/4 cup finely chopped onion (about 1/2 a med onion)', '2 cups arborio rice or other risotto rice', '1 cup white wine', ""1 or 2 Meyer lemons, enough for 1 Tbsp of zest, and 3 Tbsp of juice (if using regular lemons instead of Meyer, you'll need less juice, start with 1 Tbsp and add more to taste)"", '1 tablespoon of chopped, fresh oregano leaves (can also use mint)', '1/4 teaspoon freshly ground black pepper', '1/4 cup lightly toasted pine nuts (optional)', '1/4 cup finely grated Parmesan (optional)']",12,"['1 Heat salted water: Put 1 1/2 quarts (6 cups) of water into a pot. Add 1 level tablespoon of kosher salt (or 2 level teaspoons if you are using table salt). Bring to a boil. Lower the heat to warm, cover and keep warm while you make the risotto.', '2 Saut\\xc3\\xa9 onions: In a large, wide saut\\xc3\\xa9 pan, heat olive oil and butter on medium heat. Add the onions and cook until translucent, about 5 minutes.', '3 Brown the rice: Add the rice. Stir to coat. Cook, stirring, 5-7 minutes, until the rice just barely begins to brown on some of the grains.', '4 Add the wine. Stir continuously, a few minutes, until the liquid has been completely absorbed by the rice.', '5 Start adding the hot salted water, a ladle at a time: Lower the heat to medium low. Start adding the hot salted water to the rice, one ladleful (about 1/2 cup) at a time. After each addition, stir continuously for a few minutes until the rice has completely absorbed the liquid.', 'Stir enough to keep the rice from sticking to the edge of the pan. Stirring continuously helps extract starch from the rice, to make a creamy sauce for the rice.', ""You'll end up adding a total of about 4 to 5 cups of water, depending on the rice you are using (older rice may need more water)."", 'Continue to add water and stir, until the rice is cooked through and just a tiny bit chewy. The whole process should take about 30 minutes or so. Risotto is a labor of love.', '6 Stir in 2 Tablespoons of the lemon juice, the lemon zest, chopped oregano, and black pepper, reserving a little bit of lemon zest and oregano to sprinkle on top upon service. Do a taste test. If the rice needs more seasoning, add more salt and pepper. Add more lemon juice if you want.', 'To serve, sprinkle a little lemon zest and fresh oregano on top, along with a few toasted pine nuts and finely grated Parmesan if using. Use as an accompaniment to fish, shellfish, or lamb.']",10
1051,Summer Vegetable Risotto Recipe,10,35,45,"['2 tablespoons extra virgin olive oil', '1 large garlic clove, minced', '1 1/2 cups Arborio or other risotto rice', '1/2 cup white wine', '5 cups hot water', 'Salt and black pepper', '1/2 cup sweet corn kernels (fresh or frozen)', '1/2 cup diced red bell pepper (small dice)', '2 green onions, chopped (white and green parts)', '1/2 cup grated parmesan cheese', '10-12 basil leaves, torn up small', '2 tablespoons unsalted butter (optional)']",12,"['1 Heat the water: Bring the water to a simmer in a small pot.', '2 Saut\\xc3\\xa9 garlic and rice in olive oil: In another pot, heat the olive oil over medium-high heat. When the olive oil is shimmery hot, add the garlic and saut\\xc3\\xa9 until fragrant, about 30 seconds.', 'Stir in the rice and coat with the olive oil. Saut\\xc3\\xa9, stirring constantly, for 2-3 minutes, at which point the rice will begin to smell nutty.', '3 Add the wine: Add the white wine to the rice and stir. From this point on, you will be stirring the risotto rice almost constantly. After a minute or two the rice will have absorbed the wine and when you stir, the spoon will leave streaks on the bottom of the pan.', '4 Start adding water, a cup at a time: Add a cup of the hot water to the pot. Add a generous pinch of salt. Stir until the water has been absorbed by the rice and your spoon is again leaving a trail at the bottom of the pan.', 'Add another cup of hot water and repeat.', '5 Add the corn and bell pepper: When the second cup of water is absorbed, add the corn and red bell pepper.', 'Add another cup of water and stir until it is absorbed.', 'Repeat with another cup of water and another healthy pinch of salt.', '6 Stir in the green onions and Parmesan: By now the rice should be close to being done; it should be fully cooked but still al dente, a little firm, not completely soft. When the rice reaches this stage, stir in the green onions and grated parmesan.', 'When the water has been completely absorbed, add a little more water so the risotto is loose. The risotto should fill a bowl, not sit on a plate.', '7 Stir in the basil and butter, and sprinkle with black pepper to taste. Once the butter has melted, serve at once.']",12
1052,"Rice with Carrot, Lemon, Onion and Mint Recipe",10,40,50,"['1/2 cup extra virgin olive oil', '1 onion, diced', '1 carrot, diced (1/4 in)', '1 Tbsp minced garlic', 'Salt and pepper to taste', '3 1/2 cups water', '1 teaspoon of finely grated lemon zest', '2 Tbsp lemon juice', '1 1/2 cup long grain rice (make sure that you are using long grain rice)', '4 scallions, thinly sliced on the diagonal', '1/4 cup chopped fresh mint leaves']",11,"['1 Heat the oil in a medium-sized, thick-bottomed pot over medium heat. Add the onions and carrots and cook 10 minutes, until the onions are translucent and beginning to brown. Add the garlic, cook 1 minute more. Season with salt and pepper.', '2 Add the water, lemon zest and juice and bring to a boil. Stir in the rice, reduce the heat and simmer, covered, until the rice absorbs the liquid and is tender, about 20 minutes.', '3 Remove to a bowl, add the scallions and mint, and fluff with a fork.']",3
1053,Skillet Chicken Parmesan Recipe,10,30,40,"['1 teaspoon salt', '1 teaspoon black pepper', '1 cup all-purpose flour', '1 large egg', '1 cup Italian breadcrumbs', '1/2 cup grated Parmesan cheese', '1 1/2 to 2 pounds chicken cutlets', '1 cup olive oil', '1/2 cup diced onion', '2 cloves garlic, sliced', '2 cups marinara tomato sauce, homemade or store-bought', '6 ounces mozzarella cheese, sliced', 'Fresh basil, garnish', 'Red pepper flakes, garnish', 'Cooked spaghetti or rice, for serving', 'Special equipment:', '12-inch oven-safe cast iron or stainless steel skillet']",17,"['1 Preheat oven to 400\\xc2\\xb0F. Heat olive oil in a 12-inch oven-safe skillet over medium heat. ', '2 Bread the chicken: Prepare your breading stations by stirring the salt and pepper with the flour in one bowl, whisking the egg in a second bowl, and measuring breadcrumbs and Parmesan cheese into a third bowl. Coat chicken cutlets with seasoned flour. Dust off any extra flour.', 'Transfer chicken cutlets to egg mixture and coat. Then transfer to the breadcrumbs and coat. Place breaded chicken on a plate.', ""3 Fry the chicken: You'll know the oil is ready when a few breadcrumbs sizzle immediately when added to the oil (325\\xc2\\xb0F). Add breaded chicken cutlets and fry for 4 minutes per side. The chicken should be 90 percent cooked through at this point; it should not be 100 percent cooked through. (Just a note though: You may need to fry in batches; if the pan gets overcrowded the chicken may not crisp up to your liking.)"", 'Remove chicken from the skillet, and carefully pour the olive oil into a bowl to cool, leaving about a tablespoon in the skillet. Don\\xe2\\x80\\x99t rinse out the skillet.', '4 Make the sauce: Add the onion and garlic to skillet and cook over medium-low heat for 2 minutes, until onion is translucent. Add the marinara sauce and bring to a low simmer.', '5 Finish the chicken Parm: Add the chicken back to the skillet in the sauce. Top each chicken piece with a slice of mozzarella cheese.', 'Place the skillet in the oven and bake for 10 to 12 minutes until the sauce is bubbling, the cheese is melted, and the chicken registers 165\\xc2\\xb0F in the thickest parts.', '6 Serve: Serve chicken Parmesan immediately over pasta, rice, or even with bread and a salad. Garnish with red pepper flakes and fresh basil.', 'LEFTOVERS! Leftover chicken Parmesan can be stored in the fridge for 4 to 5 days once it has cooled. For best results, reheat chicken Parm in a 325\\xc2\\xb0 F oven with some of the sauce until the cheese is re-melted.']",10
1054,How to Cook Brown Rice,0,45,45,"['1 cup long-grain brown rice', '1 3/4 cups water', '1/4 teaspoon salt, optional']",3,"['1 Rinse the rice: Put the rice in a wire mesh sieve or strainer and rinse it under cold water for about 10 seconds. Swish it around to get the excess water off.', '2 Combine the rice and liquid: In a medium saucepan (about 2 quarts), combine the rice and water. Add the salt, if using.', '3 Cover and bring to a boil: Put on the lid. Turn the heat to medium-high and bring the rice to a boil. The liquid can quickly boil over and make a big mess, so watch the pot for steam, or listen for the lid making jiggling sounds.', '4 Turn down the heat and set the timer: Once the rice comes to a boil, set a timer for 35 minutes. Reduce the heat to medium-low, or as low as it can go while still maintaining a very gently simmer (look for wisps of steam around the lid). It\\xe2\\x80\\x99s okay to take off the lid a few times to check on the progress of the rice, but try to keep it to a minimum.', '5 When the timer goes off, open the lid: Check on the doneness of the rice. You should see crater-like steam holes in the surface of the rice, and there should not be any liquid sloshing around in the bottom of the pot. If you taste a grain, it may be a little toothy, which is fine. If the rice is still outright crunchy, return it to the burner on medium-low in increments of 5 minutes.', '6 Turn off the burner and let the rice steam: Turn off the heat. Let the rice sit with the lid on for 10 minutes so it can steam. Even though the pot is not on the heat, this is part of your cooking time.', '7 Fluff and serve: Use a fork or spoon to fluff the rice before serving it.', ""8 Freeze cooled leftovers, if you like: Brown rice freezes great! Put the cooled rice in a zip-top freezer bag. Press out as much air as you can, seal it, and freeze for up to 6 months. Defrost in the refrigerator overnight, or plunge the bag in a bowl of warm water and massage every few minutes to break up the grains. Here's more on freezing rice.""]",8
1055,Slow Cooker Jambalaya Recipe,20,360,380,"['1 white onion, diced', '3 stalks celery, diced', '1 green bell pepper, diced', '3 cloves garlic, diced', '1 pound smoked sausage, sliced about 1/4 inch', '1 pound boneless chicken breasts and/or thighs, cut into bite-sized pieces', '1 (28-ounce) can diced tomatoes', '1 tablespoon dried oregano', '2 bay leaves', '1 to 2 tablespoons Creole seasoning (I like Tony Chachere\\xe2\\x80\\x99s Creole Seasoning)', '1 pound large shrimp, shell on, thawed', '1 cup long grain white rice', '1/2 teaspoon salt, or to taste', '1/2 teaspoon black pepper, or to taste', 'Fresh parsley, chopped, for garnish', 'Special equipment:', '6-quart or larger slow cooker']",17,"['3 Taste and season: Remove bay leaves from the jambalaya and taste. Season with salt and pepper to taste and garnish with fresh chopped parsley. Either peel the shells off the shrimp now, or serve with the shells on and instruct guests to remove the shells as they eat.', 'Stir the cooked rice into the jambalaya (as pictured), or serve the jambalaya ladled over top the rice.', 'Leftovers will keep in the fridge in air-tight containers for 2 to 3 days and then the shrimp start to really break down. This dish doesn\\xe2\\x80\\x99t freeze particularly well. The combination of rice, shrimp, and sauce doesn\\xe2\\x80\\x99t reheat easily without making the shrimp very rubbery.']",3
1056,Thai Noodle Salad with Peanut Sauce Recipe,25,5,30,"['For the salad:', '1 small head (about 2 cups) romaine lettuce', '1/4 head (about 2 cups) red cabbage', '1 large red bell pepper', '1 large carrot (about 1/2 cup), shredded', '1 mango', '1/4 cup cilantro leaves, plus more for garnish', '1/4 cup green onions, plus more for garnish', '1/4 cup roasted peanuts, roughly chopped, plus more for garnish', '8 ounces (227 grams) pad Thai rice noodles', 'For the peanut dressing (makes 3/4 cup):', '1/3 cup creamy peanut butter', '3 tablespoons lime juice', '3 tablespoons water', '3 tablespoons brown sugar', '4 teaspoons rice wine vinegar', '4 teaspoons soy sauce', '1 teaspoon sesame oil', '1/4 teaspoon fish sauce', '1/2 teaspoon sriracha, or chili paste', '1/2 teaspoon minced ginger', '1/2 teaspoon minced garlic']",22,"['1 Cook the rice noodles: Bring 3 quarts of water to a boil in a large pot. Add rice noodles, stirring occasionally, and cook until tender, about 5 minutes.', '2 Drain and cool the noodles: Transfer to a colander, drain, and rinse with cool water until noodles are cold. Allow to drain well until ready to add to the salad. If noodles stick together, rinse them in cool water to separate.', '3 Slice the ingredients: While the water is coming to a boil, and while the noodles cook and cool, prepare the vegetables.', 'Put a large serving bowl nearby and add each element to the bowl as you slice or chop it.', 'Cut the romaine lettuce into 1/4-inch thin strips the short way.', 'Cut the cabbage into 1/4-inch thin strips.', 'Thinly slice the bell pepper.', 'Shred the carrot. You want about 1/2 cup of shredded carrot.', 'Peel the mango and cut it into slices an 1/8-inch thick.', 'Chop the cilantro. Thinly slice the green onions.', 'Roughly chop the roasted peanuts.', '4 Make the peanut dressing: In a small bowl, whisk together peanut butter, lime juice, water, brown sugar, rice wine vinegar, soy sauce, sesame oil, fish sauce, sriracha, ginger, and garlic until smooth.', '5 Combine the salad: Add the rice noodles to the bowl with the vegetables, herbs, and peanuts. Pour half of the dressing over the salad.', '6 Serve: Garnish salad with additional cilantro leaves, green onions, and chopped peanuts. Serve the remaining dressing on the side.']",14
1057,Three-Cheese Pesto Lasagna Recipe,45,35,80,"['For the pesto (makes about 1 1/2 cups):', '4 cups lightly packed basil leaves (about 4 ounces)', '2 medium cloves garlic, chopped', '1/2 cup pine nuts', '1 cup grated Parmesan (about 3 ounces)', '1/4 cup extra virgin olive oil', '2 tablespoons freshly squeezed lemon juice', '1/2 teaspoon kosher salt (or slightly less this amount of table salt)', 'For the saut\\xc3\\xa9ed mushrooms:', '1 tablespoon extra virgin olive oil', '2 medium cloves garlic, minced', '1/2 teaspoon red pepper flakes', '1/4 teaspoon freshly ground pepper', '2 cup sliced crimini or brown mushroom caps (about 6 ounces)', '1/4 teaspoon kosher salt (or slightly less this amount of table salt)', 'For the greens:', '1 tablespoon extra virgin olive oil', '4 cups loosely packed spinach', '4 cups loosely packed kale leaves, chopped', '1/2 teaspoon kosher salt (or slightly less this amount of table salt)', 'For the cheese sauce:', '2 tablespoons butter', '2 tablespoons flour', '2 cups milk', '1 cup grated Parmesan (about 3 ounces)', 'For the ricotta mixture', '2 large eggs', '15 to 16 ounce tub ricotta', 'To assemble the lasagna:', '1 pound lasagna noodles', '2 teaspoons extra virgin olive oil, divided', '8 ounces mozzarella, sliced and torn into rough half moon pieces']",32,"['1 Make the pesto: In the bowl of a food processor, pulse to combine the basil leaves, garlic, and pine nuts. Scrape down sides as needed. With the food processor running, and add the Parmesan, olive oil, lemon juice, and salt. Spoon into a bowl and cover tightly with plastic wrap. Set aside. (This makes about 1 1/2 cups of pesto.)', '2 Prepare the mushrooms: Set a large, deep-sided skillet over medium-low heat. Add 1 tablespoon olive oil, and then garlic, red pepper flakes, and pepper. Cook 1 minute, turn heat to medium, and add mushrooms and 1/4 teaspoon salt. Saut\\xc3\\xa9 mushrooms about 4 minutes, until they begin to release their water. Transfer to a bowl.', '3 Prepare the greens: In the same pan used to cook the mushrooms, over medium heat, add 1 tablespoon olive oil. Stirring often, add the spinach and kale in 4 batches, salting each as it goes in the pan. Cook until greens have cooked down completely, about 5 minutes. Squeeze to remove excess water and set greens in a bowl.', '4 Prepare the cheese sauce: In a large saucepan, melt the butter over medium heat. Whisk in flour and then cook, whisking constantly, 3 minutes. Next, gradually whisk in milk, adding a splash at a time, allowing mixture to thicken between additions; this should take 5 to 7 minutes. Once all milk has been added, cook mixture, stirring frequently, for another 5 minutes. Remove from heat, and stir in 1 cup grated Parmesan.', '5 Prepare the ricotta mixture: Lightly beat eggs. Fold in ricotta. Set aside.', '6 Cook the lasagna noodles: Bring a large stockpot of water to a boil. Generously salt water and cook noodles until they are pliable but still have plenty of bite. Toss noodles with remaining teaspoon olive oil and set aside.', '7 When ready to assemble and bake the lasagna: Preheat oven to 425F. Grease a 9x13 baking pan with 1 teaspoon olive oil.', '8 Assemble the lasagna: Arrange 4 cooked noodles lengthwise on the bottom of the baking dish. Spread half the ricotta mixture over noodles. Scatter half the greens over ricotta. Spoon 1 cup of cheese sauce over greens, scatter half the mushrooms, and dot with 1/2 cup pesto. Add another layer of noodles, and repeat layering.', 'Add a final layer of noodles and top with the remaining 1/4 cup cheese sauce, dot with remaining 1/2 cup pesto, scatter mozzarella slices. Finish with a pinch each of salt and pepper.', '9 Bake the lasagna: Set the lasagna on a tray to catch any drips and slide into hot oven. Cook 30 to 35 minutes, or until the filling is bubbling vigorously and the mozzarella is bubbly and golden brown in spots. Cool 15 minutes, slice, and serve.', 'Reheating leftover lasagna: Cover with foil and reheat in a 350F oven for 20 to 30 minutes or until piping hot.', ""Freezing and reheating whole lasagna: Cook and cool the lasagna complete. Cover the dish with a piece of foil pressed against the surface and freeze for up to 3 months. To reheat, peel away the foil from the frozen lasagna and recover the pan (so the foil is no longer touching the lasagna but the pan is covered). Warm in a 350F oven for 70 to 90 minutes until the cheese has melted and the center is piping hot. Uncover in the last 10 minutes if you'd like a browner crust."", 'Freezing and reheating individual portions: Cook and cool the lasagna completely. Tightly wrap individual portions in aluminum foil, transfer to a sealable freezer bag or container, and freeze for up to 3 months. To reheat, unwrap the portions, transfer to an oven-safe dish, and cover with foil. Warm at 350F for 30 to 35 minutes, until the cheese has melted and the center of each portion is hot.']",13
1058,Mint Ricotta Stuffed Shells Recipe,15,60,75,"['6 ounces jumbo shell pasta (1/2 standard box)', 'For the sauce:', '1 Tbsp extra virgin olive oil', '1/2 pound mild Italian sausage (out of casing)', '1 cup finely chopped onion', '2 cloves garlic, minced (about 2 teaspoons)', '1 28-ounce can crushed tomatoes', '1/4 cup chopped parsley (packed)', '1/4 cup water', '1/2 teaspoon salt', '1/2 teaspoon black pepper', 'For the mint ricotta stuffing:', '15 (or 16) ounces ricotta cheese', '1 egg, lightly beaten', '1 bunch of mint, leaves only, chopped (about 1 cup packed)', '1 ounce (1/4 cup) grated Parmesan cheese', '1/2 teaspoon salt', '1/2 teaspoon pepper', 'To top:', '1 ounce (1/4 cup) grated Parmesan cheese', '4 ounces (1 cup) grated Mozzarella cheese']",21,"['1 Pre-cook jumbo shells very al dente: Bring 2 quarts of salted water to a rolling boil (1 Tbsp salt). Add the jumbo shells and cook until flexible but still quite firm (about 9 minutes if using Barilla shells).', 'You want to undercook the shells at this point so they will be firm enough to stuff; they will continue to cook when you bake the pasta dish.', ""Drain in a colander and rinse in cold water to stop the cooking. Separate the shells so that they aren't folded into each other."", '2 Brown the sausage, onions, garlic: While the shells are cooking start on the sauce. Heat olive oil in a large saut\\xc3\\xa9 pan on medium high heat. Break up the sausage with your fingers as you add it to the pan.', 'Cook the sausage just until still a little pink, then add the finely chopped onions. Cook for a few minutes until the onions are translucent. Use a wooden spoon to break up the chunks of sausage into smaller bits.', 'Add the garlic and cook a half minute more.', ""3 Add tomatoes, water, parsley, salt, pepper: Add the canned crushed tomatoes and all of their juices to the sausage and onions. Add water (you can add water to the can, swirl it around to get what's left of the tomato juice in the can), chopped parsley, salt and pepper."", 'Taste the sauce. If it tastes too acidic (this can happen, depending on the acidity of the tomatoes) you might want to add a teaspoon of sugar to balance the acidity.', 'Bring to a simmer, then reduce heat to the lowest temperature to keep the sauce warm while you work on stuffing the shells.', '4 Make mint ricotta stuffing: In a medium bowl, mix together the ricotta, chopped mint, egg, salt, and pepper.', '5 Stuff the shells: Use a spoon to stuff about a heaping tablespoon of mint ricotta stuffing into each of the pasta shells.', '6 Layer sauce, shells, cheese in casserole dish: Preheat oven to 350\\xc2\\xb0F. Coat the bottom of a 9x13 casserole dish with a little less than half of the sauce.', 'Arrange the stuffed shells on top of the sauce. Cover with the remaining sauce.', 'Sprinkle with grated Parmesan and grated Mozzarella.', '7 Bake: Cover with aluminum foil and bake for 30 minutes in a 350\\xc2\\xb0F oven.']",15
1059,Honey Ricotta Stuffed French Toast Recipe,10,15,25,"['2/3 cup ricotta cheese', '1/4 cup honey', 'Zest from 1 medium lemon', '2 large eggs', '3/4 cup whole milk', '1 teaspoon vanilla extract', '1/4 teaspoon salt', '2 tablespoons butter, for cooking', '1 loaf French bread', '1 pint fresh berries, such as blueberries or raspberries, for serving', 'Syrup or honey, for serving', 'Powdered sugar, for serving']",12,"['1 Prepare the filling: In a small bowl stir together the ricotta cheese, honey, and lemon zest. Set aside.', '2 Prepare the custard: In a wide dish, stir together eggs, milk, vanilla, and salt. Set aside.', '3 Slice the bread: Use a serrated knife to slice 4 large pieces (at least 1 1/2-inches thick) from the middle of the loaf of French bread, where the slices will be larger. Cut the loaf at an angle to make larger pieces. Don\\xe2\\x80\\x99t use the ends of the loaf, as they are too small.', ""When you have your four thick pieces of bread, use a small serrated knife (such as a steak knife) to make a deep slit right in the middle of each slice to form a pocket going almost the full length of the slice. Try to avoid tearing holes in the bread, but it's ok if you do."", '4 Stuff the slices: Divide the ricotta filling among the four pieces of bread. You should be able to get about 1/4 cup of filling in each piece. It\\xe2\\x80\\x99s okay if some overflows. Use a small spoon to help fill the slices without making too much of a mess.', '5 Make the French toast: In a large griddle or flat-bottomed skillet, melt butter over medium heat. When pan is ready, dip each piece of stuffed French toast into the custard mixture and coat well on all sides.', 'Move the bread straight to the hot griddle or skillet. Cook the French toast for 3 to 4 minutes per side until both are nicely browned and have a firm crust. Sear the edges of the French toast as well to make sure they are cooked.', '6 Serving the French toast: Cut each piece of stuffed French toast in half and serve each person two halves drizzled with syrup or honey and dusted with powdered sugar. I like a big handful of berries on each piece as well. Serve while warm.', 'Leftovers don\\xe2\\x80\\x99t keep well. The pieces get soggy. So only make as many as you plan to serve!']",9
1060,Spinach Ricotta Gnocchi Recipe,30,45,75,"['Gnocchi', '3 ounces fresh or frozen spinach', '1 egg', '2 teaspoons salt', '1 1/2 pounds whole milk ricotta cheese, drained of excess moisture', '1/3 cup finely grated Parmigiano-Reggiano cheese', '1 3/4 cups all-purpose flour', 'Pinch of nutmeg', 'Sauce', '1 28-ounce can crushed tomatoes (or whole tomatoes that you shred as you add to the pan)', '4 tablespoons extra virgin olive oil', '2 garlic cloves, peeled', 'Salt', '2 ounces goat cheese']",14,"['Gnocchi', '1 Blanch spinach and squeeze out excess moisture: Fill a medium saucepan halfway with water and heat until simmering. Add spinach and cook until tender, about 1 minute. Drain.', 'Let spinach cool enough to touch, then squeeze as much moisture as you can out of it. You can also use a potato ricer if you have one to squeeze the excess moisture out of the spinach.', '2 Make the gnocchi dough: Add the spinach, egg, salt, and half of the ricotta to a food processor. Pulse until completely blended.', 'Transfer mixture to a large bowl, mix in the remaining ricotta and the Parmesan cheese. Stir a pinch of nutmeg into the flour.', 'Add the flour in by hand, starting with a half of the flour. Mix everything with your hands until the mixture holds together as a dough.', '3 Knead the dough: Put the dough out on a lightly floured smooth, clean surface. Knead lightly for about a minute, adding additional flour if needed, if the dough sticks too easily to the board or your hands. (At this point, if you wrap the dough in plastic and refrigerate for an hour, it will be easier to roll out.)', 'When the dough is smooth and pliable, and still just a little bit sticky, divide it into 4 portions, each the size of an orange.', '4 Roll dough out into long ropes, cut into pieces: Flour your hands lightly. Using both hands, and a light touch, roll the dough out with a back and forth motion, starting at the center and stretching the dough out, to form a roll.', ""This is the tricky part. You don't want to put so much pressure so that you compress the dough, but you do need enough pressure to create a rope of dough."", 'The trick is to stretch the dough sideways as you are rolling. Once the segment you are working on gets to be about a foot long, you may find it easier to cut it in half, and then start working on that smaller segment.', 'Roll the dough out until the roll is about the size of a middle finger. (Note that if your hands or the board is a little too floured, you may not have enough traction between your skin and the dough to easily stretch it sideways.) Cut each roll into 1-inch pieces.', '5 Create indentations with a fork: Hold a fork at a 45% angle with its tines facing down on the work board, the curved part of the fork facing away from you. Starting with the curved outside bottom of the fork, press each piece of dough up along the length of the tines. Let the gnocchi fall back down.', 'This is a pretty quick motion, the result is an indentation of the fork tines on one side of the gnocchi, and an indentation of your fingertip on the other side.', 'Place the gnocchi on a lightly floured cookie sheet. At this point they can be cooked, or kept in the refrigerator several hours or overnight.', '6 Cook the gnocchi in boiling water: To cook the gnocchi, fill a large wide pot half-way with water. Bring to a boil, add 1 teaspoon of salt for every quart of water.', 'Once the salt has dissolved, gently drop the gnocchi in the water, one by one. Try to do this in a way that the gnocchi are not falling in on top of each other, but rest on the bottom of the pan in a single layer.', 'As the gnocchi cooks, they will rise to the surface of the water after a couple minutes. Use a slotted spoon to remove the risen gnocchi from the pot, place in a serving bowl.', 'Sometimes the gnocchi can stick a little at the bottom. If you suspect this, nudge them a little to unstick them. As you remove some gnocchi, you can add a few more to the pan.', 'The Sauce', '1 While you are cooking the gnocchi, make the sauce. Heat oil in a medium saucepan on medium heat. Add the garlic cloves and cook until lightly browned on all sides. Remove and discard the garlic.', 'Add the tomatoes (include any juices from the can) all at once (careful, they may cause the oil to splatter as the tomatoes hit the pan). As soon as the mixture boils, reduce the heat to low and let simmer, uncovered for 10 to 15 minutes. Season with salt. Stir occasionally. Use a potato masher to break up any solid pieces of tomato, you want a rough pur\\xc3\\xa9e.', '2 Once the sauce reduces to a medium thick consistency, add the goat cheese, stirring until it is well blended. Add more salt to taste.', 'Serve gnocchi with the sauce and extra grated Parmesan.']",24
1061,Ricotta Stuffed Chicken Recipe,20,60,80,"['1 whole roasting chicken, 4 to 5 lbs.', 'Stuffing:', '12 oz. ricotta cheese', '1/3 cup grated Parmesan cheese', '1 egg', '2 teaspoons chopped fresh basil (or 1 teaspoon dried)', '1 teaspoon chopped fresh tarragon (or 1/2 teaspoon dried)', '2 Tbsp chopped fresh parsley', '1 large clove garlic, minced', 'Rub:', 'Salt', 'Extra virgin olive oil', '1 teaspoon chopped fresh basil (or 1/2 teaspoon dried)', '1/2 teaspoon chopped fresh tarragon (or 1/4 teaspoon dried)', '1/4 teaspoon paprika']",15,"['1 Butterfly the chicken: Rinse chicken and pat dry with paper towels. Butterfly the chicken by using poultry shears or a knife to cut along one side of the backbone. Cut along the other side and remove the backbone and tail. (See our guide to how to spatchcock or butterfly a chicken.)', 'Spread the chicken open, skin side up. Press down on the chicken with the palms of your hands (or pound with your fists) to flatten the chicken. Fold the wings under the chicken.', '2 Make ricotta Parmesan herb mixture: In a medium bowl, mix the ricotta, Parmesan cheese, egg, parsley, garlic, 2 teaspoons of chopped basil, and 1 teaspoon of chopped tarragon.', '3 Stuff ricotta mixture under chicken skin: Using a sharp paring knife and your fingers, loosen skin over top of chicken and drumsticks starting at neck edge. Work with your fingers and hand to press under the chicken skin to separate the chicken skin from the chicken breasts, thighs, and drumsticks. Be gentle, the skin can easily tear.', 'Carefully spoon cheese mixture under skin of chicken, pressing with your fingers to distribute evenly over the chicken and drumsticks.', '4 Season chicken: Brush chicken lightly with oil; sprinkle with 1/2 teaspoon basil, 1/2 teaspoon tarragon, paprika, and a generous amount of salt.', '5a Cook chicken using an oven: Preheat oven to 500\\xc2\\xb0F. Place chicken, skin side up, on a rack in a roasting pan. Place in oven and immediately turn the heat down to 350\\xc2\\xb0F.', '5b OR Cook chicken using a grill: Prepare grill for medium indirect heat. If using a gas grill, heat all burners on high until the grill is hot, then turn off the middle burner.', ""If using a charcoal grill, bank the coals to one side of the grill and place a large aluminum drip pan underneath the grate on the side without coals, adding a couple cups of water to the drip pan so that the drippings don't burn."", 'Place the chicken, skin side up, on the cooking grate, away from the side with coals if you are using a charcoal grill, or above the middle burner if you are using gas.', ""Alternatively, you can lay the chicken out on a rack in a disposable aluminum roasting pan and place the roasting pan on the cooking grate (this tip works well with gas grills, I haven't tried it with the charcoal one yet). Cover the grill."", '6 Roast the chicken for an hour or until the juices run clear from the thigh when pierced with a fork. (Chicken should have an internal temperature of 165\\xc2\\xb0F when tested with a meat thermometer.) If the skin browns before the chicken is cooked through, cover it loosely with foil.', '7 Let rest: Transfer chicken to a cutting board; let stand 10 minutes. Cut into quarters to serve.']",13
1062,Lemony Spaghetti with Peas and Ricotta Recipe,15,20,35,"['4 tablespoons olive oil', '3/4 cup Panko bread crumbs', 'Freshly ground black pepper', '3/4 cup good quality fresh ricotta', '2 heaping tablespoons finely grated lemon zest, divided', '5 tablespoons fresh lemon juice, divided', 'Salt and pepper, to taste', '3/4 pound dry spaghetti', '1 large or 3 small spring onion bulbs, tough outer layers removed and the rest halved and thinly sliced (about 1/2 cup)', '1 1/2 cups fresh or frozen green peas', '1/4 cup chicken or vegetable stock', '2 tablespoons chopped fresh parsley']",12,"['1 Begin heating the water for the pasta: Place a large pot of salted water over high heat and bring to a boil while you proceed with the recipe.', ' 2 Toast the Panko breadcrumbs: In a large skillet over medium-high heat, heat 2 tablespoons of the olive oil. Add the Panko, and stir constantly for 3 to 5 minutes, or until the crumbs are golden. Season with salt and pepper, transfer to a bowl, and set aside. Wipe the skillet clean.', '3 Make the lemon ricotta: In another small bowl, stir the ricotta, 1 heaping tablespoon of the lemon zest, and 2 tablespoons of the lemon juice together (save the rest). Add salt and pepper to taste.', '4 Cook the spaghetti: Add the spaghetti to the boiling water and set your timer for 2 minutes less than the recommended time (this is so you can be assured that you are cooking the pasta al dente).', 'Cook the spaghetti uncovered in vigorously boiling water. When done, it should be cooked, but still firm in the middle. Scoop out 1/2 cup of the pasta water for the sauce, and drain in a colander.', '5 Cook the spring onions and peas: While the pasta cooks, heat the remaining 2 tablespoons of olive oil over medium heat in the same large skillet used to toast the breadcrumbs. Add the spring onions, and cook, stirring often, for 6 to 7 minutes, or until they are soft and translucent.', 'Add the remaining 3 tablespoons lemon juice, the remaining 1 tablespoons lemon zest, the chicken stock and the peas. Cook, stirring often for 1 to 2 minutes or until the peas are tender. Add salt and pepper to taste.', '6 Combine the spaghetti with the peas: Reduce the heat to low. With tongs, transfer the cooked spaghetti and 1/4 cup of the pasta water to the skillet. Toss until hot, adding more pasta water if necessary until the pasta is coated with sauce. Taste and add more salt and pepper, if you like.', '7 Serve the pasta: Divide the spaghetti among four pasta bowls. Dollop spoonfuls of the ricotta over the pasta, and sprinkle with the breadcrumbs and parsley.']",9
1063,Penne with Ricotta and Asparagus Recipe,15,20,35,"['Salt', '1 1/4 pound thick asparagus, woody ends trimmed', '1 pound penne pasta', '1 clove garlic, peeled and mashed', '15 oz ricotta cheese', '2 tablespoons extra virgin olive oil', '2/3 cup freshly grated Parmesan cheese', 'Kosher salt and freshly ground black pepper', 'Nutmeg']",9,"['1 Blanch the asparagus: Bring a large pot of water to a boil. (You will cook both the asparagus and the pasta in the same pot of water.) Add a couple teaspoons of salt. Have an ice bath ready. Add the asparagus and cook until tender but firm, about 4 minutes.', 'Remove the asparagus with tongs and place in the ice bath to stop the cooking.', '2 Cut the asparagus into 1/8-inch diagonal slices, leaving the tips intact.', '3 Cook the pasta: Bring the water back to a boil and add the penne pasta.', '4 Make the ricotta sauce: While the penne is cooking, rub the inside of a large serving bowl with the mashed garlic. Discard the garlic. Add the ricotta, olive oil, and 1/4 cup of the pasta cooking water. Mix together in the bowl.', '5 Add pasta to the ricotta mixture, with asparagus and parm: When the pasta is done, drain it, reserving some of the cooking water. Add the penne to the ricotta mixture. Fold in the asparagus and half of the Parmesan cheese.', 'Season to taste with salt, pepper, and several dashes of nutmeg. Add some of the reserved pasta water if needed.', '6 Serve with remaining grated Parmesan cheese in a separate bowl for sprinkling.']",8
1064,Asparagus and Ricotta Bruschetta Recipe,20,3,23,"['1 pound thick asparagus', '1 cup whole milk ricotta', 'Zest from 1 lemon', '1 tablespoon lemon juice', '1 heaping tablespoon chopped fresh parsley', '1/8 teaspoon salt', 'Pinch freshly ground black pepper', '8 (1/2-inch thick) slices good crusty bread cut from a sourdough or country loaf', '2 tablespoons olive oil', 'For garnish:', 'Olive oil', 'Flaky sea salt', 'Freshly ground black pepper', 'Lemon wedges']",14,"['1 Peel the asparagus: Cut off about 1 inch of the bottom end of each asparagus spear. Lay the spears on a flat surface and hold the tip. Use a vegetable peeler to peel off the skin from the bottom half of each asparagus spear to expose the lighter green part of the stems under the peel.', '2 Cook the asparagus: In a deep skillet, bring 1 inch of salted water to a boil. Add the asparagus, and cook at a rapid simmer for 2 to 3 minutes, or until the stalks are tender when pierced with the tip of a knife. With a slotted spoon, remove to a flat tray and blot dry with a paper towel.', 'Cut the spears into 1 1/4-inch long pieces.', '3 Mix the ricotta and lemon: In a small bowl, stir together the ricotta, lemon zest, lemon juice, parsley, salt, and pepper.', '4 Make the toast: Set an oven shelf close to the broiler, and turn on the broiler. Place the bread slices in a single layer on a baking sheet. Toast for about 1 minute on each side, or until browned and crisp on top, but still slightly chewy in the center.', 'Stay near the oven and watch carefully to keep the bread from burning. The exact time depends on the distance from the broiler and the heat of your particular broiler.', 'Remove the toasts from the oven and brush each slice with olive oil.', '5 Assemble the bruschetta: Spread 1 to 2 tablespoons of ricotta on each slice of bread. Top it with the asparagus. Drizzle with more olive oil, flaky sea salt and pepper. Serve with lemon wedges.']",8
1065,Stuffed Shells with Summer Squash and Ricotta Recipe,30,45,75,"['2 tablespoons olive oil', '1/2 sweet onion, diced', '2 cups yellow squash, chopped (from about two small squash)', '8 ounces ricotta cheese', '8 ounces grated mozzarella cheese', '1 large egg', '1/2 teaspoon salt', '12 ounces large pasta shells (about 30)', '2 cups marinara sauce', '1 teaspoon fresh thyme', '1/2 teaspoon black pepper', 'DAD ADD: Prosciutto Crispies', '3 ounces prosciutto', '1/4 cup breadcrumbs', '1 tablespoon olive oil']",15,"['1 Cook the onions and squash: In a large skillet, heat olive oil over medium heat. Add onions and squash and cook until softened, 4-5 minutes. Remove from the heat and let cool slightly.', '2 Make the filling: In a medium bowl, stir together ricotta, mozzarella, egg, and salt. When squash and onion are at room temperature, add them to the cheese mixture along with any oil in the skillet. Stir well.', '3 Cook the shells: Cook shells according to package instructions, until al dente. Be sure not to overcook the shells or they will fall apart while baking. When shells are cooked, drain and let cool until they are cool enough to handle.', '4 Fill the shells: Spread one cup of the marinara sauce on the bottom of a 9x13 baking dish. Fill each shell with a heaping tablespoon of the squash and ricotta mixture. Place the filled shell in the baking dish. Repeat until you run out of filling or shells. You should get about 30 shells.', '5 Add the sauce: Spoon the rest of the marinara over the shells and dot the surface of the shells with a little extra mozzarella cheese (optional). Season the dish with fresh thyme and black pepper.', '6 Bake the shells: Bake the shells at 350\\xc2\\xb0F for 30 minutes until the cheese in the filling has melted and the marinara is bubbling.', '7 Make the prosciutto crispy topper (optional): Tear the prosciutto into pieces. Add to a medium skillet. Cook over medium-low heat until prosciutto starts to brown and turn crispy. Remove from skillet and dice.', 'Return the diced prosciutto to the skillet. Add breadcrumbs and olive oil. Cook for another 2-3 minutes until breadcrumbs are brown and crispy. Remove and let cool, then sprinkle over pasta!', 'Leftovers: You can freeze the shells before baking or freeze the leftovers. Cool them to room temperature and then seal them in a freezer-safe container. Use them within a month or two. Reheat shells in a microwave on high for 1 1/2 to 2 minutes.']",9
1066,Italian Sausage and Mushroom Risotto Recipe,15,40,55,"['2 tablespoons extra virgin olive oil', '1 pound Italian sweet sausage, removed from casings, crumbled', '1/2 pound cremini mushrooms, diced', '10 ounces fresh shiitake mushrooms, diced', '1 teaspoon chopped fresh oregano', '1 teaspoon chopped fresh thyme', '1 1/2 cups Madeira (divided, 1/2 cup and 1 cup)', '6 cups chicken stock (use gluten-free stock if cooking gluten-free)', '1/2 cup (1 stick) butter', '1 large onion, chopped', '4 garlic cloves, minced', '2 cups arborio rice', '1/2 cup freshly grated Asiago or Parmesan cheese (for topping)']",13,"['1 Cook the sausage and mushrooms: Heat olive oil in large skillet over medium heat. Crumble the sausage into the pan, spreading it out in an even layer. Cook for a couple of minutes.', 'Add the mushrooms, thyme, and oregano. Increase the heat to medium high and cook until the mushrooms are tender, about 10 minutes. Add 1/2 cup of the Madeira and scrape to deglaze the pan, about 1 minute. Set aside.', '2 Heat chicken stock until it is steamy or simmering in a large saucepan and keep warm over low heat.', '3 Cook onions and garlic in butter: Melt butter in a large saucepan over medium-high heat. Add onion and garlic and cook until onion is translucent, about 5 minutes.', '4 Add the rice: Add the rice to the onions and cook for a couple of minutes, until the rice starts to brown.', '5 Add remaining 1 cup Madeira. Cook, stirring constantly until Madeira has been absorbed, about 2 minutes.', '6 Add the hot stock, one ladleful at a time and simmer until it is almost all absorbed by the rice, after each addition. Slowly stir the rice while it is cooking in the stock.', 'Continue to cook until rice is just tender and mixture is creamy, adding more stock by ladlefuls, stirring often and allowing most stock to be absorbed before adding more, until rice is tender, but still firm to the bite, about 20-25 minutes.', '7 Stir in the sausage and mushrooms. Season to taste with salt and pepper. Sprinkle with cheese to serve.']",9
1067,Risotto with Balsamic-Roasted Asparagus and Peas Recipe,10,30,40,"['1 pound asparagus, thick ends trimmed and discarded', '1/4 cup Filippo Berio Extra Virgin olive oil, divided', '1/2 teaspoon salt, divided, plus more to taste', '1 tablespoon Filippo Berio Balsamic Glaze', '1/2 medium onion, finely chopped', '2 cups Arborio rice', '5 to 6 cups chicken or vegetable stock, homemade or store bought', '1 cup peas, fresh or frozen', 'Finely grated zest of 1 lemon, about 1 tablespoon', '2 tablespoons lemon juice', '1/2 cup finely grated Parmesan, plus more for serving']",11,"['1 Preheat the oven to 400\\xc2\\xbaF. Line a rimmed baking sheet with parchment paper.', '2 Prep the asparagus: Working with one asparagus spear at a time, lay each on a flat surface. With a vegetable peeler, peel away the thin outer layer of each spear, starting about 3-inches below the tip and working toward the end.', 'Lay the spears on a baking sheet and drizzle with 2 tablespoons olive oil and 1/8 teaspoon of the salt. Toss to coat with 2 tablespoons olive oil and spread out in a nice, even row.', '3 Roast the asparagus: Roast for 10 minutes, or until tender when pierced with a paring knife. Drizzle with the balsamic glaze.', 'When cool enough to handle, cut the spears into 1-inch pieces. Set aside while you make the risotto.', '4 Saut\\xc3\\xa9 the onions: In a 4-quart saucepan over medium-low heat, warm the remaining 2 tablespoons olive oil. Add the onions and 1/8 teaspoon salt. Cook, stirring often, for 4 to 5 minutes, or until the onions are soft and translucent.', '5 Add the rice: Add the rice and cook, stirring, for 2 minutes, or until the grains are warm and coated with olive oil.', '6 Begin adding broth: Add 2 cups of the stock to the pot and adjust the heat so that it maintains a steady simmer. When the stock is mostly absorbed, continue to add the stock in 1/2-cup increments, stirring regularly until it\\xe2\\x80\\x99s almost absorbed, about 20-25 minutes.', 'The rice should look like shiny porridge and should be slightly al dente, but err on the side of undercooking, since it will continue to cook and absorb liquid off the heat. Taste and add more salt if needed.', '5 Finish the risotto: Towards the end of cooking, stir in the peas and cook for 2 to 3 minutes. Add the asparagus and stir over the heat until they are warm.', 'Remove the pan from the heat. Stir in the lemon zest, juice and Parmesan.  Serve in bowls with more Parmesan, if you like.']",11
1068,Instant Pot Mushroom Risotto Recipe,10,45,55,"['2 tablespoons extra virgin olive oil', '1 pound mushrooms, washed, trimmed, and quartered or sliced', '1 medium onion, finely diced', '3 cloves garlic, minced', '1/4 teaspoon salt or to taste', '1/4 teaspoon freshly ground black pepper or to taste', '2 cups Arborio or Carnaroli rice', '1/2 cup dry white wine', '2 teaspoons soy sauce', '2 teaspoons miso paste (white or red)', '3 3/4 to 4 cups low-sodium chicken or vegetable stock, divided', '2 tablespoons unsalted butter', '1/2 cup finely shredded parmesan cheese, plus more to garnish', '1/4 teaspoon lemon zest, optional']",14,"['1 Saut\\xc3\\xa9 the mushrooms: Select \\xe2\\x80\\x9cSaut\\xc3\\xa9\\xe2\\x80\\x9d on the Instant Pot and adjust the heat to high. Add the oil to the cooker. When the oil shimmers, add the mushrooms and cook, stirring occasionally, until the liquid evaporates and the mushrooms are slightly browned, about 15 minutes. (If it seems like a long time, it\\xe2\\x80\\x99s because it is. Liquid takes longer to evaporate in the deep pot of the pressure cooker.)', '2 Saut\\xc3\\xa9 the onions and garlic: Once the mushrooms are fully cooked, add the onions and garlic to the Instant Pot and cook until the onion is translucent, about 3 minutes. Sprinkle with salt and pepper to taste.', '3 Add the rice: Add the rice and cook, stirring, until the grains are coated in the oil and the outer parts of the rice kernels are translucent, 1-2 minutes. Add the wine and cook, stirring, until nearly all the wine is evaporated, about 3 minutes. (This keeps the wine from having a raw taste, which can happen in a pressure cooker.)', '4 Season and cook under pressure: Stir in the soy sauce, miso, and 3 3/4 cup stock. Secure the lid, and make sure the pressure release valve is set to seal. Program the Instant Pot to cook on Manual/Pressure at high pressure for 5 minutes. (It will take about 10 minutes for the Instant Pot to come to pressure.)', 'When the Instant Pot beeps, release the pressure using the quick release: depending on the model of cooker you have, you will do this by pushing a button on the pressure cooker or nudge the valve open with the handle of a long spoon to keep your fingers away from the steam. Unlock the lid and open it. There will be a layer of thick liquid at the top of the pot and the rice will mostly be at the bottom. Stir to combine.', '5 Check for doneness: Carefully taste a bit of the risotto. You are checking for doneness\\xe2\\x80\\x94you want the rice to have a little bite, but not be raw and crunchy.', 'If it\\xe2\\x80\\x99s loose and soupy or if it\\xe2\\x80\\x99s crunchy, turn on the \\xe2\\x80\\x9cSaut\\xc3\\xa9\\xe2\\x80\\x9d setting and cook with the lid off. If loose stir constantly, until more of the liquid has been absorbed by the rice. If it\\xe2\\x80\\x99s crunchy add the remaining 1/4 cup stock and stir until it\\xe2\\x80\\x99s absorbed a bit, about 1 minute.', ""You want the consistency to be \\xe2\\x80\\x9call'onda\\xe2\\x80\\x9d (\\xe2\\x80\\x9clike waves\\xe2\\x80\\x9d in Italian). It\\xe2\\x80\\x99s the risottoland happy place between soupy/watery and gloppy/stiff. You want it to be rich and creamy."", '6 Finish the risotto: Stir in the butter and parmesan. Taste one more time for seasoning. If it seems a little too earthy and flat, add the 1/4 teaspoon of lemon zest. Adjust with salt, if needed. Serve right away.']",9
1069,The Best Dry Brined Roast Chicken Recipe,5,4400,4405,"['1 5- to 6-pound chicken', '1 lemon', '2 tablespoons olive oil', '2 3/4 teaspoons kosher salt', '1 1/4 teaspoons freshly cracked pepper', '1 1/4 teaspoons dried thyme']",6,"['1 Prepare the pan: Line a rimmed baking sheet with foil and set a baking rack on top or use a roasting pan with a roasting rack.', '2 Make the spice rub: Zest and quarter the lemon. Combine the lemon zest, juice from 1/4 of the lemon, 1 tablespoon olive oil, 2 1/2 teaspoons salt, pepper and thyme together in a small bowl.', 'Save the lemon quarters (even the one you squeezed dry) to insert into the cavity.', '3 Season the chicken: Pat the outside of the chicken dry with a paper towel. Slide your fingers between the skin and the breast meat to loosen the skin. Try to separate the skin from around the legs as well.', 'Rub 3/4 of the spice mixture under the skin and into the breast and leg meat. Rub the remaining spice mixture inside the cavity of the bird. Insert the lemon quarters in the cavity.', '4 Truss the chicken: To truss the chicken, cut a piece of kitchen twine about 15 inches long. Tuck the wings under the bird as best you can. Center the twine under the back end of the chicken so equal lengths of twine are where you tucked the wings in.', 'Lift up each side of the twine crossing it over the top of bird\\xe2\\x80\\x99s body, wrap it around the legs. Tie the legs together.', '  5 Let the chicken air dry for 24 hours: Place the bird, baking sheet and all, into your refrigerator uncovered for 24 to 72 hours. If you don\\xe2\\x80\\x99t have the room in your refrigerator it\\xe2\\x80\\x99s ok to put the chicken on a plate and transfer it to the baking sheet when you\\xe2\\x80\\x99re ready to roast the bird.', '6 Prepare the oven: When ready to roast, move your oven rack to the second lowest spot in the oven. Preheat the oven to 375\\xc2\\xb0 F degrees.', '7 Add extra seasonings: The chicken will look a little desiccated after the 24-72 hour rest. That\\xe2\\x80\\x99s a good thing! It means your chicken will have crispy skin!', 'Transfer the baking sheet from the fridge to the counter. Rub the outside of the chicken with 1 tablespoon of olive oil, a 1/4 teaspoon of kosher salt, and a few cracks of fresh ground pepper.', '8 Roast and baste the chicken: Place the baking sheet into the oven and roast for 1 hour at 375\\xc2\\xb0 F degrees. Then turn the oven up to 425\\xc2\\xb0 F degrees for the remaining 20 minutes or until the temperature in the thickest part of the breast reaches 160\\xc2\\xb0 F degrees.', 'Check the chicken at the 45-minute mark and baste it. You may have to tip the pan a little to the corner to get to the juices. If you don\\xe2\\x80\\x99t have a baster don\\xe2\\x80\\x99t worry, just use a long-handled spoon to scoop up and pour the drippings over the chicken.', 'Continue to baste every 15 to 20 minutes until it reaches a deep, rich, golden color, the skin is crispy, and the chicken has finished cooking through.', '9 Rest the chicken: Remove the chicken from the oven when the temperature in the thickest part of the breast reads about 160\\xc2\\xb0F. Let it rest for 5 minutes. The temperature will continue to rise to reach 165\\xc2\\xb0F.', 'If you don\\xe2\\x80\\x99t have a thermometer that\\xe2\\x80\\x99s ok. The chicken is cooked through when you slice into it and the juices run clear.']",16
1070,Beer Can Chicken Recipe,10,90,100,"['1 4-pound whole chicken', '2 tablespoons extra virgin olive oil or other vegetable oil', '1 opened, half-full can of beer, room temperature', '1 tablespoon kosher salt or sea salt', '2 tablespoons chopped fresh thyme leaves, or 1 Tbsp dried thyme', '1 tablespoon black pepper']",6,"['1 Prepare your grill for indirect heat: If you are using charcoal, put the coals on one side of the grill, leaving another side free of coals. If you are using a gas grill, fire up only half of the burners.', '2 Season the chicken, rub with oil: Remove neck and giblets from cavity of chicken, if the chicken came with them. Mix the salt, pepper, and thyme in a little bowl, and rub it all over the chicken. Rub the chicken all over with olive oil.', '3 Lower chicken onto half-filled beer can: Make sure the beer can is open, and only half-filled with beer (drink the other half!) If you want, you can put a sprig of thyme (or another herb like rosemary or sage) in the beer can.', 'Lower the chicken on to the open can, so that the chicken is sitting upright, with the can in its cavity.', '4 Grill on indirect heat: Place the chicken on the cool side of the grill, using the legs and beer can as a tripod to support the chicken on the grill and keep it stable.', 'Cover the grill and walk away. Do not even check the chicken for at least an hour. After an hour, check the chicken and refresh the coals if needed (if you are using a charcoal grill).', 'Keep checking the chicken every 15 minutes or so, until a meat thermometer inserted into the thickest part of the thigh reads 160\\xc2\\xb0F - 165\\xc2\\xb0F.', 'The total cooking time will vary depending on the size of your chicken, and the internal temperature of the grill. A 4 lb chicken will usually take around 1 1/2 hours.', ""If you don\\'t have a meat thermometer, a way to tell if the chicken is done is to poke it deeply with a knife (the thigh is a good place to do this), if the juices run clear, not pink, the chicken is done."", '5 Carefully transfer the chicken to a tray or pan: I say ""carefully"" because the beer can, and the beer inside of it, is quite hot. One way to do this is to slide a metal spatula under the bottom of the beer can. Use tongs to hold the top of the chicken.', 'Lift the chicken, beer can still inside, and move it to a tray. Let the chicken rest for 10 minutes. Carefully lift the chicken off of the can. If it gets stuck, lay the chicken on its side, and pull out the can with tongs.']",11
1071,Keller\xe2\x80\x99s Skillet Roast Chicken with Root Vegetables Recipe,15,85,100,"['One 4 to 4 1/2 pound chicken', 'Kosher salt and freshly ground black pepper', ""6 garlic cloves, smashed and peeled (smash with the side of a chef\\'s knife, makes it easier to peel)"", '6 thyme sprigs', '3 medium-sized rutabagas (also called ""swedes""), ends cut and discarded, rutabagas peeled, and any outer tough layer discarded, then rutabagas cut into 1/4-inch wedges', '2 medium-sized turnips, prepared the same way as the rutabagas', '4 medium-sized carrots, peeled and cut in 2-inch segments', '1 small yellow onion, peeled, roots cut off but core kept intact, other end cut off and discarded, the onion then cut into quarters', '8 small red-skinned new potatoes', 'About 1/3 cup extra virgin olive oil', '4 tablespoons butter, room temperature (spreadable)', 'Special equipment:', 'A large (11-inch if you have it) cast-iron frying pan', 'Kitchen string']",14,"['1 Preheat oven to 475\\xc2\\xb0F.', ""2 Cut away the chicken\\'s wishbone: Use a paring knife to cut away the wishbone from the neck/breast area of the chicken. You will probably have to use your fingers to feel around for it."", 'This is a little bit tricky, but if you can remove the wishbone first, it will make the chicken easier to carve after it is cooked. (This ease of future carving is the only reason to take the bone out, so you can leave it in if you want.)', '3 Season the cavity: Generously season the cavity of the chicken with salt and pepper. Add three of the garlic cloves and 5 sprigs of the thyme to the cavity, using your hands to rub the thyme and garlic all around the cavity.', '4 Truss the chicken: Cut a 3-foot section of cotton kitchen string. Place the chicken so that it is breast up, and the legs pointing toward you. Tuck the wing tips under the chicken. Wrap the string under the neck end of the bird, pulling the string ends up over the breast, toward you, plumping up the breast.', 'Then cross the string under the breast (above the cavity and between the legs). Wrap each end around the closest leg end, and tie tightly so that the legs come together.', '5 Toss vegetables with olive oil: Place the vegetables, onions, garlic, and remaining thyme sprig into a bowl. Add 1/4 cup of olive oil and toss with your hands until well coated. Season generously with salt and pepper.', '6 Slather the chicken with oil and season well with salt and pepper.', ""7 Place chicken on a bed of the vegetables in a cast iron pan: Create a bed of the root vegetables in a large cast iron pan (or use a regular roasting pan if you don\\'t have a cast iron pan.) My father likes to leave out the potatoes at this stage and arrange them around the chicken."", 'Place the chicken on the bed of vegetables. Slather the top of the chicken breasts with butter. (Note that we added some extra sprigs of thyme to the top, probably because my dad forgot to add them to the vegetables! But it still worked.)', '8 Roast in oven: Place the pan in the oven and roast the chicken for 25 minutes at 475\\xc2\\xb0F. Then reduce the heat to 400\\xc2\\xb0F and roast for an additional 45 minutes, or until the thickest part of the thigh registers 165\\xc2\\xb0F on a meat thermometer and the juices run clear.', '9 Cover and let rest on cutting board: Transfer the chicken to a cutting board, cover with aluminum foil and let rest for 20 minutes before carving to serve.', 'You can keep the vegetables warm by keeping them in the now-turned-off oven while the chicken is resting. Stir to coat the vegetables with the cooking juices before serving', '10 Cut the chicken into serving pieces. Place vegetables on a serving platter with the chicken pieces arranged on top.']",14
1072,Smoked Paprika Roast Chicken Recipe,10,75,85,"['2 Tbsp smoked paprika', '2 Tbsp melted unsalted butter*', '1 teaspoon garlic powder', '1 1/2 teaspoons salt', '1/2 teaspoon pepper', '1 whole 4-5 pound roasting chicken', '4 Tbsp honey', '2 Tbsp lemon juice', '*If using salted butter, use only one teaspoon of salt in the rub, not two.']",9,"['1 Preheat oven to 325\\xc2\\xb0F.', '2 Pat dry chicken: Pat dry the chicken thoroughly with paper towels.', '3 Spread paprika butter mix over chicken: Mix together the paprika, melted butter, garlic powder, salt, and pepper. Spread over the entire surface of the chicken and place the chicken in a shallow baking pan.', '4 Heat the honey and lemon juice in a small pot and set aside.', '5 Bake: Bake at 325\\xc2\\xb0F for approximately 1 hour to an hour and 15 minutes. Baste with the lemon-honey mixture after 35 minutes, and then every 15 minutes after that. You may need to adjust total cooking time depending on how big your chicken is.', 'The bird is done when the juices run clear (not pink) when a knife tip is inserted into both the chicken breast and thigh, about 165\\xc2\\xb0F.', 'Add more salt and pepper to taste.']",7
1073,Roast Chicken with Carrots Recipe,15,85,100,"['Whole fryer chicken, 3 1/2 to 4 pounds, preferably organic or kosher, wingtips removed', 'Salt', 'Freshly ground black pepper', '1 lemon, halved or quartered', '1 bunch fresh thyme', '10 cloves garlic, peeled', '8 carrots, peeled, trimmed and halved crosswise', '1 to 1\\xc2\\xbd cups chicken stock', '4 tablespoons extra-virgin olive oil', '1 Tbsp red-wine vinegar, more to taste']",10,"['1 Season and stuff the chicken: Preheat oven to 425\\xc2\\xb0F (220\\xc2\\xb0C). Rinse chicken and pat dry with paper towels. Season well with salt and pepper. Stuff with lemon, thyme and half of the garlic cloves.', ""2 Truss the chicken: Using butcher's string, secure the wings and legs to the body."", '3 Place chicken in a small roasting pan or large, deep, oven-proof heavy skillet. Surround with the carrots and remaining garlic, then add 1 cup of chicken stock. Drizzle with olive oil.', '4 Roast the chicken at 425\\xc2\\xb0F (220\\xc2\\xb0C). (If you are using a convection oven, start at 425\\xc2\\xb0F (220\\xc2\\xb0C) then reduce to 375\\xc2\\xb0F (190\\xc2\\xb0C) after the first 15 minutes.)', 'Roast until chicken is golden and carrots are well caramelized, 1\\xc2\\xbc to 1\\xc2\\xbd hours, basting with broth and pan juices every 15 minutes for the first 45 minutes. Add more stock if pan looks dry.', '5 Let chicken rest: Transfer chicken, carrots and garlic to a platter. Discard twine, thyme and lemon, and let chicken rest for 10 to 15 minutes.', '6 Add vinegar to pan juices: Skim fat from pan juices and discard. Add 1 Tbsp vinegar to remaining pan juices, taste and add more to taste. Serve over the chicken.']",7
1074,Honey Glazed Lemon Roast Chicken Recipe,120,90,210,"['One 4 pound (1.8 k) whole chicken', '1 cup (236 ml) lemon juice', '1 tablespoon extra virgin olive oil', 'Kosher salt', 'Freshly ground black pepper', 'A few sprigs of fresh thyme', '1/2 fresh lemon, cut into wedges', '1/4 cup (60 ml) honey, heated to make it easier to brush']",8,"['1 Marinate the chicken: Rub the chicken with about two teaspoons of kosher salt, all around the surface of the chicken. Place the lemon juice and the whole chicken in a resealable plastic bag (like a large freezer bag). Seal the bag and move the lemon juice around so that it coats the chicken.', ""Place the bagged chicken in a bowl, so that if the bag leaks, it won't leak all over your fridge, and chill for 2 hours or overnight. Turn the chicken occasionally so that all sides stay coated with the lemon juice."", '2 Pat dry the chicken, rub with olive oil, sprinkle with salt and pepper, add herbs and lemon wedges: Preheat your oven to 400\\xc2\\xb0F (205\\xc2\\xb0C) with an oven rack set in the bottom third of the oven. Remove the chicken from the refrigerator and take it out of the marinade bag (discard the marinade).', 'Pat the chicken dry with paper towels. Rub olive oil all over the exterior of the chicken. Sprinkle all over with salt and pepper, including the cavity. Place thyme sprigs and lemon wedges into the cavity.', '3 Roast chicken and baste with honey: Place the chicken on a rack over a shallow roasting pan (we recommend a rack to help the heat circulation around the chicken). Roast for 20 minutes at 400\\xc2\\xb0F (205\\xc2\\xb0C), then lower the heat to 350\\xc2\\xb0F (175\\xc2\\xb0C). Roast for another 45 minutes.', 'While the chicken is roasting, heat the honey in a bowl in the microwave or in a small saucepan to make it easier to brush.', 'After the chicken has roasted at 350\\xc2\\xb0F (175\\xc2\\xb0C) for 45 minutes, use a pastry brush to generously brush the top and sides of the chicken all over with honey.', 'Roast for another 10 to 15 minutes at 350\\xc2\\xb0F (175\\xc2\\xb0C) until an instant read thermometer reads 160\\xc2\\xb0F (71\\xc2\\xb0C) for the breast and 170\\xc2\\xb0F (77\\xc2\\xb0C) for the thigh, or when a sharp knife inserted into the breast and thigh releases juices that run clear, not pink.', ""Honey will burn if it gets too hot, so watch the chicken at this stage. If the skin is getting too dark and the chicken still isn't done, loosely tent the chicken with a piece of aluminum foil. Brush the chicken with honey one more time before taking it out of the oven."", '4 Tent with foil and let rest: Remove the chicken from the oven and transfer to a cutting board. Tent with foil to rest for 15 minutes.', '5 Make gravy with drippings:  Scrape up the drippings from the roasting pan with a metal spatula. Pour the pan juices and drippings into a small saucepan. If there are blackened bits from burnt honey, remove them. Spoon off all but a tablespoon of fat.', 'If you want to thicken the juices for gravy, create a slurry with a teaspoon of cornstarch or flour and a tablespoon of water. Add the slurry to the drippings, heat and stir until thickened. Season to taste with salt and pepper.', 'Serve the chicken with pan juices or thickened gravy.']",13
1075,Herb Stuffed Roast Chicken Recipe,15,60,75,"['One 5 pound chicken', 'Salt', 'Freshly ground black pepper', '3/4 cup loosely packed fresh herbs (basil, parsley, thyme, marjoram or oregano), finely chopped', '2 tablespoon extra virgin olive oil', '1 lemon, halved', '4 bay leaves', '1 sprig of fresh rosemary']",8,"['1 Preheat oven with a roasting pan in it to 400\\xc2\\xb0F.', '2 Rinse and salt the chicken: Rinse the chicken and chicken cavity with water and pat dry with paper towels. Rub salt over the inside of the cavity.', '3 Stuff herbs under skin:  Grasp the skin at the tip of the chicken breast and gently pull up. Use your fingers to gently separate the skin from the breast meat, taking care not to tear the skin. Sprinkle a little salt into the gaps and insert as much of the chopped herb mixture as you can.', '4 Stuff the cavity with the lemon, bay leaves, rosemary, and any remaining herbs. Pull the skin of the chicken breast over the breast so that none of the meat is exposed.', '5 Tuck in the wings and truss with kitchen string. ', '6 Brown the breast side of the chicken in roasting pan in oven: Rub olive oil over the chicken and sprinkle all over with salt and pepper. Carefully remove the hot roasting pan from the oven and add a little oil to the bottom of the pan. Place the chicken on one side, breast side down, on the roasting pan and put it back in the oven.', 'Cook for 5 minutes, then turn the chicken so that the other breast is on the pan and cook for another 5 minutes. Starting off by cooking the chicken this way will help brown the breasts.', '7 Turn chicken over and roast until done: Then turn the chicken over so that it is breast-side up. Cook for 45 min to 1 hour, or until the juices run clear (not pink) when a knife tip is inserted into both the chicken breast and thigh, about 165\\xc2\\xb0F for the breast and thigh.']",8
1076,Roasted Garlic Chicken Recipe,5,60,65,"['1/2 cup roasted garlic cloves', '2 cups water', '1 tablespoon salt', '1/2 teaspoon freshly ground black pepper', '1 tablespoon extra virgin olive oil', '1/2 lemon, cut into 4 wedges', '2 bay leaves', '1 (3-4 pound) whole roasting chicken']",8,"['1 Make the brine: Prepare the brine by combining garlic, water, salt, pepper and olive oil in a blender. Squeeze the juice from the lemon wedges into the brine, blend. Stir in the bay leaves.', '2 Brine the chicken overnight: Place chicken in a large, resealable plastic bag, or in a large non-reactive bowl. Pour the brine all over the chicken in the bag, or in the bowl. Add the (already squeezed) lemon wedges.', 'Squeeze out all the air from the bag and seal, or place plastic wrap over the chicken in the bowl. Refrigerate overnight - 12 to 24 hours.', '3 Roast the chicken: Preheat the oven to 375\\xc2\\xb0F. Remove the chicken from the brine. Pat dry with paper towels. Sprinkle salt and pepper all over the chicken.', 'Place the chicken on a rack, in a roasting pan, breast side up. Roast for about an hour, until the juices run clear from the thigh when pierced with a fork. (Thigh meat should have an internal temperature of 165\\xc2\\xb0F when tested with a meat thermometer.)', 'Let the chicken rest for 10 minutes before carving and serving.']",6
1077,Roast Chicken with Apricot Glaze Recipe,10,120,130,"['Rub:', '2 teaspoons ground cumin', '1/2 teaspoon ground cinnamon', '1 1/2 teaspoon kosher salt', 'Chicken:', '1 4-pound (1.8 kg) whole chicken', '1 tablespoon extra virgin olive oil', 'Apricot glaze:', '1/3 cup (80 ml) apricot preserves']",9,"['1 Rub chicken with spices and let sit: Whisk together the cumin, cinnamon, and salt in a small bowl. Rub the spices all over the chicken. Loosely cover and let sit at least one hour, or preferably refrigerate overnight. In either case allow chicken to sit at room temperature for at least one hour (preferably two) before cooking.', '2 Rub chicken with olive oil and roast in oven: Preheat oven to 375\\xc2\\xb0F. Place the chicken in a roasting pan, breast-side up. Rub olive oil all over the chicken. Place in the middle rack of the oven and cook for 50 minutes at 375\\xc2\\xb0F or until the internal temperature of the chicken thighs reaches 165\\xc2\\xb0F.', '3 Heat apricot preserves: While the chicken is roasting, heat the apricot preserves in a small saucepan or in the microwave until warm and runny.', '4 Baste chicken with apricot preserves: Remove chicken from oven, and baste the exposed surfaces of the chicken all over with the apricot preserves, using a basting brush.', '5 Increase oven temp and return chicken to oven: Increase the oven temperature to 400\\xc2\\xb0F. Return the chicken to the oven and bake for an additional 8 to 10 minutes, basting the chicken again with the glaze halfway through, until the glaze is bubbly and beginning to brown.', '6 Let chicken rest: Remove from oven and let rest for 15 minutes before serving.']",6
1078,Roast Chicken with Grapes Recipe,15,75,90,"['1 roasting chicken, about 4 to 5 pounds', '1 lemon, cut into thin wedges', 'Salt and pepper to taste', '1 onion, peeled, cut into eight wedges', '1 large bunch of seedless grapes (about 3 cups total)', 'A few sprigs of fresh rosemary, thyme, sage, and/or tarragon', '2 cups of white wine (can substitute chicken stock)', 'Extra virgin olive oil']",8,"['1 Let chicken sit at room temperature (70\\xc2\\xb0F) for at least an hour so it comes close to room temp before roasting.', '2 Stuff chicken with cut grapes, onions, herbs, lemon: Preheat oven to 450\\xc2\\xb0F. Pat the chicken dry. Rub inside and outside of chicken with olive oil. Sprinkle inside and outside with salt and pepper.', ""Remove about a cup's worth of grapes from their stems and cut in half. Insert grapes into cavity."", 'Add a couple onion wedges into the cavity, along with a few sprigs of fresh herbs. You do not need to remove the rosemary from its stem. Add a couple lemon wedges to the cavity.', '3 Arrange chicken in roasting pan, surrounded with herbs, onions, lemon wedges: Line the bottom of a roasting pan with onion slices and lemon wedges. Place the chicken on a roasting rack in the roasting pan, on top of the lemon wedges and onion, breast side down.', '(Alternatively you can place the chicken directly in the pan, resting on the onions, in which case the breast meat will braise in the juices, instead of roasting.)', 'Place sprigs of herbs and slices of lemon between the wings and the body of the chicken. Arrange any remaining grapes, lemon wedges, and herbs in the pan.', '4 Roast and baste the chicken: Roast at 450\\xc2\\xb0F for 25 minutes. Then baste with a cup of the wine and reduce the heat to 400\\xc2\\xb0F. Cook for 30 minutes more and baste again with the 2nd cup of wine.', 'Cook for another 10 to 20 minutes (depending on the size of the chicken) until the juices run clear (not pink) when a knife tip is inserted into the chicken thigh, or when the temperature reading of a meat thermometer, inserted deep into the breast or thigh, reads 160\\xc2\\xb0F.', '5 Rest the chicken: Remove the roast from the oven and cover with aluminum foil. Let rest for 15 minutes. The internal temperature of the chicken will continue to rise.', '6 Carve the chicken: Turn the chicken so that it is breast side up on a carving board. First separate the legs (drumstick and thigh) from the body. Then cut away the wings.', 'Make a cut down the breast bone. Continue to cut down on one side of the breast bone, cutting the breast away from the carcass, following the curvature of the rib cage as you cut. Repeat on the other side.', 'Slice the breasts crosswise to serve. Arrange the pieces on a platter, surrounded by grapes and caramelized onions from the roasting pan. Spoon pan sauce over the chicken pieces, and serve.', '7 Serve: Serve with rice or egg noodles.']",14
1079,Feta-Brined Roast Chicken Recipe,15,590,605,"['For the brine and chicken: ', '2 ounces feta cheese', '2 teaspoons kosher salt', '4 cups water', '3 1/2 to 4 pounds whole chicken', ' For the spice rub:', '1 tablespoon dried parsley', '1 1/2 teaspoons kosher salt', '1/2 teaspoon fresh ground black pepper', '1 1/2 teaspoon dried oregano, Greek or Mediterranean-style preferred', '2 large lemons', '2 tablespoon olive oil', 'To roast and finish:', '4 tablespoons olive oil', '2 ounces feta cheese, crumbled', '5 ounces mixed baby greens']",16,"['1 Make the feta brine: Place the feta cheese, salt, and water in a blender. Process until the feta cheese has broken down into small bits and the salt is dissolved.', '2 Brine the chicken: Place the chicken in a large Ziploc bag or other container. Pour the brine into the bag or container and seal. If the chicken is not fully submerged, turn the chicken over once or twice during the brining time. Refrigerate for at least 8 hours or overnight.', '3 Dry the chicken, and bring it to room temperature: When the chicken has finished brining, place a wire rack on a rimmed baking sheet. Remove the chicken from the brine, letting as much of the brine drip off the chicken and back into the bag or container. Place the chicken on the wire rack and discard the brine.', 'Using paper towels, pat dry the chicken as much as possible all over. Let the chicken dry on the rack and come to room temperature for an hour.', '4 Preheat the oven to 450\\xc2\\xb0F.', '5 Season the chicken: Make the spice rub by combining the parsley, salt, pepper, and oregano in large bowl. Zest both lemons and stir into the rub. Slice the lemons in half.', 'Drizzle 2 tablespoons of olive oil all over the chicken, then sprinkle and massage the rub into and all over the chicken skin. Place three of the lemon halves into the cavity of the chicken, reserving the fourth half for serving. Truss and tie the chicken legs together.', '6 Roast the chicken: Pour 4 tablespoons of olive oil into a large 12-inch cast iron skillet. Heat on high until the oil starts to smoke. Carefully place the herb-rubbed chicken, breast up, into the skillet, then place it in the oven.', 'Roast the chicken, basting once or twice, for 50 to 60 minutes or until a thermometer inserted into the thickest part of the thigh reads 165\\xc2\\xb0F. If you do not have a thermometer, pierce the thigh with a skewer or a knife. The chicken is done if the juice runs clear.', ""7 Let the chicken rest: After the chicken has finished cooking and you've removed it from the oven, let it rest for 10 minutes in the pan. While the chicken is resting, sprinkle the feta cheese into the pan juices all around the chicken."", '8 Serve: When the chicken is ready to be served, place the mixed greens on a serving platter. Serve the chicken on the mixed greens with the pan juices and feta cheese drizzled all over the chicken and greens, along with the juice from the reserved lemon half.']",11
1080,How to Dry Brine and Roast a Turkey Recipe,15,0,15,"['4 cloves garlic, minced', '1 1/2 tablespoons minced fresh parsley', '1 1/2 tablespoons minced fresh rosemary, the leaves from about one 9-inch sprig', '1 1/2 tablespoons minced fresh thyme', '3/4 tablespoon dried sage, or 1 tablespoon minced fresh sage', '1 1/4  tablespoon whole black peppercorns, ground', ""3 tablespoons Morton's kosher salt (add 1 1/2 teaspoons if using Diamond Crystal)"", '1 1/2  tablespoons granulated sugar', 'Zest from 2 lemons', '3 1/2 tablespoons lemon juice (the juice from 1 lemon)', '3 1/2 tablespoons olive oil', '1 (12- to 18-pound) natural turkey, thawed (not kosher, saline-injected, or otherwise pre-salted)', '1 medium onion, quartered', '2 to 3 cups of turkey or chicken stock, if needed']",14,"['1 Combine the dry brine ingredients: In a medium-sized bowl, combine the minced garlic, parsley, rosemary, thyme, sage, ground black peppercorns, salt, sugar, lemon zest, lemon juice, and olive oil. Stir to combine. Quarter the remaining lemons, and save them for the cavity of the turkey.', '2 Prepare the turkey for brining: About 24 to 72 hours before you want to roast the bird, take the thawed turkey out of any packaging, and remove the pop-up thermometer, if it has one. Remove and reserve the giblets and neck for making gravy or stock.', ""3 Dry brine the turkey: Place turkey on either a cooling rack set on top of a rimmed baking sheet or directly on the roasting rack in the roasting pan (mine didn't fit easily in the fridge that way!). Thoroughly pat the turkey dry inside and out with paper towels. Loosen the skin of the breast and legs."", 'Spread about half of the brine mixture under the skin, massaging it into the breasts and legs, 1/4 on the outside and the remaining 1/4 inside the cavity. Refrigerate uncovered for 24 to 72 hours.', '  4 Prepare for roasting: When ready to roast the turkey, position rack in bottom third of oven and preheat the oven to 425\\xc2\\xb0F.', ""If it's not there already, transfer the turkey to a roasting rack set in a roasting pan. Into the cavity of the turkey, put the quartered onion and lemon, and the rest of the fresh herbs you used for the dry brine."", 'To truss the bird, tuck the wings under the body as best as you can. Place butcher\\xe2\\x80\\x99s twine under the turkey, close to the wings. Cross the twine at the neck of the turkey, wrap each end of twine around the tip of the leg, and tie the legs together.', '5 Begin roasting the turkey: Roast the turkey at 425\\xc2\\xb0F until the skin starts to brown in spots, about 20 minutes. Reduce the oven temperature to 350\\xc2\\xb0F and roast for another 45 minutes.', '6 Baste the turkey and finish roasting: Rotate the roasting pan, baste the turkey with the pan juices, and tent the breast with foil to prevent it from overcooking. (If you find that your turkey hasn\\xe2\\x80\\x99t produced enough juices to use for basting, warm a cup or two of extra chicken broth on the stovetop or in the microwave and use that to baste the turkey.)', 'Continue roasting until an instant-read thermometer inserted into the thickest part of a thigh without touching bone registers 160\\xc2\\xb0F. This should take an additional 30 to 45 minutes; check the temperature and baste every 15 minutes until the bird is fully cooked.', '6 Rest the turkey and serve: Transfer the turkey to a clean cutting board and tent with foil. Let it rest 20 minutes before carving. Pat yourself on the back. Pour yourself one of these bad boys, and put someone else in charge of the dishes.']",11
1081,Mom\xe2\x80\x99s Roast Turkey Recipe,15,0,15,"['1 turkey, approx. 15 lbs.*', 'Juice of a lemon', 'Salt and pepper', 'Extra virgin olive oil or softened or melted butter', '1/2 yellow onion, peeled and quartered', 'Celery tops', '1 to 2 carrots', '1 bunch of parsley', 'Several sprigs of fresh rosemary, sage, and/or thyme', '* Need help figuring out how big a turkey to get? Butterball has a turkey calculator that helps you figure out just how many pounds you need. In general, plan for:', '9-12 lb turkey for 6-9 people', '12-15 lb turkey for 10-12 people', '15-18 lb turkey for 14-16 people', '18-22 lb turkey for 20-22 people']",14,"['Add several sprigs of fresh (if possible) thyme, sage, and/or rosemary to the outside of the turkey or tucked under the wings.', ""Note that if you are using a remote thermometer (or two) to gauge the temperature of the turkey while it cooks, it's easiest to find the right place to insert the probe when the turkey is breast-side UP. So eyeball where you think the thermometer probe(s) should go first, before placing the turkey breast-side down in the pan. Once the turkey is breast-side down in the pan, insert the probes into the thickest and coldest parts of the breast and/or thighs, making sure the probe(s) is not touching the metal rack or pan. If you only have one remote thermometer, put it in the breast."", '  7 Roast the Turkey', ""Before you put the turkey in the oven, do a rough calculation of how much overall time it should take to cook the turkey. Usually they say to assume 15 minutes for every pound of meat, but I have found in practice that it's usually less than that, more like 13 minutes per pound."", 'Cooking time will vary depending on the size of the turkey, how long it has been sitting at room temperature before cooking, and the shape and particulars of your specific oven. So come up with a rough estimate for the overall cooking time, and then make sure to check how the turkey is doing well before it is supposed to be done!', 'Put the turkey in the oven at 400\\xc2\\xb0F, uncovered. For the 15 lb turkey, start the cooking at 400\\xc2\\xb0F for the first 20 minutes to brown it. Then reduce the heat to 325\\xc2\\xb0F for the next 1 to 2 hours, until the internal temperature of breast reaches about 140\\xc2\\xb0F to 145\\xc2\\xb0F or so. Then reduce the heat further to 225\\xc2\\xb0F until done, anywhere from a half hour to an hour or more.', ""Note that the lower oven temperature at the end of cooking can help you time when you want the turkey to be done. If the turkey is cooking more quickly than you expect, lowering the oven temp can extend the cooking time. If the turkey isn't cooking quickly enough and you're ready to eat, don't lower the temperature to 225\\xc2\\xb0F, or if you already have, increase it again to 325\\xc2\\xb0F."", 'Browning the Breast', ""If you want the turkey skin of the breast to be browned, when the turkey is close to being done (about 150\\xc2\\xb0F for the breast), you'll need to turn the turkey over so that the breast is on top, and put it in a 500\\xc2\\xb0F oven or under the broiler for 4 to 5 minutes, just enough time to brown the breast."", ""Note that by browning the breast you may end up over-cooking the turkey breast a little bit. We often don't turn the turkey over. Turning the turkey over can be a hot, messy job, so if you do it, the best way is to use clean oven mitts or clean kitchen towels (just throw them in the laundry afterwards.)"", 'Target Temperatures for Doneness', 'Start taking temperature readings with a meat thermometer, inserted deep into the thickest part of the turkey breast and thigh, an hour and a half before the turkey should be done.', ""You want a resulting temperature of 165\\xc2\\xb0F for the white meat (breast) and 165\\xc2\\xb0F to 170\\xc2\\xb0F for the dark meat (thighs and legs). The temperature of the bird will continue to rise once you take it out of the oven, so take the turkey out of the oven when the temperature reading for the breast is 155\\xc2\\xb0F to 160\\xc2\\xb0F, and for the thigh is 160\\xc2\\xb0F to 165\\xc2\\xb0F. If you don't have a meat thermometer, spear the breast with a knife. The turkey juices should be clear, not pink."", ""The USDA lowered its recommended cooking temperatures for poultry to 165\\xc2\\xb0F. I've often found that at that temperature the thigh meat near the bone still isn't cooked, so I aim for 170\\xc2\\xb0F for the thighs."", 'If the thighs reach their target temperature before the breast, turn the turkey over and let the turkey finish cooking breast side up.', '  8 Let Turkey Rest, Then Carve', 'Once you remove the turkey from the oven, transfer it to a cutting board, tent it with aluminum foil to keep it warm, and let it rest for 15-30 minutes, depending on the size of the turkey. Turn the turkey breast side up to carve it. (See Serious Eats video on How to Carve a Turkey.)', '  MAKING TURKEY GRAVY', 'Make the gravy while the turkey is resting covered on the carving board. If you have used a thick metal roasting pan, you can often put it directly on the stovetop burner, if not, scrape off the drippings and put them into a skillet. If you are using the roasting pan, use a metal spatula to scrape loose any dripping that might be stuck to the bottom of the pan.', 'Use a metal spoon to ladle off some of the excess fat from the pan (leave about 4 Tbsp or so of fat and drippings in the pan) and reserve for another use.', 'You can use either flour or cornstarch to make the gravy. (We find we get better results with flour, so usually make gravy with flour unless serving a guest who must eat gluten-free.)', 'If using flour, heat the fat and drippings in the pan until they are bubbly. Sprinkle with 1/4 of flour all over the fat and drippings.', 'Stir with a wire whisk to make a roux with the flour and fat. Let the flour brown a minute or so in the hot pan.', 'Slowly add 3 cups of water, stock, or milk to the pan, whisking vigorously to get rid of any lumps. Let the gravy simmer and thicken.', 'Add salt and pepper, ground sage, thyme or other seasonings to taste.', 'See our gravy recipe for more detail and for instructions on making gravy using cornstarch.', 'SAVE BONES FOR STOCK', 'When you are finished with your turkey, save the bones from the carcass to make a delicious turkey soup.']",28
1082,Roast Turkey Breast with Roasted Garlic Gravy Recipe,15,165,180,"['Roasted Garlic Gravy:', '2 turkey wings', '2 heads garlic', '2 tablespoons extra virgin olive oil', 'Salt and white pepper', '3 Tbsp butter', '2 Tbsp flour', 'Turkey Breasts:', '1 bone-in, skin-on turkey breast (with two breast halves), about 6-7 pounds', '2 tablespoons extra virgin olive oil', 'Salt and black pepper', '1 teaspoon dried thyme', '1 teaspoon ground sage or poultry seasoning']",13,"['1 Preheat oven, prep turkey wings: Preheat the oven to 350\\xc2\\xb0F. Chop the turkey wings into pieces with a cleaver or heavy kitchen knife (or have your butcher do this for you).', 'Coat the wings with some olive oil and salt well. Arrange in one layer in a roasting pan.', '2 Roast the garlic and chopped turkey wings: Slice off the top 1/4 of the garlic heads and discard. Nestle the heads into some aluminum foil and drizzle the remaining olive oil over the garlic. Close the foil and place in the roasting pan with the turkey wings.', 'Put the pan in the oven and roast at 350\\xc2\\xb0F for 45 minutes. Remove the garlic (do not unwrap), turn the turkey pieces and roast another 15 minutes.', '3 Rinse turkey breast, let sit: While the turkey wings are roasting, take the turkey breast out of its package, rinse under cool water and pat dry with paper towels. Let it sit out to come to room temperature.', '4 Make turkey wing stock: When the turkey wings are ready, place them in a medium pot and cover with water.', 'Add a cup of water to the roasting pan and scrape up any browned bits with a wooden spoon. Add this to the pot with the turkey wings. Cover and simmer gently for 1 hour.', '5 Roast turkey breast in oven: Heat the oven to 425\\xc2\\xb0F. Coat the turkey breast with more olive oil, then sprinkle it all over with salt. Sprinkle it as well with black pepper, thyme and sage.', 'Place the turkey breast skin side up on a rack in a roasting pan. Pour 1 cup of water into the bottom of the pan (this will help prevent the oven from smoking).', 'Put the turkey in the oven and cook for 10 minutes. Turn the heat down to 350\\xc2\\xb0F and cook until the thickest part of the breast reads 155\\xc2\\xb0F with a meat thermometer, about 80-90 minutes for a 6 to 7 pound breast.', '(Note that the internal temperature will continue to rise after you take the turkey out of the oven to rest.) To be on the safe side to keep from overcooking the turkey, check the internal temperature of the breast after one hour.', '6 Make the gravy while the turkey breast is roasting: Pour the turkey broth through a fine-meshed strainer into a bowl.', 'Melt the 2 tablespoons of butter in a small pot and stir in the flour. Cook the butter flour mixture over medium-low heat, stirring often, until the mixture is the color of coffee-with-cream.', 'Add the hot turkey broth to the butter flour mixture about 1/2 cup at a time, stirring constantly. Stir in enough broth to make a thin gravy, about 2-3 cups. Squeeze all the garlic from the garlic heads into the gravy.', 'Simmer gently while the turkey breast cooks, adding more turkey broth or water if the gravy gets too thick.', '7 Remove turkey from oven, let rest: When the turkey breast is ready, remove it from the oven, cover it with foil and let it rest for 15 minutes before carving.', '8 Finish gravy: Pour the gravy into a blender and pur\\xc3\\xa9e until smooth. Return the gravy to the pot and add salt and pepper to taste. Swirl in 1 tablespoon of butter to finish.', '9 Carve the turkey breast: Cut straight down from the keel bone (the keel bone separates each half of the breast) until your knife hits the breast bone. Slice the meat off and, using short strokes with the knife, free the meat from the bone.', 'If you want, pull off the tender underneath the breast and slice this piece separately; it tends to fall off the rest of the breast when you slice it anyway. Slice the deboned breast and serve.']",19
1083,"Pasta with Sausage, Tomatoes and Roasted Peppers Recipe",15,15,30,"['1 tablespoon extra virgin olive oil', '3/4 pound Italian sausage, sweet or hot', '2-3 garlic cloves, minced', '1 cup roasted red bell peppers, chopped', '1 tablespoon capers', '1/2 cup pitted black olives, halved', '3-4 large fresh tomatoes, seeded and chopped', '1/4 cup chopped fresh basil', '1 pound linguine or other pasta']",9,"['1 Heat a large pot of salted water (1 Tbsp salt per 2 quarts of water) to a boil.', ""2 Brown the sausage, add garlic, roasted red peppers, capers and olives: While the water is heating, prepare the sausage and peppers. Heat the olive oil in a large saut\\xc3\\xa9 pan on medium heat. Add the sausage, breaking it up into bits with your fingers as you add it to the pan or with a wooden spoon once it's in the pan."", ""When the sausage starts to brown, add the garlic and cook for another minute. Mix in the roasted red peppers, capers and olives. If the pasta water isn't boiling yet, remove the saut\\xc3\\xa9 pan from the heat."", '3 Cook the pasta: Once the pasta water is boiling, add the pasta to the pot.', '4 Add chopped tomatoes and basil to sausage mixture: When the pasta is almost done, increase the heat to high on the saut\\xc3\\xa9 pan and when the sausage mixture starts to sizzle, add the chopped tomatoes and basil. Toss to combine and lower the heat to medium-low.', '5 Combine pasta and sausage mixture: Drain the pasta and put it in a large bowl. Add the sausage mix to the bowl and toss to combine.']",6
1084,Best Homemade Cinnamon Rolls Recipe,30,560,590,"['For the dough:', '1 cup whole milk', '2 teaspoons active dry yeast', '1/4 cup sugar', '2 large eggs', '4 cups all-purpose flour', '1 1/2 teaspoons kosher salt', '6 tablespoons room temperature unsalted butter, very soft', 'For the filling:', '1/2 cup room temperature unsalted butter', '3/4 cup brown sugar', '1 tablespoons ground cinnamon', '1/4 teaspoon kosher salt (or slightly less table salt)', 'For the frosting:', '4 ounces cream cheese, softened at room temperature', '4 tablespoons unsalted butter, softened at room temperature', '1 to 4 tablespoons milk, whole or 2%', '2 cups powdered sugar', '1/2 teaspoon vanilla extract', 'Pinch of kosher salt', 'Special equipment:', 'Stand mixer', '9x13 baking dish']",23,"[""1 Make the dough: Warm the milk for 15 to 30 seconds in the microwave, until it's slightly warm to the touch but not steaming. In the bowl of a stand mixer fitted with the dough hook, combine the warm milk, yeast, and sugar. Let the mixture stand until foamy, about five minutes."", ""Add the eggs, flour, and salt to the bowl and mix on medium speed until a sticky dough is formed. Beat in the butter, 2 tablespoons at a time, waiting until the butter is incorporated before adding the next batch. The butter needs to be very soft for this to work; if the butter isn't incorporating, knead each piece in your fingers until soft before adding it to the dough."", 'Once all the butter is incorporated, knead the dough for 10 minutes on medium speed (or knead by hand).', '2 Rise overnight: Shape the dough into a ball, place in a large, lightly oiled bowl, and cover with plastic wrap. Let the dough rise in the refrigerator overnight, at least 8 hours. It will slowly double in size.', '3 Cut and shape the rolls: In the morning, remove the dough from the refrigerator. The dough will be quite stiff and firm, but should roll easily. Dust your work surface and a rolling pin lightly with flour, and roll the dough out into a rectangle approximately 12x16 inches in size.', 'Spread the dough with butter, leaving a 1-inch border on one of the shorter edges. Combine the brown sugar, cinnamon, and salt in a bowl. Sprinkle the mixture over the butter in an even layer.', 'Starting from the short edge (the one with butter all the way to the edge), roll the dough into a tight spiral. Pinch the spiral closed (the unbuttered edge should stick to the log of dough). Trim the ends if they are shaggy.', 'Cut the roll in half crosswise to make 2 pieces. Cut each piece in half again to make 4, and each piece again to make a total of 8 rolls. Place the rolls in a greased 9x13-inch baking dish.', '4 Cover the rolls with plastic wrap, and let them rise in a warm place for 30 to 90 minutes. Rising time will depend on the temperature in your kitchen. When ready, the rolls should be puffed and pillowy. They should be touching each other with very little space between each roll.', '5 While the rolls look half-risen, preheat the oven to 350\\xc2\\xb0F.', '6 Bake the rolls: Bake the rolls for 20 to 25 minutes until they are golden on top and puffy. Remove from the oven and cool on a rack for 5 minutes before frosting.', '7 Make the frosting: While the rolls bake, use a hand mixer or stand mixer to beat the cream cheese and butter together until creamy. Add half of the powdered sugar and 1 tablespoon of milk. Beat for 1 minute. Add the remaining sugar and vanilla, and beat for 1 additional minute. Add additional milk, 1 tablespoon at a time, until the frosting is as spreadable as you like.', ""8 Serve warm: Frost the cinnamon rolls generously while they're still a bit warm. Serve immediately.""]",13
1085,Make-Ahead Dinner Rolls Recipe,30,20,50,"['4 cups all-purpose flour (480 grams), measured into a bowl using the fluff-and-scoop method, plus more for dusting', '2/3 cup (40 grams) instant mashed potato flakes, unflavored or natural-flavored', '1 package (2 1/2 teaspoons) instant yeast', '1/4 cup (50 grams) sugar', '1 1/2 teaspoons salt', '2 large eggs', '1 1/4 cups (296ml) whole milk', '4 ounces (8 tablespoons) unsalted butter, softened at room temperature', '1 teaspoon vegetable or olive oil, for the bowl', 'About 3 tablespoons melted butter for brushing the reheated rolls']",10,"['1 Mix the dough: In the bowl of a stand mixer on low speed with the paddle attachment, stir 2 cups of the flour, the potato flakes, yeast, sugar, and salt until combined. Add the eggs and milk and beat for 1 minute at medium speed.', 'Add the butter in tablespoon size pieces on medium speed and beat until it is incorporated. This will take about 3 to 5 minutes. Scrape down the sides of the bowl and mix in 1 1/2 cups more flour at low speed. The dough will be thick and smooth.', 'Scrape down the sides of the bowl again and switch to the dough hook. Set the mixer on low speed and gradually add 1/2 cup more flour.', '2 Knead the dough: Continue kneading the dough on low speed for 10 minutes or until it cleans the sides of the bowl. The dough should be soft and slightly tacky, but not so sticky that it will be difficult to shape into rolls.', 'If it is very sticky, add more flour, 1 tablespoon at time, until the dough pulls away from the sides of the bowl.', '3 Let the dough rise: Turn the dough out of the bowl and form into a ball. Drizzle the oil into the bottom of the bowl. Set the ball back in the bowl and turn it to coat it with oil.', 'Cover the bowl with plastic wrap. Leave in a warm place to rise for 1 1/2 to 2 hours, or until doubled in size and the dough is firm but fingertips leave an impression in the dough.', '4 Shape the rolls: Turn the dough onto a lightly floured countertop and, using a rolling pin, roll it into a 12-inch square that is even in thickness. This ensures that your rolls will be approximately all the same size. With a chef\\xe2\\x80\\x99s knife or pizza cutter, cut the square into 16 equal pieces of dough.', 'For each piece of dough, fold the edges into the center and pinch the loose ends together to form a ball. Turn the dough over so the seam side is down.', 'Move it to an unfloured part of your work surface (in order to take advantage of the traction of the board to shape the rolls). Cup your hands over the dough and rotate the roll, using your cupped fingers and your palm to make a round, taut roll.', '5 Let the rolls rise: Line a rimmed baking sheet with parchment. Set the rolls on the sheet about 1-inch apart and cover with plastic wrap. Let the rolls rise for 1 hour, or until they have risen and look puffy. Toward the end of rising time, preheat the oven to 350\\xc2\\xb0F.', 'Note: For rolls that \\xe2\\x80\\x9ckiss\\xe2\\x80\\x9d each other, set 4 in a row on the baking sheet. For separate rolls, spread them slightly farther apart.', '6 Bake the rolls: Bake for 20 minutes, or until golden brown. Lift them off the baking sheet and set them on a rack to cool. If serving immediately, brush with melted butter (optional), or freeze (without the butter) and reheat at your convenience.', '7 Freeze the rolls: In packages of 6 or 8, wrap the completely cooled, baked rolls tightly in foil. Slip the foil packages into plastic freezer bags and freeze for up to one month. (The rolls may develop frost and freezer burn after one month.)', 'Note: A one-gallon freezer bag conveniently holds a 6-pack of rolls, while a two-gallon bag will hold 2 8-packs.', '8 Reheat the rolls: Remove the foil packages from the freezer bags and open the packages to allow air to circulate. Place them on a baking sheet in their open foil packets and heat in a 300\\xc2\\xbaF oven for about 10 minutes. If you like, brush with melted butter.']",16
1086,Grilled Romaine Lettuce Recipe,10,10,20,"['3 to 4 romaine hearts', '3 tablespoons extra virgin olive oil', '1 tablespoon red wine vinegar (or cider vinegar)', '2 teaspoons chopped fresh herbs such as rosemary, thyme, oregano (or 1 teaspoon dried mixed herbs)', '1/4 teaspoon salt', 'Pinch freshly ground black pepper']",6,"['1 Prep the romaine hearts: Pull off any old leaves. Chop off the top 1 or 2 inches of the lettuce head, and shave off the browned part of the root end, leaving the root end intact so that the lettuce head stays together.', '2 Prepare your grill for high, direct heat.', '3 Prepare the vinaigrette: Put the oil, vinegar, herbs, salt and pepper in a small bowl and whisk with a fork to combine. Paint the lettuce hearts all over with the vinaigrette.', '4 Grill: Grill the romaine hearts until lightly browned on all sides, turning every minute or two until done.', 'Serve immediately. You can either serve the hearts whole, or chop them and toss them for a salad.']",5
1087,Kale Caesar Salad with Creamy Parmesan Dressing Recipe,20,15,35,"['Croutons:', '6 cups of 1-inch diced rustic bread (ciabatta or Italian loaf)', '1/4 cup extra virgin olive oil', '1 clove garlic, minced (about 1 teaspoon)', '1 teaspoon kosher salt', '1/4 teaspoon black pepper', 'Vinaigrette:', '1 clove garlic', '1/2 teaspoon Dijon mustard', '1 1/2 Tbsp lemon juice', '1 1/2 teaspoon white wine vinegar (can sub apple cider vinegar)', '1/4 teaspoon kosher salt', '1/2 cup extra virgin olive oil', '1/3 cup grated Parmesan (use vegetarian Parmesan for vegetarian option)', '1/8 teaspoon ground black pepper', 'Salad:', '8 cups kale leaves (lightly packed), ribs removed and leaves torn into bite-size pieces', '2 large head romaine lettuce hearts, cut in half lengthwise, and then cut in half again lengthwise, then cut crosswise on a diagonal, to 1-inch wide strips', '4 Tbsp grated Parmesan']",19,"['1 Toast croutons: Preheat oven to 400\\xc2\\xb0F (200\\xc2\\xb0C). Spread bread cubes out in a single layer on a rimmed baking sheet. Place in oven and bake until golden brown, about 8 to 10 minutes. Remove from oven. Toss while still warm in a bowl with olive oil, garlic, salt and pepper.', '2 Make vinaigrette: Place the vinaigrette ingredients into a blender or food processor. Pur\\xc3\\xa9e until smooth.', '3 Assemble salad: Place the chopped kale and romaine leaves into a large bowl. Add the dressing and massage with your (clean) hands until the salad is well dressed. (Massaging the kale with your hands helps soften the leaves.) Alternatively, dress the salad and let it sit for an hour or two, allowing time for the dressing to soften the sturdy kale.', 'Add the croutons and the Parmesan cheese.']",4
1088,Grilled Chicken Caesar Salad Recipe,10,15,25,"['For the grilled chicken', '1/4 cup olive oil', 'Zest of one lemon', '2 cloves garlic, finely minced', '1/2 teaspoon salt', '1/2 teaspoon fresh ground black pepper', '1 pound boneless skinless chicken thighs', 'For the grilled croutons', '2 tablespoons olive oil', '1 clove garlic, minced', '1/2 teaspoon salt', '1/2 teaspoon fresh ground black pepper', '1 loaf crusty baguette, cut into slices about 1/2-inch thick', 'To assemble', '4 heads romaine lettuce hearts', 'Heaping 1/2 cup (2 ounces) Parmesan, thinly shaved', 'Fresh cracked black pepper', '1/2 cup Caesar dressing, store-bought or homemade, or more as needed']",18,"['1 Marinate the chicken: In a medium bowl, whisk together the olive oil, lemon zest, garlic, salt, and pepper. Add the chicken and toss to coat. Marinate in the refrigerator, covered, for at least 20 minutes and up to 24 hours.', '  2 Brush the bread with oil: Combine the olive oil, garlic, salt, and pepper to a small bowl. Use a pastry brush to coat each side of the bread. Set aside on a tray.', '3 Heat your grill: Preheat your grill to high heat to around 500\\xc2\\xb0F with two zones for direct and indirect grilling.', '4 Grill the bread: Grill the slices of bread over direct high heat for 2 minutes on each side. Remove from the grill and set aside while grilling the chicken.', '  5 Grill the chicken: Grill the chicken for 5 minutes on one side without disturbing, then flip and move the chicken to the cooler side of the grill. Cook 3 to 5 minutes or until internal temperature reaches 165\\xc2\\xbaF.', '6 Finish the salad: Tear the romaine hearts into bite sized pieces and toss with the dressing in a large bowl. Divide the greens between plates and top with the grilled chicken, shaved Parmesan, grilled croutons. Finish with freshly cracked black pepper.']",6
1089,Chicken and Avocado Salad with Buttermilk Dressing Recipe,15,15,30,"['For the buttermilk dressing:', '1 tablespoon finely chopped shallots', '2 tablespoons lemon juice', '1/4 teaspoon salt', '1/8 teaspoon ground black pepper', '1/2 cup mayonnaise', '1/2 cup buttermilk', '2 tablespoons chopped chives', 'For the garlic toasts:', '4 slices of crusty artisan-style bread', '2 tablespoons olive oil', '1 clove garlic, peeled', 'For the salad:', '2 hearts of romaine, leaves torn in half, or any other crunchy leafy salad green', '2 cups shredded or sliced leftover chicken', '2 medium ripe avocadoes, sliced', 'A small piece of Parmesan (about 1 ounce), shaved with a vegetable peeler']",17,"['1 Make the dressing: In a small mixing bowl or a jam jar, combine the shallots, lemon juice, salt and pepper. Let stand for 5 minutes. Add the mayonnaise and buttermilk, and whisk to combine (or put the lid on the jar and shake). Add the chives. Taste and add more salt and pepper if needed.', 'This dressing can be made ahead and kept refrigerated for about a week.', '2 Make the garlic toasts: Preheat the oven to 375\\xc2\\xb0F.  Brush the bread slices with oil and place on a rimless baking sheet. Bake for 12 to 15 minutes, until golden and crispy on the outside. Remove from the oven and cool them on the pan. Rub the garlic clove over each slice.', '3 Assemble the salad: Divide the romaine between 4 bowls or plates. Top each with avocado, chicken, and Parmesan. Drizzle with the dressing. Serve with the garlic toasts.']",4
1090,Homemade Sassafras Root Beer Recipe,10,30,40,"['Several roots (including some green stems) from sassafras saplings, about 30-40 inches worth of 1/4-inch thick roots (enough to fill one cup when you chop them into 1/2-inch pieces)', '4 cups water', '2 cloves', '1/2 teaspoon anise seeds (can sub fennel)', '4 allspice berries', '1-inch of stick cinnamon', '1/4 cup molasses', '1 cup sugar', '2 quarts soda water']",9,"['1 Prepare the roots: Scrub the roots clean of any dirt.', 'Cut the roots into 1/2-inch long pieces. (The roots can be tough, if you have a pair of pruning shears, they work great to cut the roots.) If you have a few green stems, you can include them too, but you should have mostly roots.', 'Cut up as much as you need to fill one cup.', '2 Simmer roots with spices: Put the roots into a small pot and cover with 4 cups of water. Add the cloves, anise seeds, allspice berries, and cinnamon stick. Bring to a boil, reduce to a simmer, and simmer for 25 minutes.', '3 Add the molasses and simmer for 5 minutes more. Remove from heat.', '4 Strain and add sugar: Strain through cheesecloth or a fine mesh sieve lined with a paper towel. Rinse out the pot. Return the liquid to the pot.', 'Add the sugar, heat until just a simmer and the sugar has dissolved. Remove from the heat and let cool.', '5 Add soda water to syrup to serve: To assemble the root beer, fill a glass with ice cubes, add the syrup and soda water in a 1:2 ratio, so 1/3 cup of syrup to 2/3 cups of soda water. Add more soda water if you want it more diluted, add more syrup if you want it stronger.']",8
1091,Celery Root Mash Recipe,10,35,45,"['2 pounds celery root', '1/2 cup milk or cream', '3 tablespoons unsalted butter', 'Salt to taste', 'Chopped celery root leaves, for garnish (optional)']",5,"['1 Bring a large pot of salted water to a simmer (1 Tbsp of salt for every 2 quarts of water).', '2 Peel and cube the celery root, boil until soft: While the water is coming to a boil, peel the celery roots with a knife. Cut the celery roots into 1-inch pieces.', 'Boil for 25-30 minutes, until soft.', '3 Drain the pot, steam the celery root: Drain the pot, return the celery roots to the pot to the stovetop on low. Cover and let the celery roots steam for a minute or two, shaking the pan a bit to prevent sticking.', '4 Add the milk or cream, butter and a generous pinch of salt and mash with a potato masher until it is as smooth as you like it. Add salt to taste and garnish with the celery root leaves, if using.']",5
1092,Roasted Parsnips Recipe,15,30,45,"['1 1/2 pounds of parsnips, peeled and cut into 2 1/2 inch batons', '4 teaspoons of extra virgin olive oil', 'Salt and freshly ground pepper', '1/3 cup of stock - turkey stock, low-sodium chicken stock or vegetable broth (for vegetarian option)*', '3 Tbsp unsalted butter, softened', '4 teaspoons drained, bottled horseradish (how to make homemade horseradish)', '1/2 Tbsp finely chopped flat-leaf parsley', '1/2 Tbsp minced chives', '1/2 small garlic clove, minced.', '*If cooking gluten-free, use homemade stock or gluten-free packaged broth.']",10,"['1 Roast the parsnips: Pre-heat oven to 400\\xc2\\xb0F. In a large roasting pan, toss the parsnips with the olive oil, salt and pepper. (Use a roasting pan with sides no more than 2 inches high.)', 'Add the broth, cover with aluminum foil and roast, stirring once or twice, until the parsnips are tender and the stock has evaporated or been absorbed, 20-45 minutes (depending on how tender the parsnips are to begin with). Check often to avoid their getting mushy - especially if they are to be reheated later.', 'To save time, the parsnips (with the oil, salt, pepper, and broth) can be pre-cooked in a covered container in the microwave for 5 minutes. Transfer to oven to finish cooking in a much shorter time. You may want to uncover them to help evaporate the liquid when in the oven.', '2 Make horseradish herb butter: Combine the softened butter with the horseradish, parsley, chives and garlic and season with salt and pepper.', '3 Serve: Toss the warm roasted parsnips with the horseradish-herb butter to serve.']",5
1093,Turkey Stew with Root Vegetables Recipe,10,150,160,"['2 tablespoons extra virgin olive oil', '3 pounds turkey thighs (preferred) or legs (skin on, bone in)', '1 medium-large yellow onion, peeled and roughly chopped (about 1 1/2 cups)', '2 stalks celery, roughly chopped (about 1 1/2 cups)', '2 teaspoons salt', '1 quart (4 cups) chicken, turkey, or vegetable stock', '2 medium carrots, peeled, 1/4 inch slices (about 1 1 /4 cups)', '1-2 medium turnips, peeled, 1/2 inch cubes', '1 medium rutabaga, peeled, halved, cut into 1/4 inch thick slices', '3 medium Yukon Gold potatoes, peeled and quartered', '1 teaspoon Herbes de Provence*', 'Freshly ground black pepper', ""*Herbes de Provence is a delightful French blend of herbs - Winter savory, thyme, basil, tarragon, and lavender flowers. If you don't have Herbes de Provence, you can substitute with an Italian herb mix.""]",13,"['1 Brown the turkey thighs: Preheat oven to 300\\xc2\\xb0F. Heat olive oil on medium high heat in a Dutch oven on the stove top. Wash and pat dry turkey pieces. Working in batches if necessary, brown the turkey thighs, first skin side down, 2-3 minutes on each side. Sprinkle the thighs with a little salt as you brown them.', '2 Cook the onions and celery: Once the thighs have browned, remove them from the pan and set them in a bowl. Add the onions and celery to the pot. Cook for about 5 minutes or so, until the onions are translucent and starting to brown at the edges.', '3 Add turkey thighs, salt, half of the stock: Return the turkey thighs to the pot. Add 2 teaspoons of salt and half of the stock. Bring to a simmer, remove from the stove top and put in the oven, covered, for an hour and fifteen minutes.', '4 Add rest of vegetables and remaining stock: After an hour and fifteen minutes, remove from oven and add the rest of the vegetables\\xe2\\x80\\x94carrots, turnips, rutabaga, and potatoes, the herbs, and the rest of the stock.', 'Return to the oven, covered, and cook until tender, another 45 minutes or more.', '5 Strip meat from turkey thighs, return to stew: Remove the turkey thighs from the stew and place in a bowl to cool. When cool enough to handle, strip the meat off the bones. Discard the bones and skin. Cut the meat into bite-sized pieces (1 1/2-inches or so chunks) and return to the pot.', 'Sprinkle with black pepper and add more salt to taste.']",7
1094,Mashed Rutabaga with Sour Cream and Dill Recipe,10,45,55,"['2 to 3 pounds of rutabagas, peeled and chopped into 1 inch chunks', 'Salt and black pepper', '2 teaspoons butter', '1/4 cup to 1/2 cup full-fat sour cream (more or less to taste)', '2 Tbsp chopped fresh dill or chives']",5,"['1 Boil chopped rutabaga until tender: Cover the chopped rutabaga with about 1 inch of cold water and bring to a boil.', 'Add a generous pinch of salt and boil until tender, about 30-40 minutes. Drain and return the rutabagas to the pot.', '2 Let steam, then mash: Reduce the heat to low and let the rutabaga steam for a minute or two. Mash with a potato masher.', '3 Add the butter, sour cream, and salt and pepper to taste. Just before you serve, mix in the chopped dill or chives.']",4
1095,Classic Glazed Carrots Recipe,5,20,25,"['1 pound carrots, peeled', '2-3 tablespoons unsalted butter', '1 teaspoon salt', '1/3 cup chicken stock (use vegetable stock for vegetarian option)', '1 heaping tablespoon sugar', '1/4 teaspoon white pepper (optional)']",6,"['1 Prep the carrots: Slice the carrots into 1/8 to 1/4-inch disks or diagonally. Try to cut the pieces so they are about the same size as each other, so they cook evenly.', '2 Saut\\xc3\\xa9 carrots in butter: Melt the butter in a saut\\xc3\\xa9 pan over medium-high heat, then add the carrots. Toss to combine and reduce the heat to medium. Sprinkle the salt over carrots and toss again. Saut\\xc3\\xa9 for 3-4 minutes.', '3 Add sugar, pepper, stock: then add the sugar and white pepper (if using) and toss to combine. Add the stock. Cover the pot and cook for another 3 minutes.', '4 Reduce liquid to a glaze: Uncover the pot and increase heat to medium-high. Toss the carrots once or twice to keep them moving, and cook away most of the liquid. Turn off the heat and taste. Add more salt and sugar to taste.']",4
1096,Maple Orange Glazed Carrots Recipe,5,20,25,"['1 pound carrots, peeled, sliced into 1/4-inch thick rounds', '2 Tbsp unsalted butter', '1/2 teaspoon salt', '1/4 cup maple syrup', '1/3 cup orange juice', '1/2 teaspoon orange zest', 'Pinch cinnamon']",7,"['1 Saut\\xc3\\xa9 carrots in butter: In a large, wide saut\\xc3\\xa9 pan, heat the butter on medium heat until melted. Add the carrots and toss to coat. Sprinkle with salt. Cook for 3-4 minutes.', '2 Add maple syrup, then orange juice: Add the maple syrup and cook for a minute more. Add the orange juice. Cover the pan and cook for 3 more minutes.', '3 Uncover pan and simmer away most liquid: Uncover the pan and increase the heat to medium high. Stir the carrots occasionally, and cook until almost all of the liquid has evaporated. Remove from heat.', '4 Sprinkle cinnamon over the carrots, and stir in the orange zest.']",4
1097,Scalloped Turnips Recipe,20,75,95,"['4 Tbsp butter', '1/2 cup thinly sliced onions', '4 cups peeled, thinly sliced turnips', '2 Tbsp flour', '1 teaspoon salt', 'Freshly ground black pepper', '3/4 cup milk', '1/3 cup cream']",8,"['1 Preheat oven, prepare casserole dish: Preheat oven to 350\\xc2\\xb0F. Butter a 1-quart casserole dish.', '2 Saut\\xc3\\xa9 onions: Melt 1 Tbsp butter and lightly saut\\xc3\\xa9 onions until just wilted.', '3 Layer turnips, onions in casserole: Layer a third of the sliced turnips in the casserole dish; top with a third of the onions; sprinkle with 2 teaspoons of flour, 1/3 teaspoon of salt, and one grind of pepper; pat with dollops from 1 tablespoon of butter.', 'Repeat this layering twice.', '4 Mix milk and cream together and pour over the turnips.', '5 Bake: Cover and bake in a 350\\xc2\\xb0F oven for 30 minutes, then remove cover and bake for another 30-45 minutes, or until tender and bubbly.']",6
1098,Pur\xc3\xa9ed Roasted Parsnips Recipe,10,20,30,"['2 pounds parsnips, peeled, stringy cores removed, chopped (about 1 1/2 pounds after removing cores)', '3 tablespoons butter, melted (can sub with extra virgin olive oil)', '1 1/2 cup water', '1/8 teaspoon nutmeg', 'Salt and pepper to taste']",5,"['1 Preheat oven and prep the parsnips: Preheat oven to 400\\xc2\\xb0F (205\\xc2\\xb0C).', 'Peel parsnips, make a cut off the top of the fat end of each parsnip. This will show you extent of the inner core.', 'Often this core is stringy and woody, especially at the larger end of the parsnip. When you are prepping the parsnips, cut around this core.', '2 Toss with melted butter and place in roasting pan: Place chopped parsnips in a medium sized bowl, add the melted butter and stir to coat. Lay out the parsnips on a roasting pan in a single layer.', '3 Roast in oven: Roast in the 400\\xc2\\xb0F (205\\xc2\\xb0C) oven for 20 to 25 minutes, until lightly golden, turning the parsnips once half-way through the cooking.', '4 Pur\\xc3\\xa9e cooked parsnips: Put cooked parsnips into a blender or food processor. Add 1 1/2 cups water, and pulse until pur\\xc3\\xa9ed to the desired consistency. Add more water if necessary.', '5 Season: Add nutmeg and salt and pepper to taste.']",7
1099,Creamed Turnips Recipe,5,25,30,"['3 pounds turnips', '6 black peppercorns', '6 whole cloves', '2 bay leaves', '1 tablespoon kosher salt, plus 1 teaspoon', '1/2 cup heavy cream', '2 Tbsp unsalted butter', '1 teaspoon white pepper', 'Freshly grated nutmeg to taste']",9,"['1 Boil the turnips, then drain: Peel and cut the turnips into large chunks. In a large saucepan of boiling water, add the tablespoon of salt, the peppercorns, cloves and bay leaves.', 'You may want to tie the spices into a sachet or cheesecloth bag \\xe2\\x80\\x94 this makes it easier to remove them later.', 'Boil turnips until tender, 15 to 20 minutes, then drain and remove the spices.', '2 Add cream, simmer, then mash: Return the turnips to the pot they boiled in and add the cream. Turn the burner to medium-low. Bring this to a gentle simmer and mash the turnips with a potato masher.', '3 Add seasonings: Add the white pepper, the teaspoon of salt and freshly grated nutmeg to taste and serve at once.']",5
1100,Baked Chicken Taquitos Recipe,20,20,40,"['For the taquitos:', '2 cups (about 1 pound) cooked shredded chicken (see Recipe Note)', '4 ounces cream cheese', '1 cup (4 ounces) grated cheddar cheese', '4 ounces canned mild green chilis', '1 teaspoon mild chili powder', '1 teaspoon ground cumin', '1/2 teaspoon garlic powder', '1/2 teaspoon salt', '18 to 20 (6-inch) corn tortillas', 'Vegetable oil, for brushing', 'For serving:', 'Fresh cilantro', 'Sour cream', 'Mild salsa', 'DAD ADD: Sriracha Cream Sauce', '1/4 cup sour cream', '1 tablespoon Sriracha hot sauce']",18,"['1 Preheat  the oven to 350\\xc2\\xb0F. Lightly oil a rimmed baking sheet.', '2 Make the taquito mix: In a medium bowl, mash together shredded chicken, cream cheese, cheddar cheese, green chilis, and seasonings. Mix together really well.', 'Taste and feel free to adjust seasonings to your liking. This basic version should be fairly mild and kid-friendly.', '3 Prep the tortillas: Wrap the corn tortillas in stacks of two in between damp paper towels. Microwave on high for 20 seconds to make them more flexible.', '4 Assemble the taquitos: Add two heaping tablespoons of the chicken filling to each tortilla and wrap tightly\\xe2\\x80\\x94a small cookie scoop (like this one) works well here. They should resemble long cigars.', 'Immediately brush corn tortillas with vegetable oil to prevent cracking and place, seam-side down, on the lightly oiled baking sheet.', 'Repeat until all of the filling is used. You should get 18 to 20 taquitos.', '5 Bake the taquitos: Bake the taquitos as soon as possible to prevent the tortillas from cracking too much. Bake for 20 to 25 minutes until they are crispy and golden brown.', 'If some of your tortillas crack badly, you can try again with a new tortilla and just transfer the filling over. Ultimately, though, a few cracks are okay and the taquitos can still be picked up and eaten\\xe2\\x80\\x94and they are still delicious!', '6 Make the cream sauce: While the taquitos bake, stir together the sour cream and sriracha. Taste and adjust to your liking. This can be made well in advance and keeps just fine for a few days in a covered container in the fridge.', '7 Serve: Serve immediately with the cream sauce. Leftovers can be frozen for up to a month and reheated in a warm oven.']",11
1101,Rotisserie Chicken Stroganoff Recipe,10,30,40,"['12 ounces egg noodles', '4 tablespoons butter, divided', '1 cup diced onion', '8 ounces cremini mushrooms, sliced', '2 cloves garlic, minced', '2 tablespoons all-purpose flour', '1 tablespoon Worcestershire sauce', '1/2 teaspoon salt, plus more to taste', 'Black pepper, to taste', '1 1/2 cups chicken stock', '1/2 cup sour cream', '2 heaping cups shredded rotisserie chicken (about 1 pound of meat)', 'Fresh parsley, garnish']",13,"['1 Cook the noodles: Cook the egg noodles in salted water according to the package directions. Once the noodles are cooked, drain and return them to the pot with two tablespoons of butter, and toss to coat.', '2 Meanwhile, cook the onions and mushrooms: Melt the remaining two tablespoons butter in a large skillet over medium heat. Add the onions and mushrooms and cook for 6 to 8 minutes until the vegetables have softened and are browned in spots.', 'Add the garlic and cook for a final 30 seconds, until the garlic is fragrant. Season with a pinch of salt and pepper.', '3 Make the sauce: Add the flour to the skillet and use a spatula to work the flour into the vegetables, forming a paste-like coating on the vegetables. Cook for a minute and then add the Worcestershire sauce, salt, and some freshly ground black pepper.', 'Slowly add the chicken stock in 1/2-cup increments, stirring constantly to prevent lumps.', '4 Reduce the sauce and add the chicken and sour cream: Once your chicken stock has been added, let the sauce thicken for a few minutes and then stir in the shredded chicken. Remove the pot from the heat and add the sour cream, and stir to combine. Taste the sauce and season it with salt and pepper to your liking.', 'Return the pan to low heat and warm until the sauce is once again piping hot. (If you aren\\xe2\\x80\\x99t serving the sauce immediately, you can keep the sauce warm on very low heat for a little while. Be careful as it will curdle over higher heat.)', 'If at any point the sauce gets too thick, thin it with a drizzle of cooking water from the pasta.', '5 Serve: Serve the stroganoff either by stirring the noodles straight into the sauce to combine everything, or portioning out the noodles onto individual plates and spooning the sauce over the top. Garnish with fresh parsley.', 'If you have leftovers, it\\xe2\\x80\\x99s best to store the sauce and noodles separately and then reheat the sauce gently in a skillet with a few spoonfuls of water. You can microwave the noodles with a few spoonfuls of water and then combine everything. The leftovers will keep for a few days without a problem.']",10
1102,Chicken Noodle Casserole Recipe,40,30,70,"['2 pounds skin-on, bone-in chicken breast', '4 cups low-sodium chicken broth', '4 black peppercorns', '3 1/2 teaspoons salt, divided', '1 bay leaf', '2 parsley sprigs, divided', '12 ounces extra-wide egg noodles', '1/2 medium onion, finely chopped', '2 stalks celery, finely chopped', 'Pinch of ground black pepper', '4 tablespoons (1/2 stick) unsalted butter, at room temperature', '6 tablespoons all-purpose flour', '1/3 cup whole milk', '1/3 cup sour cream', '1 (4-ounce) jar chopped pimentos, drained', '2 cups (8 ounces) grated sharp cheddar cheese']",16,"['1 Preheat oven and prepare the baking dish: Preheat the oven to 375\\xc2\\xbaF. Brush or spray a 4-quart (9x13-inch) shallow baking dish with oil.', '2 Cook the chicken: In a wide, deep saucepan, place the chicken breasts skin side down, and add the peppercorns, 1/2 teaspoon salt, bay leaf, and 1 parsley sprig. Pour the stock over the chicken (the breasts should be covered; if not, add enough water to cover by 1/2-inch).', 'Bring to a simmer, uncovered, over medium-high heat. (Bubbles should appear around the edges of the pot, but not in the center.)', 'Adjust the heat, if needed, to maintain a low simmer, and cook the chicken, skimming the foam off the top with a spoon as necessary, for 15 to 18 minutes, or until a thermometer inserted into the thickest part of the chicken registers 165\\xc2\\xb0F. With tongs, transfer the chicken to a plate to cool.', 'When cool, shred the chicken into bite-size pieces. Discard the skin and bones.', '3 While the chicken cooks, boil the noodles: Fill a large pot with water, add the remaining 3 teaspoons of salt and bring it to a boil. Add the noodles and cook for 2 minutes fewer than the package directions indicate. (This prevents the noodles from becoming overcooked when baked in the casserole.) Shut off the burner, drain the pasta and return it to the pot. In the end, you will add the finished sauce to the pot of noodles.', '4 Make the beurre manie: In a small bowl, stir the softened butter and flour together until well combined. It will look a little like paste.', '5 Cook the vegetables and make the sauce: Pour the stock through a fine mesh strainer into a bowl. You will use it make the sauce. Discard the solids. Measure 3 cups of stock and return it back to the saucepan. (Freeze any leftover stock and save it for another use.)', 'Add the onion, celery, and pepper to the saucepan with the stock, and bring the stock to a simmer over medium heat. Cook for 5 minutes or until the vegetables soften.', 'A few tablespoons at a time, whisk in the beurre manie until the clumps melt into the stock and the stock thickens slightly. Bring the sauce to a boil while whisking constantly for about 2 minutes to cook the flour. Whisk in the milk and sour cream.', 'The sauce should look like cream soup; it is not as thick as b\\xc3\\xa9chamel. Taste and add more salt and pepper, if you like.', '6 Assemble the casserole: Pour the sauce over the noodles and stir to coat. Add the shredded chicken and drained pimentos. Transfer to the baking dish and top with the grated cheese.', '7 Bake and serve the casserole: Bake for 20 to 25 minutes, or until the sauce bubbles and the cheese melts. If you like a slightly crunchy top, run the casserole under the broiler for 3 to 5 minutes, or until the cheese is golden. If desired, chop the remaining sprig of parsley and sprinkle it over the top.']",13
1103,Easy Chicken Skillet Enchiladas Recipe,10,20,30,"['8 ounces cooked chicken (about 2 cups shredded)', '1 teaspoon oil', '1/4 yellow onion, minced (about 1/3 cup)', '3 cloves garlic', '15-ounce can tomato sauce', '1/3 cup water', '4-ounce can mild green diced chilis', '2 teaspoons chili powder', '1 teaspoon oregano', '1/2 teaspoon cumin', '8 taco-sized flour tortillas', '8 ounces cotija cheese', 'To serve:', 'Cilantro', 'Radishes, thinly sliced', 'Sour cream', 'Avocado', 'Jalape\\xc3\\xb1o', 'Special equipment:', '12-inch skillet']",20,"['1 Shred chicken: Shred the leftover chicken so it\\xe2\\x80\\x99s ready when you need it. You should have about 2 cups.', '2 Make the sauce: In a large, high-sided skillet set over medium heat, add the oil. Once the oil shimmers, add onion and garlic and cook for 1 minute, just until softened.', 'Add tomato sauce, water, diced green chilis, chili powder, oregano, and cumin. Stir together, then let the sauce simmer on medium to medium-low while you assemble the enchiladas.', '3 Assemble the enchiladas: Put about 2 tablespoons of shredded chicken down the center of each tortilla. (You don\\xe2\\x80\\x99t really have to measure the meat. Just divide it evenly among the tortillas!) Sprinkle about 1 tablespoon cotija cheese (just eyeball it) across the chicken, and spoon 1-2 teaspoons sauce over the cheese.', 'Fold in the sides of the tortilla, roll it up, and put it seam side down in the sauce. Nestle them in the pan. Repeat this until the pan is full. Spoon sauce over the top of the enchiladas.', '4 Top with cheese and cover: Sprinkle additional cotija cheese over the top of the enchiladas. Cover with a lid and let them simmer until the cheese is melted and the tortillas look puffy, like they soaked up some sauce. This should take about 5 minutes.', '5 Garnish and serve: Lift the lid and sprinkle cilantro and thinly sliced radishes over the top. Serve alongside sliced avocado, jalape\\xc3\\xb1o, and sour cream.']",7
1104,Chicken Panzanella Salad Recipe,15,15,30,"['5 cups torn bread pieces', '1/4 cup chicken drippings or chicken stock', '4 cups shredded chicken', '2 medium tomatoes, chopped', '1 medium cucumber, sliced', '1/2 small red onion, sliced thin', '1/4 cup basil, torn', '2 tablespoons extra virgin olive oil', '1 tablespoon white wine vinegar', 'Coarse salt', 'DAD ADD: Blistered Mini Sweet Peppers', '6 to 8 mini sweet peppers or shishito peppers', '1 teaspoon extra virgin olive oil', 'Coarse salt']",14,"[""1 Toast the bread: If you have very stale, crunchy bread, you don't need to toast your bread. Just tear it into pieces. If you are using fairly fresh bread, spread the pieces out on a baking sheet in a single layer, then toast at 400\\xcb\\x9aF for about 10 minutes."", '2 Dress the bread: When the bread is toasted, spread the pieces on a large serving platter in a single layer or close to it. Drizzle with chicken drippings or chicken stock.', '3 Assemble the salad: Spread the shredded chicken evenly over the bread. Do the same with the tomatoes, cucumbers, red onion, and basil. Drizzle the whole salad with the extra virgin olive oil, white wine vinegar, and sprinkle with coarse salt.', '4 Make the blistered peppers (DAD ADD, optional): In a small or medium skillet, add a drizzle of oil over medium-high heat. Add the peppers and let sit, untouched, for 3-4 minutes or until the peppers start to blister. Then turn them all over and let them blister on the other side for a few minutes. Remove the peppers from the skillet and sprinkle with coarse salt. Chop and serve on top of the panzanella salad!', 'Salad leftovers will keep in the fridge for up to 2 days.']",5
1105,"Tamale Pie with Chicken, Green Chiles, and Cheese Recipe",25,50,75,"['3 cups masa harina', '2 3/4 cups hot water', '4 tablespoons (2 oz) unsalted butter, at room temperature, cut into thick slices', '1 cup (about 7 ounces) cold vegetable shortening', '1 1/2 teaspoons salt', '2 teaspoons baking powder', '1 tablespoon olive oil', '1 bunch scallions, thinly sliced', '2 (4-ounce) cans of chopped green chiles, mild or hot', 'Vegetable oil spray (for the skillet)', '1 cup fresh or frozen corn kernels', '1/2 cup sliced cilantro leaves', '2 cups grated Monterey jack cheese', '2 cups shredded, cooked chicken', '1 cup green salsa, homemade or store-bought (for serving)']",15,"['1 Hydrate the masa harina: In a bowl, mix the masa harina and hot water together to combine them.', '2 Make the dough: In the bowl of a stand mixer with the paddle attachment on medium-high speed, beat the butter, shortening, salt, and baking powder for 1 to 2 minutes, or until light and fluffy.', 'Reduce the speed to low and add the reconstituted masa harina in three additions, beating after each addition until it is incorporated. Once all the masa has been added, continue to beat on medium-high speed for another minute.', 'Leave the dough in the bowl and refrigerate it while you prepare the filling.', '3 Preheat the oven: Set a shelf in the middle of the oven and preheat it to 375\\xc2\\xbaF.', '4 Prepare the filling: In a small skillet set over medium heat, add the oil. When the oil shimmers, add the scallions and cook, stirring for 2 to 3 minutes, or until softened. Stir in the chiles. Set aside 1/2 cup for the topping.', '5 Finish the dough: Remove the dough from the refrigerator and beat it for another minute. It should look like thick cake batter and spread easily. If it seems dry, gradually beat in a little more water, one tablespoon at a time.', 'Remove the mixer from the stand, and with a silicone spatula, fold in the reserved 1/2 cup chile-scallion mixture, the corn, and 1/4 cup of the cilantro.', '5 Assemble the pie: Spray a 10-inch skillet with vegetable oil spray. Wet your hands with cool water to keep the dough from sticking to them, and press half the dough into the bottom and up the sides of the skillet. You can also use an offset spatula to do this.', 'Spread 1 cup of the grated cheese over the bottom of the pie. Top with all of the shredded chicken. Spread the remaining chile-scallion mixture over the chicken. Top with the remaining 1/4 cup cilantro. Spread the remaining 1 cup grated cheese on top.', 'Dollop large spoonfuls of the remaining dough close together all over the pie. Use the back of the spoon or an offset spatula to smooth the dough slightly, leaving a few nooks and crannies to give the top some texture.', ""6 Bake the pie: Set the skillet in the oven and bake for 45 minutes. Set it under the broiler for an additional 3 to 5 minutes, or until it's browned in a few places. Remove and let rest for about 10 minutes. Slice into wedges, and serve with green salsa, if you like.""]",12
1106,Rotisserie Chicken Alfredo Recipe,5,20,25,"['1/4 cup unsalted butter', '2 cups heavy cream', '1/2 teaspoon salt', '1/2 teaspoon black pepper', '1/4 teaspoon ground nutmeg', '12 ounces fettuccine', '2 cups shredded rotisserie chicken or cooked chicken', '1 cup grated parmesan cheese', '1 cup reserved pasta water', 'Fresh parsley, garnish', 'For the arugula salad (Dad Add):', '4 cups baby arugula', '1 cup grape tomatoes, halved', '1/2 cup shelled pistachios', 'Thin strips of parmesan cheese', 'Extra virgin olive oil, for drizzling', 'Fresh lemon juice, for drizzling', 'Coarse salt (optional)']",18,"['1 Boil a pot of water: Put a large pot of water on the stove and bring to a boil. Salt liberally.', '2 Start the sauce: Add the butter, cream, salt, black pepper, and nutmeg to small or medium-sized sauce pan. Heat over medium-low heat until the butter melts and the mixture comes to a slight simmer. Then turn heat down to low and simmer the sauce, stirring regularly to prevent scalding, until the sauce thickens slightly, enough to coat the back of a spoon easily.', '3 Cook the pasta: Add the pasta to the boiling water and cook until it\\xe2\\x80\\x99s al dente, according to package. I always like to test it a minute or two before the package says it will be done to avoid overcooking. When pasta is cooked, reserve 1 cup of pasta water and then drain pasta.', '4 Finish the alfredo: Return the cooked pasta to the pot and add the alfredo sauce and shredded chicken. Continue to cook over low heat, stirring constantly to combine ingredients. Add cheese and continue to stir (I like to use tongs for this part).', 'Sauce will thicken as you stir it with the pasta. If sauce seems too thick or gloopy, add reserved pasta water by the 1/4  cup to thin out the sauce slightly. You might not need any pasta water or you might need a good amount of it.', '5 Make the arugula salad: This is the ideal salad to serve alongside alfredo. It\\xe2\\x80\\x99s bright and peppery and cuts through the richness of the alfredo. Toss together the arugula, tomatoes, and pistachios. Divide between bowls and top with a drizzle of good extra virgin olive oil, a spritz of fresh lemon, and a sprinkle of coarse salt. Top with shaved parmesan.', 'LEFTOVERS! Leftover chicken alfredo will keep in the fridge for 3-4 days. Reheat the alfredo gently in a pot over low heat with a splash of water. Do not microwave.']",7
1107,Chicken Bacon Roulades Recipe,5,70,75,"['4 shallots, thinly sliced (about 1 cup sliced shallots)', '1/2 pound of bacon slices (thinly sliced, not thick cut)', '4 skinless boneless chicken breasts (about 1 1/2 pounds total)', 'Lemon pepper seasoning to taste (or ground black pepper with a little lemon zest)', '1 ounce grated Parmesan (about 1/3 cup)', '1 tablespoon extra virgin olive oil', '1 clove of garlic, minced (1 teaspoon)', '1/3 cup dry white wine', '2 tablespoons butter', '1 1/2 tablespoons flour', '1 1/4 cups chicken broth', '1/4 cup heavy cream']",12,"['1 Cook the bacon: Working in batches, cook the bacon over medium heat in an ovenproof thick-bottomed skillet, until lightly browned but not crisp (still flexible). Remove cooked bacon to a paper towel-lined plate.', '2 Cook the shallots: Lower the heat to low and add the shallots to the pan with the rendered bacon fat. Cook over low heat until softened. Use a slotted spoon to remove cooked shallots to a bowl, leaving remaining fat in the pan.', '3 Pound the chicken breasts thin: Place the chicken breasts between two sheets of plastic wrap and use a mallet or meat pounder (or rolling pin) to pound the chicken breasts thin, to an even thickness of about 1/8-inch.', '4 Top chicken breasts with bacon, lemon pepper, shallots, Parm: Sprinkle the chicken breasts with lemon pepper (or regular ground black pepper with a little lemon zest) and salt.', 'Place 2 to 3 bacon slices in the middle of each chicken breast, lengthwise. Sprinkle with shallots and grated Parmesan.', '5 Roll up each chicken breast like a cigar, using the plastic wrap to help you tighten the roll, and tuck in the ends to hold in the filling. Remove the plastic wrap. Use toothpicks to hold the edges of the chicken roulade together.', '6 Brown the roulades on all sides, then cook in oven: Preheat oven to 300\\xc2\\xb0F. Add a tablespoon of olive oil to the fat in the skillet and heat on medium high. When the pan is hot, add the chicken roulades to the pan and brown on all sides.', 'Move the skillet to the 300\\xc2\\xb0F oven and cook until the roulades are cooked through, about 20 minutes.', '7 Tent with foil to keep warm: When the chicken roulades are cooked through, remove them from the oven to a plate, tent with aluminum foil to keep warm.', ""Note that the skillet is very hot! Keep a pot holder draped over the handle once it's back on the stove. (At this point, whenever I take a handled pot out of a hot oven, I cool down the handles with ice cubes so that someone doesn't inadvertently try to pick up the pan with their unprotected hands.)"", ""8 Make the sauce: Pour off any excess fat from the pan (not down the drain, or you'll clog your drain). Pour wine into the hot skillet to deglaze the pan. Heat on medium high heat and use a metal spatula to scrape up any browned bits. Boil the wine down until it has reduced to just a tablespoon."", 'Reduce the heat to medium low. Add the minced garlic to the pan and swirl in the butter. Cook for a minute, then add the flour and cook, stirring, for a minute more.', 'Add the broth and the cream to the roux and whisk. Simmer, whisking, for two minutes.', 'Pour the sauce through a sieve into a saucepan and keep warm on the stove.', '9 Slice the roulades and serve with sauce: Remove the toothpicks that have been holding the roulades together. Cut the roulades into 1/2-inch thick slices. To serve, place some sauce on each plate and top with roulade slices.']",15
1108,Apple Walnut Gorgonzola Rustic Tart Recipe,15,45,60,"['1 P\\xc3\\xa2te Bris\\xc3\\xa9e (tart dough) for a 10-inch tart (see all butter crust recipe) or 1 packaged, flat pie crust', '1/2 cup walnuts, chopped', '1/4 cup crumbled gorgonzola cheese (or blue cheese)', '1 tablespoon fresh thyme, chopped, or 1/2 teaspoon dried', '2 Tbsp maple syrup', '2 large granny smith apples (or other good cooking apples such as jonagold or fuji), peeled, cored, chopped', '1 teaspoon of lemon juice (optional)']",7,"['1 Toss the walnuts, gorgonzola, thyme, chopped apples, and maple syrup together in a medium size bowl. As you are working with the apples (chopping them, mixing them in with the other ingredients), if you want, you can squeeze a little lemon juice on them to help keep them from discoloring.', 'Cover the mixture with plastic wrap while you prepare the crust.', '2 Roll out the dough: Preheat oven to 350\\xc2\\xb0F. Roll out pastry dough to 13-inches, at an 1/8 of an inch thickness. Place pastry dough on a rimmed baking sheet. (Rimmed because the pastry will leak butter during the cooking process.)', '3 Add filling, pleat dough around edge: Mound the filling in the middle of the rolled out dough, and spread out evenly to 1 1/2 inches to 2 inches from the edge of the dough.', 'Pleat the edges of the dough over the filling.', '4 Bake: Bake at 350\\xc2\\xb0F for 45 minutes to an hour, until crust is nicely browned. If at any time it looks like the walnuts are getting a little burnt, you can lightly tent a piece of aluminum foil over the center.', 'Remove from oven and let cool for 10 minutes before serving. A pizza wheel works great for slicing up the tart.']",7
1109,Rustic Apricot Tart Recipe,25,45,70,"['1/2 recipe sour cream pastry crust recipe', '1/4 cup packed brown sugar', '2 teaspoons flour', '1/8 teaspoon ground cardamom', '1 pound pitted and quartered fresh apricots', '1/4 cup raisins', '2 Tbsp chopped pecans', 'Optional: egg wash and sprinkling sugar']",8,"['1 Assemble filling: In a medium bowl, mix the sugar, flour, and cardamom. (Add a pinch of cayenne for a little extra zing if you want.) Fold in the apricot halves and raisins, until they are well coated with the mixture.', 'Set aside and let macerate for 10 minutes.', 'Then fold in the chopped pecans.', '2 Roll out pie dough: If you are working with chilled pie dough, remove from the refrigerator to let stand for 10 minutes before rolling out.', 'Lightly flour a clean surface and roll out the pie dough to a 13-inch round of even thickness.', '3 Place rolled out pie dough on foil (for grilling) OR baking sheet (for oven): If you are cooking on the grill, transfer the rolled-out pie dough to a large, lightly buttered, doubled over square of aluminum foil.', 'If you are baking in the oven, transfer to small-rimmed, lightly buttered baking sheet.', '4 Mound center of pie dough with fruit mixture: Place the apricot mixture in the center of the pie dough round, leaving a border of 2 inches on all sides.', '5 Fold up edges: Fold the edges of the pie crust up and over so that a small circle of filling is visible.', 'If you want a pretty crust for your finished rustic tart, beat one egg with a tablespoon of milk or cream and brush some of it along the top of the tart crust. Sprinkle with coarse sugar.', ""6a Baking directions using a grill: Prepare grill (either charcoal or gas) for indirect medium heat. Carefully transfer the tart on foil to the grill. Make sure it isn't directly over any coals or gas flame. Cover the grill."", 'If your grill has a temperature gauge, try to keep the temp between 350\\xc2\\xb0F and 400\\xc2\\xb0F.', 'Cook for 40-50 minutes, until crust is lightly browned and the filling is bubbly.', '6b Baking directions using an oven: Preheat oven to 350\\xc2\\xb0F. Cook tart for 45-50 minutes, until the crust is lightly browned and the filling is bubbly.', 'Great served with vanilla ice cream.']",15
1110,Sake Ginger Glazed Salmon Recipe,15,85,100,"['Marinade:', '1/2 cup sake', '1/2 cup soy sauce (use gluten-free soy sauce for gluten-free version)', '1/2 cup mirin (sweet Japanese rice wine)', '2 Tbsp finely grated fresh ginger', '2 cloves garlic, minced', 'A dash of red chili pepper flakes', '1/4 cup white sugar', 'Salmon:', '1 1/2 pounds of salmon fillets', 'Olive oil']",11,"['Preheat oven to 350\\xc2\\xb0F. Line a baking dish with aluminum foil. Brush the top of the foil with olive oil. Place salmon on the foil, skin side down. Brush with marinade.', 'Bake for 10-15 minutes depending on how thick the fillets are, basting frequently with the marinade, until the salmon is barely cooked through and is easily flaked with a fork.']",2
1111,Octopus Salad (Ensalada de Pulpo) Recipe,15,120,135,"['One 2 pound octopus, cleaned', 'Salt', 'Several large sprigs of fresh oregano', 'Several large sprigs of fresh parsley', 'Several sprigs of fresh cilantro', '1 cup seeded, chopped cucumber (peeled if the peels are thick and bitter, otherwise leave them on)', '1/2 cup finely chopped red onion', '3 green onions, sliced, including some of the darker green ends', '1 fresh jalapeno, seeded and minced (test for heat, if really hot, only use a small amount)', '1/2 cup (loose) chopped fresh cilantro, including tender stems', '1/2 teaspoon dried oregano', '2 Tbsp lime juice', '2 Tbsp cider vinegar', '1/4 cup olive oil', '2 cups chopped, seeded tomatoes']",15,"['1 Boil the octopus in salted water: Heat a large pot of lightly salted water to a boil. Place the raw octopus in the boiling water, return the water to a boil, and boil for 2 minutes. Then remove the octopus from the pot and place to cool on a sheet pan. Discard the cooking water.', ""2 Cut the octopus into large pieces, discard anything that doesn't look like meat (innards, beak, etc.) that somehow slipped by the cleaning process. Place the pieces of the octopus on the bed of herbs."", '3 Bake: Prepare a bed of herbs (parsley, cilantro, fresh oregano) in a small Dutch oven or covered casserole. Place the octopus pieces on top of the herbs, cover and bake in a 250\\xc2\\xb0F (120\\xc2\\xb0C) oven for 1 3/4 hours, until tender (adjust cooking time for smaller or larger octopi).', ""4 Prep the baked octopus pieces: Remove the pieces of octopus to a sheet pan to cool. When cool to touch, pull off any gelatinous bits that surround the pieces of the octopus that you don't want to eat. (It's a texture thing. If you don't mind the texture, don't worry about it, it tastes good.)"", ""You may also notice small round pieces of meat that sort of look like eyeballs. They're not eyeballs, but pieces from the octopus' suction cups on the tentacles. They taste good too, just like the rest of the octopus."", 'Cut the meat into 1/2-inch pieces. You should have close to 2 cups of chopped octopus meat.', '5 Combine with remaining ingredients (except tomato) and chill:  Place the chopped octopus into a large, non-reactive bowl.  Add the cucumbers, red onion, scallions, cilantro, dried oregano, and jalape\\xc3\\xb1o. Add the lime juice, cider vinegar, olive oil, a sprinkle of salt, and stir to combine.  Cover and chill for 2 hours or overnight.', '6 To serve, stir in the chopped tomatoes.']",8
1112,How to Make Croutons,5,10,15,"['French or Italian loaf bread, or a French baguette, at least a day old', '3 to 4 tablespoons butter']",2,"['1 Cut the bread into cubes: Cut the bread into even-sized cubes, about 3/4-inch to an inch wide. A loaf will yield about 8 cups of cubed bread (give or take a couple cups, depending on the size of the loaf).', ""2 If the bread isn't dry enough, put it in a warm oven: Your bread should be a little dry, at least a day old if you are using French or Italian loaf or a baguette. You don't want the bread cubes to be all dried out, just a little dry on the surface so that they brown better, and they hold up better when tossed in a salad or baked in a stuffing."", 'If the bread cubes are not dry enough, spread them out on a baking sheet and put them in a warm oven (200\\xc2\\xb0F or 90\\xc2\\xb0C) for about 10 minutes.', '3 Brown croutons in butter in saut\\xc3\\xa9 pan: Melt the butter on medium high heat in a large saut\\xc3\\xa9 pan. Add the croutons and mix them up in the butter so they get lightly coated. Spread the croutons out in a single layer in the pan.', ""Then don't stir them until they start to brown on one side. Once they start to brown, use a metal spatula to lift them up and turn them over, so more sides brown. When the croutons are at least a little toasted on a couple of sides, remove from heat."", 'If storing, let cool completely before putting in an airtight container. Otherwise the steam released from the warm croutons will take away their crunch.']",6
1113,"Mixed Green Salad with Pecans, Goat Cheese, and Honey Mustard Vinaigrette Recipe",15,20,35,"['Pecans:', '4 ounces whole pecans', '1 tablespoon butter, melted', '1 tablespoon sugar', 'Honey Mustard Vinaigrette:', '3/4 cup extra virgin olive oil', '1/4 cup balsamic vinegar', '2 tablespoons honey mustard', '1 clove garlic, minced (about 1 teaspoon)', '1/4 teaspoon red pepper flakes', 'Salt and pepper to taste', 'Salad:', '1 pound mixed salad greens, including fresh baby spinach', '4 ounces goat cheese', '1/4 cup sweetened dried cranberries', '1 red bell pepper, cored, seeded, and cut into 1-2 inch thin slices']",16,"['1 Toast the pecans: Preheat oven to 300\\xc2\\xb0F. Put the pecans in a bowl, sprinkle the melted butter over them, and toss until they are all well coated with butter. Then sprinkle the pecans with sugar and gently toss again until they are lightly coated.', 'Line a baking sheet with Silpat or parchment paper and spread the coated pecans out over it in a single layer.', 'Bake in the 300\\xc2\\xb0F oven for 20 minutes. Remove from the oven and let sit until cool enough to touch.', '2 Make the dressing: Place the olive oil, balsamic vinegar, honey mustard, minced garlic, and red pepper flakes in a jar, cover and shake until the dressing is well mixed. Season to taste with salt and pepper.', '3 Toss the salad: Place the salad greens and spinach in a large bowl. Add the goat cheese, dried cranberries, red bell pepper, and pecans. Toss with 1/4 cup of the dressing.', 'Serve immediately. Chill remaining dressing.']",6
1114,Asian Noodle Salad Recipe,20,30,50,"['10 ounces Chinese noodles (for making chow mein)', '1/3 cup soy sauce', '2 - 3 cups raw bite-sized broccoli florets (from about 1 head of broccoli)', 'Salt', '4 ounces mung bean sprouts (about 1 1/2 cups)', '3 green onions, thinly sliced white and green parts', '1 red bell pepper, cored and seeded, thinly sliced and cut into 1-inch long pieces', '1/4 large purple cabbage, cored and thinly sliced (about 2 cups)', '1 large carrot, peeled and slivered (just continue to peel with a peeler)', 'Dressing:*', '1-inch piece of fresh ginger, peeled and roughly chopped', '4 Tbsp white granulated sugar', '1 medium clove of garlic, roughly chopped', '1 teaspoon crushed red pepper flakes', '1/3 cup canola, rice bran, or vegetable oil', '1/3 cup unseasoned rice vinegar', '4 teaspoons dark sesame oil', '*This dressing is just enough to dress the noodle salad in the proportions given, and then lightly so. If you prefer stronger seasoning or more dressing, just increase the amounts by a half and add a bit more soy sauce to the noodles.']",18,"['1 Cook and drain the noodles: Bring 4 quarts of water to a rolling boil in a large pot. If using Chinese noodles, do not add salt (they are already salted). If using soba or pasta noodles, add a tablespoon of salt to the water.', 'Add the noodles to the pot. Stir the noodles frequently while they cook. Check the noodle package instructions, if using Chinese noodles, they should be done after 5 minutes of cooking.', 'Drain the noodles, rinse with cold water to stop the cooking. Spread the noodles out on a sheet pan to air dry.', '2 Steam the broccoli: Place a steamer rack in the bottom of a 3 to 4-quart pot. Add enough water to come up to the level of the steamer. Heat until boiling. Add the broccoli florets. Cover and steam cook for 4 minutes. Remove from the pot and rinse with cold water to stop the cooking. Set aside.', '3 Toss cooked noodles with soy sauce: Place the cooked noodles in a large serving bowl. Toss with soy sauce to coat completely. Let sit to absorb the soy sauce while you make the dressing.', '4 Make the dressing: Place the ginger, sugar, garlic, and red pepper flakes into a mini chopper or food processor. Pulse until finely ground. Add the vinegar and both oils to the ginger mixture. Pulse again until well blended.', '5 Toss dressing with noodles, then add vegetables: Add the dressing to the soy-sauce infused noodles, tossing to coat completely. Then add the cooked broccoli, the sliced green onions, sliced bell pepper, sliced cabbage, shredded carrot, and mung bean sprouts.', 'If making more than a day ahead, toss the noodles with the soy sauce and half of the dressing and prep the vegetables. Then when ready to serve, toss the noodles with the vegetables and the rest of the dressing.']",8
1115,Frutti di Mare Seafood Salad Recipe,20,20,40,"['Poaching Broth:', '4 cups water', '1 cup white wine or chicken stock', '2 teaspoons salt', '2-3 bay leaves', '1 teaspoon cracked black pepper', '1 small onion, roughly chopped', 'Salad:', '2 celery stalks', '1 large yellow or orange bell pepper', '1 pound tomatoes', '1/2 cup chives', '1 pound small cocktail shrimp', '1 pound small clams in shell', '1/2 pound bay scallops', '1/2 pound calamari, cut into rings', '1/4 cup high-quality extra virgin olive oil, or more to taste', 'Juice of 1-2 lemons', 'Salt and black pepper to taste']",19,"['1 Make poaching broth: Put all the poaching broth ingredients together in a medium pot, cover and bring to a boil. Turn off the heat to let the flavors steep while you cut the veggies.', '2 Prep salad vegetables: While the poaching broth is steeping, dice the yellow pepper, seed and dice the tomatoes and slice the celery stalks very thin. Chop the chives. Juice the lemons and remove any seeds. Put the diced peppers, tomatoes and celery into very large bowl. Most cocktail shrimp are pre-cleaned and cooked, so you you can put them in the bowl, too.', '3 Poach the clams: Bring the poaching broth back to a boil and add all the clams. Boil 3-4 minutes, or until the clams all open up. As soon as you see each clam open, fish it out and set it aside. Remove the meat and put in the bowl with the veggies.', '4 Poach the scallops: Turn off the heat and put the scallops in the poaching water. Cover the pot and let stand for 3-4 minutes. Fish out the scallops and put into the bowl.', '5 Poach the calamari rings: Bring the broth to a boil once more. Add the calamari rings and boil 30 seconds to 1 minute, then pour the contents of the pot into a strainer set over a bowl. You can save the broth or discard it. Pick out all the calamari rings and add to the bowl.', ""6 Dress the salad: To finish, add the olive oil and a little salt and half the lemon juice. Mix well and taste. Add more olive oil, lemon and salt until you get the flavors you want: The salad should be glistening with oil, briny and tart with lemon. Finally, mix in the chives and chill. This salad is better a few hours after it's made.""]",6
1116,Leeks Vinaigrette Recipe,10,20,30,"['6 long leeks (about 2 to 2 1/2 pounds total)', '1/4 cup extra virgin olive oil', '1 tablespoon red wine vinegar', '1 teaspoon Dijon mustard', '1/4 teaspoon Kosher salt', '1/4 teaspoon finely ground black pepper']",6,"['1 Heat a pot of water, clean the leeks: Bring a large, wide (12 inches) pot, half-full of salted water (2 teaspoons of salt for 2 quarts of water) to a boil. While the water is heating, clean the leeks, keeping them whole.', ""To do this, first rinse off any visible dirt from the leeks. Then, use the tip of a sharp knife to pierce the leek just a little bit below the point where the leek's shaft opens up into separate leaves."", 'Cut the leek from this point all the way out to the tip of the green leaves, keeping the shaft whole.', 'Open up the leaves, and place the leek under running water to clean out any dirt or sand that may be hiding between the leaves.', 'Cut off the dark green tops, leaving about an inch or two (or three if you like the more strongly flavored greens) on the shaft.', 'Cut off the roots, cutting as close to the roots as possible, to help keep the leek together while it simmers in the next step. (For a visual step-by-step, see How to Clean Leeks.)', '2 Simmer the leeks in salted water: Once the water is boiling, carefully place the cleaned and prepped leeks into the water.', 'Return to a simmer and lower the heat to maintain a simmer. Start a timer and cook for 8 to 10 minutes, or until the thickest part of the thickest leek can easily be penetrated with the tip of a sharp knife.', ""If your leeks are about an inch thick, they should just begin to be turning from bright green to olive-y green at the 8 minute mark. Thicker leeks you'll want to cook a little longer."", '3 Place cooked leeks in ice water bath: Use tongs to gently remove the leeks from the pot and place into an ice water bath to stop the cooking.', '4 Let the leeks drain: Remove the leeks from the ice water bath and let them drain. The best way to let them drain is to place them in a rimmed roasting pan and then propping up the pan at an angle so the water can run out of the leeks.', 'Let them drain for 10 minutes or so while you make the vinaigrette.', '5 Make the vinaigrette: Place the olive oil, vinegar, mustard, salt, and pepper, in a jar and whisk until well emulsified.', '6 Marinate the leeks in the vinaigrette: Place the leeks in a rimmed, long serving dish (a Pyrex casserole dish would work for this as well). Drizzle some vinaigrette over the leeks. Gently turn the leeks over and drizzle a bit more vinaigrette on the other side.', 'Cover with plastic wrap and let the leeks marinate in the vinaigrette for at least 2 hours, or up to 3 days. (Chill if marinating more than 2 hours.', 'The longer they marinate, the tastier and more tender they become.)', 'The leeks should be served at room  temperature.', 'Alternative serving suggestion: cut the marinated leeks crosswise into 1-inch long segments and serve with strips of roasted red bell peppers that have been marinating in the same vinaigrette.']",18
1117,Tuna Macaroni Salad Recipe,10,20,30,"['For the pasta:', '1 cup uncooked elbow macaroni', '1 teaspoon salt', '1 quart water', 'For the salad:', '1/2 cup chopped green onion, including green onion greens', '1 cup chopped red, orange, or yellow bell pepper', '1/4 cup chopped fresh parsley', ""2 (5-ounce) cans tuna, packed in olive oil (if it's packed in water, drain and add 2 to 3 tablespoons of extra virgin olive oil)"", '2 stalks celery, chopped (about 1 cup)', '2 tablespoons lemon juice', '1/4-1/3 a head lettuce (preferably iceberg lettuce), sliced first and roughly chopped into 2 inch long strips', '1/4 cup mayonnaise (more to taste)', '1/2 teaspoon sweet Hungarian paprika', 'Fresh ground pepper']",15,"['1 Cook the macaroni: In a saucepan, add 1 cup of elbow macaroni to 1 quart of boiling water with an added teaspoon of salt. Cook at a rolling boil uncovered for about 10 minutes until the macaroni is just a little more cooked than al dente.', 'Remove from heat, drain, and rinse with cold water.', '2 Prep the salad ingredients: While the macaroni is cooking, assemble the other ingredients. In a large bowl mix the green onion, bell peppers, parsley, tuna, celery and lemon.', '3 Combine the salad ingredients: Add the cooked and drained macaroni. Fold in the mayonnaise until well mixed. Add the paprika. Add fresh ground pepper to taste. (At this point you can make ahead and chill.)', '4 Serve: Fold in the lettuce gently and serve. The salad does not make good leftovers as the lettuce will eventually get soggy.']",5
1118,Shrimp Pasta Salad Recipe,0,20,20,"['1/2 pound bow-tie (farfalle) or orecchiette pasta, or other short pasta', 'Salt', '2 pounds small frozen, already cooked and peeled shrimp (if available, pink shrimp aka Maine shrimp)', '1 diced red bell pepper', '1 diced red onion', '1 minced garlic clove', '1 cup chopped basil leaves (loosely packed)', '1/3 cup extra virgin olive oil', '1 teaspoon of lemon zest', '1/4 cup lemon juice', '1 teaspoon red chile flakes', 'Black pepper to taste']",12,"['1 Thaw the shrimp: Defrost frozen shrimp by placing them in a bowl of cold water. Keep chilled until needed.', '2 Cook the pasta: Cook the pasta in well salted water (1 tablespoon salt for every 2 quarts water) until al dente, a bit firmer than you would normally eat. (The pasta will absorb some of the salad dressing and soften further after cooking.)', 'Rinse the pasta in cold water to stop the cooking. Drain well and put into a large bowl.', '3 Assemble the salad: Rinse the shrimp and drain well. Add them to the bowl with the pasta and mix. Add the remaining ingredients and gently mix until well combined.', '4 Chill and serve: Chill the salad for at least an hour before serving. Serve chilled.']",5
1119,Easy Steak Salad with Lemon Vinaigrette Recipe,10,10,20,"['Extra virgin olive oil', '1 pound flank steak or skirt steak', 'Salt and freshly ground pepper', '1/2 head lettuce greens', '1 bunch arugula (young leaves), tough stems removed', '1/2 red bell pepper, thinly sliced lengthwise and cut into 1-inch long pieces', '4 scallions, thinly sliced', '1 avocado, cut into bite-sized pieces', '4 ounces goat cheese, crumbled', 'Pomegranate seeds or thinly sliced kumquats (optional)', 'For the dressing:', '2 tablespoons lemon juice', '6 tablespoons extra virgin olive oil', '1 teaspoon Dijon mustard (smooth), or 1/2 teaspoon dry mustard', 'Salt and pepper']",15,"['1 Cook the steak: Heat a couple teaspoons of oil in a cast iron pan on high heat. Pat the steaks dry. Sprinkle the steaks on both sides with a little salt.', 'Sear the steaks in the pan on both sides, just until nicely browned. Remove pan from heat and cover. Let cook for a few minutes more, until the steak is done to your liking.', 'You can test with a meat thermometer. Remove steak from pan at 125\\xc2\\xb0F to 130\\xc2\\xb0F for rare, 140\\xc2\\xb0F for medium rare, 150\\xc2\\xb0 for medium. Or use your fingers to test the meat for doneness (see The Finger Test to Check the Doneness of Meat).', '2 Let the steak rest before cutting, then cut thin slices: Remove from pan to a cutting board. Let rest for a few minutes before cutting. Cut thin slices, on a diagonal so you slice wide pieces, across the grain of the meat.', '3 Make the salads: Toss together the lettuce greens, arugula, bell pepper, goat cheese, and scallions. Arrange on individual plates. Sprinkle with avocado. Lay on top several slices of chilled sliced steak. Sprinkle with pomegranate seeds or sliced kumquats if using.', '4 Make dressing: Mix together the lemon juice, olive oil, mustard, and salt and pepper to taste. Drizzle on salad.']",6
1120,Spinach and Orzo Salad Recipe,10,25,35,"['8 ounces orzo pasta', 'Salt', '1/4 cup pine nuts', '6 ounces feta cheese, roughly crumbled', '2 ounces Kalamata Greek olives pitted, roughly chopped, about 1/2 cup (about 20 olives)', '4 ounces baby spinach', '1/2 cup chopped red onion (about half a red onion)', '3 tablespoons extra virgin olive oil', '1 tablespoon balsamic vinegar', '1 tablespoon red wine vinegar (can substitute white vinegar or lemon juice)', '1 teaspoon Dijon mustard', 'Pinch dried basil', 'Pinch dried tarragon', 'Salt and freshly ground black pepper to taste']",14,"['6 Pour dressing over orzo: Pour over orzo spinach mixture and gently mix in until well incorporated.', 'Chill for at least an hour before serving.']",2
1121,Nopalitos Cactus Salad Recipe,15,10,25,"['1 pound (450 g) fresh chopped nopalitos', '1 pound cherry tomatoes, quartered (about 3 cups)', '1 cup chopped red radishes', '1 cup finely chopped red onion', '3 tablespoons lime juice', '1 tablespoon extra virgin olive oil', '1 1/2 teaspoons salt', '1/4 teaspoon freshly ground black pepper', '1/2 cup chopped cilantro']",9,"['1 Blanch and rinse nopalitos: Bring a medium pot of salted water to a boil. Add the nopalitos, return to a rolling boil and cook for 1 minute. Strain through a fine mesh sieve. Rinse with water for 1 minute.', '2 Toss with remaining ingredients: Place rinsed and drained nopalitos in a bowl with the chopped tomatoes, radishes, and onion. Toss with lime juice, olive oil, salt, and pepper. Fold in cilantro.']",2
1122,Greek Pasta Salad Recipe,20,10,30,"['For the lemon olive oil dressing:', '1/3 cup fresh squeezed lemon juice (from 2 to 3 lemons)', '1 tablespoon lemon zest', '2 cloves garlic, finely chopped', '2 tablespoons finely chopped parsley', '1/2 cup extra virgin olive oil', '1/2 teaspoon fresh oregano (optional)', '1/4 teaspoon salt', '1/4 teaspoon pepper', 'For the pasta salad:', '1 pound rotini pasta, or other pasta shape of your choice', '1/2 small red onion, quartered and thinly sliced', '1 red pepper, finely diced', '1 pint cherry tomatoes, halved', '1/2 cup pitted Kalamata olives', '1/2 cup crumbled feta', '1 cucumber, quartered and sliced', '1/4 cup parsley, roughly chopped', 'Salt and pepper to taste']",19,"['1 Cook the pasta and drain: Bring a large pot of heavily salted water to a boil. Add the pasta and cook pasta until al dente. Immediately rinse in cold water until the pasta is cool to the touch.', '2 Soak the onions: Soak the slices of onion in cold water with a pinch of salt. After 10 minutes, drain the water from the onions.', '3 Make the dressing: In a small lidded jar, shake all the dressing ingredients together. Taste and add more seasonings to taste.', '4 Assemble the salad ingredients: In a large bowl, mix together the cooled pasta, drained red onion, peppers, tomatoes, olives, feta, cucumber, and parsley. Toss gently with 1/4 cup of the lemon olive oil dressing and mix. Add more dressing, in small increments, as needed.', 'You may not use all of the dressing, but it stores well in the fridge for about a week. Season with salt, pepper to taste.']",5
1123,BLT Salad with Buttermilk Dressing Recipe,20,10,30,"['For the dressing:', '1 1/2 teaspoons finely chopped shallots', '1 tablespoon lemon juice', '2 teaspoons white wine vinegar', '1/2 cup buttermilk', '1/4 cup mayonnaise', '2 tablespoons finely sliced chives', 'For the salad:', '6 slices thick-cut bacon, cut in half', '1/2 pound green beans, preferably haricots verts, ends trimmed', '1 teaspoon olive oil', '3 to 4 heirloom tomatoes of varying colors, sliced into thick rounds', '2 medium ripe avocadoes, sliced', 'Kernels from 2 medium ears of cooked corn (about 2 cups)', 'Leaves from 1 head Boston lettuce, or salad greens of your choice']",15,"['1 Make the dressing: In a bowl, combine shallots, salt, pepper, vinegar, and lemon juice. Let sit for 10 minutes to tame the raw flavor of the shallots.', 'Whisk in the buttermilk and mayonnaise until smooth. Stir in the chives.', '2 Cook the bacon: In a large skillet over medium heat, cook the bacon until crisp. Transfer to a paper towel-lined plate.', '3 Cook the green beans: Fill a bowl with ice water and set it near the stove. Bring a saucepan of salted water to a boil.', 'Add the beans to the boiling water. Let the water return to a boil and then cook for 4 minutes, or until tender. With a slotted spoon or spider, transfer the beans to the bowl of ice water. Swish around in the cold water for 1 minute.', 'With a slotted spoon, transfer to a bowl. Sprinkle with the olive oil and salt to taste. Toss together.', '4 Assemble the salad: On one big platter or on 4 individual plates, arrange the lettuce leaves. Arrange tomato and avocado slices on top of the lettuce. Place the green beans around the salad and top with the bacon.', 'Drizzle the salad with the dressing, or serve the dressing on the side. Sprinkle the salad with more salt and pepper, if you like.']",8
1124,Harvest Salad with Miso-Maple Roasted Butternut Squash Recipe,20,25,45,"['For the squash:', '1 small butternut squash (about 2 pounds), peeled, seeded and cubed into 1/2 inch chunks', '2 tablespoons yellow or white miso', '1 tablespoon maple syrup', '3 tablespoons olive oil, divided', '1/4 teaspoon salt', '1/4 teaspoon pepper', 'For the dressing:', '1 1/2 tablespoons red wine vinegar', '1 teaspoon Dijon mustard', '1 tablespoon maple syrup', '1/4 cup extra-virgin olive oil', 'Salt and pepper to taste', 'For the salad:', '4 cups arugula', '1 cup cooked whole grains, like oat groats or wild rice', '1 crisp apple, cored and diced', '1/4 cup dried cranberries', '1/4 cup pepitas (green pumpkin seeds)', 'Arils of one pomegranate (about 1/2 cup)']",20,"['1 Roast the squash: Preheat oven to 425F. Lightly brush two baking sheets with about 1 tablespoon of olive oil.', 'In a large bowl, whisk together miso, maple syrup, the rest of the oil, salt, and pepper. Add butternut squash cubes, and toss to coat.', 'Spread squash out onto baking sheets with plenty of room between pieces. Bake for 25 minutes or until golden brown and crispy at the edges. For more caramelization, turn the squash at the 15-minute mark.', '2 Make the dressing: Mix together all ingredients in a small jar and shake well to emulsify.', '3 Assemble the salad: Toss the roasted squash (hot, warm, or cool), the dressing, and the remaining salad ingredients together in a large salad bowl. Serve immediately.']",5
1125,Cherry Tomato Orzo Salad Recipe,15,15,30,"['8 ounces orzo pasta', 'Salt', '1 pint red cherry tomatoes, sliced in half', '1 pint yellow cherry tomatoes, sliced in half', '1/4 cup extra virgin olive oil', '8 ounces feta cheese, crumbled', '1 large cucumber, peeled and chopped', '2 green onions, thinly sliced', '2 Tbsp minced fresh oregano', 'Juice of a lemon', 'Black pepper to taste']",11,"[""1 Cook orzo pasta in salted water: Bring a large pot of well salted water to a rolling boil. Add the orzo, stirring it so that it doesn't stick to the bottom of the pan. Cook, uncovered, at a high boil until al dente, cooked through but still a bit firm."", 'Drain the pasta (it helps to use a fine mesh sieve for this as the small orzo might pass through holes in a colander), and rinse with cold water to stop the pasta from cooking further.', '2 Toss pasta with olive oil, tomatoes, feta, cucumber, green onions, oregano, lemon juice, pepper: Toss the pasta with the olive oil in a large bowl. At this point you can make ahead and chill until you are ready to serve (or transport to a party).', ""Toss with the rest of the ingredients, the tomatoes, feta cheese, cucumber, green onions, oregano, lemon juice, and black pepper. The feta is salty so you shouldn't need to add more salt.""]",4
1126,"Shrimp, Arugula, White Bean, Cherry Tomato Salad Recipe",10,10,20,"['1 pound 16-20 count shelled and deveined shrimp', '2 tablespoons extra virgin olive oil', '2 15-ounce cans cannellini white beans, rinsed and drained', '1 cup cherry tomatoes, halved or quartered', '1/2 cup finely diced red onion', '3/4 teaspoon grated lemon zest', '3 handfuls baby arugula leaves', 'Dressing:', '3 tablespoons red wine vinegar', '1/2 cup extra virgin olive oil', '2 cloves minced garlic', '1/2 teaspoon salt', '1/4 teaspoon black pepper']",13,"['1 Cook the shrimp: Heat a large cast iron skillet or griddle on high heat. Add 2 Tbsp of olive oil to coat the pan. When the oil is hot, working in batches of half of the shrimp at a time, add the shrimp and saut\\xc3\\xa9 a minute on each side to sear. (You can also grill the shrimp if you prefer.)', ""When the shrimp are barely cooked through, remove from the pan and set aside to cool. (The shrimp will continue to cook for a little bit after you remove them from the pan, and you don't want overcooked rubbery shrimp.)"", '2 Assemble the salad: Put the drained beans, cut cherry tomatoes, diced onion, lemon zest, and arugula leaves into a large bowl. Fold in the shrimp.', '3 Make the dressing: In a small bowl, whisk together the red wine vinegar, olive oil, garlic, salt and pepper.', 'Gently fold the dressing into the salad and serve!']",5
1127,Grilled Shrimp Taco Bowl Recipe,40,5,45,"['For the grilled shrimp:', '1 tablespoon smoked paprika (sweet or hot)', '1 tablespoon sweet paprika', '1 tablespoon ground cumin', '1 teaspoon garlic powder', '1/2 teaspoon salt', '1/2 teaspoon chipotle powder (optional)', '1 pound shell-on shrimp (21-25 count), thawed if frozen, peeled and deveined', '1/4 cup neutral oil (I used avocado oil)', 'High heat oil such as canola or grapeseed for brushing grill grates', 'For the spicy cilantro dressing:', '2 tablespoons fresh lime juice', '2 tablespoons apple cider vinegar', '3/4 cup neutral flavored oil (I used avocado oil)', '1 clove garlic, peeled', '1 cup cilantro leaves and stems, packed', '1 jalape\\xc3\\xb1o, stem removed', 'Salt to taste', 'For the bowls:', '1 (15-ounce) can black beans, drained and rinsed', '1 (15-ounce) can corn, drained and rinsed', '1 pint cherry or grape tomatoes, halved', '2 cups cooked rice', '2 cups shredded romaine', '1 medium ripe avocado, thinly sliced or cut into chunks', '4 radishes, thinly sliced', '2 teaspoons neutral oil, such as canola or avocado', 'To serve:', '2 tablespoons finely chopped jalape\\xc3\\xb1o, to serve', '1/4 cup tablespoon finely chopped cilantro, to serve', 'Lime wedges, to serve', 'Salt and pepper to taste']",32,"['1 Combine the spices and shrimp: In a small bowl, whisk together the paprika through chipotle powder. In a larger bowl, toss shrimp with oil and then add the spices. Stir with a large spoon until evenly coated.', 'Cover and refrigerate for 30 minutes or up to overnight.', '  2 Prep the grill: When ready to grill the shrimp, preheat a gas or charcoal grill for 15 to 20 minutes to high heat. If your grill has a thermometer, make sure it reads at least 500\\xc2\\xbaF.', '3 Make the dressing: Add all the dressing ingredients except the salt to the bowl of a mini chopper or a blender. Pulse 3 to 5 times until the ingredients are broken down a bit, and then blend on high to create a creamy consistency. (The dressing may be made up to two days ahead and stored in the refrigerator.)', '4 Season the black beans: In a small bowl, toss black beans with two teaspoons oil and salt and pepper to taste.', '5 Grill the shrimp: Shake off excess marinade and thread the shrimp into two metal skewers. Using two skewers makes the shrimp easy to flip on a very hot grill.', 'When your gas or charcoal grill is hot, use tongs to oil the grill grates with a small folded piece of paper towel dipped in oil.', 'Place the skewers on the grill. Using tongs, press down gently on the skewers to encourage pretty grill marks and awesome charred flavor.', 'Flip the skewers after about 3 minutes and finish cooking on the other side for 1 to 3 minutes, or until the shrimp are opaque almost all the way through. They will continue cooking for a few minutes after they\\xe2\\x80\\x99re off the grill.', '  6 Assemble the bowls: Divide the rice between four bowls, then top each bowl with black beans, corn, tomatoes, radishes, romaine, avocado, and shrimp.', 'Serve with small bowls of limes, chopped chilies, and chopped cilantro.']",11
1128,Curried Chicken Salad with Mango Recipe,30,60,90,"['For the salad:', '4 bone-in split chicken breasts, or 4 bone-in whole chicken legs, or a combination (3 pounds total)', '4 cups water', '1 teaspoon salt', '1 cup whole almonds (skinned or blanched)', '1 ripe mango', '1/2 tart green apple', '2 stalks celery', '1 1/2 cups seedless red or green grapes', '3 tablespoons chopped fresh cilantro', '6 scallions', '1/2 cup golden raisins', 'For the curry dressing:', '2 tablespoons canola oil', '1 1/2 tablespoons curry powder', '1 tablespoon tomato paste', '1 cup mayonnaise', '1/2 teaspoon salt', '1/4 teaspoon ground black pepper', '1 1/2 tablespoons cider vinegar, plus more to taste', '1 tablespoon lemon juice']",21,"['1 Cook and cool the chicken: In a Dutch oven or large sauce pan, combine the chicken pieces, water, and 1 teaspoon of the salt. Bring to a boil, skim the surface thoroughly, and reduce the heat to low.', 'Cover the pan and simmer the chicken for 30 minutes, rotating the bottom pieces to the top halfway through cooking. Cook until the chicken is cooked through and registers 165\\xc2\\xb0F with an instant read thermometer in the thickest part.', 'Let the chicken cool in the liquid for 30 minutes. Remove from the liquid, pat it dry, and let it finish cooling on a cutting board.', '2 Cut the chicken into cubes: Pull the chicken off the bones; discard the skin and bones. Cut the chicken into 1-inch strips or cubes. Transfer to a bowl large enough to hold all the ingredients.', ""The chicken can also be prepared a day or two ahead and refrigerated until you're ready to assemble the salad. Save the cooking liquid (stock) to make another dish or freeze."", '3 While the chicken cooks and cools, prep the other ingredients: In a small, dry skillet over medium-low heat, toast the almonds, shaking the pan often, for 5 minutes, or until they start to brown and turn aromatic. Transfer to a plate to cool.', 'Use a vegetable peeler to remove the peel from the mango. Slice off large pieces on four sides (the pit is in the middle). Cut the pieces into 1-inch dice. Transfer to a large mixing bowl.', 'Dice the apple (leave the peel on). Add to the mango mixture, and gently toss with a squeeze of lemon (this will prevent the apple from browning.', 'Cut the celery stalks in half down their length and thinly slice. Halve the grapes. Chop the cilantro. Trim the tops and roots from the scallions and slice on the diagonal. Add all ingredients to the mixing bowl with the mango and apple mixture.', '  4 Make the curry paste: Wipe out the skillet used to toast the almonds. Add the oil. When it is hot, add the curry powder and cook, stirring, for 30 seconds. Remove from the heat and stir in the tomato paste. The mixture may look like a paste. Cool before using.', '5 Make the dressing: In a bowl whisk the mayonnaise, curry paste mixture, remaining 1/2 teaspoon salt, pepper, and vinegar. Stir well.', '6 Mix the salad: Add the chicken, toasted nuts, and raisins to the bowl with rest of the ingredients. Use a large metal spoon to stir gently but thoroughly.', 'Add half the dressing and stir again. Add enough of the remaining dressing to make a salad that has a little dressing or is well coated with dressing\\xe2\\x80\\x94depending on your preference.', 'Taste for seasoning and add more salt, if you like. Serve immediately or refrigerate and serve within a few hours. Leftovers will keep for a few days in the fridge, though the ingredients will start to soften. (Any remaining dressing can be saved for up to a week and used as a spread for sandwiches.)']",14
1129,Lentil Salad with Summer Vegetables Recipe,10,25,35,"['For the salad', '1 cup Puy lentils', '2 cloves garlic', '1 bay leaf', 'Handful of parsley stems, tied together with a string', '2 1/2 cups water', '3 stalks celery, diced small', '1 yellow pepper, diced', '1 pint grape or cherry tomatoes, halved', '1/4 cup minced red onion', '1 cup baby arugula', 'For the vinaigrette', '3 tablespoons lemon juice', '3 tablespoons extra virgin olive oil', '1 tablespoon fresh minced parsley', 'Zest from 1/2 lemon', '1/2 teaspoon Morton kosher salt', '1/4 teaspoon dried oregano', '1/4 teaspoon sugar', '1 tablespoon minced shallots', 'Salt and pepper to taste']",21,"['1 Cook the lentils: In a medium pot combine lentils, smashed garlic cloves, bay leaf, a handful of parsley stems. Add enough water to cover the lentils by 1 1/2 to 2 inches (about 2 1/2 cups).', 'Bring to a simmer and cook uncovered for about 25 minutes. The exact time will vary based on how dry the lentils are. When you get about 10 minutes out from the finished cooking time, start sampling the lentils to check for doneness\\xe2\\x80\\x94when cooked, they should be tender, but still intact. Continue sampling every 5 minutes until they\\xe2\\x80\\x99re ready.', 'When the lentils are done, drain them and discard the bay leaf, garlic, and parsley stems.', '2 While the lentils cook, make the vinaigrette In a large bowl, whisk together lemon juice, olive oil, parsley, lemon zest, salt, oregano, sugar, and shallots.', '3 Mix the hot lentils with the vinaigrette: Add the hot lentils to the vinaigrette, and stir to coat. By combining the vinaigrette with the lentils while they are still hot, the lentils will absorb more of the flavor from the vinaigrette making the salad extra tasty. Allow to cool.', '4 Assemble the salad: Add the prepared vegetables and arugula. If your arugula is large, stack it and slice it into thick, short ribbons before adding it to the salad. Stir to combine. Add more salt and pepper to taste and finish with a drizzle of good quality extra virgin olive oil.', 'Serve room temperature or cold, as a vegetarian meal, or alongside a sandwich, frittata, chicken, or fish. This salad is best eaten the day it\\xe2\\x80\\x99s made.']",7
1130,Mexican Green Bean Salad Recipe,15,40,55,"['1 pound fresh green beans, strings removed, ends snapped off, cut in half into about 1 1/2 inch length pieces', '1/4 cup onion, finely chopped', '2 tablespoons lime juice or white vinegar', '1 tablespoon extra virgin olive oil', '1/2 teaspoon sea salt', '1/2 teaspoon dried oregano (Mexican oregano if you can get it)', '3/4 cup packed, chopped cilantro', '1/3 cup canned, pickled jalape\\xc3\\xb1o chili peppers, sliced', '1/3 cup chopped red onion', '1/2 cup crumbled cotija cheese (salty Mexican cheese that resembles feta)', '1/2 avocado, sliced or cut into inch long pieces', '1 medium tomato, cut into 8 wedges, or a cup of halved cherry tomatoes']",12,"['1 Simmer the green beans: Bring a large saucepan of salted water to a boil. Add the beans and simmer until just crisp tender, about 5 minutes.', 'Drain the beans and run cold water over them to cool them quickly. Drain completely.', '2 Marinate in dressing ingredients: Place beans in a large bowl. Gently mix in the the lime juice or vinegar, olive oil, 1/4 cup onion, sliced pickled jalape\\xc3\\xb1os, sea salt, oregano and cilantro.', 'Let sit for half an hour.', '3 Mix in red onion and cheese: When ready to serve, gently mix in the chopped red onion and cotija cheese.', 'Serve the avocado slices and tomato wedges on the side or mixed into the salad.']",6
1131,"Shrimp, Bacon, Avocado Pasta Salad Recipe",15,30,45,"['1/2 pound dry fusilli pasta', '1/2 pound of peeled, deveined raw shrimp', '1/2 teaspoon chipotle pepper powder', '1/4 teaspoon salt (plus more salt for the pasta water)', '3-4 thick-cut slices of bacon (about 3 ounces), sliced into 1/2 inch pieces', '1/3 cup diced red onion', '1/3 cup diced red bell pepper', '1/3 cup diced yellow bell pepper', '2 green onions, thinly sliced, including the green onion greens', '1 avocado', '1/4 cup (packed) roughly chopped cilantro', 'Dressing:', '1 teaspoon Dijon mustard', '2 tablespoons fresh lime juice', '1 tablespoon white wine vinegar (can sub apple cider vinegar)', '1 teaspoon lime zest', '1/4 teaspoon salt', '2 tablespoons extra virgin olive oil']",18,"['1 Toss shrimp with chipotle chile powder and salt and put in the refrigerator to marinate while you make the pasta and the rest of the salad.', '2 Put a large pot of salted water on to a boil (2 quarts of water, 1 Tbsp salt).', '3 While the water is heating, cook the bacon. Put the bacon in a small saucepan on medium heat. Cook until most of the fat has rendered out and the bacon pieces are lightly browned. Remove bacon to a paper towel lined plate. Discard or save for future use all but one tablespoon of the rendered bacon fat (do not pour bacon fat down the drain or you will be calling your plumber).', '4 Increase the heat to high and add the shrimp. Saut\\xc3\\xa9 until done, a few minutes.', '5 When the pasta water comes to a boil, add the pasta and cook until al dente, cooked through but still a little firm to the bite (usually 1 or 2 minutes less than what the package calls for).', '6 Put all of the dressing ingredients into a jar, cover and shake until well blended.', '7 When the pasta is ready, strain it and rinse with cold water. Place in a large bowl. Add the vinaigrette and toss with the shrimp, bacon, bell peppers, and onions. Add the cilantro and avocado just before serving.']",7
1132,Cucumber Salad with Grapes and Almonds Recipe,30,5,35,"['1/4 cup slivered and blanched almonds', '1 pound cucumbers, peeled if the peel is bitter, unpeeled if not', 'Kosher salt', '1 teaspoon minced garlic', 'About 20 green grapes, sliced in half', '2 tablespoons extra virgin olive oil', '1 teaspoon sherry or white wine vinegar', '2 teaspoons minced chives, for garnish']",8,"['1 Prep the cucumbers: Slice the cucumbers in half lengthwise. Use a spoon to scoop out the seeds in the middle, discard the seeds. If using rather large cucumbers, slice them again lengthwise.  Then cut them crosswise into 1/4-inch to 1/2 inch slices.', 'Place in a large bowl and sprinkle with a teaspoon of kosher salt.  Toss to distribute the salt evenly around the cucumber pieces.', 'Let sit for 20 to 25 minutes while the salt helps pull excess moisture out of the cucumbers.', 'Then rinse off the salt, drain the cucumbers, and squeeze out more excess moisture with paper towels.', '2 Toast the slivered almonds in a small pan over medium-high heat, tossing them often, until they start to brown and smell good. Move to a bowl to cool.', '3 Combine: Mix the cucumbers, almonds, garlic, grapes, olive oil, and vinegar together in a large bowl and add more salt to taste. Garnish with chives and serve.']",6
1133,Curried Chicken Salad with Endive Recipe,20,20,40,"['Dressing:', '2 Tbsp plain yogurt', '1/3 cup mayonnaise', '1 teaspoon soy sauce', '1 teaspoon honey', '1 teaspoon curry powder', 'Pinch paprika', '2 teaspoons fresh lemon juice', '1/4 teaspoon kosher salt', '1/4 cup crushed, well-drained pineapple', 'Salad:', '1 1 /3 pounds boneless, skinless, chicken breasts OR 3 cups diced, cooked chicken', '1 apple, peeled, cored, diced', '1/2 cup minced green onion', '6 heads of California or Belgian endive', '1/4 cup chopped toasted slivered almonds']",16,"['1 Poach the chicken breasts: If you are starting with raw chicken, the first thing you are going to do is to cook the chicken (if starting with cooked chicken skip to the next step).', 'Place the raw chicken breasts in a 2 or 3 quart saucepan and cover with cold water by at least an inch or two. Add 2 teaspoons salt to the water.', 'Put the pot on medium high heat and bring to a simmer. Simmer for two minutes, then turn off the heat and cover the pot.', 'Let the chicken sit in the hot water for 15 minutes.', ""This should be enough to cook the chicken all the way through, unless you are starting with very cold chicken. If after 15 minutes you cut through one of the breasts and it still isn\\'t done, return the pot to a very low simmer for 5 more minutes, or as long as it takes to cook it all the way through."", 'Drain, chill, and cut chicken breasts into small cubes. You should have about 3 cups of cooked, diced chicken.', '2 Make the dressing: Place the yogurt, mayonnaise, soy sauce, honey, curry powder, paprika, lemon juice, and salt in a medium bowl. Whisk until thoroughly combined.', 'Add drained pineapple and stir to combine. You should have a little less than one cup of dressing.', '3 Make the filling: Place diced chicken, diced apple, and minced green onion into a medium bowl. Stir in the dressing.', '4 Stuff the endive boats: Separate leaves from the heads of the endive and place on a serving platter. Spoon chicken salad into endive ""boats"". Sprinkle with toasted almonds.']",10
1134,Classic Wedge Salad with Blue Cheese Dressing Recipe,10,5,15,"['6 thick strips bacon', '2 ounces blue cheese, crumbled', '1/4 cup mayonnaise', '1/4 cup sour cream', '1 tablespoon cider vinegar', '1/2 teaspoon Worcestershire sauce, or more to taste', 'Dash hot sauce, like Tabasco, or more to taste', '1/4 teaspoon salt, or more to taste', '1/4 teaspoon black pepper, or more to taste', 'Heavy cream or milk, as needed to thin the dressing', '1 head iceberg lettuce', '12 red or yellow cherry tomatoes, quartered', '2 tablespoons chopped fresh chives']",13,"['1 Prepare the bacon: In a heavy skillet, fry the bacon strips, turning often, for 5 minutes, or until they are evenly golden and crisp all over.', 'Transfer to a plate lined with paper towels. Cool and crumble.', '2 Make the blue cheese dressing: In a food processor, combine the blue cheese, mayonnaise, sour cream, vinegar, Worcestershire, hot sauce, salt, and pepper. Pulse the mixture until smooth. Taste for seasoning and add more Worcestershire, hot sauce, salt, or pepper, if you like. If you need to thin the mixture, add heavy cream or milk, 1 teaspoon at a time.', '3 Prepare the iceberg lettuce: Discard the outer leaves of the lettuce. Halve the lettuce through the core. Cut each half into 3 wedges so each piece has some core attached to it. With the wedges flat on the cutting board, trim out the tough part of the core from each wedge, but leave enough so that the wedges stay intact.', '4 Assemble the salads: Arrange the wedges on six salad plates. Spoon some dressing over the wedges. Sprinkle with bacon, tomatoes, and chives.']",5
1135,Asparagus Salad with Shrimp Recipe,10,10,20,"['1 pound asparagus, woody stem ends removed', '1/2 pound pink salad shrimp, cooked, shelled', '1/4 cup extra-virgin olive oil', '1 garlic clove, minced (1/2 teaspoon to 1 1/2 teaspoons, depending on how much you like fresh garlic)', '1 Tbsp lemon juice (more to taste)', '1 Tbsp minced fresh parsley', 'Salt and black pepper to taste']",7,"['1 Boil the asparagus: Bring a medium pot of water to a boil and salt it well. Add the asparagus to the boiling water and boil for 3 minutes. Use a slotted spoon to remove the asparagus to a bowl of ice water to cool.', '2 Add the shrimp to the pot of boiling water. If they are pre-cooked, remove after 30 seconds\\xe2\\x80\\x94this is just to warm them. If the shrimp are uncooked, boil them for 2-3 minutes, until cooked through. Remove the shrimp and add them to a large bowl.', '3 Slice the asparagus spears thinly on the diagonal until you get close to the tip. Cut the asparagus tips off in one piece. (They look prettier that way.)', '4 Toss everything to combine: Put the asparagus in the bowl with the shrimp. Add the remaining ingredients and toss to combine. Add salt and black pepper to taste. Add more lemon juice if desired, to taste.']",4
1136,Steak Salad with Arugula and Parmesan Cheese Recipe,20,11,31,"['For the salad', '5 ounces (about 6 cups) baby arugula', '2 tablespoons olive oil, plus more for serving', 'Salt and pepper, to taste', '1/2 cup (1 ounce) shaved Parmesan Cheese', 'For the steak', 'Vegetable oil (for the grill)', '2 (1 1/2-inch thick) sirloin steaks (about 1 3/4 pounds)', '2 lemons, cut into wedges (for serving)', 'Olive oil (for serving)']",10,"['1 Make the salad: In a bowl, toss the arugula with 2 tablespoons of olive oil. Sprinkle generously with salt and pepper and toss again. Mix in the Parmesan Cheese. Divide among four plates.', '2 Prepare the grill: For charcoal grills, fill a grill chimney with charcoal and light it. When the coals are hot (they should be covered with a layer of fine gray ash) empty the coals into the grill and push them to one side of the grill to make higher heat and lower heat cooking zones. Set the grate in place and cover the grill. Preheat the grate for 5 minutes.', 'For gas grills, heat one burner to high and one to low (225F).', 'Fold a small piece of paper towel to make a 2-inch square, and pour a few tablespoons of oil into a shallow bowl. With tongs, dip the square into the oil, and brush the grates.', '3 Cook the steaks: Brush the steaks with olive oil and sprinkle them on both sides with salt and pepper. Place them on the hot side of the grill and cook until browned and slightly charred on one side, 3 to 4 minutes. Turn the steaks over and continue to grill 3 minutes longer, or until well browned.', ""If the steaks aren't quite cooked to your desired doneness at this point, move them to the cooler side of the grill to finish cooking. Cook to an internal temperature of 135F for medium-rare, 140F for medium, or 150F for well done."", 'Transfer the steaks to a cutting board or platter, tent loosely with foil and let rest 5 minutes before slicing.', '4 To serve: Slice the steaks and divide the slices between the plates, placing them on top of the arugula. Drizzle with olive oil and squeeze lemon juice over the top. Sprinkle with more salt and pepper, if you like.']",8
1137,Smoked Salmon Pasta Salad Recipe,10,15,25,"['1 pound of dry penne rigati, gemelli, fusilli, or other short-cut pasta, or a combination', 'Salt for the pasta water', 'Extra virgin olive oil', '1 to 2 tablespoons mayonnaise', '4 ounce smoked salmon, shredded', '1/2 cup finely chopped orange or yellow bell pepper', '1/2 cup finely chopped celery', '1/4 cup chopped green onions (scallions)', '1 teaspoon salt', 'Freshly ground pepper', 'Pinch of dried dill', '1 tablespoon lemon juice']",12,"['1 Cook the pasta: Bring a large pot of salted water to a boil (use a tablespoon of salt for every 2 quarts of water). Add the pasta. Cook uncovered, at a rolling boil until al dente, or tender, but still a bit firm.', 'Drain and rinse under cold water. (If you are making the pasta ahead of time, stir in a little olive oil to keep the pasta from sticking to each other.)', 'Note that if you are using different kinds of pasta, you may want to cook them separately as different types of pasta cook at different rates.', '2 Stir in the rest of the ingredients, adjusting the amounts of mayonnaise, lemon juice, salt, and pepper to taste.', 'Serve chilled or at room temperature.']",5
1138,Arugula Corn Salad with Bacon Recipe,10,20,30,"['4 large ears of corn', '2 cups of chopped arugula (about one bunch)', '4 strips of bacon, cooked, chopped', '1/3 cup chopped green onions', '1 tablespoon extra virgin olive oil', '1 tablespoon white wine vinegar', '1/8 teaspoon ground cumin', 'Salt and freshly ground black pepper to taste']",8,"['1 Cook the corn: Cook the corn ears, in their husks, either on the grill for a smoky flavor, or by steaming in a large covered stock pot with an inch of boiling water at the bottom of the pot, for 12-15 minutes, or by cooking in a microwave.', 'Let the corn cool (can run under cold water to speed up the cooling), remove the husks and silk.', ""I recommend cooking the corn in the husks for the added flavor that the husks impart. If you boil or steam the corn ears after you've already husked them, or if you cook them in the microwave, reduce the cooking time by a few minutes."", '2 Remove the corn kernels from the cobs: To remove the kernels from the cobs, stand a corn cob vertically with the tip on a small bowl that is inverted inside a larger, shallow bowl.', 'Use a sharp knife to make long, downward strokes, removing the kernels from the cob, as you work your way around the cob.', 'Note: it may help to work over a low table, to be in a better ergonomic position to cut the cobs this way.', '3 Make the dressing: In a separate bowl, whisk together the oil, vinegar, salt and pepper, and cumin.', '4 Assemble the salad: In a medium sized bowl, mix together the corn, chopped arugula, bacon, and onions.', 'Mix dressing into salad just before serving. Taste and add more vinegar if necessary to balance the sweetness of the corn.']",9
1139,"Farro Salad with Green Beans, Corn, and Cherry Tomatoes Recipe",15,30,45,"['1/2 pound green beans, trimmed and cut into 1-inch lengths', '2 cups corn kernels, fresh or frozen', '1/2 cup pearled or semi-pearled farro', '3 tablespoons olive oil, or more to taste', '1 bunch scallions, trimmed and chopped', '1 shallot, very thinly sliced', '1/2 pint mixed yellow or red cherry tomatoes, halved or quartered if large', '2 tablespoons white wine vinegar', '2 tablespoons chopped fresh oregano, marjoram, or parsley']",9,"['1 Blanch the green beans: Bring a medium pot of water to a boil. Add a tablespoon of salt and the green beans.', 'Cook the green beans for 3 minutes or until they are bright green and barely tender. Scoop the beans out with a slotted spoon and transfer to a strainer.', 'Rinse the beans under cold water until they are cool. Pat dry with paper towels and set aside.', 'Do not drain the water; let it come back to a boil over high heat.', '2 Prepare the corn: If using fresh corn kernels, let the pot of water used for the green beans come back to a boil, then blanch the kernels for 1 minute. Drain and rinse with cold water until cool.', ""If using frozen corn, there's no need to blanch; transfer the frozen kernels to a strainer and run under water until the corn is thawed. Spread on a plate, pat dry with paper towels, and set aside."", 'Do not drain the water; let it come back to a boil over high heat.', '2 Toast the farro: Toast the farro in a dry cast iron or other heavy skillet, stirring constantly, for 5 minutes or until it smells nutty and toasted.', '3 Cook the farro: Tip the farro into the boiling water \\xe2\\x80\\x93 the grains should sizzle when they hit the water. Let the water return to a boil.', 'Cook the farro, stirring occasionally, for 12 minutes, or until it is tender but still has some bite.', ""2 Drain the farro: Drain the farro into a medium strainer and set the strainer back inside the saucepan. Cover the farro with a clean kitchen towel or paper towel and set the lid on top. (If you don't have a strainer that fits in your pan, follow these instructions.)"", 'Set aside for 10 minutes to allow the grain to steam.', '3 Season the farro: Transfer the grains to a large bowl. Sprinkle with 1 tablespoon of the olive oil. Taste for seasoning and add more salt, if you like, and pepper.', 'Cool briefly until no longer piping hot.', '5 Mix the salad: Add the green beans, corn, scallions, shallot, cherry tomatoes, remaining 2 tablespoons olive oil, vinegar, and fresh herbs to the farro. Toss gently.', ""Taste for seasoning and add more salt, olive oil, vinegar, or herbs, if you like. This salad is best the day it's made, but leftovers make a great light lunch.""]",16
1140,Soba Noodle Salad Recipe,15,15,30,"['6 Tbsp seasoned rice vinegar', '1 Tbsp sugar', '1/4 teaspoon salt', '1 large garlic clove, minced', '1 1/2 Tbsp fresh lime juice', 'Zest of one lime', '1 1/2 teaspoons dark sesame oil', '6 ounces soba noodles', '1/2 large red bell pepper, chopped', '1 small ripe mango, peeled and chopped into cubes', '1/2 cup thinly sliced fresh basil', '1/2 cup thinly sliced fresh mint', '1/2 cup chopped toasted salted peanuts']",13,"['1 Make the dressing: Place the rice vinegar, sugar, and salt in a saucepan over medium heat for 1-2 minutes until the sugar and salt dissolve. Stir in the garlic and allow to cool. Add the lime juice, lime zest, and sesame oil and mix well.', '2 Cook the noodles: Cook the noodles in salted water, until al dente, according to the package instructions. Drain and then rinse well under cool water. Transfer the noodles to a large bowl and toss with the dressing.', '3 Combine: Add the mango, bell pepper, basil and mint. Toss and plate. Serve with chopped peanuts sprinkled over the top.']",3
1141,Watercress Salad with Warm Bacon Dressing Recipe,5,20,25,"['2 bunches watercress (Try to get mature watercress as shown in the photo, not the hydroponic watercress that Whole Foods carries. It will hold up better to the hot dressing.)', '3-4 slices bacon', '1/4 cup apple cider vinegar', '4 teaspoons sugar', 'Salt and pepper', 'A pinch of ground mustard', 'A pinch of paprika (sweet)']",7,"['1 Prep the watercress: Rinse thoroughly the watercress, removing old leaves and thick stems. Set aside in a serving bowl.', '2 Cook the bacon: Heat a small stick-free pan on medium heat and cook the bacon until done, several minutes on each side. Remove the bacon from the pan and put on a paper towel. Keep the bacon fat in the pan.', '3 Make the dressing: Add the cider vinegar and sugar to the bacon fat. Stir to dissolve. Sprinkle with salt and pepper, add a pinch of ground mustard and a pinch of paprika. Taste and adjust seasoning. This is a sweet-sour dressing, so if it is too acidic, add a bit more sugar, if too sweet, add a bit more vinegar.', '4 Pour hot dressing over watercress: Bring the dressing to a simmer. Pour over the watercress. Crumble the bacon over the top. Toss and serve.']",4
1142,Caprese Corn Salad Recipe,10,20,30,"['5 to 6 ears of sweet corn (still in husks, do not shuck)', '1/4 cup extra virgin olive oil', '3 Tbsp sherry vinegar or white wine vinegar', 'Freshly ground black pepper', '1 1/2 teaspoons kosher salt', '1/2 teaspoon sugar (optional)', '3 cups roughly chopped, seeded tomatoes, or halved cherry or sun gold tomatoes', '1/2 cup sliced scallions, including light green parts', '8 ounces fresh mozzarella, cut into 1/4-inch cubes', '1/2 cup to 1 cup of fresh basil leaves, thinly sliced']",10,"['1 Grill the corn: Prepare your grill for high, direct heat. Place the corn cobs still in their husks directly on the grill. Cook for 15 minutes or so, turning every few minutes, so that the husks get completely charred. The corn will steam in the husks. There is no need to soak the corn in water first if the corn is fresh.', 'If you want some char on the corn itself, remove a few of the outer corn husks first, so there is less of a protective layer around the corn.', 'Once the husks are completely charred, remove from the grill and let cool for a few minutes. Then remove the husks and silk.', 'To remove the corn from the cob, stand the shucked cob upright in shallow baking pan or rimmed dish. Hold the cob steady in one hand, and with the other hand use a sharp knife to make downward strokes on the cob, separating the kernels from the cob.', 'Alternatively, if you have frozen corn kernels, you can use them for this salad (4 cups). Just heat a large cast iron pan on medium high to high heat. Put a layer of frozen corn directly on the pan, do not defrost first. Once the corn has browned on one side, stir and let the corn brown some more. Then remove to cool.', '2 Make the dressing: In a small bowl, whisk together the olive oil, vinegar, salt, and freshly ground black pepper to taste. Adding sugar will depend on how sweet your corn or tomatoes are, so you may want to withhold sugar until the end and add to taste.', '3 Toss together the corn, tomatoes, scallions, cheese, and dressing: In a large bowl, toss together the corn, tomatoes, scallions, Mozzarella, and the dressing. Adjust seasonings to taste. Let sit for 10 minutes.', '4 Add basil: Right before serving, stir in the freshly sliced basil.']",8
1143,Grilled Corn Salad Recipe,20,25,45,"['4 ears of corn, do not shuck (or 2 1/2 cups frozen corn for the stovetop option)', '1 large red bell pepper', '1 5-inch long zucchini, sliced in half lengthwise', '1/2 cup chopped red onion', '1/2 cup chopped cilantro', '1 serrano chili pepper, seeded and minced (optional)', '1 teaspoon ground cumin (best if you toast whole cumin seeds then grind)', '1/4 cup crumbly salty cheese such as feta or cotija (optional)', '2 tablespoons extra virgin olive oil', '2 tablespoons cider vinegar or lime juice', 'Salt and freshly ground pepper to taste']",11,"['Turn corn occasionally, so that every part of the husk is blackened. Also turn the red bell pepper occasionally until the skin has blistered up all around it. This should take 15 to 20 minutes.', 'When the corn and peppers are about 5 minutes away from being done, rub olive oil over the zucchini pieces and place the zucchini pieces directly on the grill grate, cut side down. Turn them over after a few minutes when they have some nice grill marks on them. Let them cook for just a minute or two on the other side.', '2 Finish prepping the red pepper: Place charred bell pepper in a bowl and cover with a plate so that it steams in its own heat. Once the bell pepper has cooled a bit, remove the charred peel.', 'Cut open the pepper, remove the seeds and stem. Chop the bell pepper into small pieces.', '3 Cut the kernels from the corn cob: Let the corn cool down for a few minutes and pull back the husks.', 'Take a small bowl and turn it upside down in a larger bowl. Stand the corn husks vertically, tip facing down, on top of the upside down small bowl. (You can also use the center of an upturned bundt pan.)', 'Use a sharp knife to make long, downward strokes, removing the kernels from the cob, as you work your way around the cob.', '4 Chop zucchini: Slice the grilled zucchini again lengthwise and chop into small pieces.', '5 Assemble and serve the salad: Place grilled or toasted corn kernels, chopped bell pepper, chopped zucchini, red onion, cilantro, and serrano (if using) into a large bowl.', 'Add the cumin, olive oil, vinegar or lime juice, and crumbly cheese (if using). Mix gently. Salt and pepper to taste.', 'Serve cold or at room temperature.']",11
1144,Steak Salad with Miso Vinaigrette Recipe,15,20,35,"['For the miso dressing:', '3 tablespoons white miso, or other light-colored miso', '2 tablespoons rice vinegar', '1 teaspoon Dijon mustard', '1 teaspoon maple syrup (optional)', '1 tablespoon neutral flavored oil', 'For the steak:', '1 pound skirt steak', '1 teaspoon paprika (sweet, hot, or smoked \\xe2\\x80\\x94 your choice)', '1 teaspoon garlic powder', '1/4 teaspoon salt', '1/4 teaspoon black pepper', '2 teaspoons high-heat cooking oil', 'For the salad:', '6 to 8 cups spring greens', '2 carrots, peeled and sliced', '4 to 6 radishes, thinly sliced', '1 apple, any kind, cored and thinly sliced']",18,"['1 Make the miso dressing: Whisk together miso, rice vinegar, Dijon, maple syrup, and oil. Use a blender for a creamier consistency. (This can be done several days in advance; whisk before tossing the salad if the dressing has separated.)', '2 Warm the pan for the steak: Heat a large cast iron or stainless steel skillet (or grill pan) over medium-high heat until it is very hot and a drop of water evaporates on contact, 3 to 5 minutes.', '3 Season the steak: While the pan is heating, mix together paprika, garlic powder, salt, and pepper and pat the onto the steak on all sides.', '4 Cook the steak: Turn on a vent fan or open a window \\xe2\\x80\\x93 searing the steak will create a lot of smoke. Add the oil to the hot pan and tilt the pan to coat the bottom.', 'Place the steak in the middle of the pan and cook for 3 to 4 minutes. Flip and cook for 3 to 4 minutes on the second side, or until it has reached your desired doneness. (My steak reached 125\\xc2\\xbaF, rare, in about 7 minutes total.)', '5 Rest the steak: When steak is done, move it to a cutting board to rest for 10 minutes.', '6 Slice the steak: After the resting period, slice against the grain, and trim off any excess fat or gristle. The steak can be served immediately with the salad, or cooled and refrigerated for up to 5 days for quick meals.', '7 Toss the salad: When you\\xe2\\x80\\x99re ready to eat, toss greens, carrots, radishes, and apples together in a large bowl with a tablespoon of the miso vinaigrette. Taste one of the leaves and add more vinaigrette, one tablespoon at a time, to taste.', '8 Serve the salad: Divide the salad between four plates. Top with slices of steak, dividing the steak evenly between all the plates.', 'For dinner parties, serve the salad on a large platter and let guests help themselves. (This recipe can also be easily doubled for larger parties.)']",10
1145,Easy Grilled Salmon Recipe,15,30,45,"['1 1/2 to 3 pounds salmon fillets, skin-on (about 1/3 to 1/2 pound per person)', 'Extra virgin olive oil', 'Marinades', 'Basic marinade:', '3/4 cup soy sauce (use gluten-free soy sauce if cooking gluten-free)', '4 garlic cloves, minced', 'Basic teriyaki marinade:', '1 cup soy sauce (use gluten-free soy sauce if cooking gluten-free)', '1-inch knob of fresh ginger root, grated', '4 to 5 cloves garlic, crushed', '2 to 4 tablespoons brown sugar', 'Teriyaki marinade with mirin:', '1/2 cup soy sauce (use gluten-free soy sauce if cooking gluten-free)', '1/4 cup mirin (sweet Japanese rice wine) or seasoned rice vinegar', '1/4 cup brown sugar', '2 tablespoons minced garlic', '2 tablespoons minced fresh ginger', '1/4 cup minced green onions', '2 tablespoons vegetable oil', 'Pinch chili pepper flakes', 'Yakitori marinade with sake:', '1/2 cup sake', '1/2 cup soy sauce (use gluten-free soy sauce if cooking gluten-free)', '1/2 cup mirin', '2 tablespoons finely grated fresh ginger', '2 cloves garlic, minced', 'A dash of red chili pepper flakes', '1/4 cup white sugar']",28,"['1 Make the marinade: Combine marinade ingredients in a bowl. If sugar is an ingredient in the marinade you are using, stir until the sugar is completely dissolved.', ""2 Marinate the salmon fillets: Cut fillets 1 1/2 to 2 inches wide. Place marinade ingredients in a large casserole dish (or a plate with sides so the marinade doesn't run). Coat the salmon fillets in the marinade and then place them skinless-side down in the marinade."", 'Marinate for 20 minutes for a quick marinade (can do this at room temperature while you are preparing the grill) or if you have more time, from 1 to 2 hours in the refrigerator.', 'Before grilling, remove fillets from marinade and discard the marinade. Generously rub or brush oil on both sides of fish fillets.', '3 Prepare the grill: Prepare the grill for high direct heat (if you are using a charcoal grill, prepare one side of the grill for high direct heat and the other side with fewer coals for indirect heating).', 'When the grill is hot (you should be able to hold your hand one inch above the grill grates for only 1 second), brush the grill grates with oil. (The best way to do that is to fold up a paper towel, dip in oil, and use tongs to rub the folded up paper towel on the grill grates.)', '4 Place fillets skinless side down on the hot grill: Place salmon fillets on grill, skinless side down (skin-side up) first, so that the fillets can get nice grill marks on the hot grill while the fish is still firm. Close the grill lid. Cook 1 to 3 minutes on the first side, depending on how thick the fillets are.', 'Once the fish fillets have been placed on the grill, do not move them until you are going to flip them over. Otherwise, they may fall apart.', '5 Turn fillets over to grill skin-side down: Look for grill marks on the fish and a small layer of opaque (cooked) fish where the fish is closes to the grill. Using tongs, and a metal spatula to help if necessary, carefully turn the fish onto the other side, so that the skin side is now on the grill grates.', 'If you are using a charcoal grill, the fillets should be placed on the side of the grill furthest from the coals. If you are using a gas grill, just reduce the flame to medium.', 'Close the grill lid. Cook for another 2-5 minutes, again depending on the thickness of the fillets. Salmon should be just barely opaque throughout when done.', ""Better to err on the side of undercooking the salmon, rather than overcooking. You can always put the fish back on the grill, but once a good fillet is overcooked, there's nothing you can do."", 'Remove from grill and serve immediately.']",13
1146,Panko-Crusted Baked Salmon Recipe,10,12,22,"['4 teaspoons extra virgin olive oil', '4 pieces thickly cut, boneless salmon (each 6 oz)', 'Salt and pepper to taste', '2 Tbsp honey mustard or sweet-hot mustard', '2 teaspoons chopped fresh thyme', '2/3 cup panko bread crumbs', '2 Tbsp chopped Italian parsley', '1/2 teaspoon Hungarian sweet paprika']",8,"['1 Preheat the oven to 400\\xc2\\xb0F (convection or regular). Set the salmon on a foil-lined baking sheet skin side down. Sprinkle with salt and pepper.', '2 In a small bowl, combine the honey mustard and 1 teaspoon of the thyme. In another small bowl, mix the panko with the remaining 1 teaspoon of thyme, 4 teaspoons of olive oil, parsley, and paprika. Add salt and pepper (a light sprinkle).', '3 Using a small spoon, spread the mustard mixture on the salmon; top with the bread crumb mixture.', '4 Roast the salmon for 12-14 minutes (test at 10) or until it is almost completely firm to the touch and flakes when poked with a fork. Serve at once.']",4
1147,Sous Vide Teriyaki Salmon Recipe,10,70,80,"['1 1/2 to 2 pounds salmon or salmon fillets, 1-inch thick', '3 cloves garlic, minced (about 4 teaspoons)', '1-inch piece ginger, peeled and minced (about 4 teaspoons)', '1/4 cup soy sauce or gluten-free tamari', '1/4 cup water', '2 tablespoons brown sugar', '2 tablespoons rice vinegar or white wine vinegar', '1/2 to 2 teaspoons cornstarch, for thickening the sauce', 'Sliced green onions or chopped cilantro, to serve', 'Special equipment:', 'The Joule or other sous vide immersion circulator', 'Quart-sized freezer bag (I use Ziploc)']",12,"[""1 Get ready: Pull out 4 freezer bag, and label each bag with the recipe and the basic cooking instructions (you'll thank me for this later when you're trying to remember which recipe to follow!). Flip the zip-top edge of the bag outward, forming a cuff around the bag. This helps the bag stay open and upright."", 'Fill a large bowl or stock pot with 4 or 5 inches of water. Lay out a kitchen towel.', '2 Make the teriyaki marinade: Whisk together the soy sauce, water, brown sugar, and vinegar for the marinade.', ""3 Cut the salmon into 4 portions (if not already done). Aim for equal portions, though it's fine if they are different shapes. If you're buying at fish counter, you can also ask the person at the counter to do this for you."", '4 Season the salmon: Divide the garlic and ginger between the fillets (about 1 teaspoon of each per fillet). Use your fingers to spread the garlic and ginger evenly over the surface of the salmon. This step helps them stick to the surface of the salmon after the teriyaki marinade is added.', ""5 Transfer the salmon to freezer bags: Slide one fillet into each bag. Usually the fillets fit in the bottom of the bag (as pictures), but it's fine if they are sideways."", '6 Add the marinade and seal the bag: Holding the bag upright, add about 3 tablespoons of marinade to the bag. Flip the cuff back up and seal the bag almost closed, leaving about an inch un-zipped.', 'Holding the bag by the unzipped portion, submerge the bag in the pot of water. Use your other hand to gently press out any air pockets from around the salmon. Lower the bag right up to the unzipped portion so that all the air bubbles are forced out, then pinch the bag closed.', ""Lift the bag out of the water; the plastic should hug the sides of the salmon, pressing right up against the fish. If it doesn't, or if you see any big air bubbles around the salmon, repeat sealing the bag. (Read more here.)"", 'Transfer the bag to the kitchen towel and pat dry. Repeat with adding the marinade and sealing the remaining freezer bags of salmon.', ""7 Cook or freeze the salmon: If desired, skip to the next step and cook the salmon right away. Otherwise, freeze the salmon overnight or up to 3 months. The marinade will become opaque but may not completely solidify; this is normal. Even if you plan on eating the salmon within a few days, I'd recommend freezing it so that the fish doesn't over-marinate."", '8 When ready to cook, heat the sous vide bath: Fill a large pot with at least 6 inches of water. Add the Joule (or other sous vide device) and heat the water to 122\\xc2\\xb0F for silky, very tender salmon, or to 130\\xc2\\xb0F if you prefer your salmon more firm and flaky.', ""9 Cook the fish: Once the sous vide bath is heated, add as many salmon fillets as you'd like to cook. (Do not thaw frozen salmon.) It's fine if the tops of the bags poke out from the surface of the water, but the salmon itself should be completely submerged. Add additional water if needed to cover."", 'Cook fresh (unfrozen) salmon for about 40 minutes, or cook frozen salmon for 70 minutes (the cooking time is the same whether cooking at 122\\xc2\\xb0F or at 130\\xc2\\xb0F). Salmon can be left in the sous vide bath for up to 30 minutes after the end of cooking without significant change in flavor or texture (after 30 minutes, it starts to get a little mushy).', 'When done, pull all the bags from the water and lay them on a kitchen towel. Pat the bags dry.', '10 Make the teriyaki sauce: Holding the bag over a microwave-safe measuring cup, snip one of the corners of the bag and empty the teriyaki marinade into the cup. Add water as needed so that you have 1/4 cup of liquid for every salmon fillet you have prepared. Whisk in 1/2 teaspoon of cornstarch for every 1/4 cup of liquid.', ""Microwave on high in 30 second bursts, whisking between each burst, until the sauce thickens and bubbles around the edges (about 30 seconds for each quarter cup). If it doesn't seem to be thickening, whisk in another 1/4 teaspoon of cornstarch for each 1/4 cup and continue heating."", ""11 Serve the salmon: While the sauce is heating, slide each salmon fillet out of its bag and onto a plate. If you'd like crispy skin (optional), warm a tablespoon of oil in a large skillet over medium-high heat and sear the salmon, skin-side down, for a few minutes or until the skin is browned and crispy."", 'Transfer each fillet to a plate, drizzle each one with sauce, and sprinkle with sliced green onions or chopped cilantro. Serve warm.']",19
1148,Salmon with Lemon Cream Sauce Recipe,5,15,20,"['3 Tbsp lemon juice', '1/4 cup chicken broth, fish stock, clam juice, white wine, or water', '2/3 cup heavy cream', '1 tablespoon extra virgin olive oil', 'Salt', 'Freshly ground black pepper', '1 1/2 pounds salmon fillets', 'Parsley for garnish']",8,"['1 Cook the lemon cream sauce: Pour the lemon juice, broth and cream into a small pot and bring to a simmer. Immediately lower the heat to low, cover the pot and simmer gently for 10 minutes. Add salt and pepper to taste. The last minute or two, uncover the pot and increase the heat to high to reduce the sauce a bit.', '2 Prep the salmon: While the sauce is cooking, rinse the salmon in cold water and check for any stray scales (if skin-on). Use needle nose pliers to remove any pin bones. Pat the fish dry with paper towels.', '3 Cook the salmon fillets: Add the oil to a saut\\xc3\\xa9 pan large enough to fit the fillets in one layer. Heat the pan on high and let the pan heat up for 90 seconds.', ""You can either lay the fillets in the pan skin-side down or skin-side up. If you lay the fillets down skin-side down, this will help crisp up the skin which is great to eat (try it, if you haven\\'t, it tastes like salmon bacon!)."", 'If you lay the fillets down skin-side up first, the fillets will be easier to turn over without falling apart, because the raw skin helps hold the fillet together. Your choice.', 'Lay the fillets in the hot pan and lower the heat to medium.', 'Let the fillets sizzle steadily for 3-5 minutes, depending on how thick the fish is. A 1-inch-thick fillet will take about 5 minutes.', 'With a metal spatula, gently turn the fillets over. Cook for another 1-5 minutes, depending on how well-done you like your fish.', 'We like our salmon a little rare in the center, so we cook the second side of a 1-inch fillet about 3 minutes.', '4 Pour lemon cream sauce over the salmon: Place the salmon fillets on plates and pour lemon cream sauce over them and sprinkle with chopped parsley to serve.', ""If you\\'ve crisped up the skin, serve the fillets skin-side up so they stay crispy. Otherwise serve the fillets skin-side down.""]",11
1149,"Oven-Roasted Salmon, Asparagus and New Potatoes Recipe",10,32,42,"['1 pound (450 g) small new potatoes, scrubbed clean and halved', '2 tablespoons extra virgin olive oil', '1/2 teaspoon salt', '1/2 pound (225 g) medium asparagus, trimmed and sliced on the diagonal, 1-inch long pieces', '1 tablespoon chopped fresh dill', '1 strip of lemon zest', '1 small garlic clove, coarsely chopped', 'Freshly ground pepper', '1 1/2 pounds (680 g) of salmon fillets or salmon steaks cut about 1-inch thick', '1 lemon, cut into large wedges']",10,"['1 Roast the potatoes: Preheat oven to 400\\xc2\\xb0F (205\\xc2\\xb0C). In a sheet pan, or a large, shallow roasting pan (not glass, as it might break in an oven that hot) toss the potatoes with olive oil and sprinkle all over with salt.', 'Place the potatoes cut side down in the roasting pan and cook for 10-12 minutes, until the potatoes begin to brown on the bottom.', 'Turn the potatoes over and roast another 10 minutes until browned on top. Remove the roasting pan from the oven.', '2 Toss asparagus with dill, zest, garlic, salt, olive oil, and mix with potatoes: In a medium bowl, toss the asparagus with the chopped dill, lemon zest, garlic, about 1/2 teaspoon of salt and a little olive oil. Add the asparagus mixture to the potatoes and stir to combine.', '3 Make room for salmon fillets in the pan, and roast: Push the vegetables to the side of the dish to make room for the salmon. If you are using fillets, put them skin side down. Salt the salmon well and return the baking dish to the oven.', 'Roast the salmon and asparagus for 10 minutes, or until the fish is just cooked through.', 'If you want, remove the skin and center bones (if you are using steaks), and arrange on individual plates before serving. Garnish with fresh dill and lemon wedges.']",7
1150,"Angel Hair Pasta with Salmon, Arugula, and Creamy Lemon-Parmesan Sauce Recipe",10,25,35,"['2 tablespoons extra virgin olive oil, separated', '6 salmon fillets (2 1/2 to 3 ounces each, about 1 to 1 1/4 pounds total), preferably wild-caught King or Sockeye salmon', '2 1/4 teaspoon kosher salt, divided', '1 teaspoon ground black pepper, divided', '1 pound angel hair pasta', '4 tablespoons unsalted butter, separated', '1 tablespoon minced shallot', '4 garlic cloves, minced', '1 cup dry white wine or seafood stock', 'Juice and rinds of 2 lemons (1/3 to 1/2 cup juice)', '2 cups heavy cream', '5 ounces arugula (4 packed cups)', '1 cup freshly grated Parmesan cheese']",13,"[""1 Warm your oven: Set the oven to its lowest setting (mine is 150\\xc2\\xb0F) to keep the salmon warm once it's cooked."", '2 Start the water for pasta. Bring a large pot of salted water to boil.', '3 Season the salmon fillets: Rub both sides of the fillets with 1 teaspoon of the kosher salt and a 1/2 teaspoon of the black pepper.', '4 Sear the salmon: Heat 1 tablespoon of the olive oil over medium-high heat in a large saut\\xc3\\xa9 pan (preferably nonstick). Once the oil starts to ripple in the pan, place the salmon fillets into the pan, skin-side up.', 'Press the fillets down gently to make sure the entire surface makes contact with the pan. Sear the salmon fillets for 3 minutes, or until the flesh turns an opaque pink 1/4 of the way up the sides of the fillets.', '5 Flip the salmon and keep it hot: Use a spatula to flip the salmon and sear it, skin-side down, for an additional 3 minutes.', 'Transfer the fillets to a sheet pan and place them in the heated oven while you finish the dish. It\\xe2\\x80\\x99s okay if the salmon is not cooked completely through just yet\\xe2\\x80\\x94it will continue to cook in the oven.', '6 Cook the shallot and deglaze the pan: In the same pan you used to sear the salmon, heat the remaining tablespoon of olive oil and 2 tablespoons of the butter over medium-high heat. Add the shallot and the garlic to the pan and saut\\xc3\\xa9 for 3 minutes, or until glossy and fragrant.', 'Pour the white wine and lemon juice into the pan and use a wooden spoon to scrape up any bits of food that have stuck to the bottom of the pan. Add the lemon halves and bring the mixture to a boil.', '7 Reduce the sauce and cook the pasta: Reduce the sauce in the pan by half by maintaining a boil. This should take 3 to 4 minutes.', '8 Cook the pasta: By now, your pasta water should be at a rolling boil. Add generous tablespoon of salt to the boiling water and drop the pasta into the middle of the pot. Stir the pasta immediately to separate the noodles.', 'Lower the temperature slightly to prevent the water from boiling over and cook the pasta for 4 to 5 minutes, until al dente (or according to package directions). Drain the pasta.', '9 Finish the sauce:  Once the liquid in the pan has reduced by half, reduce the heat to medium-low. Remove the lemon halves. Slowly stir in the heavy cream and the remaining butter.', 'Allow the sauce to come to a simmer, then add the arugula. Stir to coat the arugula in the sauce and allow it to wilt slightly\\xe2\\x80\\x94this should only take a minute or so. Add the Parmesan, along with the remaining salt and pepper. Taste and adjust the seasoning, if necessary, by adding a bit more salt or pepper.', '10 Combine the pasta and sauce: Add the pasta to the pan with the sauce. Using tongs, toss in the pasta in the sauce until it is evenly coated.', '11 Serve the pasta with the salmon: Remove the warm salmon fillets from the oven and arrange on top of the pasta. Serve immediately. While this dish is best enjoyed the same day it\\xe2\\x80\\x99s made, we have had success with reheating the leftovers in the microwave the next day.']",16
1151,Honey Apple Cider Glazed Salmon Recipe,0,25,25,"['1/2 cup unfiltered apple juice or apple cider (not hard cider)', '1 1/2 tablespoons honey', '4 salmon fillets (6 ounces each)', '1 tablespoon extra virgin olive oil', 'Salt', '2 teaspoons lemon juice', '1 tablespoon butter', '8 ounces fresh baby spinach', 'Freshly ground black pepper', 'Lemon slices for garnish']",10,"['1 Make apple cider honey glaze: Put the apple cider and honey in a small shallow pan on medium high heat. Let it come to a boil and boil it until the mixture reduces by about half, leaving you with a little more than 1/4 cup of glaze. Let cool for a minute.', '2 Let raw salmon fillets sit in prepared glaze: Arrange the salmon fillets (skin-side down, if using skin-on salmon fillets) in a rimmed dish large enough to fit all of the fillets in a single layer. Pour the honey cider glaze over the salmon.', 'Let it sit for 5 minutes, then turn the salmon pieces over and let sit for another 5 minutes in the glaze.', '3 Place fillets in hot pan flesh side down: Heat olive oil in a large skillet on medium-high. (It helps to use a relatively stick-free pan like hard anodized aluminum.) Sprinkle the flesh side of the salmon fillets with salt.', 'Place the fillets flesh side down (skin-side up) in the hot pan. Cook for 2 minutes on medium high heat.', 'As you cook the fish, brush the sides of the fillets with some of the glaze.', '4 Turn fillets over so flesh side up: Turn the salmon fillets over (now skin-side down) and brush with the remaining honey cider glaze.', 'Sprinkle salmon with lemon juice. Lower the heat to medium. Cook for 3 to 5 minutes until the salmon is just barely cooked through.', '5 Brush the cooked fillets with remaining pan glaze: Remove the pan from heat. Some of the glaze should have caramelized in the pan. Use a pastry brush to brush any pan juices over the top of the fillets.', 'Cover with foil to keep warm.', '6 Wilt baby spinach: In a separate large skillet, melt the butter over medium-high heat. Add the baby spinach to the pan. Cook for a minute.', 'When the spinach begins to wilt, use tongs to turn the leaves over in the pan to help coat the leaves with a little butter.', 'Sprinkle with salt and pepper. Continue to cook a minute or two more until the spinach is wilted.', '7 Serve: To serve, divide the spinach among 4 plates. Arrange a piece of salmon to the side or on top and garnish with a slice of lemon.']",14
1152,Grilled Salmon with Dill Butter Recipe,15,10,25,"['4 6-ounce portions of salmon, preferably skin-on', 'Salt', '2 tablespoons extra virgin olive oil, plus more to wipe down the grill', '1/4 cup unsalted butter, at room temperature', '2 teaspoons chopped fresh dill', 'One lemon, thinly sliced, for garnish']",6,"['1 Salt the salmon: Remove the salmon from the refrigerator and sprinkle a little salt over it. Let it sit at room temperature while you preheat your grill for high, direct heat.', '2 Mix dill with butter: While the grill is heating, mix the fresh dill with the butter in a small bowl.', '3 Grill the salmon: When the grill is hot, scrape down the grates with a grill brush. Pour a little olive oil onto a paper towel, and use tongs to wipe down the grill grates.', 'Coat the salmon in the remaining 2 tablespoons of oil and place, skin side up, onto the grill grates. Grill over high heat for 2-4 minutes (depending on how thick your salmon pieces are) undisturbed.', 'Carefully turn the salmon with a spatula. If using a gas grill, reduce the heat to medium. If using a charcoal grill, move the salmon to the cooler side of the grill.', 'Cover and grill it for another 3-5 minutes, depending on how well done you prefer your salmon. The salmon should be just cooked through when done.', ""4 Serve: To serve, place a few thin slices of lemon on each plate. Remove the salmon pieces from the grill (it's okay if the skin sticks to the grill grates) and place on the lemon slices. Top each piece of salmon with about a tablespoon of the dill butter and serve at once.""]",7
1153,Miso Glazed Salmon Recipe,35,10,45,"['2 Tbsp red miso or 3 Tbsp white miso', '2 Tbsp sake', '2 Tbsp sugar (less or more to taste)', '2 teaspoons soy sauce', '4 6-ounce skinless salmon fillets']",5,"['1 Mix the miso, sake, soy sauce, and sugar in a small bowl. Adjust proportions to taste.', '2 Marinate the salmon: Pour half of the mixture into a container large enough to fit the salmon fillets, then pour the rest over the top of the fish. Make sure the fish is coated with the miso sauce.', 'Cover the container and marinate for at least 30 minutes, and up to overnight.', '3 Broil the salmon: Line a broiling pan with aluminum foil. Brush a little vegetable oil over the foil and lay the salmon fillets on top. Make sure there is an even, thin coating of marinade on top of the fish.', 'Place the fillets no closer than about 6 inches from the broiler element in your oven. Broil for 6-10 minutes, depending on how thick the fillets are and how hot your broiler is.', ""Keep an eye on the salmon. The marinade has sugar in it that can easily cause the glaze to burn. If it starts charring and the cooking isn't yet finished, place the fish on a lower rack in the oven."", 'Serve with rice and stir-fried vegetables.']",7
1154,Hoisin Glazed Baked Salmon Recipe,5,40,45,"['2 Tbsp hoisin sauce', '2 teaspoons soy sauce', '1 Tbsp lime juice (can sub rice vinegar)', '1-2 teaspoons sugar', '1 large garlic clove, smashed and minced', '4 6-ounce salmon fillets', 'Vegetable oil, for greasing the broiler pan']",7,"['1 Make the hoisin marinade: Mix the hoisin sauce, soy sauce, lime juice, sugar, and garlic together in a bowl. Taste and adjust to your taste (more lime juice if too sweet, more sugar if too acidic).', '2 Marinate the salmon: Coat the salmon pieces in the marinade and chill for 30 minutes to 1 hour.', '3 Broil the salmon: Set the rack in your broiler to about 6 inches underneath the heating element. Turn on the broiler.  Lightly grease a foil-lined broiling pan with vegetable oil.', 'Arrange the salmon pieces skin side down (if your fillets still have skin on one side) on the pan and paint with a little more of the marinade.', 'Broil until done, about 5-10 minutes, depending on the thickness of the salmon fillets and the heat of your broiler.', 'Serve with steamed rice. Asparagus or Asian Coleslaw would work well as side dishes for this salmon.']",6
1155,Salmon with Fennel Baked in Parchment Recipe,10,20,30,"['1 fennel bulb, sliced paper thin (a mandoline helps for this)', '4 6-ounce portions of fresh salmon fillets (skinless is best)', 'Kosher salt', 'Freshly ground black pepper', 'Lemon juice (to taste)', '12 very thin slices of whole lemon (from 1 to 2 lemons)', 'Several sprigs of fresh fennel fronds', '2 Tbsp butter', ""4 12x18-inch pieces of parchment paper (can sub aluminum foil if you don't have parchment paper)""]",9,"['1 Preheat oven to 350\\xc2\\xb0F (175\\xc2\\xb0C).', '2 Create a crease in parchment paper: Lay down a square of parchment paper on a flat surface. Fold the parchment in half to create a crease, then open it up again.', '3 Layer fennel, salmon, fronds, lemon, butter on parchment below the crease: Place several slices of fennel bulb below the crease of the parchment paper in a mound, and sprinkle with salt.', 'Place one fillet of salmon on top of the fennel bulb slices. Squeeze fresh lemon juice over the salmon (anywhere from a teaspoon to a tablespoon, or to taste). Sprinkle the salmon generously with salt and pepper.', 'Lay sprigs of fennel fronds over the salmon. Lay 3 thin slices of lemon over the fennel fronds and salmon (more if you want). Or you could put the lemon sliced down first and top with the fronds, your choice. I think the slices on top look better. Dot the top with butter.', '4 Fold the parchment over the salmon and secure close. There are several way that you can accomplish this.', 'One easy and particularly attractive way is to fold a corner near the folded edge of the parchment paper into a triangle. Then about halfway down that triangle, fold another triangle over the previous triangle.', 'Working down and around the parchment edges, you can create folds all around the edges. When you come to the last folded edge, tuck the corner under the parchment.', 'There is an excellent video available that shows this technique here: How to Wrap Fish in Parchment. This technique works well with individual portions.', 'You may find it easier to wrap a large (multi serving) fillet in the following way. Arrange the fillet so that its long side is facing you, and the two shorter ends are to the left and right. Then lift up the parchment edges closest to you, and furthest from you, bring them together, and fold them over a few times.  Then tuck the left and right edges under the fillet.  ', '5 Bake: Place on a roasting pan or baking sheet. Bake at 350\\xc2\\xb0F for 20 minutes.', 'Serve immediately. To serve, you can either carefully transfer each salmon fillet and mound of fennel slices to individual plates, or you can serve the salmon in the pouch itself, on a plate.', 'To eat, you can either unwrap the pouch, or cut through the top with a sharp knife to expose the salmon inside.']",13
1156,Slow-Roasted Salmon with Sweet Chili Glaze and Scallions Recipe,10,20,30,"['For the glaze:', '1/2 cup sweet Thai chili sauce', '1 teaspoon Sriracha', '2 tablespoons lime juice', '2 teaspoons soy sauce', '1 tablespoon finely chopped fresh ginger', '1 bunch scallions, thinly sliced', 'For the salmon', '1 1/2 pounds center-cut salmon fillet, skin and pin bones removed', '1/2 teaspoon salt', '1/8 teaspoon ground black pepper', 'To serve:', '2 to 3 handfuls baby greens (arugula, spinach, kale or a combination)', '1 tablespoon olive oil', 'Salt and pepper, to taste', '1 tablespoon lime juice', 'Leaves from 2 to 3 sprigs cilantro', 'Leaves from 2 to 3 sprigs mint', '1 lime, cut into wedges, for serving']",19,"['1 Make the glaze: In a bowl, stir together the Thai chili sauce, sriracha, lime juice, soy sauce, ginger and half of the chopped scallions. Reserve the remaining scallions for the garnish.', '2 Prepare the salmon: Check the salmon for pin bones by running your fingers gently over the surface; remove any pin bones you find (see Recipe Note). Sprinkle the salmon with salt and pepper on both sides.', 'Spread about 1/3 cup of the glaze in the center of a 9x13-inch baking dish. Set the salmon fillet on top and move it around a little so that the bottom is coated with glaze. Spread the top with the remaining glaze. If you like, you can do this ahead, cover it, and refrigerate for up to 2 hours.', '3 Slow-roast the salmon: Preheat the oven to 275\\xc2\\xba F.  Roast for 18 to 23 minutes, or until a thermometer inserted into the thickest part of the fish registers 130 degrees. (The temperature will rise a few degrees once the salmon is out of the oven.)', '4 Toss the salad: In a bowl, toss the greens with the olive oil, salt and pepper. Sprinkle with the lime juice and toss again. Arrange the greens on a platter.', '5 Serve the salmon: With a serving spoon, break the salmon into a few large pieces and set them on the platter on top of the greens. Scatter the cilantro, mint, and remaining scallions on top. Place the lime wedges around the fish and serve.']",6
1157,Smoked Salmon and Goat Cheese Toasts Recipe,10,20,30,"['8 oz soft fresh goat cheese', '1 tablespoon chopped fresh rosemary', '1 tablespoon chopped fresh thyme', '2 teaspoons of grated lemon peel', '1/2 teaspoon coarsely ground black pepper', '2 1/2 tablespoons extra virgin olive oil', '30 thin slices French-bread baguette', '12 oz thinly sliced smoked salmon', 'Thinly peeled lemon peel strips from one lemon, cut into tiny slivers*', ""*Use a sharp vegetable peeler to peel wide strips from a lemon. Probably the peel from just half of one lemon will do. Take a metal spoon and scoop out and discard any white pith that is under the peels you've removed. The pith is bitter. Then slice the peel into tiny slivers. If you do this part in advance, cover with plastic wrap so the strips do not dry out before you put them on the salmon.""]",10,"['1 Mix cheese, herbs, lemon zest, pepper: Preheat oven to 350\\xc2\\xb0F. Mix first goat cheese, herbs, lemon zest, and black pepper in a small bowl to blend. Set aside. (The cheese mixture can be mixed a couple of days ahead of time.)', '2 Toast bread slices in oven: Brush oil over both sides of bread slices. Arrange bread in single layer on a large baking sheet. Bake until bread is just crisp, about 5 minutes on each side. (You can prepare the toasts a couple hours in advance.)', '3 Assemble salmon, cheese, toasts: Spread cheese mixture over toasts. Top with salmon, trimming to fit. Garnish with lemon peel strips. Arrange on platter and serve.']",3
1158,Grilled Salmon with Peach Salsa Recipe,20,10,30,"['For the salmon:', '1 1/2 teaspoons smoked paprika', '1 1/2 teaspoons granulated garlic', '1 1/2 teaspoons granulated onion', '1 teaspoon light brown sugar', '1/2 teaspoon salt', '1/2 teaspoon black pepper', '1 pinch of cayenne (optional)', '1 pound skin-on salmon filets (about 4 pieces)', '2 to 3 tablespoons neutral cooking oil, such as grapeseed, avocado, or canola oil', 'For the salsa:', '2 heaping cups diced peaches, unpeeled (about 3 medium peaches)', '1 medium ripe avocado, diced', '1/4 cup finely diced red onion', '1/4 cup chopped cilantro', '2 tablespoons finely minced jalape\\xc3\\xb1o (optional)', '1 tablespoon fresh lemon juice', '1/4 teaspoon salt', 'To serve:', 'A few slices of jalape\\xc3\\xb1o', 'A few sprigs of cilantro', 'Special equipment:', 'Gas or charcoal grill', 'Nonstick Grill Pan']",24,"['1 Season the salmon: Whisk together paprika, garlic, onion, maple sugar, salt, pepper, and cayenne.', 'Sprinkle spice mixture evenly on all sides of the salmon. Refrigerate uncovered while making the salsa and preheating the grill, about 20 minutes.', '2 Make the salsa: In a medium bowl, mix together the peaches, avocado, onion, cilantro, jalape\\xc3\\xb1o, lemon juice, and salt. Season to taste, adding more salt or jalape\\xc3\\xb1o if you like. If your peaches are a bit tart, you can add a pinch of sugar.', '3 Prep the grill: Preheat a gas or charcoal grill to 500\\xc2\\xbaF for at least 15 minutes, or until you can hold your hand above the grates for 2 to 3 seconds.', '4 Grill the salmon: Brush all sides of the salmon with oil\\xe2\\x80\\x94about a tablespoon total. Brush a bit of oil onto the grill grates as well, ensuring that any fish touching the grates through the grill pan will easily lift away.', 'Place the salmon skin side up on the grill pan and transfer the pan to the grill. Close the lid and cook undisturbed for 2 to 3 minutes. Using a fish spatula or tongs, gently lift one corner of the fish. The grilled side should be opaque and show some sear marks. If not, check every minute or so until it is.', 'Gently, flip the fish to skin side down, close the lid, and grill for another 3 to 4 minutes. Open the lid and watch carefully until the fish is done, another 1 to 3 minutes. The salmon is perfectly cooked when the top and bottom are opaque and there is a nice translucent streak through the middle. (If you prefer your salmon more well-done, continue cooking to your preferred doneness.)', '5 Serve: Remove from the grill and serve immediately. Top with peach salsa and cilantro and chilies for garnish.']",8
1159,Fresh Salmon Cakes with Spicy Mayo Recipe,15,20,35,"['For the spicy mayo:', '1 cup mayonnaise', '1 teaspoon Dijon mustard', '1 tablespoon bottled cocktail sauce, or more to taste', '1/4 teaspoon Sriracha or other chili-garlic sauce, plus more to taste', '1 tablespoon lemon juice, or more to taste', '1/4 teaspoon salt', '1/4 teaspoon ground black pepper', 'For the salmon (or substitute about 3 cups leftover cooked salmon):', 'Canola oil (to oil the baking dish)', '1 1/2 pounds boneless salmon, skin intact', '5 tablespoons canola oil', '1/4 teaspoon salt', '1/4 teaspoon ground black pepper', 'For the cakes:', '1 day-old dinner roll (about 3-inches across) or 2 slices sandwich bread', '1/4 cup fresh dill leaves, stripped from the stem', '1 large egg, lightly beaten', '3 tablespoons bottled cocktail sauce', '1/2 teaspoon Worcestershire sauce', '1/4 teaspoon salt', '1/4 teaspoon black pepper', '1/2 cup all-purpose flour, for shaping']",23,"['1 Make the spicy mayo: In a bowl, whisk the mayonnaise, mustard, cocktail sauce, Sriracha, lemon juice, salt, and pepper.', 'Taste for seasoning and add more Sriracha or lemon juice, if you like. Cover and refrigerate until needed, or up to a 5 days.', '2 Cook the salmon: Turn on the broiler with an oven rack positioned about 8 inches below. Rub a baking dish with oil (any baking dish large enough to hold the salmon is fine). Rub the salmon on both sides with 1 tablespoon of the oil, and sprinkle with 1/4 teaspoon of the salt and 1/4 teaspoon of the pepper.', 'Set it in a baking dish, skin side up, and slide it under the broiler. Broil for 4 minutes, or until the skin is charred.', 'Turn the oven temperature down to 400 degrees. Continue cooking the salmon for 8 minutes, or until the flesh is opaque in the center and the flesh flakes apart easily.', '3 Break the salmon into flakes: Let cool until cool enough to handle. Peel away and discard the skin. Transfer the fish to a bowl and gently flake it into small pieces with your hands or a fork.', 'You should have about 4 cups of flaked salmon.', '4 Make the salmon mixture: Tear the dinner roll into 1-inch pieces and add to the bowl of a food processor. Add the dill, egg, cocktail sauce, Worcestershire sauce, the remaining 1/4 teaspoon salt, and remaining 1/4 teaspoon pepper.', 'Pulse until the mixture is blended and still a little chunky. (Do not process so long that the mixture becomes a paste.)', 'Add the egg mixture to the salmon mixture and stir thoroughly with your hands or a spatula.', '5 Shape the patties: Dust a cutting board with the flour. With your hands, shape the salmon mixture into 8 patties. Sprinkle them lightly with flour and set on a large plate or baking sheet.', '6 Pan-fry the cakes: Set the oven at 250F. In a large nonstick skillet over medium-high heat, heat 2 tablespoons of the canola oil.', 'Add 4 of the cakes and cook without disturbing for 4 minutes, or until golden on the undersides. Turn and cook 4 minutes more, or until golden. Transfer to the baking dish and keep warm in the oven.', 'Discard the oil in the pan (the flour tends to brown too much) and carefully wipe the pan with a paper towel. Fry the remaining 4 cakes in the remaining 2 tablespoons oil in the same way.', '7 Serve warm with spicy mayo. ']",15
1160,Salmon Teriyaki Skewers with Pineapple Recipe,5,78,83,"['1/2 cup soy sauce', '1/4 cup mirin rice wine or rice vinegar', '1/4 cup brown sugar', '2 Tbsp minced garlic', '2 Tbsp minced fresh ginger', '1/4 cup minced green onions', '2 Tbsp vegetable oil', 'Pinch chili pepper flakes', '1 lb salmon fillet, rinsed, cut into 1 to 1 1/2-inch cubes', '1 lb fresh pineapple, cut into 1 to 1 1/2-inch chunks', '2 green onions, cut into 1-inch segments', '8 bamboo skewers, soaked in water for at least 20 minutes before using']",12,"['1 Make the teriyaki marinade: In a medium bowl, mix together the soy sauce, mirin or rice vinegar, and brown sugar, until the sugar is completely dissolved. Add the fresh ginger, minced green onions, chili pepper flakes, and vegetable oil.', '2 Marinate and chill the salmon: Place the cubes of salmon in the bowl, coat completely with the marinade. Cover and chill for 1 to 2 hours.', '3 Simmer marinade: Remove salmon from marinade. Place marinade in a small sauce pan and bring to a boil, simmer for 10 minutes, set aside.', '4 Grill: Thread salmon, pineapple, and onion pieces on skewers. If using a grill, prepare grill for high, direct heat. Oil the grill grates. Place skewers on grill. Cover. If using an oven broiler, place on a rack on a broiling pan, so that the salmon pieces are 6 inches from the element. Turn after 2 to 4 minutes. Baste with reserved marinade. Cook for 2 to 4 minutes more, basting frequently, until salmon is just barely cooked through.', 'Serve immediately.']",5
1161,Slow Cooker Poached Salmon Recipe,5,70,75,"['3 cups water', '1 cup white wine', '1/2 cup celery (1 rib)', '1 cup sliced leeks (1 small)', '2 teaspoons peppercorns', '2 cloves garlic, minced', '2 large sprigs fresh dill, plus 2 tablespoons chopped (for garnish)', '1/4 cup lemon juice (from 2 lemons)', '1 teaspoon kosher salt', '2 to 2 1/2 pounds skin-on fresh salmon, cut into fillets or left whole', 'Special equipment:', '6-quart slow cooker']",12,"['1 Make the broth: Combine water, white wine, celery, leeks, peppercorns, garlic, sprigs of dill, lemon juice and 1/2 teaspoon kosher salt. Cook on high for 1 hour.', '2 Poach the salmon: Season the salmon with salt and pepper, and use your fingers to pat it in. Reduce the heat on the slow cooker to low. Add the salmon carefully, skin side down, using a parchment sling, tongs, or clean hands. Cover the and cook for 4 minutes.', 'Remove the cover, turn the salmon carefully using tongs, cover, and cook for an additional 4 to 6 minutes, until opaque and cooked through. Thin fillets will finish more quickly; thicker fillets will take slightly longer.', '  3 Remove the salmon. Carefully remove the salmon from the slow cooker and transfer to a platter.', '4 Strain the poaching broth: Strain off the solids using a fine mesh sieve. If desired, drizzle some of the poaching liquid over the top of the salmon, or reserve it for another use.', '5 Serve: Sprinkle the salmon with chopped dill and serve immediately. Serve with some combination of asparagus, potatoes, or rice.']",6
1162,Grilled Fish Tacos with Strawberry Pineapple Salsa Recipe,30,10,40,"['For the salsa (makes 2 1/2 cups salsa):', '1 cup finely diced strawberries', '1 cup finely diced pineapple', '1/2 cup finely diced red onion', '1 clove minced garlic', '1 cup roughly chopped cilantro, loosely packed', '1 small red chili, diced (optional)', '1 lime, juiced (about 1 1/2 tablespoons juice)', '1/4 teaspoon salt', '1/4 teaspoon pepper', '1/2 teaspoon sugar (optional if the salsa is tart)', 'For the tacos:', '1 pound firm-fleshed fish (like sea bass, swordfish, halibut, mahi mahi or salmon)', '1 teaspoon ground cumin', '1 teaspoon sweet paprika', '1 teaspoon smoked paprika', 'Heavy pinch of cayenne (optional)', '1/4 teaspoon salt', '1/4 teaspoon pepper', '1 tablespoon olive oil', 'Grapeseed or other high heat oil for grill', '12 small (4- to 6-inch) corn tortillas', 'To serve:', 'Shredded red cabbage', 'Sliced radishes', 'Avocado', 'Sour Cream', 'Lime wedges', 'Cilantro']",29,"['1 Make the salsa: In a bowl, mix together all salsa ingredients, except for the sugar, and refrigerate for at least 30 minutes or up to 2 days.', 'Taste and add sugar or additional seasonings to taste when ready to serve.', '2 Heat the grill. If you have a gas grill, make sure to preheat it for at least 10 minutes with the lid closed. If you have a charcoal grill, push the coals to one side to make high heat and lower heat zones for cooking.', '3 Prepare the fish: Remove fish from the refrigerator and pat dry with paper towels.', 'In a small bowl or jar, mix spices until completely combined. Brush the fish with a little oil, then sprinkle all over with seasoning.', 'Rest the fish at room temperature while the grill heats up.', '4 Oil the grill: When your grill is hot, wipe the grates with oil. You can either use a grill brush or a small wad of paper towels dipped in the oil. Wipe the grates 5 to 10 times until they look black and glossy.', '5 Grill the fish: Place your fish, skin side down, on the grill. If using a charcoal grill, place over indirect heat. On a gas grill, turn the heat down to medium (about 350F) and close the lid.', 'Grill 2 minutes, then check the fish by lifting one corner of the fish to see if it will come up without sticking. The skin should be crisp and brown.', 'If it lifts easily, flip the fish and cook for another 3 to 5 minutes with the lid closed. If the fish doesn\\xe2\\x80\\x99t lift easily, continue cooking and checking every 30 seconds.', 'Grill until the fish is cooked through and flakes easily with an internal temperature of 145F.', 'Transfer the fish to a plate to rest.', '6 Grill the tortillas: Turn heat to high and brush grates with oil again (or cook over direct heat on a charcoal grill). Cook tortillas for 30 seconds on each side to warm and soften.', '7 Serve: Cut the fish into several pieces. Serve on tortillas, topped with salsa and other toppings.']",14
1163,One-Pan Roasted Harissa Salmon with Vegetables Recipe,10,20,30,"['For the salmon and vegetables:', '1 1/2 pounds whole salmon fillet', '1 1/4 pounds green beans, trimmed', '2 medium red bell peppers, sliced', '1/4 cup olive oil, divided', '2 tablespoons dry harissa spice blend (divided)', '1/2 teaspoon salt (divided)', 'For the cherry tomato salad:', '1 bunch parsley, roughly chopped', '2 teaspoons red wine vinegar', '2 tablespoons olive oil', '1 clove garlic', '1/3 cup roasted salted pistachios (optional)', '1 pint cherry tomatoes, halved', 'Pinch of salt (or more if not using the pistachios)']",15,"['1 Heat the oven to 425F. Line a full sheet pan with foil. (If your sheet pan is too small to fit the side of salmon and the vegetables, cut the fillet in half and cook on two sheets pans.)', '2 Remove the pin bones from the salmon with needle nose pliers.', '3 Roast the vegetables: Toss the green beans and peppers with 1 tablespoon olive oil, 2 teaspoons harissa, and a pinch of salt. Spread on the sheet pan in a single layer. Roast for 10 minutes.', '4 Prepare the salmon: Sprinkle both sides of the salmon with the remaining harissa and a 1/4 teaspoon salt, then brush with olive oil. (This helps prevent the spices from scorching in the oven.)', '5 Roast the salmon with the vegetables: Pull the sheet pan of veggies from the oven and use a spatula to stir them and clear some space in the middle for the salmon. Return to the oven and roast for 8 to 10 minutes.', '6 Prepare the tomato salad: While salmon is in the oven, use a mini food processor or blender to mix parsley, red wine, and olive oil. Once it\\xe2\\x80\\x99s well-mixed, add the garlic and pistachios (if using) and pulse just a few times. You want some nice chunks in there. Toss with the cherry tomatoes and season with salt to taste.', '7 To serve: Scoop the roasted vegetables onto a serving platter and lay the salmon on top. Spoon the cherry tomato salad over the salmon and serve.']",7
1164,Salsa Verde Chicken Enchiladas Recipe,30,10,40,"['For the chicken:', '1 1/3 pounds skinless chicken thighs, boneless or bone-in (1 3/4 lbs if bone-in)', '2 clove garlic, halved', '1/4 medium onion', '2 teaspoons sea salt', 'For the tomatillo salsa:', '1 1/2 lbs tomatillos, papery husks removed, rinsed', '2 serrano chile peppers, top cut off to expose interior and to remove stems', '2 cloves garlic', '1/2 cup chopped white or yellow onion', '1/2 cup chopped cilantro, stems included', '1 tablespoon fresh lime juice', '1 teaspoon sea salt', 'For the enchiladas:', '1 tablespoon extra virgin olive oil, corn oil, or peanut oil', '12 corn tortillas (use sturdy yellow corn tortillas)', '1/4 cup sour cream', '1/2 cup crumbled Mexican Cotija or Queso Fresco cheese', '1/3 cup chopped red onion for garnish', '1/2 cup chopped fresh cilantro, including stems for garnish']",20,"['1 Poach chicken thighs: Put chicken thighs in a medium sized saucepan and just cover with water. Add the halved garlic, 1/4 of an onion, and 2 teaspoons of salt to the water.', 'Bring to a simmer, reduce the heat to very low to maintain the heat at just below a simmer, and cook, covered, for 10 to 15 minutes, or until the chicken is just barely cooked through. (Here are the step-by-step instructions for How to Poach Chicken.)', 'Remove chicken thighs to a separate bowl and let cool enough to touch.', '2 Cook the tomatillos: While the chicken is cooking, put the tomatillos and serrano chile peppers in a separate sauce pan and cover them with water. Bring to a boil, reduce to a simmer. Simmer until the tomatillos are cooked, and have changed color, but are not mushy, about 5 minutes. Remove from heat.', '3 Make the salsa verde: Use a slotted spoon to transfer tomatillos and serrano chiles to a blender. Add 1/4 cup of the tomatillo cooking liquid to the blender, as well as 2 cloves of garlic, a half cup of chopped onion, 1 tablespoon of lime juice, and about 1/2 cup of chopped cilantro. Add one teaspoon of salt.', ""Pur\\xc3\\xa9e until blended, 15 to 30 seconds. Taste for heat. If not spicy enough add another chile pepper (it doesn't have to be cooked). Add more salt to taste if necessary."", 'You should have about 3 cups of salsa.', '4 Shred chicken meat, toss with salsa verde: Remove the cooked chicken meat from the bones (if using bone-in thighs).', 'Shred the meat with a fork or knife. Put the chicken in a bowl and add 1/2 cup of the tomatillo sauce to the chicken. Taste the chicken; if it needs salt, add a little.', '5 Soften the tortillas: Heat a tablespoon of oil in a frying pan on medium high heat. Add a tortilla to the pan and let it sizzle for 10 seconds or so. Use a metal spatula to flip it to the other side. Let it sizzle for a few seconds. Place another tortilla on top of this one (to soak up the excess oil) and flip again.', 'You can keep going, stacking corn tortillas on top of the tortillas that appear to have excess oil. This way the new tortillas absorb some of the excess fat from the other tortillas.', 'When the tortillas are heated through, remove them to a plate lined with paper towel. Add a more oil to the pan as needed, and continue to heat through and soften all of the tortillas.', '6 Roll up tortillas with chicken: Preheat the oven to 250\\xc2\\xb0F. Scoop a spoonful of chicken into the center of the tortilla and roll up the tortilla. Place the rolled tortilla seam side down in a casserole dish and repeat with all of the tortillas.', '7 Cover with foil and warm in oven: Cover the rolled tortillas with foil and keep warm in a 250\\xc2\\xb0F for 10 minutes.', '8 Heat salsa and smother the rolled tortillas with it: Place the remaining tomatillo salsa in a small saucepan and heat on medium high heat until simmering. Remove warmed rolled tortillas from the oven and smother with the salsa.', 'Let some of the sauce go between the rolled up tortillas so that it gets to the bottom of the pan.', '8 Add sour cream and garnishes: Top with crumbled cotija cheese, chopped red onion, and chopped fresh cilantro.', ""Thin the sour cream with a tablespoon of water and drizzle all over the top of the enchiladas. (Don't skip the sour cream! It's essential to balance the sharp acidity of the salsa verde.)"", 'Serve immediately.']",19
1165,Grilled Shrimp Tacos with Mango Avocado Salsa Recipe,25,20,45,"['Grilled Shrimp:', '1 pound shrimp (16/20 count) peeled and deveined (frozen is fine)', '1 quart water (4 cups)', '1 tablespoon kosher salt', '1 cup cubed ice', 'Olive oil', 'Skewers for grilling, if bamboo, soak in water for an hour', 'Mango Avocado Salsa:', '1 ripe but still firm mango, peeled and cut into small cubes', '1 ripe avocado, seeded, peeled, and cut into small cubes', '2 Tbsp finely chopped red onion', '1/2 fresh jalape\\xc3\\xb1o pepper (less or more to taste), minced', '3 Tbsp fresh lime or lemon juice', '1/2 teaspoon kosher salt', '2 Tbsp chopped fresh cilantro leaves (optional)', 'Tortillas:', '10 to 12 corn or flour tortillas']",17,"['1 Defrost frozen shrimp: If you are starting with frozen shrimp, put a quart of cold water in a large bowl and add a tablespoon of salt. Stir until the salt is dissolved. Add the shrimp and several large ice cubes. Let sit until defrosted (keep ice in the water).', 'If your shrimp is fresh or already defrosted, if you want you can put the shrimp in salty water for 15 minutes or until you are ready to thread skewers and grill the shrimp.', '2 Prepare the salsa: Place the chopped mango, avocado, red onion, jalape\\xc3\\xb1o in a bowl. Sprinkle with salt and gently toss with fresh lime or lemon juice. Add fresh cilantro (if using) right before serving.', ""3 Prepare your grill for high direct heat (you'll know it's hot enough when you can hold your hand 1 inch above the grill grates for 1 second)."", '4 Thread the shrimp onto skewers: Use two bamboo skewers at a time to thread the shrimp.  This will make it easier to turn and keep the shrimp from spinning on the skewer.', 'Starting at the big end of the shrimp, hold the shrimp in a tight spiral like the shape of an apostrophe. Starting at the large end of the shrimp, thread the 2 skewers through the shrimp, starting at the big end and going through the smaller end, right before the tail section.', 'Thread 3 to 4 or more on a skewer, depending on how long your skewers are, leaving a little space between each shrimp so that the shrimp cook evenly.', 'Brush shrimp with a thin coating of olive oil on both sides.', '5 Grill the shrimp: Brush hot grill with a wadded up paper towel soaked in olive oil. Place the skewers of shrimp on the hot grill. Grill for 2-5 minutes per side, depending on how hot your grill is and how big your shrimp are.', ""The cut end of the shrimp will change from translucent to opaque as it cooks. It's done when it is just barely opaque. Take it off the grill. Don't overcook or your shrimp will be rubbery!"", ""Remove the shrimp from the skewers when they are still relatively hot (they'll slide off better when warm)."", '6 Warm the tortillas: Depending on the type of tortilla you are using (flour tortillas work well, as do soft white corn tortillas), you can put them on the grill for a few moments to toast them just a little on each side.', 'You can also warm tortillas in a microwave (works well to soften them), or in a frying pan. If warming corn tortillas in a frying pan, it helps to add a little oil to the pan.', 'To serve, place a few shrimp in the center of a tortilla and top with mango avocado salsa!']",14
1166,Flank Steak with Orange and Avocado Salsa Recipe,15,16,31,"['For the salsa', '2 tablespoons finely diced red onion', '2 tablespoons lime juice', '1 tablespoon white vinegar', '1 tablespoons olive oil', '1/4 teaspoon salt, or to taste', '1/8 teaspoon freshly ground black pepper', '4 to 5 oranges, any kind', '1/4 cup chopped cilantro leaves ', 'For the steak', '1 1/2 pounds flank steak', '1 tablespoon plus 2 teaspoons olive oil', '2 teaspoons ancho chili powder', 'Salt and pepper, to taste', 'To serve:', '4 ounces queso fresco, crumbled', '1 avocado, sliced', '1/4 cup cilantro leaves', 'Warm tortillas or salad greens, for serving (optional)']",19,"['1 Begin making the salsa: In a bowl, combine the red onion, lime juice, vinegar, oil, salt and pepper. Let stand for 5 minutes while you slice the oranges. (The acid in the lime and vinegar takes the edge off the raw onion so it doesn\\xe2\\x80\\x99t overpower the salsa.)', '2 Prepare the oranges: With a serrated knife, trim the ends of each orange. Place one orange flat end down on a cutting board. Using a sawing motion and going from top to bottom, cut away the pith and peel from the orange following the curve of the orange.', 'Cut the orange into slices. Cut the slices into halves if small, and quarters if large. Repeat with the remaining oranges.', '3 Finish the salsa: Add the sliced oranges and any accumulated juices to the bowl with the onion and lime juice. Taste and add more salt and pepper, if you like.', '4 Pound and season the steak: Cover a cutting board with a piece of plastic wrap and set the steak on top. Place another sheet of plastic wrap on top of the steak. Using a mallet, a rolling pin or a heavy frying pan, pound the steak to an even thickness of about 1/2-inch.', 'Uncover the steak and rub each side with 1/2 tablespoon of the olive oil. Sprinkle each side with ancho chile powder and pat it into the meat. Sprinkle with salt and pepper.', '5 Cook the steak: Set a cast-iron pan or griddle over high heat and heat until hot. Add 2 teaspoons of the oil and tilt the pan to spread it over the bottom.', 'Add the steak and cook for about 2 to 3 minutes on a side, or until it is lightly browned and the internal temperature registers 125\\xc2\\xbaF for rare or 130\\xc2\\xbaF for medium rare.', '6 Rest the steak: Transfer the steak to a cutting board and let rest for 5 to 10 minutes.', '7 Slice and serve the steak: On a cutting board, slice the and transfer it to a serving platter. Top with the salsa. Finish with queso fresco and cilantro scattered over top and the avocado slices arranged alongside. Serve with warmed tortillas, if you like.']",10
1167,Tomatillo Salsa Verde Recipe,10,15,25,"['1 1/2 lb tomatillos', '1/2 cup chopped white onion', '2 cloves (or more) garlic (optional)', '1/2 cup cilantro leaves', '1 Tbsp fresh lime juice', '2 Jalape\\xc3\\xb1o peppers OR 2 serrano peppers, stemmed, seeded and chopped (you can use whole for more heat if you want)', 'Salt to taste']",7,"['3 Pulse in blender: Place the cooked tomatillos, lime juice, onions, garlic (if using), cilantro, chili peppers in a blender or food processor and pulse until all ingredients are finely chopped and mixed.', '4 Season to taste with salt. Cool in refrigerator.', 'Serve with chips or as a salsa accompaniment to Mexican dishes.']",3
1168,Cactus and Corn Salsa Recipe,15,15,30,"['2 nopales cactus paddles, spikes removed*', '2 green tomatoes, cored and cut in half', '1/2 large, white onion, peeled and cut into 4 chunks', '2 jalape\\xc3\\xb1o chiles, red or green, more or less to taste', '1 teaspoon extra virgin olive oil plus more to grease baking sheet', '1 cup frozen corn**', '1 cup cilantro, stems removed', '1 garlic clove, peeled', 'Juice from 1/2 a lime, about 1 tablespoon', '2 tablespoons tequila, optional', '1 teaspoon dried Mexican oregano', 'Salt to taste', 'Tortilla chips, to serve', ""*This recipe is designed for the whole paddles, but you may be able to make it with bagged cut cactus for nopalitos if that's all that is available in the market. Just arrange them close together on the roasting pan while you roast the vegetables so they don't dry out."", '**You can also use freshly cooked corn or grilled corn, stripped from the cob. In this case, skip the corn roasting in step 2, and just add to the salsa in the last step.']",15,"['1 Prep cactus paddles: Heat oven to 425\\xc2\\xb0F. Working with a large sharp knife with a fairly straight edge, scrape off any remaining prickles or nubs on the cactus paddles.', 'Cut the paddles crosswise into 1-inch thick strips. Lightly grease a baking sheet with olive oil.', '2 Roast the cactus paddles, onion and jalape\\xc3\\xb1os in oven: Place cactus, green tomatoes, white onion and jalape\\xc3\\xb1os on the baking sheet in preheated 425\\xc2\\xb0F oven for 12 minutes. The cactus should still be slightly crisp when pierced with a fork.', '3 Roast the corn kernels: Heat a cast iron or stick-free skillet with 1 teaspoon olive oil over medium heat on the stove top. When the pan is heated, add frozen corn and spread out in an even layer. Do not stir the corn. Allow it to roast in the hot pan for about 2 to 3 minutes.', 'The corn should become browned and roasted. You can check by gently flipping a few pieces with the corner of a spatula.', 'When corn is browned, stir and roast for another 2 to 3 minutes. Remove from heat. Place corn in a small bowl and set aside.', '4 Pulse in a food processor: Place the oven roasted vegetables in a food processor with the cilantro, garlic, lime juice, tequila, oregano and salt. Pulse until nearly smooth, about 30 seconds.', '(Be careful when you remove the lid on the food processor\\xe2\\x80\\x94the heat released from the peppers will zoom up your nose and down your throat, so don\\xe2\\x80\\x99t stand directly over the open food processor.)', '5 Stir in the roasted corn: Pour the salsa into a serving dish. Stir the roasted corn into the finished salsa. Allow to rest in the fridge for 30 minutes to 1 hour. Serve with tortilla chips.']",9
1169,Turkey Tacos with Cranberry Salsa Recipe,15,10,25,"['Turkey Tacos', '8-12 corn tortillas', 'Extra virgin olive oil', '2 cups grated Monterey Jack cheese, or mild cheddar', 'Cooked turkey meat, cut into bite-sized pieces', 'Lettuce, thinly sliced', 'Fresh cilantro for garnish', 'Cranberry Salsa', '1 1/2 cups of fresh or frozen cranberries', '1/2 an apple, peeled and cored', 'Chopped serrano or jalapeno chili to taste (about a half a chili, but taste for desired heat)', '4 tablespoons sugar', '2 tablespoons chopped peeled ginger', '2 tablespoons chopped fresh cilantro', '1 tablespoon of lime or lemon juice', 'Dash of salt']",16,"['1 Prepare cranberry salsa: Put the cranberries, apple, chile, sugar, ginger, cilantro, and lime or lemon juice in a food processor and pulse until coarsely shredded, about 10 short pulses.', 'Let sit 15 minutes for the cranberries to macerate. You can also use cranberry relish, just add chopped chiles and cilantro.', '2 Heat the tortillas: Heat a large frying pan on medium high heat. Unless you are using freshly made homemade tortillas, you will need to soften them first.', 'Place a small amount (1/2 a teaspoon) of oil in the pan and spread to coat the bottom of the pan.', 'Place a tortilla in the pan and let it heat up until bubbles start to form. Then flip it over.', '3 Add cheese and turkey to tortillas: Sprinkle grated cheese on half of the tortilla, and top with chopped cooked turkey. Fold the empty half of the tortilla over the side with cheese and turkey (like an omelette).', 'Cook until the cheese begins to melt, then flip the taco over so that the tortilla browns on the other side as well. Continue to cook the tacos in this manner.', 'To serve, open up the tacos and put some chopped lettuce and plenty of cranberry salsa over the cheese and turkey. Garnish with fresh cilantro leaves.']",8
1170,Saut\xc3\xa9ed Shrimp with Tropical Fruit Salsa Recipe,10,15,25,"['1/2 cup sweetened coconut flakes', '1 Tbsp cooking oil (coconut oil or canola oil)', '1 pound raw shrimp, peeled and deveined', '1 mango, peeled and diced', '1 cup diced pineapple', '2 kiwi-fruit, peeled and diced', '1/4 cup finely diced red or sweet onion', '1 teaspoon sugar, or to taste', '1/4 lime', '1/8 \\xe2\\x80\\x93 1/4 teaspoon chili powder', 'Salt and pepper', '3 fresh mint leaves, thinly sliced']",12,"['1 Toast coconut flakes: Heat a large frying pan or saut\\xc3\\xa9 pan on medium heat. Add the coconut flakes and stir constantly, until the flakes are slightly browned at the edges.', 'Immediately spoon onto a plate to stop the cooking and prevent burning. Set aside to cool.', '2 Saut\\xc3\\xa9 the shrimp: Season the shrimp with salt and pepper. Return the same frying pan to the stove and heat on medium high heat. Pour in 1 tablespoon of cooking oil and swirl to coat.', 'When the oil is hot, add the shrimp and cook for 2 minutes each side or until just barely cooked through. Spoon out the shrimp to a serving platter.', '3 Saut\\xc3\\xa9 the fruit: Use the same frying pan, heat to medium-high heat, pour just 2 teaspoons of cooking oil and swirl to coat.', 'When the oil is shimmering, add the diced onion and saut\\xc3\\xa9 for 1 minute. Add the mango, pineapple, and the kiwi and cook for 1 minute until bubbly and softened.', 'Add the fresh mint, sugar, chili powder and just a pinch of salt.', 'Finish with a light squeeze of lime, sprinkled on top of the shrimp.', '4 Sprinkle with toasted coconut flakes: Sprinkle the shrimp and salsa with toasted coconut flakes.']",9
1171,Grilled Tomatillo and Corn Salsa Recipe,15,25,40,"['3 pounds of tomatillos, husks removed, rinsed clean', ""2 corn cobs, husks still on, OR 2 cups of cooked corn (Trader Joe's has frozen roasted corn which would work great)"", '1/4 cup chopped fresh cilantro', '2 cloves garlic, minced', '1 jalape\\xc3\\xb1o, minced (remove seeds for less heat)', '3-4 Tbsp lime juice', '2 teaspoons salt', '1/4 teaspoon cayenne', '1/8 teaspoon cumin', '1/4 teaspoon dried oregano', '1/2 cup finely diced red onion']",11,"['1 Grill the tomatillos: Prepare grill for direct, high heat. Place the tomatillos directly on the grill. Turn occasionally until charred in several places, and the color indicated the tomatillos are cooked and changes from vibrant green to olive green.', '2 Grill the corn: If you are grilling the corn as well, place the corn cobs, still in their husks, directly on the grill. (If you are using fresh corn, there is no need to soak them in water.)', 'Grill until the husks are completely charred and blackened all around. (See How to Grill Corn on the Cob.) The flavor from the charred corn husks will cook into the corn as it grills.', 'Remove from grill. Let cool. Strip off the burnt husks and silks from the corn cobs. Use a sharp knife to cut away the corn kernels from the cobs.', '3 Pulse tomatillos, cilantro, garlic, jalape\\xc3\\xb1o, lime juice, salt, cayenne in food processor: Place the tomatillos, cilantro, garlic, jalape\\xc3\\xb1o, lime juice, salt, cayenne, cumin and oregano in a food processor. Pulse until pur\\xc3\\xa9ed, with a few remaining chunks of tomatillos.', '4 Stir in the corn and minced red onion. Adjust seasonings, add more salt to taste.']",6
1172,Grilled Shrimp with Tomato Olive Salsa Recipe,30,10,40,"['Salsa', '1 large shallot, minced', '2 tablespoons red wine vinegar', '1 large garlic clove, minced', 'Salt and black pepper', '1 tablespoon small capers', '1/2 cup (heaping) chopped black olives', '2 pounds plum tomatoes', '3 tablespoons extra virgin olive oil', '1/4 cup chopped parsley', 'Shrimp', '2 pounds large shrimp, peeled and deveined', '3 tablespoons extra virgin olive oil', 'Salt']",14,"['1 Soak the shallots in vinegar: Place the minced shallots in a small bowl and add the red wine vinegar. The vinegar will help take the bite out of the raw shallots.', '2 Blanch and peel the tomatoes: The best way to peel the tomatoes is to score the tips slightly with a sharp knife, drop them into boiling water, let them boil for 1 minute, and then plunge them into a large bowl filled with ice water.', 'Remove the tomatoes from the ice water and peel off the outer skin. Seed and dice the tomatoes and put in a large bowl.', '3 Combine salsa ingredients: Add the shallots, minced garlic, capers, black olives, and olive oil to the bowl with the tomatoes. Sprinkle with salt and pepper, gently mix the ingredients together and set aside.', ""4 Prepare the shrimp to grill: If you haven't already done so, peel and devein the shrimp. Coat the shrimp with olive oil. Sprinkle the shrimp with salt and put them on skewers. We recommend threading the shrimp on two skewers so that the shrimp are easier to flip on the grill."", '5 Grill the shrimp: Preheat your grill on high direct heat. Clean the grates. Grill the shrimp with the grill cover open for a few minutes on each side, just enough to cook them through.', '6 Serve: When you are ready to serve, add the parsley to the salsa. Serve the salsa with the shrimp.']",7
1173,Crispy Chicken Skin Tacos with Habanero Salsa Recipe,10,25,35,"['Chicken Skin:', 'Skin from a whole chicken or 5 chicken breasts or leg/thighs*', 'Salt', 'Habanero Salsa:', '1-2 habanero chiles, seeds removed and chopped', '4 green onions, white and light green parts only', '1/4 cup chopped cilantro', '2 Roma or other plum tomatoes, seeded and chopped', '3 Tbsp lemon juice', '1/4 small head of iceberg lettuce, thinly sliced, sprinkled with cider vinegar and salt', '1 avocado, seeded, peeled, and chopped', 'Garnish and Tortillas:', 'More chopped cilantro and green onion for garnish', '4 or more corn or flour tortillas (use corn tortillas if cooking gluten-free)', '*Pulling the skin off of chicken can be a little slippery, especially off of chicken legs. Get it started with your fingers, then grip the skin with a paper towel and pull.']",15,"['1 Fry chicken skin on medium-low heat: Lay the chicken skin, fat side down, in a non-stick pan set over medium-low heat. Slowly crisp the skins, letting the fat render. Press them down with a wooden spoon if air pockets develop. Cook them for 5-8 minutes before flipping them over.', 'Once you have turned the chicken skins over, salt them.', '2 Make habanero salsa: While the skins are cooking, put the habaneros, green onions, cilantro, tomatoes, and lemon juice into a food processor. Add a pinch of salt. Pulse a few times to combine. Set aside in a small bowl.', '3 Cut fried chicken skin into strips: When the chicken skins are browned and crispy, remove them to a paper towel-lined plate to absorb the excess fat. Then place them on a cutting board and cut them into strips.', '4 Heat tortillas: Pour off all but a thin sheen of chicken fat from the pan (do not discard down a drain or you may clog your drain). Heat the tortillas in the pan over medium-high heat, turning now and then, until they air pockets develop and the tortillas soften.', '5 Assemble the tacos: Place lettuce, chopped avocado, crispy chicken skin, habanero salsa, and more cilantro or green onion on the heated tortillas. Fold and eat.']",6
1174,Green Beans with Salsa Recipe,5,6,11,"['Fresh green beans - 1 1b, strings removed, stem end cut off, cut into even sized pieces, approximately 2"" long', '1 tablespoon salt', '1 tablespoon extra virgin olive oil', 'Prepared salsa']",4,"['1 Boil the green beans: In a medium sized pot, add enough water to cover the beans (about 2 quarts). Add 1 tablespoon of salt for every 2 quarts of water. Bring the water to a boil. Add the beans and boil with the pot uncovered for 5 minutes. Remove from stove, strain out the beans, set aside.', '2 Heat olive oil, add beans and salsa:  Put the empty (dry) pan back on the stove over high heat and add the olive oil. Let this heat up for 1 minute, then toss in the beans and about 1/2 cup of prepared salsa.', 'Toss to combine and cook 1 minute. Add salt or more salsa to taste.']",3
1175,Tomatillo Chicken Stew Recipe,20,40,60,"['Tomatillo Sauce', '1 1/2 pounds tomatillos', ""1-2 jalape\\xc3\\xb1o chile peppers, or 2-3 serrano chili peppers (include the seeds if you want the heat, remove them if you don't want the heat), stems discarded, chopped"", '1 clove garlic, chopped', '1 teaspoon salt', '2 tablespoons lime (or lemon) juice', 'Pinch of sugar', 'Stew', '2 pounds boneless, skinless chicken thighs or breasts, trimmed of excess fat, cut into 1-inch cubes', 'Salt and pepper', 'Extra virgin olive oil', '2 yellow onions, chopped', '2 cloves garlic, minced', '1 teaspoon ground cumin', '1 teaspoon ground coriander', '1 1/2 cup chicken stock', '2 cups tomatillo sauce', '1 teaspoon dry oregano or 1 tablespoon fresh, chopped', '1/2 cup packed chopped cilantro (about one bunch, rinsed and chopped, stems and leaves)']",19,"['1 Make the tomatillo sauce: Remove the papery husks from the tomatillos and rinse well. Cut the tomatillos in half and place them cut-side down on an aluminum foil-lined roasting pan.', 'Broil for 5-7 minutes until blackened in spots. Let cool enough to handle.', 'Place the tomatillos, any juice they have released, chile peppers, garlic, salt, lime juice and sugar in a blender, and pulse until well blended. If you make ahead, refrigerate until needed.', '2 Brown the chicken: Heat a couple tablespoons of olive oil in a large, thick-bottomed pot on medium high heat until almost smoking. Pat dry the cubed chicken parts with paper towels. Sprinkle salt and pepper over them.', 'Working in batches so as not to crowd the pan, and adding more olive oil when necessary, brown the chicken pieces on two sides.', ""When you place the pieces in the pan, make sure there is room between them (otherwise they will steam and not brown), and don't move them until they are browned on one side."", ""Then use tongs or a metal spatula to turn them over and don't move them again until they are browned on the other side. Do not cook through, but only brown."", 'Remove the chicken pieces from the pan and lower the heat to medium. There should be a nice layer of browned bits (fond) at the bottom of the pan.', '3 Cook the onions, add cumin and coriander, add garlic: Add the onions to the pan, and a tablespoon or two more olive oil if needed (likely).', 'Add ground cumin and coriander. Cook a few minutes, stirring occasionally until onions are softened and the browned bits from the chicken have been picked up by the onions and are no longer sticking to the pan.', 'Add the garlic and cook for 30 seconds more, until fragrant.', '4 Add the browned chicken, the tomatillo sauce, chicken stock, and oregano to the pan. Stir to combine. Bring to a boil and reduce to a simmer.', 'Cook, partially covered, for 20 minutes until chicken is cooked through. Add the cilantro to the stew in the last minute or so of cooking.', 'Serve over white rice, accompanied with sour cream if needed to offset the heat from the chiles. The stew will thicken as it cools.']",14
1176,Turkey Chile Verde Recipe,20,240,260,"['Salsa verde:', '1 1/2 lbs fresh green tomatillos', '5 cloves garlic, peel ON', '1 jalapeno, stems and seeds removed, chopped*', '2 poblano chiles', '1 bunch of cilantro, rinsed, roughly chopped, including stems', '1 teaspoon salt', '2 Tbsp lime juice', 'Pinch sugar', 'Turkey:', '3 pounds boneless, skinless turkey thighs**', 'Salt and pepper', '2 tablespoons extra virgin olive oil', '2 yellow onions, coarsely chopped (about 3 cups)', '1 teaspoon cumin', '3 garlic cloves, peeled, finely chopped', '2 1/2 cups chicken stock', '1 teaspoon chipotle powder', '2 tablespoons fresh oregano, chopped', '2 bay leaves', 'Pinch of ground cloves', '* You can moderate the heat of this dish with the seeds from the jalapenos. Taste the tomatillo sauce after you blend it. If it needs more heat, blend in some of the jalapeno seeds.', ""** If you can only get bone-in, skin-on, that's okay. Remove the skin and discard or save it to use it to make turkey bacon. Cut as much meat as you easily can away from the bone, and then cook the meaty bone with the turkey chunks. Remove the bone when the meat is cooked and shred the meat from the bone.""]",23,"['1 Roast the poblano chiles: Roast the poblano chiles over a gas burner or under a broiler, until blackened almost all over. Place chiles in a paper bag, close the bag, and let the chiles steam in their own heat for a few minutes.', 'Remove the chiles from the bag, remove the charred skin, the stem and the seeds. (For a step-by-step, see How to roast chile peppers over a gas flame.)', '2 Broil the tomatillos: Remove the papery husks from the tomatillos. Rinse the tomatillos with water (they may be a little sticky).', 'Slice the tomatillos in half and place cut-side-down on a roasting pan lined with aluminum foil. Toss the garlic cloves (peel on) in with the tomatillos.', 'Cook under a broiler until lightly browned, about 5-7 minutes. Let cool to the touch, then remove the garlic cloves from their skins.', '3 Make the salsa verde: Place tomatillos, garlic, jalape\\xc3\\xb1o, poblanos, cilantro, salt, lime juice, and sugar in a blender. Start on a low speed and then increase the blender speed and pur\\xc3\\xa9e until smooth. Set aside (can make a day ahead and refrigerate until needed).', '4 Prepare the turkey thigh meat: Cut the turkey thigh meat into 1 to 1 1/2 inch chunks, cutting away and discarding any tough gristly bits or big pieces of fat. Pat dry with paper towels. Sprinkle with salt and pepper.', '5 Brown the turkey: Heat olive oil in a large (6 to 8 qt) Dutch oven or high-sided saut\\xc3\\xa9 pan on medium high or high heat (hot enough to sear the meat).', 'Working in batches so as not to crowd the pan (a crowded pan will make it harder for the meat to brown), sear the chunks of turkey on all sides (do not stir the meat in the pan until they have browned well). Remove with a slotted spoon to a bowl.', '6 Saut\\xc3\\xa9 onions, add garlic: Add the chopped onion and the cumin to the pot, and cook, stirring and scraping up any browned bits from the bottom of the pan, until the onions are translucent (about 5 minutes).', 'Add the garlic, cook for 30 seconds more.', '7 Add turkey, tomatillo sauce, stock, spices to pot: Return the turkey to the pot. Add the tomatillo sauce and the chicken stock.', 'Add the chipotle powder, oregano, bay leaves, and ground clove. Add a teaspoon of salt, and a little freshly ground black pepper.', '8 Simmer 3 to 4 hours: Bring to a simmer, and reduce heat to low (enough to maintain a low simmer), while the pot stays uncovered. Cook for 3 to 4 hours, uncovered, until the turkey is tender.', 'If at some point you think that too much liquid is going to evaporate, cover the pan. Otherwise keep it uncovered. You want the sauce to become more concentrated. Adjust seasonings to taste. You may need to add more salt than you would expect.', 'Serve in a bowl, with chopped fresh cilantro, and sides such as chopped avocado, thinly sliced lettuce that has been seasoned with vinegar and salt, sliced radishes, thinned sour cream or crema fresca, and with fresh heated tortillas or tortilla chips. Or serve with rice and beans, or wrapped up in a large flour tortilla, burrito style.']",16
1177,Green Chile Enchiladas Recipe,15,45,60,"['For the tomatillo sauce:', '1 1/2 pounds tomatillos', '3 cloves garlic, still in their peels', '2 jalape\\xc3\\xb1o peppers', '1/2 cup chopped fresh cilantro, leaves and stems', 'Salt', 'For the enchiladas:', '4 large Anaheim or Hatch green chiles (can sub with poblanos, if you want spicier)', '12 yellow corn tortillas (look for sturdy corn tortillas)', 'Extra virgin olive oil, corn oil, or canola oil', '1/2 to 1 pound Monterey Jack cheese, grated (quantity depends on how cheesy you want the enchiladas to be)', 'For garnish:', 'Sour cream', 'Cilantro']",14,"['1 Prepare the tomatillo sauce: Remove the husks from the tomatillos. Rinse off the tomatillos.', 'Cut the tomatillos in half and place them cut-side down on a roasting pan lined with aluminum foil. Place the garlic and jalape\\xc3\\xb1os on the pan with the tomatillos.', 'Broil on the top rack on the oven for 5 to 10 minutes until the tomatillos are lightly charred. Remove from the oven and let cool to touch. Remove garlic from the garlic skins, discard the skins.', 'Cut open the jalape\\xc3\\xb1os and remove and discard the seeds and the stems.', 'Place tomatillos, cooked garlic, the jalape\\xc3\\xb1os, cilantro, and 1 teaspoon of salt in a blender, pulse until well pur\\xc3\\xa9ed. Set aside. (You can make several days in advance and store in the refrigerator.)', '2 Roast the chiles: If you have a stove-top gas burner, you can roast the chiles directly over the flame of the burner (see How to roast chile peppers over a gas flame), otherwise use a broiler and broil the chiles in a roasting pan, turning them until they are blackened all over.', '3 Steam, peel, and deseed the chiles: Place the blackened chiles in a bowl and cover with a plate. Let the chiles steam in their own heat for 5 minutes. Then remove the chiles from the bowl and peel off and discard the blackened skin.', ""Slice open the chiles and remove and discard the seed pod, any seeds (they're hot!) and the stems. Slice the chiles into strips."", '4 Warm the tortillas: Heat a couple tablespoons of oil in a frying pan (cast iron works well) on medium-high heat.', 'Once the oil is hot, add a corn tortilla to the pan. The tortilla should sizzle as it hits the pan. Turn it over and let it cook until little pockets of air start to bubble up.', 'Remove the tortilla from the pan with a metal spatula, shaking off any excess oil, to a plate lined with paper towels.', 'Cook the remaining tortillas this way, adding more oil as needed. Separate the cooling tortillas with paper towels.', '5 Assemble the enchiladas: Preheat the oven to 350\\xc2\\xb0F. Spread a little tomatillo sauce in the bottom of a 9x13 casserole pan.', 'One by one, place a little grated cheese and a strip or two of green chiles in the center of the tortillas, roll them up, and place them seam side down in the casserole.', 'Once you have filled the casserole with the rolled tortillas, spread the remaining tomatillo sauce over them, and sprinkle with the remaining cheese.', '6 Bake: Bake for 15 minutes at 350\\xc2\\xb0F, until the cheese is melted.', '7 Serve: Serve with sour cream (thinned with some water) drizzled over, and some chopped fresh cilantro. Thinly sliced iceberg lettuce that has been sprinkled with cider or white vinegar and salt is also good with it. Makes for excellent leftovers; will keep in the refrigerator for several days.']",17
1178,"Freezer Breakfast Burritos with Sausage, Eggs and Salsa Verde Recipe",15,30,45,"['1 pound sweet pork sausage', '2 to 3 medium Yukon potatoes, diced (about 3 cups; no need to peel them)', '1 green pepper, diced', '1 medium yellow onion, diced', '8 ounces mild or sharp cheddar cheese, grated', '1 tablespoon butter', '8 large eggs', 'Salt and pepper', '1 cup salsa verde, homemade or store-bought', '8 large burrito-sized flour tortillas']",10,"['1 Cook the sausage: In a large skillet over medium heat, cook the pork sausage. Break it up as it cooks until it\\xe2\\x80\\x99s browned evenly. Transfer the cooked pork to a bowl.', '2 Cook the vegetables: Add the potatoes to the skillet used to cook the pork and cook until they are tender and browned in spots, 8 to 10 minutes, stirring regularly. Any fat left over from the pork should be enough to cook the potatoes in, but if the skillet is very dry, add a drizzle of olive oil.', 'Add the diced peppers and onions  and continue to cook until the veggies soften, another few minutes. Season with salt and pepper. Remove the skillet from heat.', '3 Scramble the eggs: In a separate nonstick skillet over low heat, add the butter. Whisk together the eggs in a medium bowl. Once the butter has melted, add eggs and cook until scrambled and set, but not completely dry. Remove from heat and set aside. (You can do this at the same time the vegetables are cooking if you want to multitask!)', ""4 Assemble the burritos: Once your fillings are cooled slightly (it\\xe2\\x80\\x99s okay if they are still a bit warm, as long as they're not steaming), lay out a large flour tortilla on a clean surface."", 'Add about 1/8 of the pork sausage, 1/8 of the potato filling, 1/8 of the cheddar cheese, and 1/8 of the eggs. It\\xe2\\x80\\x99s okay to eyeball the amounts, but you should have enough of each filling to make eight burritos. Top with about two tablespoons of salsa verde.', '  5 Roll the burritos: Fold the sides over the filling and then roll the tortilla into a tight burrito. Immediately roll the burrito in foil. Repeat with all burritos.', '6 Freeze the burritos: Transfer the foil-wrapped burritos to a large, freezer-safe, resealable plastic bag and freeze. Burritos will store well in the freezer for up to three months.', ""Even if you plan to eat your burritos the same week you make them, we still recommend freezing the burritos until you're ready to eat them. This preserves them better than in the fridge and prevents the burrito from becoming overly soggy."", '7 Reheat the burritos: Unwrap burrito from foil and microwave on high for 4 to 5 minutes, turning once halfway through. At that point the burrito will be hot and you could eat it as is. Serve with extra salsa verde, if desired.', 'As a bonus step, which I love: place the reheated burrito in a small nonstick skillet over medium heat and let the tortilla crisp up for 2 to 3 minutes per side. If you loathe any hint of sogginess in your burritos, this will eliminate the problem!']",11
1179,Grilled Salsa Verde Chicken Recipe,5,30,35,"['8 bone-in, skin-on chicken thighs (about 3 pounds)', '1/2 teaspoon salt', '1/8 teaspoon black pepper', '1 1/2 cups salsa verde, either jarred or homemade, divided', 'Oil for the grill', 'To serve, any of the following:', 'Rice', 'Tortillas', 'Thinly sliced radishes', 'Fresh cilantro leaves', 'Corn, on or off the cob', 'Cherry tomatoes', 'Avocado slices']",13,"['1 Prepare the chicken: With scissors or a sharp knife, trim the excess skin and fat from the thighs. Sprinkle with salt and pepper on both sides.', '2 Marinate the chicken: In a bowl, toss the chicken with 1 cup of the salsa verde to coat. Cover with plastic and refrigerate for 1 hour or up to overnight.', '3 Prepare the grill: If you are using a gas grill, set one side to high temperature and the other side to low temperature. Heat the grill to at least 450\\xc2\\xb0F.', 'If you are using a charcoal grill, prepare a two-level fire by mounding the coals on one side of the grill, and leaving the second side empty.', 'When your grill is hot, use tongs to oil the grill grates with a small folded piece of paper towel dipped in oil.', '4 Grill the chicken: Remove the chicken from the marinade. Place the thighs on the hot side of the grill, skin-side down. Cook them for a minute or two\\xe2\\x80\\x94just long enough for the skin to show the grill marks. Flip over and sear briefly on the other side. (Exact timing depends on the heat of your particular grill.)', 'Move the chicken to the cooler side of the grill. Continue to cook, turning once or twice, for about 6 to 8 minutes or until the temperature in thickest part of the chicken registers 165\\xc2\\xbaF. Transfer the chicken to a platter and let it rest for 10 minutes.', '5 Serve the chicken: Transfer the chicken to a platter or individual plates. Serve with the remaining 1/2 cup salsa verde on the side and your choice of toppings.']",8
1180,Italian Sub Sandwich Recipe,10,5,15,"['1 large Italian bread loaf', '1/3 cup mayonnaise', '4 ounces Genoa salami', '4 ounces pepperoni', '8 ounces roasted turkey breast', '6 ounces Provolone cheese', '2 cups chopped iceberg lettuce', '1/2 cup chopped tomatoes', '1/4 cup pickled sliced banana peppers (pepperoncini)', '1/4 cup chopped Kalamata olives', '3-4 tablespoons extra virgin olive oil', '2 tablespoons red wine vinegar', '2 teaspoons dried Italian seasoning']",13,"['1 Prepare the bread: Cut Italian loaf in half longwise with a serrated knife. Scoop out some of the bread in the top half of the loaf. This will give you more room for toppings and make sure the sandwich doesn\\xe2\\x80\\x99t fall apart. Just don\\xe2\\x80\\x99t go too deep. You still need it to hold together. (Use the leftover bread to make breadcrumbs!)', '2 Layer the meats and cheese: Spread mayonnaise on the bottom half of the loaf. Layer the meats and cheese on the bottom portion of the loaf in any order you like. I prefer to the do the cured meats on the bottom, then turkey, and then cheese, but there is no science to it.', '3 Finish the sandwich: Chop the iceberg lettuce, tomatoes, banana peppers, and olives. Add a bed of lettuce to the top half of the loaf (that has been hollowed slightly).', 'Top with chopped tomatoes, peppers, and olives. Drizzle the vegetables liberally with extra virgin olive oil, red wine vinegar, and Italian seasoning. Bring the two halves of the loaf together and press slightly.', '4 Cutting and serving the sandwich: Cut the large sandwich into six evenly sized pieces. Serve immediately or wrap and store for later.', 'Leftovers! If you aren\\xe2\\x80\\x99t serving immediately, cut the sandwich into portions, and wrap each portion tightly with plastic wrap. Sandwiches will keep well in the fridge for 2-3 days.']",6
1181,Sous Vide French Dip Sandwiches Recipe,45,1440,1485,"['3 pounds boneless beef top or bottom round roast', '1 teaspoon salt, plus more to taste', '1/4 teaspoon black pepper, plus more to taste', '1 to 3 tablespoons cooking oil, like canola or grapeseed', '1/2 cup red wine', '2 cups low-sodium beef broth or stock', '1 bay leaf', 'To serve:', '1 large yellow onion, or 2 small yellow onions, thinly sliced (1 to 1 1/4 pounds)', '6 to 8 French rolls or hoagie buns', 'Sliced provolone cheese, optional', 'Special equipment:', 'Joule immersion circulator, or other immersion circulator', 'Large (8-quart or more) stock pot', 'Name-brand 1-gallon resealable plastic freezer bag, such as Ziploc']",15,"['8 Heat the water with the immersion circulator: Place the pot of water on a trivet or other heatproof surface. Place the immersion circulator in the water and set it to heat the water based on your preferred doneness for the roast beef: 135\\xc2\\xb0F (medium-rare), 140\\xc2\\xb0F (medium), 145\\xc2\\xb0F (medium-well) or 150\\xc2\\xb0F (well-done).', ""It will take approximately 5 to 10 minutes for the water to heat, depending on the volume of water in your pot. (You can also use warm water out of the tap to cut down on heating time.) Once the water is up to temp, your immersion circulator will indicate that you\\'re ready to start cooking."", 'With Joule, this is controlled through the Joule app: Open the app on your phone and press the orange circular button in the bottom right corner. Input the temperature and press the orange button again to start the device and begin heating the water.', ""9 Cook the roast: Once the water has finished heating, lower the roast into the water. It\\'s fine if the zipper is above the surface of the water, but the roast itself should be completely submerged by at least an inch or so. Add more water if needed."", ""Cook the roast for 18 to 24 hours (yes, hours!). It will become more tender the longer you let it cook. Set a timer so you know when it\\'s ready."", ""10 Check the roast and monitor the water during cooking: Every so often during cooking, take a peek at your roast and make sure that it\\'s still submerged in the water and the bag isn\\'t leaking. (If it\\'s leaking, the liquid will start to look diluted and you\\'ll notice air bubbles in the bag. Just transfer the roast and liquid to another bag and carry on with cooking. This doesn\\'t happen very often, but is something to watch out for.)"", ""Keep an eye on the water level and add additional water if it looks like it\\'s getting low. The immersion circulator will heat the water right back up to temperature. To help prevent evaporation, you can also cover your pot with plastic wrap, a silicon bowl cover (as I have), or any other cover."", '11 Cook the onions at any point while the roast is cooking: At any point during this cooking time when you have a spare 10 minutes, cook the onions. Warm a teaspoon or two of oil in a skillet and cook the onions with 1/4 teaspoon salt until they are very soft and browned.', ""If you\\'re not serving them right away, cool and refrigerate until needed. To reheat, add them to a hot skillet and stir until warmed through."", ""12 Sear the roast (again!): When you\\'re done cooking the roast, lift the bag from the water and set it on a kitchen towel on the counter. Warm a tablespoon of oil in a large skillet over medium-high heat."", 'Open the bag with the roast; be careful not to spill any of the cooking liquid. Use tongs to lift the roast from the bag and transfer it to a cutting board. Pat it dry on all sides.', 'Transfer the roast to the hot skillet and sear on all sides, 2 to 3 minutes per side, until the outside is very crusty. Add more oil as needed to the pan. Once seared, set the roast on a cutting board until ready to slice.', '13 Strain the ""jus"": While the roast sears, strain the cooking liquid (""jus"") into a measuring cup. Taste and add salt or pepper if needed. If the jus seems overly concentrated to you, add a little water to thin it out again.', 'Use a little of the jus to deglaze the pan after searing the roast, if you like.', 'Transfer the jus to individual cups for serving.', '14 Toast the French rolls: Warm the oven to 400F. Open up all the French rolls and arrange them in a single layer on a baking sheet with the cut sides facing up. Toast in the hot oven until they are warm and feel crispy when you press the surface of the bread, about 5 minutes. Remove from the oven, but leave the oven on.', 'If you like, spoon a little of the beef jus over the bottom buns for flavor.', ""15 Slice the beef: Use a sharp chef\\'s knife and slice the beef against the grain as thinly as possible."", '16 Assemble the sandwiches: Pile slices of beef on the bottom half of the rolls. The meat should divide equally between all the rolls, but you may have some leftover.', 'Top each pile of beef with some onions and a slice or two of cheese, if desired.', '17 Broil the sandwiches: Set aside the tops of the buns so they don\\\'t burn. Switch the oven to ""broil"" and slide the pan of sandwiches under the broiler. Broil until the cheese starts to melt, about 1 minute.', '18 Serve the sandwiches: Top each sandwich with the top bun. Serve with the jus alongside for dipping. (Refrigerate leftovers and consume within 3 to 4 days, or freeze for up to 3 months.)']",22
1182,Reuben Sandwich Recipe,5,10,15,"['Sandwich ingredients:', '2 Tbsp butter, softened', '8 slices rye bread', '8 slices Swiss cheese', '3/4 lb corned beef brisket, thinly sliced', '1/2 lb sauerkraut', '1/4 cup Russian Dressing', 'Russian Dressing:', 'Combine the following ingredients. Makes one-half cup.', '1/3 cup mayonnaise', '1 1/2 Tbsp ketchup', '1 1/2 teaspoons prepared horseradish', '1/2 teaspoon Worcestershire sauce', 'Salt, to taste', 'Freshly ground black pepper, to taste']",15,"['1 Butter one side of four slices of bread, and place the slices buttered-side down on a large piece of wax paper on a flat surface. Top each with a slice of Swiss cheese, and then divide half of the corned beef among them.', '2 Using paper towels, squeeze out excess moisture from the sauerkraut. Divide the sauerkraut among the sandwiches, and top each with one tablespoon of Russian dressing. Add another layer of corned beef and a second slice of Swiss cheese to each sandwich. Top with the remaining bread slices; butter the side facing out.', '3 Preheat a griddle or frying pan to medium heat. Cook the sandwiches on one side until the bread is golden brown. Use a spatula to carefully flip the sandwiches over and finish cooking on the second side. Cut the sandwiches in half before serving.', 'Serve with a side of coleslaw.']",4
1183,Hot Turkey Sandwich Recipe,5,5,10,"['1 1/2 lb leftover turkey meat, sliced', '1/2 cup or so of leftover turkey gravy', 'Stock or water (to thin the gravy if needed)', '4 large slices of rustic bread']",4,"['1 Heat gravy in a skillet until bubbly. If the gravy is too thick, thin with a little stock or water.', '2 Add pieces of sliced cooked turkey meat to the gravy. Coat with the gravy on all sides and heat until the meat is heated through.', '3 Arrange a slice of bread (rustic French or Italian loaf would work great) on a plate. Top with sliced turkey and gravy.']",3
1184,Easy Croque-Madame (Ham and Grilled Cheese Sandwich with Fried Egg) Recipe,10,10,20,"['2 slices sandwich bread, any favorite variety', '2 tablespoons mayonnaise', '1 tablespoon Dijon mustard', '2 thin slices Gruyere, or other firm, melting cheese (like Comt\\xc3\\xa9, Emmental, Jarlsberg), or enough cheese to cover the bread slices', '2 thin slices deli ham, like Black Forest', '2 tablespoons mayonnaise', '1 1/2 tablespoons butter', '1 tablespoons olive oil', '1 large egg', 'Pinch teaspoon salt', 'Pinch teaspoon black pepper', '1 teaspoons chopped fresh thyme or parsley', 'Special equipment:', 'Large (9- or 10-inch) cast-iron or nonstick skillet', 'Grill press']",15,"['1 Make the sandwich: Spread both slices of bread with mayonnaise. Flip them over and spread the other side with mustard. Onto one slice of bread, layer a slice of cheese, the ham, and the other slice of cheese. Top with the other slice of bread, mustard-side down. (The mayonnaise sides should face out.)', '2 Fry the sandwiches: Melt the butter in a large skillet over medium heat, then add the sandwich. If you have a bacon press, grill press, or panini press, set it on top to weight the sandwich down (otherwise, just press a few times with the flat of your spatula during cooking). Cook for 3 minutes, or until the bottom slice of bread is golden.', 'Carefully flip the sandwich in the skillet. Set the bacon press back on top (or press with the flat of your spatula), and cook another 3 minutes or until the underside is golden. Transfer to a plate.', '3 Fry the egg sunny-side up: Wipe out the skillet. Heat the olive oil in the skillet over medium heat until the oil shimmers and flows easily. Add the egg and cook for 1 minute exactly. Cover the skillet and cook for another 30 to 60 seconds, or until all the whites are set. (A runny yolk is preferred for this sandwich, however cook the egg for longer if you prefer a more hard-cooked yolk.)', '4 Serve: Slide the egg onto the top of the sandwich. Sprinkle with salt and pepper, along with thyme or parsley. Serve immediately.']",5
1185,Portobello Mushroom Burger Recipe,20,20,40,"['4 portobello mushroom caps', 'Extra virgin olive oil', 'One 8-ounce jar of sun-dried tomatoes in oil', '8 ounces of baby spinach', '1 red onion, sliced into 1/4-inch rounds', 'Salt', 'Mayonnaise', '4 hamburger buns']",8,"['1 Prepare your grill for high, direct heat.', '2 Wilt the baby spinach: While the grill is heating, if you wish, saut\\xc3\\xa9 the baby spinach in a tablespoon of olive oil and a sprinkle of salt in a large saut\\xc3\\xa9 pan on medium high heat, just until the spinach wilts, then remove to a plate.', 'The gently wilted spinach will stay on the portobello mushroom burger better than raw spinach, which tends to fall off.', 'Or you can use raw baby spinach. Your choice.', '3 Clean mushrooms and brush with oil: Wipe the mushrooms clean with a damp paper towel. If you are working with whole mushrooms, slice off the stems (you can use for another purpose, chopped and saut\\xc3\\xa9ed or for making stock.)', 'Paint the tops of the mushroom caps with some of the oil from the sun-dried tomatoes.', '4 Grill onion rounds, mushroom caps, buns: Scrape the grill grates clean. Using a folded up paper towel dipped in olive oil, wipe down the grill grates to oil them.', 'Brush the onion rounds with some olive oil and place them on the grill.', 'Place the mushroom caps on the grill, top side down first. Sprinkle with a little salt. Grill the mushroom caps and the onion rounds for 4-5 minutes per side.', 'Grill the burger buns, cut side down, for about 1/2 to 1 minute, until lightly toasted.', '5 Assemble: To assemble, spread some mayonnaise on each bun. Put a portobello mushroom cap on the bottom, then layer on the spinach, sun-dried tomatoes, and finally some onion. Serve at once.']",11
1186,Blue Cheese Burgers Recipe,15,40,55,"['1 pound ground beef (16-20%)', '1 tablespoon Dijon mustard', '2 cloves minced garlic', '2 green onions, chopped', '1/2 cup (about 2 ounces) crumbled blue cheese', '1 egg', '1 tablespoon water', 'Salt and freshly ground black pepper']",8,"['1 Gently mix ground beef with the other ingredients: Put ground beef, mustard, garlic, onions, blue cheese, water, egg, and a sprinkling of salt and pepper into a large bowl. Use your hands to gently mix the ingredients together until just incorporated. Do not over-mix.', '2 Shape into patties and chill: Shape into patties, about 1/2 inch thick and larger than your bun. Refrigerate at least 30 minutes or until you are ready to cook.', '3 Prepare charcoal or gas grill for cooking over high direct heat. Using tongs and a folded up paper towel dipped in vegetable oil, oil the grill grates. Make sure grill is hot and well oiled before laying down the patties.', '4 Season and grill the burgers: Season patties with salt and pepper. Place the patties on the clean, well-oiled grill grate. Grill the burgers for about 5 minutes per side. Do not press down on the burgers while cooking.', ""If you don't have a grill, you can use a grill pan or a cast iron frying pan for the burgers."", 'Serve on hamburger buns with lettuce and mayonnaise.']",6
1187,"Greens, Eggs, and Ham, Grilled Cheese Sandwich Recipe",5,10,15,"['Butter', '1 egg', '2 slices rye bread', 'Enough sliced ham to form a 1/4-inch layer to cover a slice of rye bread', 'Small handful of baby spinach (or sliced young chard)', 'A few slices of gruyere cheese']",6,"['1 Fry the egg: Heat a couple teaspoons of butter in a small stick-free pan on medium heat. When the pan is hot and the butter foamy, crack the egg into the pan.', ""Cook the egg until the whites are cooked and it is still somewhat runny in the yolk (or not runny at all if that's what you prefer), and remove the egg from the pan to a plate and set aside."", '2 Fry one side of buttered slice of bread: Heat a cast iron pan or griddle on medium high heat. Spread some butter on one side of one slice of rye bread.  Place the slice butter side down on the pan.', '3 Add layers of ham, spinach, egg, cheese: Add a layer of ham to the bread. Add a layer of spinach to the ham. Place the egg on the spinach.  Top with a layer of cheese and finally the second slice of rye bread.', '4 Butter top slice of bread and flip over: Spread some butter over the top of the top slice of bread. When the bottom slice is nicely toasted, use a metal spatula to carefully flip the sandwich over to the other side. You may need to use your hands to help the flip happen without everything spilling out. If the ingredients do spill out a bit, just gently edge them back in.', '5 Cook until bread is toasty and cheese is melty: Press down with a spatula to help get the heat to the cheese. Cook until toasted on this second side. Remove from pan, cut in half, and eat!']",6
1188,Smoked Salmon and Gruyere Grilled Cheese Sandwich Recipe,0,20,20,"['1/2 Meyer lemon, thinly sliced, seeds removed', '1/2 teaspoon salt', '8 slices French bread', '4 ounces smoked salmon', '4 ounces Gruyere cheese, sliced or shredded', '1 Tbsp chopped chives', 'Butter']",7,"['1 Cook lemon slices in salted water: In a small saucepan bring 1 cup of water to a boil. Add a half teaspoon of salt. When the salt has dissolved, add the slices of lemon to the pan, layering them down flat in the pan.', 'Let water boil away until it is almost all gone and there is just a thin syrup left in the pan. Do not stir while cooking. Remove from heat.', '2 Heat a large cast iron pan on medium high heat. While the pan is heating, arrange the sandwiches (next step).', '3 Arrange the sandwiches, layering the smoked salmon, cheese, chives, and cooked lemon slices: Lay out 4 slices of bread. On top of them layer slices of smoked salmon, cheese, and chives. Use a fork to lift the lemon slices out of the pan and add one large lemon slice to each sandwich. Top with a second layer of bread.', '4 Butter top of bread slices, put sandwiches in the pan, buttered side down: Butter the top bread slices generously with butter. Once the pan is hot, place the sandwiches in the pan, butter side down. Lower the heat to medium.', 'Let cook for a few minutes until the bottom of the sandwiches are well toasted.', '5 Butter the top of the sandwiches in the pan, flip sandwiches over: Butter the top side of the sandwiches in the pan. Use a metal spatula to flip the sandwiches over. Press down on the sandwiches with the metal spatula.', ""Let cook until the bottom of the sandwiches is nicely browned. If the cheese isn't melting, turn the heat to low, cover the pan and let cook for a few minutes more.""]",8
1189,Grilled Cheese Sandwich with Sauerkraut on Rye Recipe,5,10,15,"['2 slices dark rye bread', 'Several thin slices of aged, Gruyere Swiss cheese', '1/3 cup drained and heated sauerkraut', '2 teaspoons of butter']",4,"['1 Butter slices of bread on one side, place butter side down on hot frying pan: Heat a frying pan to medium high heat. For each slice of bread, butter one side and place slice butter side down on the hot pan.', '2 Add cheese, sauerkraut, top with cheese-less bread slice: Add a layer of cheese to one of the slices. As the bread begins to toast just slightly, and the cheese begins to soften, spread the heated sauerkraut over the slice of bread with cheese. Using a spatula, flip the cheese-less bread slice over on top of the slice with cheese and sauerkraut.', ""3 Flip the sandwich in the pan: After 30 sec or so, check to see if the cheese is just beginning to melt. If it is, flip the whole sandwich over onto the other side. Toast a minute more or less on that side until the cheese has melted, but isn't runny. Remove the sandwich from the pan. Slice in half.""]",3
1190,Greek Chicken Skewers with Yogurt Sauce (Chicken Souvlaki) Recipe,20,160,180,"['For the chicken:', 'Finely grated zest of 1 lemon', '1/4 cup lemon juice (from 2 lemons)', '1/2 teaspoon dried oregano', '1 clove garlic, finely chopped', 'Salt and pepper, to taste', '1 teaspoon Maras pepper (or substitute 1/2 teaspoon paprika plus 1/8 teaspoon cayenne pepper)', '1/3 cup olive oil', '1 pound boneless, skinless breasts, cut into 3/4-inch cubes', 'For the yogurt sauce:', '1 cup plain yogurt, any variety', '2 tablespoons tahini', '3 to 4 teaspoons lemon juice (from half a lemon)', 'Salt and pepper, to taste', 'To serve:', '4 (6-inch) pita breads (leave whole; do not split)', '12 cherry tomatoes, halved', '1 Persian cucumber, thinly sliced', '1/4 small red onion, thinly sliced', '1 cup packed arugula', 'Leaves from 3 to 4 sprigs of mint', 'Special equipment:', 'Bamboo or metal skewers (if cooking on a grill)', 'Cast-iron grill pan (if cooking indoors)']",24,"['1 Make the chicken marinade: In a medium bowl whisk, combine the lemon zest, lemon juice, oregano, garlic, Maras pepper (or cayenne and paprika), salt, and pepper. Gradually whisk in the olive oil.', '2 Marinate the chicken: Scoop out and set aside 1/4 cup of the marinade to use when serving. Add the chicken pieces to the bowl with the remaining marinade. Cover and refrigerate for 30 minutes, or for up to 2 hours. (Longer is better if you have time!)', '3 Make the yogurt sauce: In a small bowl, whisk the tahini and yogurt together until smooth. Stir in 3 teaspoons of lemon juice, salt and pepper. Taste and add more lemon juice, salt, or pepper as needed.', '4 If cooking on an outdoor grill, soak 6 bamboo skewers in warm water (or use metal skewers).', '5 Cook the chicken:', 'To cook the chicken on a grill: Light a charcoal grill or turn a gas grill to medium-high. Oil the grates before grilling. Thread the chicken pieces on metal or soaked bamboo skewers while the grill is heating.', 'Grill, turning occasionally, for 3 to 4 minutes, or until seared on the outside and cooked through to an internal temperature of 165F. Transfer the cooked chicken to a platter and set aside. ', 'To cook the chicken on the stovetop: Set a cast iron grill pan over medium-high heat and heat until hot. A flick of water should sizzle instantly on contact. Turn on a vent fan or open a window; the chicken will be smoky.', 'Add a teaspoon of oil to the grill pan and swirl to coat. Working in batches if necessary, lay the chicken pieces on the hot grill pan and cook, turning often with tongs, for 4 to 6 minutes, or until seared on the outside and cooked through to an internal temperature of 165F. Transfer the cooked chicken to a platter and set aside.', '6 Warm the pita bread: On the hot grill pan or on the outdoor grill, warm the pita bread for a minute or two, turning once, until slightly puffed and warm to the touch.', '7 Assemble the souvlaki sandwiches: Spread each pita with 2 tablespoons or more of the yogurt sauce, to taste. Top each with a quarter of the chicken pieces, tomatoes, cucumber, onion, arugula, and mint. Drizzle with a few spoonfuls the reserved marinade and serve.']",11
1191,Crab Salad Panini Recipe,10,12,22,"['1/4 cup chopped fresh parsley', '1/4 cup chopped green onion', '1/4 cup mayonnaise', '4 teaspoons lemon zest', '1 teaspoon lemon juice', '1 teaspoon Worcestershire sauce', '1/2 teaspoon freshly ground black pepper', '1/4 to 1/2 teaspoon Tabasco sauce', '14 to 16 oz fresh lump crab meat', '8 slices sourdough bread', '4 Tbsp butter, room temperature']",11,"['1 Place parsley, green onion, mayonnaise, lemon zest, lemon juice, Worcestershire sauce, black pepper, and Tabasco sauce in a large bowl.  Stir to combine. Gently fold in the crabmeat, taking care not to break up the clumps of crabmeat.', '2 Heat your panini grill. Spread some butter on two slices of bread to flavor the outside of the sandwich. Turn over one slice of bread and top it a quarter of the crab mixture. Close the sandwich with the other slice of bread, buttered side up.', '3 Grill two panini at a time, with the lid closed, until the the bread is toasted, 4 to 5 minutes.']",3
1192,Green Goddess Veggie Burgers Recipe,20,75,95,"['For the veggie burgers:', '2 (15-ounce) cans chickpeas, drained and rinsed', '1 medium carrot, grated, about 1 cup loosely packed', '1 clove garlic', '2 teaspoons ground cumin', '2 teaspoons paprika', '1/2 teaspoon salt', '1 large egg', '1/4 cup breadcrumbs', 'For the Green Goddess Sauce:', '3/4 cup mayonnaise', '3/4 cup sour cream', '1 ripe avocado', '1/2 cup fresh parsley', '1/4 cup tarragon', '3 tablespoons minced chives', '2 tablespoons lemon juice', 'Salt and pepper', 'To serve:', '6 burger buns', 'Green lettuce', 'Sliced red onion', '6 slices Monterey Jack (or any good melting) cheese (optional)']",23,"['1 Make and chill the patty mixture: In a food processor, add the chickpeas, grated carrot, garlic, and spices. Pulse the mixture a few times until combined into a rough paste. Add the egg and breadcrumbs, and pulse a few more times until mixture is evenly mixed.', 'Transfer the mixture to a bowl, cover, and chill for at least an hour or up to 24 hours. Chilling helps the mixture hold together a little better when forming the patties and when grilling.', 'Patties can also be shaped and grilled immediately, but will be fairly delicate. We recommend using a grill pan to grill the patties.', ""2 Shape the patties: Divide burger mixture into six even patties, and transfer to a plate or sheet pan to make it easy to carry to the grill. If you're not grilling right away, loosely cover the patties and store in the refrigerator until you're ready to grill."", '3 Make the Green Goddess Sauce: Combine all ingredients for the sauce in a food processor with the blade attachment. Process until the sauce is smooth, has a uniform color, and an even consistency. It should be thick enough to hold its shape on a spoon. Taste the sauce and season to your liking with salt and pepper.', 'This sauce can also be made a few days ahead and kept refrigerated.', '4 Prep all other burger ingredients: Make sure your burger buns, lettuce, sliced onion, and cheese are all prepped and arranged near the grill.', '5 Preheat the grill: Preheat a gas or charcoal grill to direct medium-high heat. Prep all other burger ingredients (lettuce, red onion, cheese).', '6 Grill the burgers: When you\\xe2\\x80\\x99re ready to cook burgers, lightly oil the grill grates or a grill pan with canola oil.', 'Grill burgers for 4 to 5 minutes per side, or until a crust forms on the outside. If you\\xe2\\x80\\x99re using cheese, add sliced cheese in the last minute of grilling.', '7 Serve: Serve the burgers immediately with fresh lettuce, red onion, and slathered with the Green Goddess sauce.', 'Cooked burgers will keep well in the fridge for 4 to 5 days and uncooked burgers should be cooked within a day or two or frozen for later and then thawed before grilling.']",12
1193,Pesto White Bean Veggie Burgers Recipe,20,70,90,"['For the pesto:', '5 tablespoons extra virgin olive oil', '1 cup loosely packed fresh basil leaves', '1 clove garlic', '1/4 cup grated Parmesan cheese', '1/4 teaspoon Kosher salt', 'A few grinds of fresh-cracked black pepper', '1/4 cup full-fat Greek yogurt', 'For the veggie burgers:', '2 tablespoons olive oil, divided, plus more to shape burgers if needed', '1 small yellow onion, minced (about 1 cup)', '1 garlic clove', '1 (15-ounce) can cannellini or navy beans, drained and rinsed', '3/4 cup (85 g) bread crumbs', '1 large egg', '1 teaspoon balsamic vinegar', '1/4 teaspoon kosher salt', '1/4 teaspoon freshly ground black pepper', '3/4 cup cooked brown rice', '1/4 cup fresh parsley leaves, coarsely chopped', 'To serve:', '4 hamburger buns', '1 large tomato, sliced', 'Small handful lettuce leaves']",24,"['1 Make the pesto: In the bowl of a food processor, add the olive oil, basil, garlic, Parmesan cheese, salt and pepper, and process until smooth. Scoop the pesto out into a small bowl, leaving about 2 tablespoons behind in the bowl of the food processor (you\\xe2\\x80\\x99ll come back to this in a moment).', 'Add the Greek yogurt to the small bowl of pesto (the sauce you\\xe2\\x80\\x99ve removed from the food processor) and stir to combine. Set aside.', '2 Cook the onion and garlic: In a medium saut\\xc3\\xa9 pan, warm 1 tablespoon olive oil over medium heat until shimmering. Add the onion and cook until translucent, 4 to 5 minutes. Add the garlic and cook an additional 1 minute.', '3 Blend the burger mixture: Returning to your food processor with the reserved pesto, add the white beans, cooked onion mixture, bread crumbs, egg, balsamic vinegar, salt, and pepper into the bowl.', 'Pulse until just combined\\xe2\\x80\\x94you want it to remain slightly chunky, not completely pureed, otherwise it won\\xe2\\x80\\x99t hold together as well.', '4 Fold in the rice and parsley: Turn the bean mixture out into a large mixing bowl. Fold in the rice and parsley.', '5 Chill the bean mixture: Cover bean mixture with plastic wrap and refrigerate for at least 1 hour or up to 2 days.', '6 Shape the burgers: When you\\xe2\\x80\\x99re ready to cook the burgers, divide the mixture into 4 equal portions. Shape each into patties about 1-inch thick. If the mixture starts sticking to your hands, coat your palms with a little extra olive oil.', ""7 Cook the burgers: Heat the remaining 1 tablespoon oil in a large skillet or grill pan over medium heat. Set patties into the skillet; don't crowd the skillet\\xe2\\x80\\x94cook in batches if needed. Cook about 5 minutes per side, or until golden brown on both sides. Add a little more oil to the pan if the burgers begin to stick."", '8. Serve! Serve the burgers on buns, topped with lettuce, tomato, and creamy pesto sauce.']",10
1194,Black Bean Burgers with Spicy Mayonnaise Recipe,20,70,90,"['For the spicy mayonnaise:', '1/2 cup mayonnaise', '3/4 teaspoon ancho chile powder', '2 teaspoons lime juice', 'For the burgers:', '1 clove garlic, thinly sliced', '1 poblano pepper, seeded and cut into 1-inch chunks', '1/2 medium onion, cut into 1-inch chunks', '1 medium zucchini (about 9 ounces), cut into 1-inch chunks', '4 tablespoons olive oil, divided', '1 slice whole wheat bread, or 1/2 burger roll, torn into pieces', '2 (15-ounce) cans black beans, rinsed, drained and patted dry with paper towels', '1 large egg, well beaten', '1/2 teaspoon salt', '1/8 teaspoon black pepper', '4 to 6 ounces shredded Monterey jack or pepper jack cheese', 'For serving:', '4 to 6 hamburger rolls', '1 large red onion, sliced', '1 large tomato, sliced', '1 medium ripe avocado, sliced']",21,"['1 Make the spicy mayonnaise: In a bowl, stir together the mayonnaise, ancho chili powder and lime juice. Set aside, or refrigerate for up to a week.', '2 Chop the vegetables: In a food processor, finely chop the garlic. Add the pepper and onion and pulse until finely chopped. Add the zucchini and pulse again to chop it into small pieces.', '3 Cook the vegetables: In a large nonstick skillet over medium heat, heat 2 tablespoons of the oil. Add the chopped garlic, pepper, onion, and zucchini. Cook, stirring often, for 5 minutes, or until most of the liquid has evaporated. Transfer to a large bowl. Wipe out the skillet.', '4 Make the breadcrumbs: Without cleaning the food processor, add the torn bread pieces and pulse until they form soft breadcrumbs. Add to the bowl of vegetables.', '5 Chop the beans: In the food processor (again, don\\xe2\\x80\\x99t bother to wash it), pulse the beans until they are in small pieces, but not pasty. Transfer to the bowl with the vegetables and breadcrumbs.', '6 Mix and refrigerate the burger mix: Add the egg, salt, and pepper to the bowl. With a spatula, stir until well mixed. Refrigerate for an hour.', '7 Shape the patties: Shape the chilled mixture into 4 to 6 patties about 3 inches wide. At this point, the patties can be cooked immediately, or stacked between parchment and refrigerated for up to 2 days.', '7 Cook the burgers: In a large non-stick skillet over medium heat, heat the remaining 2 tablespoons of oil. Add the patties and cook for 5 minutes on a side, or until browned and hot all the way through. Top with the grated cheese, cover the pan, and cook for 2 to 3 minutes, or until the cheese melts.', '8 Assemble the burgers: Spread the spicy mayonnaise on the bottoms and tops of the buns. Add the burgers and top with sliced tomatoes, onions, avocados and lettuce. Serve extra mayonnaise on the side.']",9
1195,Tarragon Tuna Melt Recipe,10,8,18,"['1 thinly sliced green onion, including the greens', '3 Tbsp chopped fresh flat-leaf parsley', '2 Tbsp chopped fresh tarragon leaves or 2 teaspoons dried tarragon, crumbled', 'Zest of one lemon', '2 teaspoons lemon juice', '1 teaspoon Dijon mustard', '1/8 teaspoon freshly ground black pepper', '1/3 cup mayonnaise', '2 6-ounce cans of solid white tuna, well drained and flaked', '8 1/2-inch slices French or Italian loaf bread (or your favorite bread)', '1 thinly sliced tomato (8 slices)', '4 ounces grated sharp white cheddar cheese (about 1 cup)', '2 Tbsp softened butter']",13,"['1 Make the tuna mixture: Mix the green onion, parsley, tarragon, lemon juice, lemon zest, Dijon mustard, black pepper, and mayonnaise in a medium sized bowl. Add the drained tuna, mixing with a fork to break up the flakes.', '2 Prepare the tuna melts for the griddle: Lay out four slices of bread. Divide the tuna mixture evenly onto the slices. Top each bread slice with tomato slices and grated cheese. Spread one side of the remaining four bread slices with butter. Place bread slices, buttered side up, on top of the cheese.', '3 Cook tuna melts on the first side: Heat a large griddle, on medium heat (or couple cast iron skillets). Place the sandwiches, buttered side down, onto the hot griddle. Gently spread butter on top of the bread slices. Cook for about 3 minutes, or until nicely browned on one side.', '4 Flip and cook the other side: Use a metal spatula to lift up the sandwiches and carefully turn them to the other side. Cook for another 3 minutes or so, until the second side is browned.', '5 Serve immediately.']",5
1196,"Gruyere, Apple, and Fig Jam Panini Recipe",6,5,11,"['2 Tbsp butter, at room temperature to make it easy to spread', '4 slices rustic whole-grain bread, sliced from a dense bakery loaf', '2 Tbsp fig jam', '4 ounces Gruyere cheese, thinly sliced', '1/2 Granny Smith apple, cored and thinly sliced']",5,"['1 Heat the panini press to medium-high heat. (Or if not using a panini press, preheat a cast iron frying pan on medium high heat.)', '2 Assemble sandwiches: For each sandwich, spread butter on two slices of bread. Turn the slices over and spread a layer of fig jam on the other side of each slice.', 'To one slice add a layer of sliced cheese, several apple slices, and a layer of more cheese. Top the sandwich with the other slice of bread, buttered side up.', '3 Grill in panini press: Place up to two panini at a time in the preheated panini maker, and close the lid closed. Grill until the cheese is melted and the bread is toasted, about 4 to 5 minutes.', 'If making a grilled cheese sandwich instead of a panini, place in heated cast iron pan, cook until one side is browned, use a metal spatula, carefully flip the sandwich over and toast on the other side until the cheese is melted. You may need to lower the heat on the pan to allow enough time for the cheese to melt without burning the bread.']",5
1197,Turkey Grilled Cheese Sandwich with Pickled Onions Recipe,5,10,15,"['2 slices of rye bread', '2-3 Tbsp butter', '3-4 slices leftover turkey', '2-3 slices Monterey jack cheese', '2-3 pieces of arugula (optional)', 'A handful of sweet pickled onions or another sweet pickle']",6,"['1 Heat a frying pan, preferably a cast iron one, over medium-high heat for 1-2 minutes.', '2 Assemble the sandwich: While the pan is heating, assemble the sandwich, starting with a layer of bread, then cheese, then turkey, arugula, pickles, and another slice of bread.', '3 Butter and cook one side: Butter the side closest to the cheese and place the sandwich butter-side down on to the hot pan to cook.', ""4 Butter top side, flip sandwich, and cook other side: Once the bottom of the sandwich is browned, about 2-3 minutes, butter the top of the sandwich and carefully flip the sandwich over in the pan. Toast for another minute, then turn the heat to its lowest setting and cover the pan. Watch the cheese, and when it melts you're done. Eat immediately.""]",4
1198,Stovetop Double-Stack Cheeseburgers Recipe,10,15,25,"['For the easy burger sauce:', '1/2 cup mayonnaise', '2 tablespoons ketchup', '1 tablespoon pickle relish', 'For the burgers:', '20 to 24 ounces ground beef (90/10)', '1 teaspoon salt', '1 teaspoon black pepper', '1/4 teaspoon garlic powder (optional)', '2 teaspoons olive oil', '4 to 8 slices American cheese', '4 hamburger buns', 'Fresh lettuce', 'Tomato slices', 'Red onion slices', 'Special equipment:', 'Cast iron skillet']",17,"['1 Make the burger sauce: Stir together the burger sauce ingredients, and adjust the flavors to your liking. Some people like more ketchup or more relish.', '2 Make the burger patties: Measure out ground beef into eight 3-ounce patties (for double cheeseburgers) or four 5- to 6-ounce patties (for single burgers). Some people even prefer a single, thin 4-ounce patty.', 'Be gentle with the ground beef. Keep it in loose balls for now. Season the outside of the balls with salt and pepper.', '3 Add the patties to the pan and press: Preheat a skillet over medium-high heat. Add a drizzle of olive oil. Add the beef balls one at a time, pressing each one by covering it with foil and pressing down to flatten with a second small pan or skillet. Try to get the patty as even as possible. For double burgers, you are looking for a very thin patty. For single burgers, shoot for about 1/3-inch thick patty.', 'Repeat with pressing each of the patties in the pan, reusing the same piece of foil.', '4 Cook the patties: Cook patties for 2 minutes for the thinner double patties, or 3 to 4 minutes for the thicker single patties. Flip, top with cheese, and cook until the cheese is melted, another 2 to 3 minutes.', 'The patties will shrink a bit as they cook. It\\xe2\\x80\\x99s okay to press on them a bit with your spatula to reshape them slightly, but try to keep a light touch, or you will push out all the juices.', '4 Assemble the burgers: When your burger patties are cooked through and the cheese is very melted, smear the bottom bun with 1 to 2 tablespoons of burger sauce and top with lettuce. Add your burger patty (or patties) and top with sliced tomato and red onion.', 'Serve immediately!']",9
1199,Cauliflower Steak Sandwiches with Red Pepper Aioli Recipe,15,35,50,"['For the aioli:', '1 clove garlic, thinly sliced', '2 tablespoons lemon juice', 'Pinch of salt', '3/4 cup roasted red peppers from a jar, drained and diced', '1/2 cup mayonnaise (any kind)', '1/4 teaspoon Maras, Aleppo, or other red pepper flakes', 'For the sandwiches:', '2 medium or 1 very large head of cauliflower', '3 to 4 tablespoons olive oil', '1/2 teaspoon salt', '1/8 teaspoon ground black pepper', '1 teaspoon smoked paprika', '8 slices sourdough bread', '2 large tomatoes, thickly sliced', '2 handfuls arugula, or other greens of your choice, such as crisp lettuce']",16,"['1 Preheat the oven to 450\\xc2\\xbaF. Spray or brush a rimmed baking sheet with olive oil.', '2 Make the aioli: In a food processor, combine the garlic, lemon juice, and a pinch of salt. Let the garlic soak for about 5 minutes to soften the garlic\\xe2\\x80\\x99s raw harshness. Add the roasted peppers and puree until smooth. Add the mayonnaise and red pepper flakes and pulse to mix. The consistency of the aioli should be slightly thinner than mayonnaise. Taste and add more red pepper flakes, if you like.', '3 Slice the cauliflower steaks: Leaving the core intact, trim a sliver from the bottom of the stem end of the cauliflower and remove the leaves. Stand the cauliflower upright on its base. With a large knife, cut it into 1/2-inch thick steaks. You should get at least 4 slices that hold together.', 'You will have some \\xe2\\x80\\x9cscraps\\xe2\\x80\\x9d\\xe2\\x80\\x94slices of cauliflower that are not attached to the base. If they are flat, you can roast them with the steaks and use them to build your sandwich. Don\\xe2\\x80\\x99t throw other scraps away! Either roast them on a separate baking sheet when you roast the steaks, or save them for cauliflower rice.', '4 Roast the cauliflower: Brush both sides of the steaks and the flat scraps with oil. Sprinkle both sides generously with salt and pepper. Set them on the baking sheet, and sprinkle lightly with the paprika.', 'Cover the cauliflower with foil and roast for 10 minutes. (This allows the cauliflower to steam briefly and soften in the center.) Remove the pan from the oven and remove the foil. Return it to the oven and roast for 10 minutes longer, or until the cauliflower begins to brown.', 'Carefully turn the steaks over, sprinkle with more paprika, and bake for an additional 8 to 10 minutes, or until golden and tender when you insert the tip of a knife into the steak. Remove from the oven and set aside. Total roasting time is about 30 minutes.', '5 Toast the bread: Set your oven to broil. On a baking sheet, spread the bread slices. Brush them on both sides with oil. Broil for 1 to 2 minutes on each side, or until toasted on the outside but still slightly soft in the middle. Watch carefully to keep them from burning!', '6 Assemble the sandwiches: Spread the aioli on each slice of bread. On each of 4 slices, set the cauliflower on top. Top each with tomato slices and arugula. Cover each with a second slice of bread. Cut the sandwiches in half and serve.']",9
1200,Dr Pepper Barbecue Sauce Recipe,5,95,100,"['1 cup minced onion', '1/4 cup vegetable oil', '1 1/2 cups Dr Pepper', '1 can of crushed tomatoes, about 15 ounces', '1/2 cup orange juice', '1/4 cup cider vinegar', '1/2 cup honey', '1/2 to 1 teaspoon cayenne', 'Salt to taste']",9,"['1 Heat the vegetable oil in a pot over medium-high heat. Add the onions and saut\\xc3\\xa9 for 4-5 minutes, stirring often.', '2 When the onions are just beginning to brown, add the remaining ingredients and stir well to combine. Simmer for 30 minutes.', '3 Pour the sauce into a blender or food processor and pur\\xc3\\xa9e it until it is smooth. (Note that if you are using a blender, either work in batches, filling the blender no more than a third of the way at a time with the hot sauce, or slowly add the sauce while the blender is running on low speed.)', '4 Put the sauce into a saucepan, bring to a simmer and continue to simmer, uncovered, for 1-2 hours.', 'The sauce will store for several weeks in the fridge.']",5
1201,Vanilla Roasted Strawberries Recipe,5,0,5,"['1 pound strawberries, rinsed', '3 tablespoons granulated sugar', '1 vanilla bean, optional']",3,"['1 Preheat the oven: Position a rack in the center of the oven. Preheat the oven to 425\\xc2\\xb0 F.', '2 Prep the berries: Hull the strawberries (use a huller if you have one, or a paring knife if you don\\xe2\\x80\\x99t). To remove the stem and leaves from the berry using a paring knife, insert the tip of your paring knife as close to the stem as possible, and cut a narrow, shallow cone around it. Discard the stem.', 'If the strawberries are large, halve or quarter them. You can leave smaller berries whole.', '3 Combine strawberries with other ingredients: Put the strawberries in a 9x9-inch shallow, non-reactive baking dish (ceramic, enameled, or Pyrex are good choices). Add the sugar. Cut the vanilla bean in half vertically with a sharp knife and scrape out the seeds; add the seeds and the scraped-out vanilla bean to the berries. Toss to combine.', '4 Roast the berries Place the dish, uncovered, in the oven and bake for 30, stirring after 15 minutes, if you remember. The berries will collapse and lots of juice will rapidly bubble all around them.', '5 Cool: Cool to room temperature; everything will thicken and become jammy as it cools.', '6 Store: Store, covered, in the refrigerator for up to a week. Leave the vanilla bean in there so the flavors both deepen and mellow as it all sits. Serve over cakes, ice cream, yogurt, or spoon into oatmeal.']",7
1202,How to Make Butterscotch Sauce,5,0,5,"['4 tablespoons unsalted butter', '1 cup of tightly packed dark brown sugar', '\\xc2\\xbe cup heavy whipping cream (not ultra-pasteurized)', '1 tablespoon vanilla extract', '1 teaspoon kosher salt']",5,"['Butterscotch sauce takes about a half an hour to make, from start to finish.', '1 Have everything ready to go: First, before you begin, make sure you have everything ready to go - the cream and the brown sugar next to the pan, measured and waiting. Making butterscotch is a fast process that cannot wait for hunting around for ingredients.', '2 Melt butter, add brown sugar: In a heavy bottomed stainless steel 2 quart saucepan, melt butter over low to medium heat. Just before butter is melted, add all dark brown sugar at once and stir with wooden spoon until sugar is uniformly wet.', '3 Stir infrequently: Stir infrequently until mixture goes from looking grainy to molten lava. Make sure to get into the corners of your pot, and watch closely to notice how the mixture changes. It will take about 3 to 5 minutes.', '4 Note the texture: Right before you add the cream, the caramelizing brown sugar will begin to look and feel more like liquid and less like thick wet sand.', '5 Add the cream, let boil: At this point add all the cream at once and replace your spoon with a whisk. Lower heat a little and whisk cream into mixture.', 'When liquid is uniform, turn heat back to medium and whisk every few minutes for a total of 10 minutes or until it registers 225\\xc2\\xb0F on a digital or candy thermometer.', '6 Let rest, then transfer to storage vehicle to cool: After liquid has been boiling on the stove for its 10 minutes, turn heat off and let rest for a minute or two before transferring into a heatproof storage vessel. (I prefer a stainless steel or glass bowl.) Cool to room temperature.', ""7 Taste, add salt and vanilla extract to taste: When butterscotch liquid is room temperature, take a small taste. It's important to know what cooked brown sugar and butter tastes like, and what happens when transforming that flat sweetness into real butterscotch flavor."", 'Whisk in half the salt and vanilla extract. Taste again. Add more salt and vanilla extract until the marvelous taste of real butterscotch is achieved.', 'Butterscotch makes a fantastic topping for ice cream.', 'Chill butterscotch sauce in a non-reactive container with a tightly fitting lid only after sauce has chilled completely. It will keep for one month refrigerated, that is if you can keep from eating it all the moment it has cooled down and been seasoned to your liking.']",12
1203,Basic Tomato Sauce Recipe,5,35,40,"['2 tablespoons extra virgin olive oil', '1/2 medium onion, finely chopped', '1 small carrot or 1/2 large carrot, finely chopped', '1 small stalk of celery, including the green tops, finely chopped', '2 tablespoons chopped fresh parsley', '1 clove garlic, minced', '1/2 teaspoon dried basil or 2 Tbsp chopped fresh basil', '1 28 oz. can whole tomatoes, including the juice, or 1 3/4 pound of fresh tomatoes, peeled, seeded, and chopped', '1 teaspoon tomato paste', 'Salt and freshly ground black pepper to taste']",10,"['1 Gently cook the onion, carrot, celery, and parsley: Heat olive oil in a large wide skillet on medium heat. Add the chopped onion, carrot, celery and parsley. Stir to coat.', 'Reduce the heat to low, cover the skillet and cook for 15 to 20 minutes, stirring occasionally until the vegetables are softened and cooked through.', '2 Add garlic: Remove cover and add the minced garlic. Increase the heat to medium high. Cook for garlic for 30 seconds.', '3 Add tomatoes, tomato paste, basil, salt, pepper, then simmer: Add the tomatoes, including the juice and shredding them with your fingers if you are using canned whole tomatoes. Add the tomato paste and the basil. Season with salt and pepper to taste.', 'Bring to a low simmer, reduce the heat to low and cook, uncovered until thickened, about 15 minutes.', 'Optional, pur\\xc3\\xa9e for smooth sauce: If you want you can push the sauce through a food mill, or pur\\xc3\\xa9e it in a blender or with an immersion blender, to give it a smooth consistency.']",6
1204,Spanish Romesco Sauce Recipe,5,20,25,"['1/4 cup extra virgin olive oil', '1 1-inch thick slice of crusty bread, torn into pieces', '1/2 cup blanched almonds, chopped or slivered (can substitute hazelnuts, peeled)', '5-6 garlic cloves, chopped', '1 teaspoon salt', '1 15-ounce can of crushed tomatoes, or canned whole tomatoes (including the juice) that have been de-seeded, or 1 pound fresh tomatoes that have been par-boiled, skins removed, and de-seeded', '1 8-ounce jar of roasted red bell peppers, drained', '1 tablespoon smoked paprika (preferred) or sweet paprika', '2-3 tablespoons sherry vinegar or red wine vinegar']",9,"['1 Saut\\xc3\\xa9 torn bread and almonds: Preheat the oven to 350\\xc2\\xb0F. Heat the olive oil in a medium saut\\xc3\\xa9 pan over medium-high heat. When the oil is hot, saut\\xc3\\xa9 the bread and almonds, stirring often, until they just begin to brown.', 'Add the garlic and saut\\xc3\\xa9 another 1-2 minutes, stirring once or twice.', '2 Process with remaining ingredients: Place the contents of the saut\\xc3\\xa9 pan into a food processor with the remaining ingredients\\xe2\\x80\\x94salt, tomatoes, roasted bell peppers, smoked paprika, vinegar. Pur\\xc3\\xa9e until smooth.', '3 Bake: Spread the sauce out on a rimmed sheet pan and bake in a 350\\xc2\\xb0F oven for 10-15 minutes, or until the edges begin to caramelize.', 'Allow to cool and scrape into a container to store.', 'To use romesco sauce, mix with pasta, shrimp, chicken or vegetables either before or after they are cooked, much like you would a pesto.', 'Kept in a sealed container, Romesco sauce will last for a week or more in the fridge. It freezes well, too.']",7
1205,Orange Butter Sauce (Beurre Blanc) for Seafood Recipe,5,20,25,"['2 oranges', '1/2 cup (120 ml) white wine', '2 teaspoons minced shallots', '1/2 pound (2 sticks, 225 g) cold, unsalted butter', 'Salt and white pepper']",5,"['1 Make a syrup with orange zest, orange juice, wine, and shallots:  Zest half of one orange (about 2 teaspoons) and juice the two oranges (about 3/4 cup).', 'Put the juice, zest, wine and shallots in a sauce pan on medium high heat.', 'Cook until it is syrupy and almost gone.', '2 Slowly whisk in butter: On low heat, whisk in the butter continuously and vigorously, 1 tablespoon at a time.', 'Butter is the only emulsifier for this sauce, and if you slowly add it, continuously stirring, the sauce will achieve a silky smooth texture. Do not let the sauce boil!', '3 Add salt and pepper to taste.']",6
1206,Spicy Cranberry Sauce with Pinot Noir Recipe,5,25,30,"['1 tablespoon vegetable oil', '2 cups fresh or frozen cranberries (about 8 ounces)', '1 tablespoon minced fresh ginger', '2 cups Pinot Noir or other dry red wine', '1 cup sugar', '3 tablespoons chopped crystallized ginger', '1/2 teaspoon curry powder', 'Large pinch of Chinese five-spice powder*']",8,"['In a dry skillet, roast peppercorns by shaking the pan over low to medium heat until the aroma of the peppercorns is released (about three minutes). Grind the roasted peppercorns and 4 star anise in a blender or pepper mill. Mix in ground cloves, ground cinnamon, and ground fennel seeds. Grind the seasonings until very fine. Store in an airtight container.']",1
1207,South Carolina Mustard BBQ Sauce Recipe,5,35,40,"['4 Tbsp. butter', '1/2 onion, grated', '1/2 cup yellow mustard (the kind you get at the ballpark)', '1/2 cup brown sugar', '1/2 cup cider vinegar', '1 Tbsp dry mustard (like Coleman\\xe2\\x80\\x99s)', '1 teaspoon cayenne', '1 bay leaf', 'Salt to taste']",9,"[""1 Heat the butter over medium heat until it's frothy, then add the onion and saut\\xc3\\xa9 for 3-4 minutes. Do not let the onions brown."", '2 Add everything else, stir well and simmer slowly for 30 minutes or more.']",2
1208,Asparagus Pesto with Pasta Recipe,10,30,40,"['1 bunch asparagus spears (about 1 lb), trimmed of tough ends and halved crosswise', '3 handfuls baby spinach leaves', '2 cloves garlic, peeled', '1 cup freshly grated Parmesan cheese, plus more for topping', '1 cup pine nuts', '1/4 cup extra-virgin olive oil, plus more for topping', 'Juice of 1/2 lemon', '1/2 teaspoon fine-grain sea salt', '8 ounces of dried pasta or 12 ounces fresh -linguini, fettuccine, spaghetti', 'Mix spinach pasta with regular wheat pasta for a medley of colors.']",10,"['1 Bring 2 pots of water to a rolling boil, one large for the pasta and one medium sized for the asparagus.', '2 Toast pine nuts: While the water is heating, put the pine nuts in a single layer in a large skillet. Heat on medium heat, stirring occasionally, until fragrant and lightly browned.', 'Remove pine nuts from pan and set aside. You will use 3/4 cup of the pine nuts for the pesto paste and 1/4 cup to mix in whole.', '3 Blanch asparagus: Salt the asparagus water and drop the spears into the pan. Cook for only 2 or 3 minutes, until the spears are bright green and barely tender.', 'Drain under cool water to stop the cooking. Cut the tips off, and set aside, several of the asparagus (diagonal cut about an inch from the end) to use for garnish.', '4 Make asparagus pesto: Add the asparagus, spinach, garlic, Parmesan, and 3/4 cup of the pine nuts to a food processor.', 'Pur\\xc3\\xa9e and, with the motor running, drizzle in the 1/4 cup of olive oil until a paste forms. If too thick, thin it with a bit of the pasta water.', 'Add the lemon juice and salt, taste and adjust seasoning.', ""Here's a trick that Heidi taught me. When emptying the food processor bowl of its contents, hold the bottom of the bowl with one hand with a finger in the center hole, holding the blade in place and keeping it from falling out."", ""5 Make pasta, toss with pesto: Salt the pasta water well and cook the pasta until just tender. Check the directions on the pasta package. You'll need more time for dried pasta and less for fresh."", '', 'This fresh pasta cooked up in no time at all.', 'Drain and toss immediately with 1 cup of the asparagus pesto.', 'Serve sprinkled with the remaining 1/4 cup toasted pine nuts, a dusting of Parmesan, and a light drizzle of olive oil.']",14
1209,Mushroom Sugo Recipe,30,180,210,"['1 ounce dried porcini mushrooms', '4 Tbsp extra-virgin olive oil', '2 medium yellow onions, peeled and minced (yielding about 2 cups minced onion)', '2 carrots, peeled and minced (yielding about 1 1/2 cups minced carrots)', '3 celery ribs, minced (yielding about 1 1/2 cups minced celery)', '6-8 cloves garlic, peeled and minced', '1 bunch parsely, minced (yielding 1/3 cup loosely packed)', '1/2 teaspoon minced fresh rosemary', '1/4 teaspoon fresh thyme', ""1/4 teaspoon fresh marjoram (we didn't have marjoram growing so we used fresh oregano instead, which has a similar flavor)"", '1/2 cup dry red wine', '1 15-ounce can of tomato sauce', '1 beef bouillon cube (use vegetable bouillon cube for vegetarian option)', '1 bay leaf', 'Freshly ground black pepper']",15,"['1 Soak dry mushrooms in water: Place dry mushrooms to soak in a bowl with 2 cups of warm water. Set aside.', '2 Slowly cook minced onions until deep golden: Heat olive oil in a medium, thick-bottomed pot (4 or 5 quart) over medium heat. Add the minced onions and stir to coat with the olive oil.', 'Cook, stirring occasionally, until the onions turn a deep golden color, about 30 to 40 minutes. Adjust the heat lower if necessary to keep the onions from drying out.', '', '3 Add carrots, celery, garlic, herbs in stages: Add the minced carrots and cook for 5-6 more minutes. Add the celery and cook until soft, about 10 more minutes. Add the garlic, parsley, rosemary, thyme and marjoram. Cook for 4-5 minutes more.', '4 Remove the porcini from the soaking liquid, reserving the liquid. The easiest way to do this we found is to pour the porcini and soaking liquid through a coffee filter, into a bowl or measuring cup. This helps remove any grit that may be lingering in the soaking liquid.', 'Finely chop the mushrooms and add to the vegetables in the pot.', '5 Add wine: Push the vegetables to one side of the pot and increase the heat to high. Add the 1/2 cup of red wine to the side of the pot without the vegetables and cook on high heat for 2-3 minutes.', '', '6 Add remaining ingredients and simmer: Add the tomato sauce, 1 1/2 cups of the mushroom soaking liquid, the bouillon cube (break it up with your fingers as you add it), and the bay leaf to the pot.', 'Bring to a simmer and reduce the heat to low. Add ground black pepper to taste. Cover the pot and simmer, stirring occasionally, for 1 1/2 hours. Discard the bay leaf.', 'Serve over polenta or toss with ravioli or other pasta.']",12
1210,Vegan Date Caramel Dip Recipe,0,0,0,"['12 ounces Medjool or Halawy dates \\xe2\\x80\\x93 as plump and fresh as you can find', '1 1/2 cups of hot water, just below boiling', '1 tablespoon vanilla extract', '1/8 teaspoon salt', '2 tablespoons coconut cream (optional)', '1 teaspoon lemon juice (optional)', 'Special equipment:', 'Food processor or blender']",8,"['1 Soak the dates in hot water for 5 to 10 minutes: When ready their skin should easily to peel off with your fingers. Strain the dates from the soaking liquid, reserving the liquid.', '2 Peel the dates and remove the seeds: Peel the skins off all the dates with your fingers. Split them open (you should be able to just pinch them open; otherwise use a paring knife). Remove the pit.', '3 Puree the dates until creamy: Put the dates into the bowl of a food processor or blender. Add the vanilla, 2 tablespoons of the reserved soaking water, and salt. Process until very smooth, 5 to 10 minutes. Stop and scrape down the sides of the bowl every couple of minutes. If the sauce seems too thick, add a little water until you reach a smooth, spoonable consistency.', '4 For a creamier sauce, add coconut cream: Add the coconut cream at the very end and pulse 10 times to incorporate.', '5 Taste and adjust as needed: Taste the sauce. Add lemon juice or more salt if needed.']",5
1211,Sun-Dried Tomato Pesto Recipe,5,8,13,"['1/2 cup walnuts (or other nut)', '1 cup (8 ounces) sun-dried tomatoes packed in oil', '3 garlic cloves, sliced', '3/4 cup grated Parmesan cheese', '1/2 teaspoon kosher salt', '1/4 teaspoon pepper', '1/4 teaspoon chili flakes (optional)', '1 to 2 roasted red pepper quarters, from a jar (about 1/4 cup, optional)', '1/2 cup good quality olive oil', 'Special equipment:', 'Food processor']",11,"['1 Toast the walnuts: Preheat the oven to 350\\xc2\\xb0F. Place the nuts on a sheet pan in a single layer. Toast for 6 to 8 minutes or until fragrant and lightly colored. Remove from the oven and allow to cool.', '2 Start processing the ingredients: Place the half of the sun-dried tomatoes along with all the walnuts, cheeses, garlic, salt, pepper, chili flakes and preserved roasted red pepper (if using) into a food processor or blender. Pulse a few times until chopped well.', '3 Add the rest of the tomatoes and the oil: Next, add the rest of the sun-dried tomatoes and the oil they\\xe2\\x80\\x99re packed in. (Splitting up the tomatoes will add some variance in texture.)', 'With the motor running, steam in the olive oil, pausing to scrape down the sides once or twice, until the pesto has a uniform, but not-quite-pureed, consistency. (You want to ensure there\\xe2\\x80\\x99s still a bit of chunkiness to get a nice, toothsome texture.)', 'Use right away or store in an airtight container in the fridge for up to 1 week or in the freezer for up to 3 months for when needed.']",5
1212,Bavarian Sauerkraut Recipe,5,0,5,"['1 16-oz can or jar of sauerkraut (best is fresh sauerkraut in jars, found in refrigerated section of grocery store)', '1 cup white wine', '1/2 cup chopped onion', '1/2 cup peeled and chopped apple', '10 juniper berries, cracked', 'Salt and pepper', '1 Tbsp extra virgin olive oil']",7,"['Place sauerkraut in a pot. Add wine, onion, apple, juniper berries, salt, pepper and oil. Bring to a simmer and let simmer for 30 to 45 minutes, until the onions are soft.']",1
1213,Franks and Sauerkraut Paprikash Recipe,10,40,50,"['1 1/2 pound frankfurters, hot dogs, or mild German or Polish sausage, cut into 2 1/2-inch segments', '2 Tbsp butter', '2 cups chopped onion', '1 clove garlic, minced', '2 teaspoons paprika', '1 teaspoon dried dill, or 1 Tbsp fresh chopped dill', '1 teaspoon caraway seed', '1 cup beef broth or chicken broth', '1 large (25 to 28 ounce) can sauerkraut, drained', '2 cups sour cream']",10,"['1 Heat a large thick-bottomed pan or Dutch oven on medium heat. Melt the butter, add the onion, garlic, and paprika, cook until the onion is soft, about 5 minutes.', '2 Add the franks, dill, caraway, and broth. Bring to a boil, reduce heat and simmer for 15 minutes.', '3 Add the sauerkraut, simmer, covered, 15 minutes longer.', ""4 Remove from heat, stir in the sour cream (do not let the mixture boil after you've added the sour cream)."", 'Serve plain, or with boiled or mashed potatoes.']",5
1214,Reuben Casserole Recipe,30,45,75,"['8 slices (9 ounces) seeded sliced rye bread', '8 ounces cream cheese, room temperature', '1 1/2 pounds sliced pastrami or corned beef (from the deli or homemade)', '8 ounces sliced Swiss cheese', '22 ounces (2 3/4 cups) sauerkraut, drained', '1 1/2 cups Thousand Island dressing', '2 teaspoons caraway seeds', '1/2 teaspoon kosher salt', 'Butter for the baking dish', 'Special equipment:', '9x13-inch baking pan', 'Food processor']",12,"['1 Prepare the pan and heat the oven: Butter a 9x13 baking dish and preheat the oven to 350\\xc2\\xb0F.', ""2 Cube and crumb the bread: Take 6 slices of the bread and cut them into 1-inch cubes. Ultimately, you need enough bread to cover the bottom of your baking dish. If you're bread isn't pre-sliced, you might need more to do this."", 'Take the remaining 2 slices of bread and pulse in a food processor until fine crumbs are formed.', '3 Chop the meat and the cheese: Chop the pastrami (or corned beef if you\\xe2\\x80\\x99re using) into bite sized pieces. I do this by stacking it and cutting the meat first in strips, then I cut across the strips to form rough squares. It doesn\\xe2\\x80\\x99t need to be perfect. It\\xe2\\x80\\x99s a casserole.', 'Stack the cheese slices one on top of the other, then cut it in strips, and then cut across the strips into squares.', '4 Make the filling: In a large bowl, add the cream cheese and smoosh it with a spoon or spatula to soften and break it up a bit. Add the meat, Swiss cheese, sauerkraut, thousand island dressing, caraway seeds, and salt. Stir to combine, making sure you fully incorporate the cream cheese.', '5 Layer the casserole: Place the cubed bread on the bottom of your 9x13 baking dish (slice and add more cubes if needed to make a full layer). Then spoon the filling over the top of the bread. Spread it out as evenly as possible. Sprinkle the breadcrumbs over the top.', '6 Bake the casserole: Place the casserole in the oven and bake for 40-45 minutes until the crumbs are toasted and the casserole is heated through.']",8
1215,Biscuits and Gravy Recipe,0,35,35,"['For the Buttermilk Biscuits:', '2 1/2 cups self-rising flour (plus extra for flouring your surface)', '2 tsp sugar (optional)', '1/2 tsp kosher salt', '4 Tbsp vegetable shortening (see Baking Tips below)', '4 Tbsp butter, cut into cubes, chilled', '1 cup chilled buttermilk, plus 1-2 Tbsp more, if needed', '1 Tbsp melted butter (optional, to brush on top of biscuits after baking)', 'For the Sausage Gravy:', '1 lb sage-flavored pork sausage', '1/4 cup finely chopped white or yellow onion', '6 tbsp all purpose flour', '4 cups whole milk', '1/2 tsp poultry seasoning', '1/4 tsp ground nutmeg', '1/4 tsp salt', '1-2 dashes of Worcestershire sauce', '1-2 dashes of Tabasco sauce, cayenne pepper, or other hot sauce', '1-2 Tbsp butter or bacon grease (if needed)']",19,"['TO MAKE THE BUTTERMILK BISCUITS:', 'Baking Tips: 1) Spoon the flour into your measuring cup, and level it off with the back side of a knife. If you scoop the flour, it will pack into the measuring cup, yielding too much flour, 2) Instead of 4 Tbsp each of butter and shortening, feel free to use 8 Tbsp of shortening or butter, or any combination up to 8 Tbsp.', '1 Preheat oven to 450\\xc2\\xb0F. Prepare a floured surface for shaping the dough and have an un-greased baking sheet ready (lined with Silpat sheets if you have them).', '2 Whisk together flour, sugar and salt in a medium-sized bowl.', '3 Using a fork or a pastry blender cut in the shortening and butter. Work quickly, you don\\xe2\\x80\\x99t want the fats to melt \\xe2\\x80\\x93 the key to fluffy biscuits is minimal handling. The mixture should be crumbly.', '4 Make a well in the flour mixture, and pour in the buttermilk. Stir with a spoon and blend just until the liquid is absorbed and the dough comes away from the sides of the bowl \\xe2\\x80\\x93 add 1-2 tbsp more buttermilk if the dough is dry. Do not over mix; the dough will be tacky, neither wet nor dry.', '5 Fold and shape dough: With lightly floured hands, turn out the dough onto a lightly-floured surface and gently fold it over on itself 2 or 3 times. Shape into a 3/4\\xe2\\x80\\x9d thick round. If you use a rolling pin, be sure to flour it first to keep the dough from sticking to the pin.', '6 Cut out biscuits: Using a 2-inch biscuit cutter, cut out the biscuits pressing straight down (avoid the temptation to twist the cutter as twisting keeps the biscuits from rising). Dip the cutter in flour between cuttings to keep the dough from sticking to the cutter.', 'Place biscuits on the baking sheet so that they just touch (for crunchy sides, leave space in between). Reshape scrap dough and continue cutting. Remember to handle the dough as little as possible.', '(At this point you can start on making the sausage gravy below, and put the biscuits in the oven right before adding the milk in the last gravy step.)', '7 Bake: Bake at 450\\xc2\\xb0F for 15-18 minutes or until lightly golden brown on top. Turn the baking sheet around halfway through baking.', '8 Brush with butter: (Optional) Brush the tops of the biscuits with melted butter.', 'TO MAKE THE SAUSAGE GRAVY:', '1 Brown the sausage, stir in onions: Preheat a 4-quart saucepan over medium high heat (put a few drops of water in the pan \\xe2\\x80\\x93 when they evaporate, you know the pan is ready). Crumble the sausage into the pan and let it brown for a minute or two, then turn down to medium heat.', 'Continue cooking, breaking up the sausage into smaller pieces, until no pink remains. Stir in the onions and cook until they are transparent.', '2 Adjust fat, add flour, brown the flour: Remove sausage with a slotted spatula or spoon, leaving the drippings in the pan. If less than 3 tbsp of drippings remain, add enough butter (or bacon grease) to equal about 3 tbsp of drippings.', 'Add the cooked sausage back to the pan on medium heat, and sprinkle the flour over the sausage.', 'Stir in the flour and cook for about 6-8 minutes, until the mixture starts bubbling and turns slightly golden brown.', '3 Add seasonings: Stir in poultry seasoning, nutmeg, Worcestershire sauce, Tabasco sauce and salt \\xe2\\x80\\x93 cook for 1 minute to deepen the flavors.', '4 Add the milk, and cook until thickened: Slowly add the milk and cook over medium heat, stirring occasionally, until thickened (about 15 minutes). Be patient, it will thicken!', 'TO SERVE THE BISCUITS AND GRAVY:', 'To serve, break a biscuit in half and put it in a bowl or on a plate. Spoon a generous portion of sausage gravy over the biscuit half and top with the other biscuit half.']",22
1216,Shrimp Gumbo with Andouille Sausage Recipe,15,90,105,"['1/2 cup peanut oil, or other vegetable oil', '1/2 cup all-purpose flour', '1 green bell pepper, chopped', '1 medium onion, chopped', '3 celery stalks, chopped', '4 garlic cloves, minced', '1 tablespoons Cajun seasoning', '1 quart shellfish or chicken stock, plus 1 cup water (see Recipe Note)', '2 teaspoons Worcestershire sauce', '8-12 ounces smoked andouille sausage, cut into 1/4-inch thick rounds', '2 pounds shrimp, peeled and deveined', 'Salt and pepper to taste', '3-5 green onions, white and green parts, chopped', 'Fil\\xc3\\xa9 powder (optional)', 'Hot sauce (such as Tabasco) to taste']",15,"['1 Make the roux. Heat the peanut oil in a large, thick-bottomed pot, such as a Dutch oven, on medium high heat, for a minute or two. Whisk in the flour and lower the heat to medium. Stir almost constantly, making sure to scrape the bottom of the pan as you stir.', 'Let the roux cook until it is the color of peanut butter, then lower the heat to medium low. Keep cooking and stirring (careful, you want the flour to cook, not burn!) until the roux is the color of an old penny, about 20-30 minutes total time.', '2 Stir in the vegetables: Mix in the ""holy trinity"" of green pepper, onion and celery and increase the heat to medium-high. Cook, stirring often, for 5 minutes.', 'Add the garlic and cook another 2 minutes. Stir in the Cajun seasoning.', '3 Slowly add stock, then simmer: In a separate pot, heat the stock and water until steamy. Slowly add the steamy stock and water to the bell pepper onion roux mixture, stirring constantly while you do so.', 'Bring the gumbo to a simmer and add the Worcestershire sauce and salt to taste. Simmer gently for 30 minutes.', 'If you find that the roux has broken a bit and oil is pooling on the surface of the gumbo, whisk in about another 1/2 to 1 cup of water. This will often ""fix"" it.', '4 Stir in the andouille sausage and cook for 5 minutes (andouille sausage is already cooked, so you just need to heat it).', '5 Add the shrimp, return to a simmer and cook another 5 minutes, until the shrimp has just cooked through. Add salt and black pepper to taste.', '6 Serve: Serve with white rice, garnished with green onions. To eat, sprinkle with fil\\xc3\\xa9 powder and hot sauce.']",10
1217,Pasta with Turkey Sausage and Smoked Mozzarella Recipe,5,30,35,"['2 tablespoons extra virgin olive oil', '1 medium yellow onion, chopped', '1 clove garlic, minced', '2 14-ounce cans crushed tomatoes or whole peeled tomatoes', '1 pound Italian turkey sausage, bulk or cut into 1/2-inch slices*', 'Pinch red pepper flakes', '3/4 pound fusilli pasta', 'Salt', '3 ounces smoked Mozzarella cheese, cut into 1/4-inch cubes', '1/4 cup freshly grated Parmesan cheese', '*If you put the sausage in the freezer first for a half hour, it will be easier to slice.']",11,"['1 Saut\\xc3\\xa9 onions and garlic: Heat olive oil in a large skillet on medium heat. Add the onions and cook until translucent, about 5 minutes. Add the garlic and cook a minute more.', '2 Add tomatoes and sausage: Add the tomatoes to the pan (if using canned whole tomatoes shred them with your fingers as you add them to the pan). Include the juices.', 'Add the sausage and red pepper flakes. Cover and cook on medium low heat for 20 minutes, until the sauce is thickened.', '3 Cook the pasta: While the sauce is cooking, cook the pasta. Bring a large pot of water to a boil, add a teaspoon and a half of salt for every quart of water.', 'Cook the pasta according to pasta package instructions, until al dente, or cooked through, but still a bit firm. Drain the water from the pasta.', 'Combine the pasta and the sauce in a large serving bowl.', '4 Add smoked mozzarella and Parmesan: Stir in the cubed smoked mozzarella cheese. Continue to stir until the cheese has softened and is a bit melty. Sprinkle with Parmesan cheese.']",7
1218,Chicken Gumbo with Andouille Sausage Recipe,20,180,200,"['1/3 pound bacon, diced', '2-3 pounds chicken thighs, skin on', 'Salt', '1-2 pounds andouille sausage', '1/2 cup peanut or other vegetable oil', '1 cup flour', '2 green peppers, diced', '4 celery stalks, diced', '1 large onion, diced', '4 garlic cloves, minced', '2 tablespoons tomato paste', '1 quart chicken stock', '1 quart water', '1/2 to 1 pound okra, sliced into discs', '3 green onions, chopped', '1/2 cup fresh parsley, chopped', 'Cajun spice mix', '1 teaspoon black pepper', '1/2 to 1 teaspoon cayenne pepper', '1 teaspoon celery seed', '2 Tbsp sweet paprika', '1 Tbsp garlic powder', '1 Tbsp dried thyme', '1 Tbsp dried oregano']",24,"[""1 Cook the bacon: Cook the diced bacon until crispy in a large stew pot set over medium heat. Remove the bacon and set aside; you'll add it back in when you serve your gumbo."", '2 Brown the chicken in the bacon fat: Once the bacon is cooked, set the chicken thighs skin side down in the bacon fat to crisp. Salt the meat side, which will be facing up in the pot.', 'Cook the chicken, without moving, for at least 4-5 minutes before trying to turn the chicken over.', 'Brown the other side of the chicken thighs. Incidentally, you start with skin side down to render some fat, which you will need for the roux.', '3 Brown the sausages: Remove the browned chicken thighs and set aside. Brown the sausages in the fat, remove and set aside.', '4 Make the roux: If you want, measure how much fat is in the pot; it should be about 1/2 cup. Or, do what I do and add 1/2 cup peanut oil to the pot. Let this heat up a minute or two, then stir in 1 cup flour. Stir this almost constantly for the first few minutes, then every couple minutes or so thereafter.', 'Lower the heat to medium-low and cook this roux until it turns dark. How dark? I like my roux the color of coffee with just a tiny bit of cream.', 'You can go all the way to chocolate brown, but be careful! If you burn your roux you will need to start over and make it again. This whole process can take 30 minutes.', '5 Heat chicken stock: While you are stirring and cooking the roux, bring the chicken stock and water to a boil in a separate pot.', '6 Add onion, bell pepper, celery to roux, add garlic, then tomato paste: Add to the roux the onion, green pepper and celery and mix well. Let this cook, stirring often, for about 5 minutes.', 'Add the garlic, stir again and cook for another 2 minutes. Mix in the tomato paste.', '7 Ladle hot stock into the gumbo, stir in some spice: Using a large ladle, add the hot chicken stock to the gumbo. It will sizzle and seize up as the roux absorbs the liquid.', 'Keep adding more stock, stirring all the time and scraping the bottom of the pot, to incorporate all the stock and all the roux.', 'You might not need all 2 quarts, but add enough to make the gumbo slightly more watery than you want it to be at the end\\xe2\\x80\\x94remember you are going to cook this down for several hours.', 'Stir in half the Cajun spice mix, taste the gumbo, and add more if you want.', ""8 Lower the heat, add the chicken, simmer: Lower the heat to medium-low and add back the chicken thighs. Now you can either eat the skin while it's still crispy, or toss it into the gumbo and chop it fine later. I tend to do half-and-half."", 'Simmer this gently, stirring from time to time, until the meat wants to fall off the bones of the chicken, about 90 minutes. Remove the chicken and let it cool a bit.', '9 Add sausage, okra, chicken meat: While the chicken is cooling, cut the andouille sausage into thick discs and drop them in the gumbo.', 'Add the okra.', 'Pick the chicken meat from the bones and chop it roughly. Add it back to the gumbo.', 'At this point you can cook the gumbo for another hour, or up to several more hours, depending on how cooked down you want the final stew to be.', '10 Add green onions, parsley, bacon to serve: When you are ready to eat, add the green onions, parsley and bacon and stir well. Serve over rice, or with good French bread.']",22
1219,Roasted Spaghetti Squash with Sausage and Kale Recipe,15,75,90,"['3 tablespoons extra virgin olive oil', 'One 3-pound (1.4 kg) spaghetti squash', '3/4 pound (340 g) turkey sausage (or any favorite sausage), bulk or removed from casings', '1/2 cup minced red onion', '3 cloves garlic, minced', '1 to 2 cups thinly sliced kale', '1 cup (100 g) coarsely grated Parmesan cheese', '1 tablespoon finely chopped fresh oregano', 'Kosher or sea salt', 'Freshly ground black pepper']",10,"['1 Preheat oven and prepare pan: Preheat oven to 375\\xc2\\xb0F (190\\xc2\\xb0C). Oil a sheet pan with one tablespoon of the oil, or line the sheet pan with Silpat.', ""2 Prep the spaghetti squash: With a sharp chef\\'s knife, slice off 1/2-inch from the ends of the spaghetti squash. Then stand the squash up on one of the ends to stabilize it, and cut the squash in half, top to bottom."", 'Scoop out any seeds and stringy bits inside, and place the squash halves cut-side down on the oiled or lined sheet pan. Poke the tops of the halves with the tip of a sharp knife.', '3 Bake: Bake at 375\\xc2\\xb0F (190\\xc2\\xb0C) for 35 to 45 minutes until you can easily poke the sides of the squash with a fork. Remove from oven and let sit until cool enough to handle. Then using the tines of a fork, scrape out the ""spaghetti""-like strands of the squash to a bowl.', '4 Saut\\xc3\\xa9 onions, garlic, kale: In a large saut\\xc3\\xa9 pan, heat 2 tablespoons of the olive oil on medium heat. Add the onions and cook until soft, 2 to 3 minutes. Then add the garlic and cook for a minute more.', 'Add the sliced kale and cook for a minute or two.', '5 Add the sausage: Add the sausage and cook without stirring, until the sausage starts to brown, then stir and continue to cook, stirring occasionally, until the sausage bits are cooked through, about 2 to 3 minutes.', '6 Add the spaghetti squash strands to the sausage mixture and stir to combine, cook until the squash is heated through, about a minute.', '7 Add Parmesan and oregano: Remove from heat and add the grated Parmesan cheese and oregano. Season with salt and pepper to taste. Serve immediately.']",9
1220,"Quick Sausage, Kale, and Crouton Saut\xc3\xa9 Recipe",10,20,30,"['Olive oil', '2 cups (60 grams) 1-inch cubes of sturdy white bread (such as sourdough or ciabatta)', '1/2 pound (225 grams) fresh sweet Italian sausages, casings removed', '1 garlic clove, minced or pressed', '3/4  cup (200 grams) cooked white beans (about half a 15.5-ounce can)', '2 big handfuls (or more, to taste) torn curly kale leaves', 'Kosher salt and freshly ground black pepper and', 'Red pepper flakes, to taste', '2 tablespoons (30ml) red wine vinegar', 'Grated Parmesan (optional)']",10,"['1 Make the croutons: Heat two glugs of oil in a large heavy skillet over medium-high heat. Add the bread cubes and toast, stirring, until lightly browned and mostly crisp, 3 to 4 minutes.', '2 Cook the sausage: Push the croutons aside and add another glug to the pan, then the garlic and sausage meat. Cook, breaking up sausage into small bits, until browned all over.', '3 Cook the greens and beans: Add the greens and cook until they begin to wilt, then add the beans and warm through. Season well with salt, black pepper, and red pepper flakes', 'Add vinegar to the pan and use it to scrape up any stuck bits.', '4 Serve: Scrape the saut\\xc3\\xa9 into bowls, finish with cheese if desired, and inhale.']",5
1221,Stuffed Zucchini with Turkey Sausage Recipe,10,55,65,"['1 zucchini about 12 inches long, or 3-4 medium zucchini', '3 tablespoons extra virgin olive oil', '1/2 cup chopped onion', '3 cloves garlic, minced', '1/2 cup chopped mushrooms', '2 tablespoons dry white wine', '1 pound ground turkey', '2 diced tomatoes', '3 tablespoons chopped fresh basil', '1 teaspoon chopped fresh rosemary', '3/4 cup grated Parmesan cheese', '1 egg, lightly beaten', '2 teaspoons salt', '2 teaspoons pepper']",14,"['1 Prep zucchini: Cut zucchini in half lengthwise. Scoop out insides, leaving shells about 1/4 inch thick. Reserve about half of the insides.', '2 Saut\\xc3\\xa9 onion, garlic, mushrooms, zucchini insides: Heat 2 Tbsp of olive oil in a skillet on medium high heat. Saut\\xc3\\xa9 onion and garlic until soft. Add mushrooms and reserved zucchini insides, and saut\\xc3\\xa9 another 2 minutes.', '3 Brown the ground turkey: In a separate skillet heat a Tbsp of olive oil on medium high heat. Add the ground turkey. Lightly brown the turkey, stirring only occasionally. After the turkey browns on one side, stir it so that it has a chance to brown on other sides. Cook until the ground turkey is lightly browned, about 6 minutes.', '4 Make stuffing: Stir the onion and mushroom mixture in with the ground turkey. Add the wine. Stir in tomato, basil and rosemary and cook 1 minute longer. Drain any excess fat. Remove mixture from heat and set it aside.', 'When mixture has cooled, add cheese, egg, salt and pepper.', '5 Stuff zucchini shells and bake: Fill zucchini shells with mixture. Fill a baking pan with 1/4 inch of water. Place filled zucchini halves in pan and bake at 375\\xc2\\xb0F for 40 minutes, until golden brown. Remove zucchini from pan and serve while hot.']",6
1222,Grilled Sausage and Mushroom Bowls Recipe,15,20,35,"['For the grain bowls:', '1 cup uncooked millet or other favorite grain (or 4 cups cooked grains)', '1/2 cup chimichurri, pesto, or other favorite flavorful sauce', 'For the grilled sausages and vegetables:', '1 pound cremini or baby bella mushrooms', '2 heads romaine lettuce', '1 bunch green onions', '2 1/2 tablespoons olive oil', '4 chicken or pork sausages, any favorite kind', 'Salt and pepper']",10,"['1 Cook the grains: Prepare the grains according to package instructions, letting them cook while you prepare the rest of the recipe.', 'The grains can be cooked several days in advance. Reheat before serving.', '2 Preheat your grill: Prepare one side of the grill for direct grilling and one side for indirect heat. The grill is ready when you can hover your hand 3 to 4 inches above the hot side of the grill for only a couple of seconds before feeling discomfort.', '3 Prepare the vegetables for grilling: Cut smaller mushrooms into halves and larger mushrooms into thick, 3/4-inch slices. Skewer the mushrooms through the stem, from bottom to top, so they will lay flat on the grill.', ""Cut the heads of romaine into quarters through the root. The wedges should remain attached at the root; it's ok if a few outer leaves fall off (save those for sandwiches!)."", 'In a small bowl, mix two and a half tablespoons olive oil with a heavy pinch of salt and black pepper. Brush the oil evenly over all of the mushrooms, the green onions, and the romaine, and set aside.', '4 Grill the sausages and mushrooms: Brush grates with a bit of extra oil and place the sausages and mushrooms on the cooler side of the grill.', 'Close the lid and cook for 5 minutes, then flip the sausages and mushrooms. Close the lid and cook for another 3 to 5 minutes, or until sausages are almost entirely cooked through. (If your sausages are pre-cooked, they just need to be warmed through.)', 'Move the sausages and mushrooms to the hot side of the grill and cook on each side for 1 to 2 minutes until they show grill marks and are caramelized.', 'Transfer the sausages and mushrooms to a platter to rest while you grill the rest of the vegetables.', '5 Grill the green onions and romaine: Place the green onions and romaine halves on the hot side of the grill, and grill for about one minute on each side.', 'Transfer to a serving platter.', '6 To serve: Slice each sausage into three large pieces. Fill each bowl with 1/2 to 1 cup of cooked grains and top with a few pieces of sausage, some green onions, some mushrooms, and a wedge of romaine. Drizzle with chimichurri and top with fresh herbs.']",13
1223,Cheesy Apple and Sausage Pie Recipe,15,100,115,"['1 basic pie dough recipe, rolled out and lining a 9 or 10-inch pie dish, or 8x8 baking dish, chilled (or one frozen pie crust)', '2 large tart green apples, peeled and sliced 1/4-inch thick', '1/2 medium onion, chopped (about half a cup)', '1 teaspoon sugar', '3 Tbsp butter', '3/4 lb sweet Italian sausage (bulk, or removed from casings)', '1 clove garlic, minced', '2 cups (8 ounces) shredded fontina, provolone, and or asiago cheese', '1 cup ricotta cheese', '1/4 cup feta cheese', '2 eggs, slightly beaten']",11,"['1 Pre-bake the pie crust: Preheat oven to 350\\xc2\\xb0F. Line the inside of a pie shell with heavy aluminum foil, pressing against the dough on the sides. Fill all the way to the rim with pie weights (sugar or beans work well). Bake for 35 minutes or until the crust begins to brown. (Sometimes store-bought frozen crusts do not require as much baking time as homemade crusts.)', 'Remove the pie crust from oven and let cool. Remove the foil and pie weights.', '2 Cook the apple, onions, sugar in butter: Melt butter in a large skillet on medium heat. Add the apples, onions, and sugar, cook, stirring occasionally, until tender, about 5 minutes.', 'In the last 30 seconds or so, add the garlic and cook until fragrant. Transfer mixture to a separate bowl.', '3 Cook the sausage: Add the Italian sausage to the skillet. Cook on medium heat, stirring only infrequently, until sausage is cooked through. Remove from heat.', 'Remove the sausage with a slotted spoon to a dish lined with paper towels to absorb the excess fat.', '4 In medium sized bowl, mix together the cheeses and beaten eggs.', '5 Layer sausage, apple mixture, and cheese mixture in pie crust: Place sausage on bottom of pre-baked pie crust. Add the cooked apple onion mixture over the sausage.', 'Pour the cheese egg mixture over the apple mixture and spread it so it evenly covers the pie.', '6 Bake: Bake at 350\\xc2\\xb0F for 35 to 40 minutes, until a knife inserted in the center comes out clean. Let stand for 10 minutes before serving.']",10
1224,Cheesy Slow Cooker Sausage Balls Recipe,10,140,150,"['2 pounds Italian sausage, either bulk or removed from the casing', '4 ounces (1 cup) sharp cheddar cheese, grated', '8 ounces cream cheese', '1 teaspoon kosher salt', 'Olive oil, for browning', '3 cups marinara sauce, store-bought or homemade', 'Fresh parsley, garnish', 'Pasta, for serving (optional)', 'Special equipment:', '6-quart slow cooker']",10,"['1 Make the sausage balls: In a medium bowl, mix together Italian sausage, cheddar cheese, cream cheese, and kosher salt. Use your hands to mix the mixture really well so there are no huge chunks of cream cheese.', 'Shape the mixture into tablespoon-sized balls. (Tip: it\\xe2\\x80\\x99s easier to make the balls if your hands are cold and wet!) Alternatively, use a small cookie scoop to create the meatballs. You should get around 30 balls out of the mixture. Put the meatballs on a plate.', '2 Brown the sausage balls: Add a small drizzle of oil to a medium skillet over medium-high heat. Add a batch of sausage balls (about 12-14 balls, or as many as will fit in your skillet without crowding). Cook for 2-3 minutes, flipping once to get some browning on at least two sides. The sausage balls do not need to be completely cooked through.', 'Repeat with the remaining sausage balls until all the balls have been browned. (It will probably take three batches to brown them all.) When finished, add the sausage balls to a slow cooker pot.', '3 Cook the sausage balls: When all the sausage balls are browned and in the slow cooker, gently stir in the marinara sauce (the sausage balls may be fragile) and cook on high heat for 2 hours or low heat for up to 8 hours.', 'Serve finished sausage balls garnished with parsley and served with toothpicks as an appetizer or over pasta for a full meal.', 'Leftovers keep fantastically in the fridge for 5-6 days. Reheat in a pot over low heat with a splash of water. You can also freeze the sausage balls in a freezer-safe container for up to 3 months.']",7
1225,Orecchiette Pasta with Sausage and Kale Recipe,10,20,30,"['12 ounces orecchiette pasta', '14-16 ounces bulk Italian sausage', '1 large bunch purple or Tuscan kale, de-stemmed and leaves chopped', '1 large shallot, sliced', '2 cloves garlic, sliced', '1/2 cup salted pasta water', '1 lemon, juice only', 'Salt, to taste', 'For the Crispy Parmesan Breadcrumbs', '2 tablespoons butter', '1/2 cup breadcrumbs', '1/2 cup grated parmesan cheese', '1/2 teaspoon red pepper flakes (optional)']",13,"['1 Make the crispy parmesan breadcrumbs: Melt butter in a medium skillet over medium heat. In a small bowl, toss together breadcrumbs, parmesan, and red pepper flakes to avoid any huge parmesan clumps. Pour into skillet and stir to coat with butter. Cook for 3-4 minutes, tossing occasionally, until browned. Set aside until ready to eat.', '2 Cook the pasta in salted water: Fill a large pot with water and set it over medium-high heat. Add a tablespoon of kosher salt (or 2 teaspoons table salt) per quart of water. The water should taste seasoned, but not seawater-salty. It\\xe2\\x80\\x99s important to get the salt level right in the water because we will be using it to finish the dish.', ""When the water is boiling, add the pasta and stir it rapidly to separate the pasta, since orecchiette has a tendency to stick together. Cook until al dente, probably 9-11 minutes. Scoop out a cup of the pasta water (don't forget!), then drain and rinse the pasta to stop the cooking."", '3 Cook the sausage: While the pasta cooks, add the Italian sausage in small chunks to a large skillet over medium heat. Cook, letting the sausage render out fat, for 6-7 minutes, stirring occasionally, until the sausage is cooked through.', 'At this point, there should be enough fat from the sausage in the skillet, but if your skillet is very dry, add a drizzle of olive oil before the next ingredients go in.', '4 Add kale, shallot, and garlic: Add the chopped kale, shallot, and garlic to the skillet. Stir to combine and cook for 2-3 minutes until kale is wilted.', '5 Add cooked orecchiette and pasta water: Add the cooked orecchiette, 1/2 cup pasta water, and lemon juice to the skillet. Toss to combine and heat until the pasta water thickens to form a light sauce. If the pasta seems dry, add more pasta water.', 'Serve pasta in shallow bowls garnished with crispy breadcrumb topper.', 'Store leftovers in the fridge for 5-6 days. Reheat in the microwave with a splash of water or over the stove in a skillet on medium-high heat.']",9
1226,Tomato Ricotta Tart Recipe,20,30,50,"['For the cheese layer:', '2 cups ricotta cheese', '1/4 cup finely grated Parmesan cheese', '2 tablespoons fresh thyme leaves', '1 teaspoon kosher salt', '1/4 teaspoon crushed red pepper flakes', '2 cloves garlic, grated on a microplane or finely minced', '1 egg yolk', 'For the phyllo-parmesan crust:', '12 sheets phyllo dough, thawed according to package directions', '6 tablespoons unsalted butter, melted', '5 tablespoons finely grated Parmesan cheese, divided', 'To assemble:', '2 pounds ripe tomatoes, cut into 1/3-inch thick slices', '1 teaspoon fresh thyme leaves', '1/2 teaspoon kosher salt']",16,"['1 Mix the cheese layer: Mix the ricotta, grated Parmesan, thyme, kosher salt, red pepper flakes, garlic, and egg yolk together in a bowl. Set aside.', '2 Preheat the oven and prepare the phyllo: Preheat the oven to 400\\xc2\\xb0F. Carefully unroll the thawed dough and cover with a damp cloth to keep from drying out while you assemble the crust for the tart.', '3 Assemble the crust: Brush the bottom of a 13-by-18-inch rimmed baking sheet with some of the melted butter. Lay one sheet of phyllo dough on top.', 'Brush the phyllo with some of the butter and place another sheet of phyllo on top. Brush the second sheet with some butter and sprinkle 1 tablespoon of the Parmesan cheese over the top.', 'Repeat with the remaining sheets of phyllo dough and butter, sprinkling 1 tablespoon Parmesan cheese on every other sheet. Do not brush the top of the last sheet with butter.', '4 Assemble the tart: Spread the cheese mixture in an even layer on top of the phyllo crust. Arrange the tomato slices on top of the cheese mixture. Sprinkle the thyme leaves and salt on top of the tomatoes.', '5 Bake the tart: Bake in the oven until the phyllo is crisp, about 30 minutes. The phyllo dough will shrink slightly during baking and will no longer fill the baking sheet\\xe2\\x80\\x94don\\xe2\\x80\\x99t panic!', 'Let it cool slightly, about 5 minutes, and cut into squares. (A pizza wheel works great for this.) This is best served immediately or at room temperature. (You can refrigerate any leftovers, but the phyllo crust will lose its crispness.)']",8
1227,Seared Scallops with Asparagus Sauce Recipe,5,25,30,"['6 sea scallops*', 'Salt', '1 pound asparagus', '1/2 cup warm chicken broth (if cooking gluten-free use gluten-free stock)', '2-3 tablespoons butter', '2 tablespoons extra virgin olive oil or canola oil', '*Sea scallops are the big scallops, about 1 1/2-inches wide, as opposed to bay scallops which are small, about 1/2-inch wide. Look for \\xe2\\x80\\x9cdry pack\\xe2\\x80\\x9d scallops, as they are not treated with chemicals to keep them fresh; the chemicals are not overly harmful, but they change the texture of the scallop and make them harder to sear properly.']",7,"['1 Salt the scallops: Salt the scallops well and set aside at room temperature while you make the asparagus sauce.', '2 Cook the asparagus for the sauce: Use a potato peeler to shave the outer layer off the asparagus spears, up to about three-quarters of the way up the spear. This part is more fibrous and will not break down as well in the blender. Chop the asparagus spears into 2-inch pieces.', 'Boil the asparagus in a pot of salted water for 5-8 minutes. This is longer than you\\xe2\\x80\\x99d normally cook asparagus, but you want the spears to blend well later.', 'Remove the asparagus from the pot. If you want to retain that vibrant green color, shock them in an ice bath.', '  3 Make the asparagus sauce: Put the cooked asparagus in a food processor or blender. Add half the chicken stock and pur\\xc3\\xa9e until smooth. (If you want an even smoother texture you can push the pur\\xc3\\xa9e through a fine mesh sieve or a food mill.)', 'Pour the sauce into a small pot and add the butter. Heat over very low heat until the butter melts, but do not let it boil, or even simmer. The sauce should be warm, not hot. If the sauce is too thick you can add more chicken stock. Add salt to taste.', '4 Sear the scallops on one side: Pat the scallops dry with a paper towel. Heat a saut\\xc3\\xa9 pan on high heat. Add your cooking oil, and let it heat up for 2 minutes. The pan should be very hot. If it starts to smoke, move the pan off the heat. Lay in the scallops in the pan, well separated from each other. You might need to sear in batches.', 'If your scallops are thicker than 1 inch, turn the heat down to medium-high. Most sea scallops are about an inch. Let them sear without moving for at least 3-4 minutes.', 'Keep an eye on them. You will see a crust beginning to form on the outside edge of the scallop, and the meat will begin to whiten upward. A good time to check the scallop is when you see a golden brown ring at the edge of the scallop.', 'Try picking it up with tongs, and if it comes cleanly, check it \\xe2\\x80\\x93 you should see a deep golden sear. If not, let it back down and keep searing.', '5 Sear the scallops on the other side: When the scallops are well seared on one side, turn them over and sear on high heat for 1 minute (give or take). Then turn off the heat.', 'The residual heat will continue to cook the scallops for a few minutes. Let the scallops cook for at least another minute, or more if you like your scallops well-done.', '6 Serve: To serve pour a little sauce in the middle of the plate, top with the scallops, the more browned side up.', 'Serve at once. Garnish with a little chopped parsley if you want, and maybe with a wedge of lemon.']",14
1228,Pan Seared Scallops with Sweet Corn and Chiles Recipe,15,15,30,"['For the creamy corn:', '5 ears corn, shucked', '2 tablespoons butter', '1/2 medium onion, finely chopped', '1/2 poblano chile, finely chopped', '1/2 cup heavy cream', '1/2 cup water, plus more as needed', '1/4 teaspoon salt', '1/8 teaspoon ground black pepper', '1/4 cup chopped fresh cilantro or parsley', 'For the scallops:', '12 to 16 dry sea scallops (about 1 1/4 pounds)', '1/2 teaspoon salt', '1/8 teaspoon ground black pepper', '2 tablespoons olive oil', '2 tablespoons lime juice', 'Lime wedges, for serving', '3 to 4 tablespoons coarsely chopped cilantro or parsley, for serving']",18,"['1 Remove the corn kernels: Set an ear of corn on a cutting board, and working from the thick to the narrow end, cut off 2 rows of kernels. Turn and cut off 2 or 3 more rows. Continue in this way until all the kernels are off all the cobs. Transfer to a large bowl.', '2 Scrape the cob to release the creamy milk from the corn: After you have removed the kernels, hold one cob over the rim of the bowl of corn, and use the back of the knife to rub across it, going back and forth, to release the pulpy corn milk into the bowl.', 'Repeat with all the ears. You should be able to get about 1 tablespoon of corn milk per cob. The starchy liquid of the corn milk adds creaminess to the kernels.', '3 Cook the corn: In a large skillet over medium heat, melt the butter. Add the onion and diced poblano. Cook, stirring often, for about 5 minutes, or until the vegetables soften. Add the corn, corn milk, cream, water, salt, and pepper. Cook, stirring often, for 3 to 4 minutes, or until the kernels are tender. Remove from heat.', 'The mixture should look creamy. If it seems dry, stir in more water, 1 tablespoon at a time. Stir in the cilantro or parsley. Remove from the heat and set aside while you cook the scallops.', '4 Prepare the scallops: Rinse the scallops under cold running water. If the side muscle (the small, tough pieces of scallop that attached the scallop to its shell) is present, remove it with a sharp paring knife. Pat the scallops dry with paper towels and sprinkle with salt and pepper.', '5 Cook the scallops: In a large skillet (preferably cast-iron) over medium-high heat, heat the oil until very hot. Add the scallops without crowding them, and turn the heat to medium. Cook for about 5 minutes, or until they are golden brown on the bottom. Turn the scallops over and remove the pan from the heat.', 'Let them rest for a few minutes to cook in the residual heat from the pan. They are done when they feel firm to the touch and have a slight almost frilly-looking separation on the edge of the scallop. Serve them with the browned side up.', '6 Serve the scallops: If necessary, reheat the corn over medium heat. Divide the corn evenly into shallow bowls. Place 3 to 4 scallops, browned side up, over the corn. Sprinkle the scallops with the lime juice and cilantro or parsley. Serve with lime wedges.']",9
1229,Pork Schnitzel Recipe,10,20,30,"['4 boneless pork chops (1 pound total), 1/2 inch thick', '1/4 cup flour', ""1 teaspoon seasoned salt (Spike or Lawrey's, or just substitute plain salt)"", '1/4 teaspoon freshly ground black pepper', '1 egg, beaten', '2 tablespoons milk', '3/4 cup fine dry breadcrumbs or panko', '1 teaspoon paprika', '3 tablespoons extra virgin olive oil or canola oil', '3/4 cup chicken stock', '1/2 teaspoon dried dill or 2 teaspoons chopped fresh dill', '1/2 teaspoon salt', '1/2 cup sour cream (full fat)']",13,"['1 Use a meat hammer to pound the pork cutlets to 1/4-1/8 inch thickness. Cut small slits around the edges of the cutlets to prevent curling.', '2 Set out 3 shallow bowls. One with a mixture of the flour, seasoned salt, and pepper. The second with the egg and milk whisked together. The third with a mixture of the breadcrumbs (or panko) and paprika.', '3 Dredge cutlets: Heat the olive oil in a large skillet on medium high heat. Dredge the cutlets first in the seasoned flour, then dip the cutlets in the egg mixture, and then into the mixture of bread crumbs and paprika.', '4 Working in batches, saut\\xc3\\xa9 the cutlets for 3-4 minutes on each side. Remove the cutlets from the skillet and cover with foil or place in a warm oven to keep warm.', '5 Deglaze pan, make sour cream dill sauce: Add the chicken stock into the skillet to deglaze the pan, scraping the bottom of the pan to loosen the brown bits.', 'In a small bowl mix the dill and salt into the sour cream. Stir the sour cream mixture into the chicken stock.', 'Heat and stir until mixture thickens (do not let boil).', 'Serve the cutlets with the sauce, and lemon slices if you like.']",8
1230,Cheddar and Jalape\xc3\xb1o Biscuits Recipe,10,15,25,"['1 1/3 cups (175g) all-purpose flour', '1/4 cup (45g) polenta or fine milled corn meal', '3 tablespoons (45g) sugar', '2 teaspoons baking powder', '1/2 teaspoon salt', 'Pinch cayenne pepper', '6 ounces (1 1/2 cups packed, 170g) shredded sharp cheddar cheese, divided (1 1/4 cup and 1/4 cup)', '2 tablespoons diced fresh jalape\\xc3\\xb1os (more or less to taste)', '3/4 cup + 2 tablespoons heavy cream (200ml), plus extra for brushing']",9,"['1 Preheat oven to 425\\xc2\\xb0F (220\\xc2\\xb0C).', '2 Whisk dry ingredients, add cheese and jalape\\xc3\\xb1os: In a large bowl, whisk together the flour, polenta, salt, sugar, cayenne, and baking powder.', 'Stir in 1 1/4 cups of the grated cheddar cheese and the diced jalape\\xc3\\xb1os.', '3 Add the cream: Make a well in the center of the flour mixture. Pour the cream into the center of the well and your (clean) hands to gently bring together the ingredients.', 'If you need to add a bit more cream then do so a tiny trickle at a time. You just want everything to get wet enough so that the dough will be sticky and clumpy.', '4 Knead the dough, just enough: Turn the dough out onto a surface lightly dusted with flour. Knead the dough just a few times - maybe only three or four pushes. You just want it to just come together. (Over-kneading will result in firmer, denser biscuits.)', '5 Cut out biscuit shapes: Form the dough into a disc about 3/4-inch to an inch thick. Use a biscuit cutter (or a small juice glass) to cut round biscuit shapes out of the disk. Combine the leftover dough and keep forming small round biscuit shapes until the dough is used up.', '6 Brush with cream, sprinkle with cheese: Place on a silicone-lined or parchment lined baking sheet, with at least an inch or two between the biscuits. Brush the tops of the biscuits with a little more cream. Top the biscuits with a sprinkle of the remaining cheese.', '7 Bake: Bake at 425\\xc2\\xb0F (220\\xc2\\xb0C) for 11-12 minutes or until golden and the cheese is nicely melted.']",9
1231,"Joe\xe2\x80\x99s Special (Scrambled Eggs with Spinach, Beef, and Mushrooms) Recipe",10,30,40,"['2 tablespoons unsalted butter', '8 ounces crimini mushrooms, sliced', '1 medium yellow onion, diced', '4 cloves garlic, chopped', '1 teaspoon salt, divided', '6-ounce bag (8 cups) baby spinach', '1 pound (85 to 95%) lean ground beef', '1 teaspoon Worcestershire sauce', '1/4 teaspoon ground black pepper', '1/8 teaspoon ground nutmeg', '6 large eggs', '1 teaspoon Tabasco sauce, optional', 'Sliced sourdough bread or rolls, to serve']",13,"['1 Cook the mushrooms, if using: Melt the butter in a large (12-inch) skillet over medium heat. Add the mushrooms into the skillet in a single layer and leave them alone, without stirring, until they begin to brown, about five minutes.', '2 Cook the onions: Add the onions, garlic, and 1/2 teaspoon of the salt to the mushrooms. Cook, stirring occasionally, until the onions are softened and the garlic has lost its raw bite, about five more minutes.', '3 Wilt the spinach: Add the spinach to the skillet, stirring it into the other ingredients for a couple minutes so that it wilts and reduces in volume.', 'When the spinach has just barely wilted, transfer everything from the skillet to a large, shallow serving bowl. ', '4 Cook the ground beef. Add the ground beef to the empty skillet over medium heat. Sprinkle the Worcestershire sauce, pepper, nutmeg, and remaining 1/2 teaspoon of salt over top. Cook the beef, breaking it up with your spatula into crumbles.', 'Continue to cook until the beef is fully cooked through with no trace of pink remaining, 8 to 10 minutes.', 'Transfer the cooked beef to the serving bowl with the saut\\xc3\\xa9ed vegetables. Pour off any fat still in the pan, leaving just a thin film to cook the eggs. (Add a teaspoon of cooking oil or butter if the pan seems dry.)', '  5 Scramble the eggs. Return the pan to the stove and reduce the heat to medium low. In a medium mixing bowl, whisk the eggs with tabasco, just until thoroughly combined.', 'Pour the eggs into the skillet, and scramble just until the curds are barely wet and beginning to break apart, stirring often, about five minutes.', '6 Mix everything together and serve. Add the cooked beef and vegetables back to the skillet, breaking up the eggs into bite sized pieces and stirring everything together until evenly combined.', 'Transfer everything back to the serving bowl and serve hot, with sourdough bread alongside.']",11
1232,Scrambled Eggs with Kale and Mozzarella Recipe,10,5,15,"['1 tablespoon extra virgin olive oil', '1/4 cup of chopped onion', 'Pinch of red pepper flakes', '1 ounce fresh kale, de-stemmed and thinly sliced (about 1 cup)', '4 eggs, beaten', '1/2 cup of grated mozzarella cheese', '1/2 teaspoon Italian seasoning (dried rosemary, oregano, thyme, basil)', 'Salt and freshly ground black pepper to taste']",8,"['1 Saut\\xc3\\xa9 onions with red pepper flakes: Heat olive oil in a stick-free frying pan on medium high heat. When the oil is hot, add the chopped onion and red pepper flakes. Cook for one minute.', '2 Add kale: Add the thinly sliced kale to the pan, toss with the onions and olive oil. Cook for a few minutes, until the kale is just wilted.', '3 Add beaten eggs: Lower the heat to medium. Add the beaten eggs to the pan. Stir until the eggs begin to set.', '4 Add cheese and seasoning: Stir in the shredded mozzarella cheese and Italian seasoning.  Remove from heat and continue to stir a few times until the cheese is melted and the eggs are cooked. Sprinkle with salt and pepper to taste.']",4
1233,Make-Ahead Feta and Spinach Breakfast Wraps Recipe,20,20,40,"['2 tablespoons olive oil', '4 scallions, thinly sliced', '1 teaspoon dried oregano', '8 large eggs, well beaten', 'Salt and pepper, to taste', '4 10-inch flour tortillas', '3 ounces (about 3 cups packed) fresh baby spinach leaves', '1/2 cup (4 ounces) crumbled feta cheese']",8,"['1 Cut four 12-inch squares of parchment paper and set nearby.', '2 Scramble the eggs: In a large nonstick skillet over medium heat, heat the oil. Add the scallions and oregano and cook for 2 to 3 minutes, or until the scallions soften slightly.', 'Add the eggs, salt and pepper, and cook, stirring constantly, until starting to set but still runny.', '3 Add the spinach: Take the pan off the heat and fold in the spinach. Turn the heat to medium-low, and return the pan to heat. Continue to cook for 1 to 3 minutes longer, or until the spinach starts to wilt (some leaves will still be un-wilted) and the eggs are cooked.', 'Transfer the eggs to a platter to cool slightly.  Wash out the skillet.', '4 Warm the tortillas: Place the cleaned skillet over medium heat, and heat until hot. One at a time, warm the tortillas for 15 to 20 seconds on a side, turning with tongs, until softened and lightly browned in spots, but not crisp. Stack on a plate and cover with a tea towel to keep warm and pliable.', '5 Make the wraps: Spread a quarter of the egg filling in a line about 2 inches from the bottom edge of a tortilla. Sprinkle with 2 tablespoons of feta.', 'Fold the bottom edge of the tortilla over the filling. Fold in the sides and roll to enclose the filling in a neat bundle. With the seam side down, wrap in the parchment paper. Repeat with the remaining tortillas and filling.', 'Store wrapped wraps in the refrigerator until ready to serve.', '6 To serve: Preheat the oven to 350F. Place the wraps in their parchment paper in a baking dish, and warm for 15 to 20 minutes, or until hot. Remove from the oven and remove the paper. (Alternatively, warm individual wraps in the microwave, but the oven is better for reheating several at once.)', 'Cut each wrap in half on the diagonal and serve.']",11
1234,Tuscan Scrambled Eggs Recipe,5,50,55,"['3 tablespoons extra virgin olive oil', '1 large yellow onion, peeled and chopped', '1 1/4 pound (600g) plum tomatoes, peeled and chopped or one 14-ounce can of diced tomatoes', '6 eggs', 'Salt and freshly ground pepper']",5,"['1 Cook the onions until golden: Heat olive oil on medium heat in a nonstick skillet. Add the onions and cook until translucent, just starting to turn golden in color, about 6 minutes.', '2 Add tomatoes, cook low and slow: Add the tomatoes and cook over low heat until the liquid evaporates, about 40 minutes.', '3 Add eggs: Whisk the eggs in a bowl until well blended. Season with a little salt and pepper. Add the eggs to the tomato and cook over medium heat, stirring constantly, and scraping from the bottom with a wooden spoon.', 'Remove from heat as soon as the eggs begin to set, but are still moist, about 3 minutes. Turn out onto a serving plate. Serve immediately.']",4
1235,Moqueca \xe2\x80\x93 Brazilian Fish Stew Recipe,10,35,45,"['Soup', '1 1/2 to 2 pounds of fillets of firm white fish such as halibut, swordfish, or cod, rinsed in cold water, pin bones removed, cut into large portions', '3 cloves garlic, minced', '4 tablespoons lime or lemon juice', 'Salt', 'Freshly ground black pepper', 'Extra virgin olive oil', '1 cup chopped spring onion, or 1 medium yellow onion, chopped or sliced', '1/4 cup green onion greens, chopped', '1/2 yellow and 1/2 red bell pepper, seeded, de-stemmed, chopped (or sliced)', '2 cups chopped (or sliced) tomatoes', '1 tablespoon paprika (Hungarian sweet)', 'Pinch red pepper flakes', '1 large bunch of cilantro, chopped with some set aside for garnish', '1 14-ounce can coconut milk', 'Rice', '1 tablespoon extra virgin olive oil', '1/2 onion, chopped', '1 clove garlic, minced', '1 cup white rice', '1 3/4 cups boiling water (check your rice package for the appropriate ratio of liquid to rice for the type of rice you are using)', '1 teaspoon salt']",22,"['1 Coat fish with garlic and lime juice: Place fish pieces in a bowl, add the minced garlic and lime juice so that the pieces are well coated. Sprinkle generously all over with salt and pepper.', 'Keep chilled while preparing the rest of the soup.', '2 Make rice for serving with soup: If you are planning on serving the soup with rice, start on the rice.', 'Bring a couple cups of water to a boil. Heat one Tbsp of olive oil in a medium saucepan on medium high heat. Add the chopped 1/2 onion and cook, stirring, until the onion is translucent. Add the garlic and cook for 30 seconds more, until the garlic is fragrant. Add the raw white rice and stir to coat completely with the oil, onions, and garlic.', 'Add the boiling water. (The amount depends on your brand of rice, check the package. If no amounts are given, add 1 3/4 cup of water for every cup of rice.) Stir in 1 teaspoon of salt.', 'Bring to a simmer, then lower the heat, cover, and let cook for 15 minutes, after which, remove from heat until ready to serve with the soup.', '3 Start cooking the onion, bell pepper, tomatoes, onion greens: In a large covered pan (such as a Dutch oven), coat the bottom with about 2 Tbsp of olive oil and heat on medium heat.', 'Add the chopped onion and cook a few minutes until softened. Add the bell pepper, paprika, and red pepper flakes. Sprinkle generously with salt and pepper. (At least a teaspoon of salt.) Cook for a few minutes longer, until the bell pepper begins to soften.', 'Stir in the chopped tomatoes and onion greens. Bring to a simmer and cook for 5 minutes, uncovered. Stir in the chopped cilantro.', ""4 Layer vegetables with fish, add coconut milk: Use a large spoon to remove about half of the vegetables (you'll put them right back in). Spread the remaining vegetables over the bottom of the pan to create a bed for the fish."", 'Arrange the fish pieces on the vegetables. Sprinkle with salt and pepper. Then add back the previously removed vegetables, covering the fish.', 'Pour coconut milk over the fish and vegetables.', '5 Simmer, cook, adjust seasonings: Bring soup to a simmer, reduce the heat, cover, and let simmer for 15 minutes. Taste and adjust seasonings.', 'You may need to add more salt (likely), lime or lemon juice, paprika, pepper, or chili flakes to get the soup to the desired seasoning for your taste.', 'Garnish with cilantro. Serve with rice or with crusty bread.']",15
1236,Saut\xc3\xa9ed Kale with Tahini Sauce Recipe,10,15,25,"['1 pound kale, well rinsed', '2 tablespoons extra virgin olive oil', '1 cup chopped onion', '1 clove garlic, minced', 'Salt', '4 tablespoons tahini (use tahini made with toasted sesame seeds, not raw)', '2 tablespoons lemon juice', '3-4 tablespoons water', '1 teaspoon dark sesame oil', '1 tablespoon toasted sesame seeds for garnish']",10,"['1 Remove kale ribs, slice kale: Using a sharp paring knife, cut out the rib of each kale leaf. Discard or compost. Slice the leaves roughly 1/2-inch thick.', '2 Cook onion and garlic: Heat olive oil on medium high heat in a large saut\\xc3\\xa9 pan. When hot, add the chopped onion. Cook for a couple of minutes until translucent. Add the garlic and cook for a minute more.', '3 Add kale to the onions: Add the kale to the saut\\xc3\\xa9 pan. Even if you have a pretty large pan, the kale will be practically falling out of it. Put in as much as you can and use tongs to turn over and mix with the oil and onions.', 'After a couple minutes the kale should wilt a bit so you can add the rest of the raw kale.', 'Cook, turning the kale leaves over occasionally until the kales leaves have wilted and are tender. Sprinkle a little salt over the kale leaves while cooking.', '4 Make tahini sauce: While the kale is cooking, whisk together the tahini, lemon juice, water, 1/2 teaspoon of salt, and dark sesame oil. Add more salt and sesame oil to taste.', '5 Toss cooked kale with sauce: Once the kale is done, toss in the sauce, reserving a little to drizzle on top.', 'Serve, topped with a little sauce and toasted sesame seeds.']",8
1237,Banana Sheet Cake Recipe,20,20,40,"['Cake', '2 cups all purpose flour', '1 teaspoon baking soda', '1 teaspoon cinnamon', '1/2 teaspoon salt', '1/2 cup (1 stick) unsalted butter', '1 cup white granulated sugar', '1/2 cup brown sugar', '2 eggs', 'The scraped insides of one vanilla bean, or 1 teaspoon of vanilla extract', '1 cup of mashed ripe bananas (2 large or 3 medium bananas)', '1/2 cup full fat sour cream', 'Frosting', '6 ounces cream cheese, room temp', '4 Tbsp (1/4 cup) unsalted butter, room temp', '2 cups powdered sugar', '1 teaspoon vanilla extract', '1 teaspoon lemon juice']",18,"['1 Preheat the oven to 350\\xc2\\xb0F (175\\xc2\\xb0C) . In a medium bowl, whisk together the flour, baking soda, cinnamon, and salt.', '2 Beat together in a mixer the butter and sugars. Beat in the eggs one at a time. Mix in the vanilla and mashed bananas.', '3 Mix in half of the flour mixture, then the sour cream, then the other half of the flour mixture.', '4 Spread batter evenly in a greased 10x15 baking pan. Bake at 350\\xc2\\xb0F (175\\xc2\\xb0C) for 20 minutes, or until nicely browned and the surface bounces back when you press it with your finger. Cool completely before frosting.', '5 To make the frosting, mix all of the ingredients together with an electric mixer. If too stiff to spread, add a teaspoon or two of water. Spread the frosting evenly over the cake and slice to serve.']",5
1238,Grandma\xe2\x80\x99s Zucchini Cake Recipe,15,45,60,"['Cake:', '2 cups flour', '2 teaspoons cinnamon (can sub 1 teaspoon with other spices such as allspice and nutmeg, go easy on the cloves though)', '2 teaspoons baking soda', '1 teaspoon salt', '1/4 teaspoon baking powder', '3 eggs', '2 cups white, granulated sugar', '1 cup vegetable oil', '1 teaspoon vanilla extract', '1 teaspoon grated lemon zest (optional, my addition)', '2 cups (from about 3-4 regular sized zucchini) grated un-peeled zucchini (place grated zucchini in a sieve and press out some of the excess moisture before measuring)', '1 cup chopped walnuts or pecans (my grandmother recommends black walnuts)', '1/2 cup golden raisins (optional)', 'Frosting:', '3 ounces cream cheese, softened to room temperature (Philadelphia cream cheese recommended)', '1/4 cup butter, room temperature', '1 1/2 to 2 cups of powdered sugar']",18,"['1 Preheat oven to 350\\xc2\\xb0F. Butter a 9x12 or 9x13 baking pan (I used a pyrex pan).', '2 In a medium bowl, whisk together the flour, cinnamon, baking soda, salt, and baking powder. Set aside.', '3 In a mixer, beat the 3 eggs on high speed until frothy. Lower the speed and beat in the sugar, vegetable oil, vanilla, and lemon zest (if using). Stir in the flour mixture, a third at a time. Stir in the zucchini and chopped nuts and/or raisins.', ""4 Pour mixture into a 9x12 or 9x13 baking pan. Bake at 350\\xc2\\xb0F for 40 to 45 minutes. (My grandmother's notes say you can also bake in an angel food pan for 1 hour.) Remove from oven and let cool completely before frosting. (While the cake is cooling, let the frosting's cream cheese and butter sit at room temperature to soften.)"", '5 To make the frosting, beat together the cream cheese and butter. Add the powdered sugar and beat until smooth.', 'Frost the cake and serve. Store covered with aluminum foil.']",6
1239,German Chocolate Snack Cake With Coconut-Pecan Frosting Recipe,30,35,65,"['For the cake:', '2 cups (280 grams) all-purpose flour', '1/4 cup (21 grams) unsweetened cocoa powder', '1 teaspoon baking powder', '1/2 teaspoon baking soda', '1/2 teaspoon kosher salt', '1 cup boiling water', '4 ounces unsweetened baking chocolate', '1/2 teaspoon espresso powder, optional (for deeper chocolate flavor)', '2 cups (400 grams) granulated sugar', '4 large eggs', '1 cup canola oil', '2 teaspoons vanilla extract', 'For the coconut pecan frosting:', '3 large egg yolks', '8 ounces evaporated milk', '1 1/2 cups (323 grams) lightly packed brown sugar', '4 ounces (113 grams, 1 stick) unsalted butter', '1 teaspoon vanilla', '1/4 teaspoon kosher salt', '2 1/2 cups sweetened, shredded coconut', '1 1/2 cups chopped pecans', 'Special equipment:', '9x13-inch baking dish']",24,"['1 Prep the oven and pan: Preheat the oven to 350\\xc2\\xb0F. Grease a 9x13 inch baking pan.', '2 Combine the dry ingredients: Sift the flour, cocoa, baking powder, soda, and salt into a large mixing bowl.', ""3 Make the batter: In a measuring cup combine the boiling water, chocolate, and espresso. Cover and let the hot water melt the chocolate, about 10 minutes, and whisk until smooth. Check the water with your finger; it's fine if it's still a little warm, but it should no longer be hot to the touch."", ""In a separate bowl (or in your measuring cup, if it's large enough), combine chocolate-water with the sugar, eggs, oil, and vanilla extract. Whisk to combine."", 'Pour the chocolate mixture into the flour mixture and beat, using a stand mixer or a hand mixer, until just combined. Stop periodically and scrape the bottom of the bowl.', '4 Bake the cake: Spread the batter into the pan and bake for 25 to 35 minutes or until the top springs back to the touch, the sides of the cake have pulled slightly away from the pan, and a toothpick inserted into the center comes out clean.', 'Leave the cake in the pan, and set it on a wire rack to cool completely before frosting, about 45 minutes.', '5 Make the frosting: Whisk together the egg yolks, evaporated milk, and brown sugar in a saucepan. Add the butter and warm over medium-high heat, stirring constantly until the mixture thickens, about 10 minutes. Remove from the heat and stir in the vanilla and salt, followed by the coconut and pecans.', 'The frosting should be thick, creamy, and nubbly with coconut and pecans.', '6 Finish the cake: Cool the frosting to room temperature and spread generously onto the cake. Serve the cake from the pan.', ""The cake can be made a few days ahead, but wait to top it with the coconut-pecan frosting until before serving. This cake is best served the same day it's frosted. Leftovers can be kept, covered, for 2 to 3 days at room temperature.""]",11
1240,Loaded Sheet Pan Nachos Recipe,10,7,17,"['For the nachos:', '1 tablespoon olive oil', '1 medium onion (about 1 cup), chopped', '1 pound ground beef (80-20 mix)', '1 teaspoon chili powder', '1 teaspoon coriander', '1/2 teaspoon dried oregano', '3/4 teaspoon Morton kosher salt (maybe more)', '1 (16-ounce) bag tortilla chips, preferably thick and sturdy', '1 bell pepper, cored, halved and chopped (about 1 cup)', '1 (15-ounce) can black beans, rinsed and drained', '1 cup frozen corn', '1 (2.25-ounce) can sliced black olives, about 1/4 cup', '1 to 1 1/2 cups grated cheddar cheese or shredded Mexican cheese blend', 'For garnish, optional:', '1 avocado, cubed', '2 scallions, green ends sliced thinly', '1 plum tomato, diced', '1/2 cup cilantro, chopped', '1 jalape\\xc3\\xb1o pepper, seeded and thinly sliced', '1/3 cup sour cream', 'For the cilantro-lime cr\\xc3\\xa8me:', '1 cup sour cream', 'Juice of one lime', '1/3 cup cilantro', 'Pinch of salt']",26,"['1 Preheat the oven to 400\\xc2\\xb0F.', ' 2 Cook the onions and beef: Heat the olive oil in a medium nonstick or cast iron skillet, and cook the onions for 5 minutes until they start to soften.', 'Add the beef, chili powder, coriander, oregano and kosher salt. Break the beef up with a wooden spoon and cook until it browns, about 8 to 10 minutes. Remove from the heat and set aside.', '3 Line the pan with tortilla chips: This is not an exact science\\xe2\\x80\\x94I probably used 6 to 8 handfuls of tortilla chips to line the sheet pan. You want them close and touching and mostly in one layer, but not too high.', '4 Add the beef: Using a slotted spoon to drain off the fat, transfer the beef to the pan with the chips, scattering it evenly across the pan. Be generous\\xe2\\x80\\x94you\\xe2\\x80\\x99ll use it all up.', '5 Add the toppings: Add the bell pepper, black beans, corn, black olives, and cheese.', '6 Bake the nachos: Bake the nachos in the oven for about 5 to 7 minutes, or until the cheese melts and becomes bubbly.', '7 Make the cilantro lime cr\\xc3\\xa8me: While the nachos bake, place the sour cream, lime, cilantro, and salt into the bowl of a food processor fitted with the blade. Process until the ingredients become smooth and there are no lumps. Taste and add more salt if necessary.', 'If you don\\xe2\\x80\\x99t want to bother with your food processor, you could finely chop the cilantro and stir it into the sour cream with the lime juice and salt.', '8 Drizzle the cr\\xc3\\xa8me and serve: Remove the sheet pan from the oven and sprinkle with the fresh cilantro. Using a spoon drizzle the cr\\xc3\\xa8me across the top of the nachos.', 'Serve the pan as is right on the table with little bowls of the garnishes alongside.']",11
1241,Sheet Pan Ranch Pork Chops Recipe,10,60,70,"['For the homemade ranch mix:', '2 tablespoons dried parsley', '1 tablespoon dried chives', '1 tablespoon dried dill', '1 tablespoon granulated onion', '1 tablespoon granulated garlic', '1 tablespoon kosher salt', '1 teaspoon black pepper', 'For the sheet pan pork chops:', '4 pork chops (boneless or bone-in, 1 1/2 to 2 pounds total)', '1 cup buttermilk', '4 tablespoons ranch seasoning mix, divided', '8 ounces cremini mushrooms, halved', '4 medium carrots, peeled and roughly chopped (about 2 cups)', '1 pound new potatoes, halved', '2 tablespoons olive oil']",16,"['1 Preheat the oven to 400\\xc2\\xb0F.', '2 Make the ranch mix: Stir together dried seasoning ingredients in a small bowl and set aside. The recipe won\\xe2\\x80\\x99t use the entire mix, so store leftover seasoning mix in an airtight container in the pantry for up to three months.', '3 Prepare the pork chops: Stir 3 tablespoons of ranch seasoning mix with one cup of buttermilk. Add pork chops and allow to marinate for at least 20 minutes, but you could do it a day in advance as well.', '4 Roast the veggies: Add vegetables to a medium bowl. Drizzle them with olive oil and toss with 1 tablespoon of ranch seasoning mix. Spread the vegetables out on a sheet pan. Bake for 20 minutes.', '5 Add the pork chops: Remove sheet pan and stir veggies. Remove pork chops from the marinade and pat them dry. Then nestle pork chops into the veggies on the sheet pan. Try to make sure everything is in a single layer, but it\\xe2\\x80\\x99s okay if the veggies stack a bit.', 'Sprinkle the sheet pan with a little extra ranch seasoning mix, about 1 teaspoon.', '6 Bake the pork chops: Bake pork chops with the veggies for 10 minutes, and then turn them and add another teaspoon of seasoning to the pork chops. Bake them for another 10 minutes and then check them with a meat thermometer. They should reach 145\\xc2\\xb0F in the thickest part; keep in mind they will continue to cook after you remove them from the oven.', '7 Serve the pork chops: Let the sheet pan rest for five minutes before serving, then divide vegetables and pork chops between plates.', 'Leftovers will store great in the fridge for 4 to 5 days. For best results, reheat in a 350\\xc2\\xb0F oven until warm. You can also microwave in 30-second bursts.']",9
1242,Sheet-Pan Harissa Chicken with Carrots and Cauliflower Recipe,15,1530,1545,"['1/4 cup harissa paste (See Recipe Note if using harissa powder)', '2 to 4 tablespoons olive oil, divided', '1 teaspoon ground coriander', '1 teaspoon ground cumin', '8 bone-in chicken pieces (about 2 1/2 pounds), thighs, legs, breasts, or a mix', '1 medium head cauliflower', '1 large sweet onion', '4 medium carrots', '1 lemon, very thinly sliced', '1 teaspoon salt, divided', '1/2 cup water', '2 tablespoons chopped fresh cilantro', 'Cooked rice or pasta (thin spaghetti works well) to serve']",13,"['1 Make the marinade: In a bowl, stir the harissa paste with 2 tablespoons of the olive oil, coriander, and cumin. The mixture should form a paste that just drops off the spoon. Stir in the remaining olive oil, if needed, a little at a time.', '2 Marinate the chicken: If using thighs or legs, trim the excess skin and fat; transfer the thighs or legs or breasts to a bowl. Add half the harissa mixture and turn the chicken until it is thinly coated all over.', 'Cover and refrigerate for at least 1 hour, or for up to 12 hours. Refrigerate the remaining marinade separately until needed.', '3 Prep the vegetables: Remove the green leaves from the cauliflower but do not core it. Cut the cauliflower into florets and stalks, and transfer them to a large rimmed baking sheet.', 'Peel and cut the carrots into 2-inch pieces. Cut the thinner pieces half down the length; cut the larger, thicker pieces into quarters. Peel and cut the onion in half and slice 1/4-inch thick.', '4 Cook the vegetables: Heat the oven to 425\\xc2\\xb0F. Combine the cauliflower, onions, carrots, and lemon slices on a sheet pan. Add dabs of the remaining harissa mixture here and there over the vegetables. Sprinkle evenly with 1/2 teaspoon of salt. Add the water to the edge of the pan.', 'Cover the pan with foil and cook the vegetables and the sliced lemons for 20 minutes. Remove and toss gently. Continue cooking for about 15 minutes, uncovered, or until the vegetables are almost tender when pierced with a skewer. Remove from the oven and turn again gently.', '5 Cook the chicken and vegetables: Increase the oven temperature to 450\\xc2\\xb0F. Set the chicken, skin side up, on the vegetables. Sprinkle evenly with 1/2 teaspoon of salt.', 'Continue cooking, uncovered, for 25 to 30 minutes, until the chicken is cooked through (breasts will register 160\\xc2\\xb0F on a meat thermometer; legs and thighs 180\\xc2\\xb0F). The vegetables will be very tender and are meant to be served quite soft.', '6 Serve: Remove from the oven, sprinkle with cilantro, and serve with rice or spaghetti.']",10
1243,Sheet Pan Chicken Fajitas with Peppers and Onions Recipe,15,30,45,"['For the marinade:', '1/4 cup freshly squeezed lime juice (from 1 to 2 limes)', '1/4 cup freshly squeezed orange juice (from 1 small orange)', '2 tablespoons pickling juice, from a jar of pickled jalape\\xc3\\xb1os (optional)', '1 tablespoon ancho chili powder (or chili powder blend)', '2 teaspoons dried oregano', '1 teaspoon ground cumin', '3/4 teaspoon salt', '3 tablespoons olive oil', 'For the chicken and vegetables:', '1 large red or yellow onion, cut into 1/4-inch thick slices', '2 large sweet bell peppers (red, yellow or green, or a combination), cut into 1/4-inch thick slices', '2 skinless, boneless chicken breast halves (about 1 1/4 pounds), cut into 1-inch strips', '8 to 12 corn tortillas', 'For garnish:', '1 avocado, sliced', 'Handful of fresh cilantro leaves', '1 lime, quartered', 'Cooked rice and/or beans', 'Special equipment:', 'A rimmed baking sheet']",21,"['1 Preheat the oven to 450\\xc2\\xbaF. Lightly oil a rimmed baking sheet.', '2 Make the marinade: In a medium bowl, whisk together the lime juice, orange juice, pickling juice, chili powder, oregano, cumin, and salt. Whisk in the olive oil. Pour half of the marinade into a separate bowl or cup, and set aside.', '3 Marinate the chicken: Add the chicken to the bowl with the marinade. Toss to coat, and set aside to marinate while the peppers and onions are roasting (about 15 minutes).', '4 Cook the peppers and onions: In the center of a sheet pan, mound the onions and peppers. Drizzle the reserved half of the marinade over them and toss to coat.', 'Spread them in one layer and roast for about 15 minutes, or until they begin to soften.', '5 Cook the chicken with the peppers and onions: Add the chicken strips to the pan with the softened vegetables, distributing them among the peppers and onions. Drizzle any excess marinade over the pan.', 'Bake for 15 minutes, or until the chicken is cooked through (at least 165\\xc2\\xbaF when measured with an instant read thermometer).', '6 Broil the chicken and vegetables to char them: Set a rack 3 to 4 inches from the broiler and turn on the broiler. Broil for 2 to 3 minutes, or until the chicken and vegetables are lightly charred.', '7 Warm the tortillas: Set a dry skillet over medium heat and heat until hot. Lay one tortilla at a time on the hot pan and turn, as above. Use 2 pans or a pancake griddle if you want to heat more than one at time.', 'Alternately, you can place a tortilla (one at a time) directly over a gas burner on medium-low heat for about 20 seconds, or until it starts to puff slightly. With tongs, turn it over and let it heat for a few more seconds on the other side.', 'The microwave also works. Just wrap 1 to 3 tortillas in a damp paper towel and microwave for 30 seconds, or until hot.', 'Wrap the warm tortillas in a napkin and set them on a plate.', '8 Serve the fajitas: Transfer the chicken and vegetables to a warm platter. Bring the platter and the warm tortillas to the table for people to help themselves. Serve with lime wedges, cilantro, and avocado. If you like, you could serve with rice and beans, too.']",13
1244,BBQ Chicken Sheet Pan Pizza Recipe,15,15,30,"['1 pound pizza dough, store-bought or homemade, room temperature (See Recipe Note)', '2 tablespoons olive oil', '2 cups cooked shredded chicken', ""1 cup BBQ sauce, such as Hunt's Hickory BBQ Sauce"", '6 ounces (about 1 1/2 cups) shredded mozzarella cheese, divided', '1/2 red onion, thinly sliced', '1 jalape\\xc3\\xb1o, thinly sliced']",7,"['1 Preheat the oven to 450\\xc2\\xbaF. Place a rack in the lowest position.', '2 Stretch the dough onto the baking sheet: Place the dough in the center of the baking sheet and drizzle with the oil. Turn the dough to coat it well, spreading some of the oil over the baking sheet.', 'Gradually stretch the dough until it reaches the edges of the baking sheet, being careful not to rip any holes in the dough. If it springs back or is difficult to stretch, this usually means that the dough is too cold. To remedy the situation, cover with plastic wrap and let rest for 10 minutes before continuing.', '3 Top the pizza: Mix together the shredded chicken and barbecue sauce in a bowl, then spread evenly over the pizza dough, leaving a little bit of a border around the pizza.', 'Sprinkle evenly with two-thirds of the cheese, scatter the red onion and then the jalape\\xc3\\xb1o, and then sprinkle with the remaining cheese. (I like to have cheese both under and over the toppings, but you can assemble it however you choose.)', '4 Bake the pizza: Set the pan on lowest shelf of the oven and bake until the cheese melts and the pizza is golden brown, about 15 minutes. Cut into squares and serve hot.']",6
1245,Meat Lovers\xe2\x80\x99 Sheet Pan Pizza Recipe,20,25,45,"['8 ounces Italian sausage', '2 pounds room temperature pizza dough, homemade or store-bought', '1/2 cup pizza sauce, homemade or store-bought', '1 pound mozzarella cheese, grated', '4 ounces ham', '4 ounces pepperoni slices', '1 red bell pepper, sliced thin', 'Dried parsley, garnish', 'Salt and pepper', 'Special equipment:', 'Rimmed quarter-sheet pan (9x13 inches)']",11,"['1 Preheat oven to 400\\xc2\\xb0F.', ' 2 Prep the sausage: The only thing you need to cook for the toppings is the sausage. Cook it in a medium skillet over medium heat until it\\xe2\\x80\\x99s cooked through, about eight minutes. Break up the sausage as it cooks.', '3 Shape the pizza crust: Roll the dough out on a lightly floured surface into a rectangle roughly the size of your quarter-sheet pan. Then lift and transfer it to the pan, and press it into the sides of the pan firmly to form a lip of dough.', 'Don\\xe2\\x80\\x99t be nervous about this step! Pizza dough is sturdy. Even if it tears a bit, just press it together in the pan and it\\xe2\\x80\\x99ll bake up fine!', 'Try to make sure the dough is an even thickness on the bottom of the sheet pan, but it doesn\\xe2\\x80\\x99t have to be perfect. Having some inconsistencies makes homemade pizza great.', '4 Top the pizza: Once the dough in the sheet pan, add the sauce in a thin layer. You can add more sauce if you like a saucier pizza, but I personally like a thin layer.', 'Then add the cheese followed by all the toppings. Finish the pizza with big sprinkles of dried parsley and season with salt and pepper.', '5 Bake the pizza for 20 to 25 minutes. It\\xe2\\x80\\x99s done when the crust around the edges is puffed and a deep tan color. The center should be bubbling hot and some of the cheese may have even browned a bit in spots.', '6 Cool and serve: Let the pizza cool slightly before cutting and serving. Slice into square-ish shaped pieces. Leftovers will keep for about a week. It\\xe2\\x80\\x99s best to reheat them in a covered skillet over low heat for a few minutes.']",9
1246,Classic King Crab Recipe,5,8,13,"['3-4 pounds Alaskan king crab legs and claws', '1 stick of butter', 'Lemon wedges for garnish']",3,"['1 Melt butter: Melt the butter in a small pan and keep warm on its lowest setting.', '2 Steam the crab legs: Set a steamer tray inside a large pot and pour enough water inside to steam the crab. Remember, you are only reheating the crab, so you will only need about an inch of water, tops. Bring this to a boil before laying the crab legs on the steamer. Cover the pot and steam for 5 minutes.', '3 Make cuts into crab shells: Remove the crab legs and use kitchen shears to cut the shells. You can either totally remove the meat from the shell or just get each one started for your guests. Serve with the melted butter.']",3
1247,Dungeness Crab Cakes Recipe,30,70,100,"['1 pound lump crabmeat, picked through and any bits of shell removed (try not to break up the lumps of crabmeat as you pick through it)', '1/2 stick (1/4 cup) unsalted butter, divided', '1/2 cup chopped shallots', '1 teaspoon kosher salt', '2 large eggs', '1 1/2 teaspoons Worcestershire sauce', '1 teaspoon sweet paprika', '1/2 teaspoon freshly ground black pepper', '2 tablespoons prepared tartar sauce', '1 teaspoon lemon zest', '1/4 teaspoon Tabasco sauce', '2 tablespoons chopped fresh parsley', 'About 4 slices white bread, crusts removed, torn into small pieces, yielding 2 cups', '2/3 cup fresh breadcrumbs']",14,"['1 Cook the shallots: Heat one tablespoon of butter in a small skillet over medium high heat. Add the shallots and a half teaspoon of salt.', 'Cook until the shallots are translucent, a couple minutes. Do not brown. Let the shallots cool.', '2 Make the crab cake mixture: Whisk together the eggs, Worcestershire sauce, remaining half teaspoon of salt, paprika, freshly ground black pepper, tartar sauce, lemon zest, Tabasco, parsley, and the cooked shallots.', 'Gently fold in the crabmeat and torn bread, taking care again to not break up the lumps of crab meat. The mixture will be very wet.', ""4 Form the crab cakes: Using your clean hands, take a scoop of the crab mixture and gently form it into a patty form about 2 1/4 inches across and 3/4 inches thick. Continue until you've made 12 crab cakes."", '5 Coat with breadcrumbs: Line a rimmed tray with a piece of wax paper just large enough to hold the cakes, and sprinkle the bottom of the tray with half of the bread crumbs.', 'Set the crab cakes in one layer on the top of the layer of breadcrumbs and sprinkle them with the remaining breadcrumbs.', '6 Chill: Cover the crab cakes loosely with another sheet of wax paper and chill in the refrigerator for at least one hour.', '7 Cook crab cakes: Heat the remaining 3 tablespoons of butter in a large nonstick skillet on medium-high heat until the butter melts and foams up.', 'When the foam subsides, working in batches, place the crab cakes in the pan (do not crowd the pan), and cook until golden brown, about 3 minutes on each side.']",10
1248,Spicy Crab Cakes with Horseradish Mayo Recipe,20,75,95,"['4-5 slices white bread', '3/4 cup chopped fresh parsley', '1 large egg yolk', '2 teaspoons lemon juice', '2 teaspoons Worcestershire sauce', '1 1/2 teaspoon Tabasco sauce', '2 tablespoons plus 1 teaspoon Dijon mustard', '1/2 teaspoon paprika', '1/2 teaspoon chopped fresh or dried thyme', '1/2 teaspoon celery seeds', '1/4 teaspoon freshly ground black pepper', '5 tablespoons extra virgin olive oil', '1/4 cup chopped onion', '1/4 cup chopped green bell pepper', '1/4 cup chopped red bell pepper', '1 pound cooked fresh Dungeness crabmeat, picked over and drained', 'Horseradish Mayo:', '1 cup mayonnaise', '2 tablespoons prepared horseradish (see how to make horseradish for a scratch version)', '2 tablespoons fresh lemon juice', '2 teaspoons grated lemon zest', '1/8 teaspoon freshly ground black pepper', 'Kosher salt']",23,"[""1 Make fresh breadcrumbs: Chop up the bread into big chunks and place in a food processor. Pulse until you have fine breadcrumbs. You'll need about 4 cups. Place the breadcrumbs in a shallow bowl and stir in 1/2 cup of the chopped fresh parsley. Clean out the food processor bowl."", '2 Process crab cake binder ingredients: Put the egg yolk, lemon juice, Worcestershire sauce, Tabasco, mustard, paprika, thyme, celery seeds and black pepper into the food processor. Pulse until blended.', 'While the motor is running slowly add a thin stream of olive oil through the feed tube until the sauce emulsifies. Remove from food processor to a large bowl.', '3 Make crab cake mixture: To the large bowl with the sauce, stir in the chopped onion, bell pepper, and remaining 1/4 cup of parsley. Gently fold in the cracked crab meat. Do not over mix! Gently fold in half of the breadcrumb mixture.', '4 Make patties, dredge in remaining breadcrumbs: Carefully form six crab cakes patties. Lightly dredge them in the remaining breadcrumbs.', '5 Chill: Cover with plastic wrap and refrigerate for at least an hour.', '6 Fry crab cakes: Heat 2 tablespoons of butter in a large non-stick skillet on medium heat. Working in batches, fry crab cakes gently 4 to 5 minutes on each side, until they are golden brown and heated through. Add more butter to the pan if necessary.', '7 Make horseradish mayo sauce: To prepare the horseradish mayonnaise, combine all ingredients in a small bowl and mix well. Taste and adjust seasoning. Cover and refrigerate.']",8
1249,Crab Cakes with Ginger and Lime Recipe,75,20,95,"['8 ounces fresh lump crab meat, well picked through to remove any bits of shell', '3 scallions, including green parts, finely chopped (about 1/4 cup)', '2 tablespoons finely chopped cilantro', '1 teaspoon freshly grated ginger root', '1 teaspoon finely grated lime zest', '1 teaspoon lime juice, plus a little more for sprinkling on at service', '1/2 to 1 teaspoon sriracha sauce, depending on how spicy you would like the crab cakes to be', '2 tablespoons mayonnaise', '2 tablespoons of panko breadcrumbs for crab mixture plus 3/4 cup of panko breadcrumbs for breading', '1/2 cup all purpose flour', '1 egg, beaten', '2 tablespoons extra virgin olive oil', '1 tablespoon butter', 'Lime slices for garnish']",14,"['1 Prepare crab cake mixture:  In a medium bowl, combine the scallions, cilantro, ginger, lime zest, lime juice, and mayonnaise. Stir in the lump crab meat and the panko to combine. Cover with plastic wrap and chill for 1 to 2 hours.', '2 Form into 1-inch round balls: Using your clean hands, form the crab mixture into 1-inch diameter round balls.', '3 Coat in flour, egg, and panko: Set out 3 bowls, one for flour, one for the beaten egg, and one for panko breadcrumbs. Roll each crab ball in first the flour, then the beaten egg, and finally the panko. Set aside on a plate.', '4 Cook crab cakes: Heat the oil in a large, heavy-bottomed saut\\xc3\\xa9 pan on medium high heat. Swirl in the butter.', 'After the butter has foamed up and melted, place the panko coated crab balls into the pan and press down gently with a metal spatula.', 'Do not crowd the pan, you may need to work in batches.', 'Cook a minute or two, until golden brown on one side, then gently turn the crab cakes over and cook until golden brown on the other side.', '5  Remove to a paper towel lined plate or to a sheet pan in a low oven to keep warm.', '6 Sprinkle with lime juice to serve, and serve with a slice of lime.']",9
1250,Vegetarian Shepherd\xe2\x80\x99s Pie with Carrots and Mushrooms Recipe,45,30,75,"['For the filling:', '1/4 cup + 2  tablespoons all-purpose flour', '4 tablespoons (1/2 stick) soft, unsalted butter', '3 1/2 cups low-salt vegetable stock or water', '1 cup white wine', '8 ounces baby carrots (about 2 cups)', '8 ounces cremini or button mushrooms, halved, or quartered if large (about 2 cups)', '4 stalks celery, cut into 1-inch lengths (about 2 cups)', '1 bay leaf', '1/2 teaspoon salt', '1/8 teaspoon pepper', '8 ounces green beans, cut into 2-inch lengths (about 2 cups)', '1 cup frozen pearl onions', '1 1/2 cups frozen peas', '1/2 cup whole milk or cream (optional)', 'For the topping:', '2 1/2 to 3 pounds Yukon gold potatoes (about 4 very large potatoes), peeled and cut into 2-inch pieces', '2 1/2 teaspoons salt', '1 cup milk', '3 tablespoons unsalted butter, cut into 2 or three pieces', '1/8 teaspoon ground black pepper', '2 1/3 cups grated sharp cheddar', '1/2 bunch scallions, finely chopped', '1/2 cup chopped fresh parsley', 'Special equipment:', '9x13 baking dish, or a 3-quart shallow baking dish']",26,"['1 Make the buerre mani\\xc3\\xa9: In a small bowl, stir the butter and flour together until blended and set aside.', '2 Cook the vegetables: In a large pot, bring the stock and wine to a simmer. Add the carrots, mushrooms, celery, bay leaf, salt, and pepper. Cook at a low boil for 15 minutes. Add the green beans to the pot and cook for 5 minutes longer, or until the vegetables are tender.', '3 Assemble the filling: With a slotted spoon, transfer the celery, carrots, green beans, and mushrooms to the baking dish, blotting each spoonful on a folded paper towel to drain excess liquid. Leave the broth in the pan.', 'Distribute the frozen onions and frozen peas over the vegetables in the baking dish. Remove the bay leaf.', '4 Make the sauce. Bring the reserved broth in the pot to a boil over medium heat. Stir in the beurre mani\\xc3\\xa9. Simmer the sauce, whisking often, until it has thickened. The beurre mani\\xc3\\xa9 will look clumpy at first but will quickly smooth out as the butter melts into the sauce.', 'If you would like a richer sauce, stir in the optional milk or cream. Taste and add more salt and pepper, if you like.', '5 Combine the sauce and vegetables: Pour the sauce over the vegetables in the baking dish. Stir gently to coat and set aside while you finish the topping.', '6 Heat the oven: Adjust the oven rack to the middle position and preheat the oven to 400\\xc2\\xb0F.', '7 Cook the potatoes: In a large pot, cover the potatoes with cold water and add 2 teaspoons of salt. Bring to a boil over high heat. When the water boils, adjust the heat to a simmer.', 'Simmer the potatoes for 12 to 14 minutes, or until tender when pierced with the tip of a knife. Drain the potatoes in a colander. Return the potatoes to the pot and set it over medium heat.', '8 Mash the potatoes: Stir the potatoes constantly for about 1 minute, or until the liquid in the pot evaporates and the potatoes look dry. Push them to one side of the pot and pour 1/2 cup of the milk into the empty space. Cook until the milk is hot, then add the butter pieces. (Hot milk makes the mashed potatoes fluffier.)', 'Mash the potatoes, milk, and butter with a potato masher. Gradually add enough additional milk to achieve a creamy consistency. Beat with a whisk to lighten the potatoes and smooth them out.', '9 Finish the potatoes: Add the remaining 1/2 teaspoon salt and the pepper. Stir in 2 cups of the cheese, scallions, and parsley. Taste and add more salt and pepper, if you like.', '10 Top and bake the pie: Spoon the potatoes over the vegetables in the baking dish. Use a fork to make swirls in the potatoes to create peaks and valleys. Sprinkle the top with the remaining 1/3 cup grated cheese.', '11 Bake: Bake for 30 minutes, or until the filling bubbles and the potatoes are golden. Let rest for 10 minutes and serve.']",15
1251,Healthy Shepherd\xe2\x80\x99s Pie Recipe,45,25,70,"['For the potato-cauliflower topping:', '1 1/2 pounds russet potatoes, peeled and cut into 1-inch pieces', '1 teaspoon kosher salt, plus more for salting the cooking water', '8 ounces cauliflower florets (2 heaping cups)', '2 tablespoons extra-virgin olive oil', '1/2 cup low-fat milk', 'Freshly ground black pepper', '1/2 cup shredded sharp or extra-sharp cheddar cheese (2 ounces)', 'For the filling:', '1 tablespoon extra-virgin olive oil', '1 large onion, diced', '2 large carrots, diced', '1 large celery stalk, diced', '2 large cloves garlic, minced', '1 1/2 teaspoons fresh thyme (or 1/2 teaspoon dried)', '1 pound extra-lean ground beef', '1 1/2 teaspoons kosher salt, plus more if needed', 'Freshly ground black pepper', '1 cup fresh or frozen English peas', '3 tablespoons tomato paste', '1/2 cup red wine (substitute chicken broth, if desired)', '1/2 cup low-sodium chicken broth', '1 tablespoon Worcestershire sauce']",23,"['1 Preheat the oven to 400\\xc2\\xb0F.', '2 Cook the potatoes and cauliflower: Put the potatoes into a medium saucepan and cover by 2 inches with cold water. Add enough salt so the water tastes pleasantly of the sea (about 2 teaspoons). Bring to a boil over high heat.', 'After 3 minutes at a full boil, add cauliflower and cook until the vegetables are tender enough to easily slide a knife through, another 4 to 6 minutes. Drain well and return to the cooking pot.', '2 Create the creamy mash: Add the olive oil, milk, salt, and several grinds of black pepper. Use a potato masher to blend everything into a creamy mash. Taste and add more salt or pepper as needed.', '3 Cook the vegetables and meat: Heat the olive oil in a large skillet over medium high. Add the onion, carrots, and celery, and saut\\xc3\\xa9 until they begin to soften, about 4 minutes.', 'Add the garlic, thyme, beef, salt, and a generous shower of freshly ground black pepper. Saut\\xc3\\xa9 until the meat is crumbly and no longer pink. Add the peas, tomato paste, wine, chicken broth, and Worcestershire sauce. Adjust the heat so the liquid simmers.', 'Simmer, stirring occasionally, until the liquid reduces slightly and the flavors brighten, about 10 minutes. Taste and add more salt if needed.', '4 Assemble the casserole: Transfer the meat and vegetable mixture to a baking dish, such as an 8-inch square baking pan, 9-inch round cake pan, or 1 to 1 1/2-quart oval baking dish. Spoon the cauliflower/potato mash evenly over the beef. Scatter the cheese on top.', '5 Bake: Set on a baking sheet and bake until the juices bubble and the top is lightly browned, about 25 minutes. Feel free to set briefly under a broiler to brown further.', 'Remove from the oven and serve.']",10
1252,Turkey Meatballs (That Aren\xe2\x80\x99t Dry!) Recipe,15,40,55,"['Meatballs', '1 tablespoon butter', '1 large shallot, minced (about 1 Tbsp)', '1 clove garlic, minced (about 1 teaspoon)', '6 ounces mushrooms (a mix of shiitake and cremini), finely chopped', '1 teaspoon herbes de Provence', '1 pound ground turkey meat (we prefer thigh meat)', '1 tablespoon chopped fresh parsley (plus more to sprinkle over when you serve)', '1 teaspoon Dijon mustard', '1/2 teaspoon balsamic vinegar', '1/4 teaspoon lemon zest (optional, if you have it use it)', '1 tablespoon mayonnaise', '1 teaspoon Kosher salt', '1/2 teaspoon ground black pepper', '1 tablespoon extra virgin olive oil', 'Optional Marinara Sauce', '1 tablespoon extra virgin olive oil', '1/4 cup minced onion', '2 cloves garlic minced (2 teaspoons)', '1 (28-ounce) can whole peeled tomatoes', 'Salt and pepper to taste']",21,"['1 Cook the shallots and mushrooms: Melt the butter in a small frying pan on medium heat. Add the minced shallots and cook gently for 3 to 4 minutes until softened.', 'Stir in the minced garlic and the mushrooms. Continue to cook on medium heat until the mushrooms are cooked through and have given up some, but not all, of their moisture.', 'Stir in the herbes de Provence. Remove from heat. Place in a bowl and quickly chill to cool.', '2 Make the meatball mixture: In a large mixing bowl, place the ground turkey, parsley, Dijon mustard, balsamic vinegar, lemon zest if using, mayonnaise, salt, black pepper, and the cooled mushroom shallot mixture.', ""Using your clean hands gently mix the turkey and other ingredients together until well combined. Don't over mix."", '3 Shape the meatballs: Form meatballs, 1 to 1 1/2 inches wide, depending on your preference. Smaller meatballs with be easier to serve as a one-bite appetizer, larger meatballs for a main dish. Place meatballs on a tray.', '4 Brown the meatballs: Heat olive oil in a large saut\\xc3\\xa9 pan on medium low to medium heat. Once the oil is hot, place the meatballs in the pan, allowing for space around each meatball.', ""Do not crowd the pan; if your pan isn't big enough, cook the meatballs in batches. Gently cook the meatballs until cooked through, turning them frequently so that they get lightly browned on all sides. If meatballs are not browning, increase the burner heat a little."", '5 Optional sauce. Heat a tablespoon of olive oil in a saut\\xc3\\xa9 pan on medium heat. Add the minced onions and cook until translucent, about 4 to 5 minutes. Add the garlic and cook for one minute more.', 'While the onions and garlic are cooking, pulse the canned tomatoes in their juices in a blender or food processor until chopped, but not completely smooth.', 'Add the tomatoes to the onion garlic mixture. Cook for ten minutes. Add salt and pepper to taste.', 'Add meatballs to the sauce. Simmer for a minute to warm the meatballs through. Sprinkle with a little chopped parsley to serve.']",12
1253,Mini Muffin Frittatas Recipe,15,35,50,"['2 large chard leaves, center ribs removed', '1 teaspoon salt for the blanching water', '1 Tbsp butter', '4-6 shiitake mushrooms (1.5 ounces total), minced', '1/4 cup minced shallots', '1 Tbsp chopped fresh oregano or 1 teaspoon of dried crumbled oregano', '2-3 Tbsp crumbled feta cheese', '8 large eggs, beaten', '1/4 teaspoon salt (more or less to taste)', '1/8 teaspoon ground pepper', 'Equipment needed:', 'Two 12-well mini-muffin tins, greased with a little butter or olive oil']",12,"['1 Blanch and chop the chard: Heat a couple quarts of water to boiling in a pot. Add a teaspoon of salt to the water. Add the chard leaves to the boiling water. Boil until just tender, 2-4 minutes. Remove from pot and rinse in cold water to stop the cooking. Squeeze out excess water. Then chop finely and set aside.', '2 Saut\\xc3\\xa9 shallots and mushrooms: Melt butter in a small saut\\xc3\\xa9 pan on medium heat. Add the minced shallots and mushrooms. Cook for 5 to 6 minutes until the shallots are translucent and the mushrooms are soft. Stir in the oregano.', '3 Add salt, pepper, to eggs, pour partially into muffin wells: Preheat oven to 325\\xc2\\xb0F (160\\xc2\\xb0C). Stir salt and pepper into the beaten eggs. Pour eggs into a measuring cup with a pouring edge or spout to make it easier to fill the wells of mini-muffin tins. Fill the wells a quarter of the way.', '4 Fill wells with fillings, top with remaining egg mixture: Distribute the mushroom shallot mixture, chard, and feta in even amounts throughout the muffin tin wells. Then top with the remaining egg mixture.', '5 Bake at 325\\xc2\\xb0F (160\\xc2\\xb0C) for 20 minutes. If you want, finish by browning under the boiler for a minute or two, until lightly browned.', '6 Let cool slightly in pan. Then loosen the mini frittatas from the pan using a wooden skewer.  Serve warm or at room temperature.']",6
1254,Slow Cooker Bourbon Short Ribs with Cheesy Grits Recipe,30,480,510,"['For the short ribs:', '1/2 cup all-purpose flour', '1 teaspoon salt', '1/2 teaspoon black pepper', '3 to 4 pounds bone-in beef short ribs', '3 tablespoons olive oil', '1 large shallot, sliced', '2 stalks celery, chopped', '2 large carrots, chopped', '2 cups beef broth', '1/4 cup bourbon', '1/4 cup brown sugar', '2 tablespoons Worcestershire sauce', '2 cloves garlic', '1 bay leaf', 'Orange zest, for garnish', 'For the cheesy grits:', '1 cup coarse ground corn grits', '4 cups chicken or vegetable stock', '1/2 teaspoon salt', '1/2 teaspoon black pepper', '2 tablespoons butter', '1 cup grated cheddar cheese', 'Special equipment:', '6-quart slow cooker']",25,"['1 Quickly brown the short ribs: Toss flour with salt and pepper and coat ribs well in the mixture.', 'Heat oil in a large skillet over medium-high heat. Add the short ribs and brown well on all sides, working in batches so as to not crowd the pan.', 'When the short ribs are browned well, transfer them to a slow cooker.', '2 Scrape up the pan drippings: Add the shallot, carrots, and celery to the skillet along with 1/2 cup of water. Use the liquid to scrape up any bits stuck to the pan.', 'Transfer the vegetables (they don\\xe2\\x80\\x99t need to be fully cooked) to the slow cooker along with any liquid from the skillet.', '3 Slow cook the short ribs and veggies: Add beef broth, bourbon, brown sugar, Worcestershire, garlic, and bay leaf to the slow cooker. Cover and cook on low for 8 hours (or high for 5 to 6 hours).', '4 Cook the grits: When there\\xe2\\x80\\x99s about thirty minutes left on the short ribs, heat the stock in a medium pot over medium heat until it\\xe2\\x80\\x99s simmering.', 'Whisk in corn grits in a steady stream. Turn the heat down to low, and cover the pot and simmer for about 20 minutes until grits are thick and tender. Stir regularly to prevent sticking.', 'The only way to truly know when grits are done is to taste them. If they are crunchy, keep going and if you need to add more liquid, then do so.', 'When the grits are soft, add salt, pepper, butter, and cheese and stir to combine. Keep warm until ready to serve. If the grits get too thick (they hold their shape if stirred and don\\xe2\\x80\\x99t flow back into a single layer), add water by the 1/4 cup to loosen the grits.', '5 Serve: Divide the grits onto between plates and top each plate with a short rib. Add the veggies and a few spoonfuls of juice from the slow cooker as well and garnish with fresh orange zest.']",11
1255,Strawberry Shortcake Recipe,15,25,40,"['Strawberries:', '3 baskets of fresh strawberries (about 6 cups)', '1/2 cup (100 g) white granulated sugar for the strawberries', 'Whipped Cream:', '1 cup (236 ml) of heavy whipping cream', '2 teaspoons powdered sugar', '2 drops of vanilla extract', 'Biscuits:', '3 1/4 cups (455g) all purpose flour, divided ( 3 cups and 1/4 cup)', '3 tablespoons sugar', '1 1/2 tablespoons baking powder', '3/4 teaspoon salt', '12 tablespoons (168g) unsalted butter, cut into small cubes', '1 cup (236 ml) milk', '1/4 (60 ml) cup heavy cream', '1 1/2 teaspoons vanilla extract']",16,"['STRAWBERRIES', '1 Prep the strawberries: Cut the stems away from the strawberries and discard. Cut the strawberries in half, and then either quarters or thick slices.', '2 Macerate the strawberries with sugar: Put the cut strawberries into a large bowl and sprinkle with sugar. Start with 1/4 cup of sugar and then add up to another 1/4 cup depending on how sweet your strawberries are. Gently stir the strawberries until they are all coated with some sugar.', 'Let sit at room temperature for about 20 minutes, until the berries soften and begin to release their juices.', '3 Mash some of the strawberries: After 20 minutes or so, mash about a quarter of the berries in the bowl with a potato masher and stir to mix.', ""You don't want to mash all the berries, just enough of them for their juices. Let sit while you bake the biscuits."", '4 Bake the biscuits using one of the recipes below.', '5 Make whipped cream: While the biscuits are baking, whip the cream using an electric mixer, adding a drop or two of vanilla and 2 teaspoons of powdered sugar. Cover with plastic and place in the refrigerator to chill until ready to serve.', 'To serve, break up one biscuit per person into big pieces into a bowl. Ladle strawberries over the biscuit. Add a dollop of whipped cream.', 'HOMEMADE BISCUITS', '1 Stir flour with dry ingredients: In a large bowl, vigorously whisk together 3 cups of the flour, the sugar, baking powder, and salt.', '2 Work in the butter: Cut the butter into the flour mixture, either using your fingers, a pastry cutter, a fork, or a food processor, until the largest pieces of butter are the size of peas.', '3 Add the wet ingredients: Stir together the milk and cream, add the vanilla extract. Make a well in the center of the flour and pour the milk mixture into it.', 'Mix with a fork or wooden spoon until the mixture is just combined. It should look rather shaggy. If it is too wet to work with, sprinkle some of the remaining 1/4 cup of flour over it. Gently knead by hand a few times to form a loose ball of dough, adding more flour if needed. It should be slightly tacky but not wet.', '4 Chill: Place the dough on a lightly floured surface and form it into an 8-inch square, about 3/4-inch to an inch thick. Place it on a parchment or silicone-lined baking sheet, cover with plastic wrap and chill for 20 minutes.', '5 Bake: Heat the oven to 425\\xc2\\xbaF. Remove the dough from refrigerator. Cut the dough into 9 even squares and space them about 2 inches apart from each other on the baking sheet.', 'Bake until the biscuits are medium golden brown, 18 to 20 minutes.', 'Makes 9 biscuits.', 'Bisquick biscuits:', 'For quick and easy shortcake biscuits using Bisquick baking mix, see our Bisquick shortcake biscuit recipe.', 'Gluten-free biscuits:', 'For flaky, fluffy, tender gluten-free biscuits, see our Gluten-free Biscuits Recipe.', 'Dairy-free vegan biscuits:', 'For easy, tender vegan shortcake biscuits, see our Dairy-free Vegan Biscuits recipe.']",24
1256,Blueberry Shortcake Recipe,10,30,40,"['Berries', '5 cups blueberries, fresh or frozen', '3/4 cup sugar', '1 teaspoon lemon zest', '1 Tbsp lemon juice', '1 pinch cinnamon', 'Biscuits', '2 cups all purpose flour', 'Pinch cinnamon', 'Pinch ground nutmeg', '2 Tbsp white granulated sugar', '1 Tbsp baking powder', '1/2 teaspoon salt', '8 Tbsp (1 stick) cold, unsalted butter, cut into 1/2-inch cubes', '7/8 cup (1 cup minus 2 Tbsp) heavy whipping cream', '1 large egg*', '1 tsp vanilla extract', 'Heavy cream for whipping', '*The egg is optional. Including the egg will result in a less crumbly shortcake biscuit, but either way, with or without egg, is good.']",19,"['1 Simmer blueberries, sugar, lemon, cinnamon: Place blueberries, sugar, lemon zest, lemon juice, and cinnamon into a medium saucepan. Heat until the sugar has melted and the mixture is just barely coming to a simmer.', 'Use a potato masher to mash some of the berries to help release their juices. Remove from heat and let come to room temp.', '2 Preheat the oven to 425\\xc2\\xb0F.', '3 Stir flour with dry ingredients, work in butter: In a large bowl stir together the flour, cinnamon, nutmeg, sugar, baking powder, and salt. Add the small cubes of butter, and use your fingers to rub the butter into the dry ingredients until the mixture resembles a coarse meal, with pea-sized pieces of butter still intact.', '4 Mix in wet ingredients: In a small bowl mix the egg, whipping cream, and vanilla extract. Form a well in the center of the dry ingredients and pour the wet mixture into it. Stir with a fork just until the dough barely comes together. Do not over mix or your biscuits will be tough.', '5 Form dough into rounds: Turn the dough out onto a clean, lightly floured surface. Form the dough into a large pancake shape, about 3/4 to 1-inch thick.', 'Using a pastry round (or the lightly floured ridges of drinking glasses) cut into biscuit forms and place 1 1/2-inches apart on a baking sheet lined with parchment paper or silpat.', ""You can also cut the biscuits into squares if that's easier. The the dough is too soft to work with, put it in the refrigerator to chill for about 15 minutes first."", '5 Bake the biscuits: Put the biscuits in the 425\\xc2\\xb0F oven for 12-15 minutes, or until they have risen and are lightly browned. Remove from the oven and let cool on a baking rack.', '6 Serve the berries spooned over biscuits that have been broken open, and top with whipped cream.']",10
1257,Strawberry Shortcake Sliders Recipe,20,40,60,"['Biscuits', '2 cups all purpose flour', '2 Tbsp granulated sugar', '1 Tbsp baking powder*', '1/2 teaspoon salt', '8 Tbsp (1 stick) cold, unsalted butter (if using salted, skip the salt in dry ingredients), cut into small cubes and chilled (freezer for 15 minutes or longer)', ""7/8 cup (that\\'s one cup minus 2 tablespoons) heavy whipping cream"", '1 large egg', '1 teaspoon vanilla extract', 'Strawberries', '2 baskets of fresh strawberries, rinsed, stems removed and discarded, sliced (1/8"" to 1/4"" thick)', '1/4 cup granulated sugar', 'Whipped Cream', '1 cup heavy whipping cream', '1 Tbsp granulated sugar', '1/2 teaspoon vanilla']",16,"['1 Whisk together flour, sugar, salt, baking powder, cut in butter: In a large bowl, vigorously whisk together the flour, sugar, salt, and baking powder for the biscuits. Cut the butter into the flour mixture with a fork or a pastry cutter, or pulse in a food processor until the largest pieces of butter are the size of peas.', '2 Stir in cream, egg, vanilla, knead to make biscuit dough: Use a fork to whisk together the cream, egg, and vanilla in a small bowl.', 'Make a well in the large bowl of the flour mixture and pour the cream mixture into the center of it. Use a fork to mix until the dough is evenly moistened. The dough mixture should look shaggy. If the dough is too wet to handle, sprinkle on more flour (up to 1/2 cup more) to the mix.', 'Knead the dough with your hands 8 turns or so to create a ball.', '3 Flatten dough, cut into biscuit shapes, chill: Lightly flour a smooth surface. Turn the dough out onto the surface and pat or roll out until it is between 1/2-inch and 3/4-inch thick.', ""Use a 1 1/2-inch diameter biscuit cutter (or a juice glass) to cut out round biscuit shapes from the dough. (It helps to dip the biscuit cutter in some flour before each cut, so that the dough doesn\\'t stick to the form.)"", 'Place rounds on a baking sheet, space about 1 1/2 to 2 inches apart from each other. Chill for 10 minutes in the refrigerator before baking.', '4 Bake biscuits: Heat oven to 425\\xc2\\xb0F. Bake biscuits on middle rack for 12 minutes, or until risen and lightly browned. Remove from oven and let cool.', '5 Macerate strawberries in sugar: While the biscuits are baking, prepare the strawberries and whipped cream. Place the sliced strawberries in a bowl and sprinkle sugar over them. Gently mix so that the sugar coats most of the strawberries.', 'Let sit until the sugar dissolves and the strawberries release their moisture.', ""6 Whip cream with sugar and vanilla: To make the whipped cream, make sure you are starting with cream that is very cold. It helps to chill the bowl first too. Use a hand mixer (you can make whipped cream in a blender, but watch out; it\\'s easy to over-whip the cream in a blender) to whip the cream until it just begins to firm up."", 'Sprinkle the sugar and vanilla over the cream. Continue to whip until it is thick and holds its shape.', ""Cover with plastic wrap and keep chilled until it\\'s time to assemble the mini strawberry shortcakes."", '7 Assemble strawberry shortcake sliders: When the biscuits have cooled to room temperature, gently break them apart, separating the tops from the bottoms.', 'Place a strawberry slice or two on each bottom, and place a dollop of whipped cream on top of the strawberries.', 'Then place the top biscuit piece on top of the whipped cream. Voil\\xc3\\xa1! You have your slider. Alternatively, you can serve them without the top.']",16
1258,Whole Wheat Strawberry Shortcake Recipe,35,25,60,"['For the strawberries:', '16-ounces strawberries, stemmed and sliced', '1 tablespoon sugar', 'For the shortcakes:', '3/4 cup whole wheat flour', '3/4 cup all-purpose flour', '2 tablespoons sugar', 'Zest of 1 medium lemon', '2 teaspoons baking powder', '1/2 teaspoon kosher salt', '6 tablespoons cold unsalted butter, cut into 1/2-inch cubes', '1 large egg', '1/2 cup low-fat Greek yogurt', '2 tablespoons milk (whatever you have in the fridge)', 'For the yogurt whipped cream:', '3/4 cup heavy cream', '3 tablespoons sugar', '1/2 teaspoon vanilla extract', '3/4 cup plain low-fat Greek yogurt (use nonfat or full-fat if you can\\xe2\\x80\\x99t find low-fat)']",19,"['1 Preheat oven to 350\\xc2\\xb0F.', '2 Macerate the berries: Toss together the sliced strawberries and 1 tablespoon sugar in a medium bowl. Set aside.', '3 Mix the dry ingredients: In a large bowl, whisk together the whole wheat flour, all-purpose flour, sugar, lemon zest, baking powder, and salt.', '4 Cut the butter into the dry ingredients: Add the butter and use a pastry cutter to incorporate it into the flour. Alternatively, use your fingers to pinch the pieces of butter one-by-one and toss them with the flour until your dough is crumbly, like gravel.', '5 Mix the wet ingredients and combine: In a medium bowl, whisk together the egg, 1/2 cup yogurt, and milk until smooth. Add the wet ingredients to the flour mixture and stir just until the dough comes together in clumps.', '6 Shape the cakes and bake: Turn the dough onto a large, lightly floured baking sheet and firmly pat it into a 5 1/2-inch square. Cut the dough into quarters and separate the four shortcakes so they have room to rise as they bake.', '7 Bake the shortcakes: Bake until lightly browned along the bottom, about 25 minutes. When the shortcakes are done, let them cool for at least 15 minutes before using a serrated edge knife to split them in half.', '8 Make the whipped cream: Put the heavy cream, sugar, and vanilla extract into the bowl of an electric mixer. Beat on high until stiff peaks form. Use a rubber spatula to gently fold the 3/4 cup yogurt into the whipped cream.', '9 Assemble the strawberry shortcakes: To assemble, divide the shortcake halves onto 8 small plates. Divide the strawberries among the cakes evenly and top with a generous spoonful of yogurt whipped cream.']",9
1259,Bang Bang Shrimp Tacos Recipe,30,20,50,"['For the bang bang sauce:', '1 cup mayonnaise', '1/4 cup chili garlic sauce', '1 teaspoon Sriracha sauce, optional', 'For the shrimp:', '1 1/2 pounds extra-large (26-30 count) shrimp, peeled and deveined', '1 cup buttermilk', '1 1/2 cups all-purpose flour', '1/2 cup cornstarch', '1 teaspoon kosher salt', '1/4 teaspoon black pepper', '6 cups vegetable oil for frying', 'For serving:', '10 taco-sized flour tortillas, warmed (or Bibb lettuce leaves)', '8 ounces shredded cabbage, about 3 cups', 'Thinly sliced radishes', 'Thinly sliced jalape\\xc3\\xb1o peppers', 'Sliced green onions', 'Chopped cilantro']",19,"['1 Make the bang bang sauce: In a bowl, whisk the mayonnaise, chili garlic sauce, and sriracha together until blended. Store up to two days in the refrigerator until ready to use.', '2 Marinate the shrimp: In a separate bowl, marinate the shrimp in the buttermilk for 20 minutes.', '3 Prepare your breading station: Combine the flour, cornstarch, salt, and pepper in a medium bowl.', 'Set a cooling rack on top of a sheet pan on which to place the breaded shrimp prior to frying (this helps achieve a crispy coating on the shrimp).', 'Set up a draining station as well by lining another sheet pan with a thick layer of paper towels. (Or, if you have another cooling rack to set over the sheet pan, that\\xe2\\x80\\x99s even better!)', 'Set the oven to 200\\xc2\\xb0F.', '4 Bread the shrimp: While the oil heats, drain the buttermilk and toss the shrimp, in batches, in the flour mixture. Shake off any excess flour and arrange the shrimp on the cooling rack to \\xe2\\x80\\x9cdry out\\xe2\\x80\\x9d while you\\xe2\\x80\\x99re heating your frying oil.', '5 Heat the oil: Place a thermometer in a wide, deep pot, such as a Dutch oven, and add the oil. Heat over medium-high heat until the oil reaches 350\\xc2\\xb0F. (This will take about 20 minutes.)', '6 Fry the shrimp: Add a handful of the shrimp to the hot oil, and after a minute of frying, use a slotted spoon to stir and separate the shrimp; they like to stick together. Fry for 4 to 4 1/2 minutes, or until the shrimp are golden brown.', '7 Keep the shrimp warm and continue frying: Remove the shrimp from the oil with a slotted spoon and place them on your draining rack/pan. Place the cooked shrimp in the warm oven.', 'Continue frying the remaining shrimp in batches. Remember to let the oil come back up to 350\\xc2\\xb0F in between batches.', '8 Sauce the shrimp: Once all of the shrimp has been fried, toss it all in 1 cup of the sauce. Reserve the remaining sauce for drizzling on top of the tacos.', '9 Assemble the tacos: Fill the warmed tortillas with a handful of shredded cabbage, then top the cabbage with the shrimp, then more sauce (if desired). Garnish the tacos with sliced radishes, jalape\\xc3\\xb1os, green onions, and the chopped cilantro, then serve.', 'These tacos are best enjoyed right away.']",14
1260,Mexican Shrimp Cocktail Recipe,20,15,35,"['1 pound medium shrimp, raw or cooked', 'Salt', '1 cup chopped red onion', '1 cup peeled, diced cucumber', '1/2 cup chopped celery', '1 jalapeno, minced', '1 15-ounce can whole peeled tomatoes, chopped OR 1 1/2 cups of freshly chopped tomatoes with their juices', '1/2 cup ketchup', '1/4 cup chopped cilantro', 'Juice of a lime, about 2 Tbsp', 'Hot sauce (like Crystal or Tabasco) to taste (about 1 Tbsp to 1/4 cup of Crystal)', '1 avocado, cut into chunks']",12,"['1 Peel, devein, and cook raw shrimp (if using): If you have pre-cooked, peeled and deveined shrimp you can skip to the next step. If you are working with raw shrimp, peel and devein them.', 'If you have a little extra time and want your shrimp to be extra good, put the shells in 6 cups of cool salted water, bring to a boil, then strain the shell stock into a separate pot and cook the shrimp in that liquid.', 'If you want to skip that step, just bring a medium pot salted water to a boil (a Tbsp salt for 2 quarts of water), add the shrimp, and cook for 2-3 minutes, until just cooked through. Reserve a cup of the cooking water and chill it.', '2 Cut half of the cooked shrimp into chunks: Cut half of the shrimp into large chunks, leaving the other half whole (for a more attractive presentation).', '3 Toss with other ingredients, chill: Put the chopped shrimp in a bowl with the chopped onions, cucumber, celery, jalape\\xc3\\xb1o, tomatoes, ketchup, cilantro, lime juice and hot sauce. Gently stir to combine, and chill.', '4 Add some cooled shrimp cooking water: Once the cooking water has cooled at least to room temperature, add a little at a time to the shrimp cocktail, until the shrimp cocktail is the consistency you want (use clam stock or lightly salted water\\xe2\\x80\\x94a third of a teaspoon of salt dissolved into a cup of water\\xe2\\x80\\x94if you are starting with already cooked and peeled shrimp).', '5 Stir in salt, hot sauce, avocado: To serve, add salt and more hot sauce to taste and gently mix in the chopped avocados. Dip the whole shrimp in the cocktail and arrange them on top.', 'Serve in parfait glasses or in small bowls with tortilla chips on the side.']",8
1261,Shrimp and Grits Recipe,10,45,55,"['4 1/2 cups water', '1 teaspoon salt', '1 cup stone-ground white grits', '2 Tbsp unsalted butter', '2 ounces white cheddar cheese, shredded', '4 thick slices bacon', '1 cup chopped white or yellow onion', '1 cup chopped green pepper', '2 garlic cloves, minced', '1 to 1 1/2 pounds shrimp, peeled and deveined', '1 cup chicken stock', '3 green onions, chopped (white and light green parts only)', '2 Tbsp chopped parsley', 'Juice of a lemon, about 1-2 Tbsp']",14,"['1 Saut\\xc3\\xa9 bacon, render fat: Fry the bacon in a large saut\\xc3\\xa9 pan on medium heat until crispy. Remove the bacon and chop. Pour off all but about 3 tablespoons of the fat. Turn off the heat.', ""2 Boil the grits: Bring the water to a boil in a medium pot. Add the salt. Slowly pour the grits into the boiling water while you stir with a wooden spoon. Stir and pour gradually so you don't get any lumps. When all the grits are incorporated, turn the heat down to a low simmer and cook the grits, stirring often, for 35 minutes."", '3 Chop the shrimp: Reserve about 1/3 of the shrimp whole and cut the rest into 3-4 pieces each. Set aside.', '4 Saut\\xc3\\xa9 onions, peppers, bacon, garlic, shrimp: When the grits have cooked for 30 minutes, heat the saut\\xc3\\xa9 pan on medium high. When the bacon fat is hot, saut\\xc3\\xa9 the onion and green pepper over medium-high heat until soft, about 4 minutes.', 'Add the bacon, garlic cloves and shrimp and toss to combine. Let this cook another minute.', '5 Add stock, let boil to reduce: Add the chicken stock and let this boil down for 5 minutes.', ""6 Add cheese and butter to grits: Meanwhile, stir the cheddar cheese and butter into the grits. The dish might not need any more salt, but add some if you'd like."", ""7 Serve: To serve, spoon out some grits in individual bowls. Add to the shrimp the green onions, parsley and lemon juice to taste. Add salt if it needs it. Spoon some shrimp over the grits and make sure at least one whole shrimp is on everyone's plate. Serve at once.""]",8
1262,Ginger Sesame Garlic Shrimp Recipe,10,10,20,"['Marinade:', '1/4 cup soy sauce (use gluten-free soy sauce for gluten-free version)', '2 tablespoons seasoned rice vinegar', '2 teaspoons brown sugar', '2 tablespoons extra virgin olive oil', '1 teaspoon dark sesame oil', '3 cloves garlic, minced (about 1 Tbsp)', '1 Tbsp grated ginger', 'Shrimp:', '1 pound 16-20 count shrimp, peeled and deveined', '1 tablespoon peanut oil or canola oil', '3 green onions, including onion greens, sliced on the diagonal', '1 Tbsp sesame seeds, toasted']",13,"['1 Marinate the shrimp: In a medium bowl whisk together the soy sauce, seasoned rice vinegar, and brown sugar until the sugar has dissolved. Then whisk in the olive oil, sesame oil, minced garlic, and grated ginger. Place the shrimp in the bowl with the marinade. Toss to coat with the marinade and chill until ready to cook.', ""2 Toast sesame seeds: If you haven't already done so, toast the sesame seeds in a small saut\\xc3\\xa9 pan on medium high heat until lightly browned."", '3 Stir-fry shrimp and green onions: Heat cooking oil in a large stick-free saut\\xc3\\xa9 pan or wok (can use seasoned cast iron) on high heat. When the oil is shimmering hot, almost smoking, use a slotted spoon to move the shrimp from the marinade into the hot pan. (Watch out, it will splatter.) Stir-fry for a minute.', 'Add half of the sliced green onions. Continue to stir fry, turning the individual shrimp over if necessary, until the shrimp are pink and just cooked through. No more than 2 minutes max total cooking time, a minute on each side.', '4 Reduce marinade: Remove shrimp from pan and transfer to a serving bowl. Place the remaining marinade in the hot saut\\xc3\\xa9 pan and simmer it until it has reduced to a syrup.', '5 Pour sauce over shrimp, sprinkle with sesame seeds, green onions: Pour over the shrimp. Toss to coat. Sprinkle the shrimp with toasted sesame seeds and remaining green onions.', 'Serve immediately with rice, soba noodles, rice noodles, bok choy, spinach, broccoli, or asparagus.']",7
1263,Angel Hair Pasta with Shrimp and Parmesan Lemon Cream Sauce Recipe,10,15,25,"['3/4 cup heavy whipping cream', '1/4 cup chicken stock', '3 Tbsp lemon juice', '3/4 pound angel hair pasta (also called capellini)', 'Salt and black pepper', '1 pound raw medium shrimp, peeled and deveined*', '1/2 cup (loosely packed) chopped parsley', '1/4 cup (loosely packed) chopped chives', 'Zest of a lemon', '1/2 cup freshly grated parmesan cheese', '*To defrost frozen shrimp, place them in a bowl of cold water.']",11,"['1 Heat salted water for pasta: Bring a large pot of salted water to a boil. (1 Tbsp salt for every 2 quarts water)', '2 Simmer cream, stock, lemon juice: In a smaller pot, heat the cream, chicken stock and lemon juice to a low simmer. Simmer gently for 3 to 4 minutes.', '3 Add the angel hair pasta to the boiling water.', '4 Add the shrimp to the simmering lemon cream sauce. Stir well and add a pinch of salt and black pepper. The shrimp should cook in about the same time as the angel hair pasta, about 3 to 4 minutes.', 'Halfway through the cooking, stir in the parsley and chives.', '5 Drain pasta, combine with shrimp, sauce, zest, Parmesan: When the pasta is done, drain and put it in a large bowl. Stir in the shrimp and lemon cream sauce, the lemon zest, and most of the Parmesan.', 'Divide into servings, and top with the remaining parmesan.', ""Note, if the resulting mixture seems too dry, just add a little water or cream. If it seems too wet, don't worry, the pasta will absorb the sauce.""]",8
1264,Grilled Garlic Shrimp Skewers Recipe,15,10,25,"['1 pound 16-20 count large prawns, peeled and deveined (can still have tail on for presentation)', 'Extra virgin olive oil', 'Salt', '3 tablespoons butter', '3 cloves garlic, minced', '1/4 teaspoon kosher salt', '1 teaspoon minced chives for garnish', 'Special equipment:', 'Short bamboo skewers, about 20, soaked for 30 minutes in water before grilling']",9,"['1 Prepare grill: Prepare your grill for direct high heat, with one side of the grill as a cool side with no coals or flame.', '2 Thread shrimp on skewers: While the grill is heating, thread the pre-soaked skewers through the shrimp. Start at the tail and push the skewers through the middle and end of the shrimp. Brush shrimp with olive oil and sprinkle with salt.', ""3 Melt butter with garlic: Place butter and garlic in a microwave-safe bowl and heat in microwave until the butter has melted and is hot. (If you don't have a microwave you can also just melt the butter with the garlic in a small saucepan on the stovetop.)"", '4 Grill shrimp: Arrange skewers on grill so that the shrimp are over the coals or flame and the exposed bamboo skewer ends are over the cool side of the grill. Grill for about 2 minutes on each side.', '5 Serve basted with garlic butter: As soon as the shrimp are done, remove from grill and place in a serving dish. Baste generously with melted garlic butter. Sprinkle with chives to serve!', 'Serve immediately.']",6
1265,Peppery Garlic Prawns Recipe,10,65,75,"['4 cloves garlic, crushed', '1/2 teaspoon salt', '1 teaspoon crushed black peppercorns*', '1 teaspoon fresh lemon juice', '2 tablespoons brandy', '1 lb. raw medium-sized shrimp, shelled, de-veined and split (tails on or off)**', '1-2 tablespoons extra virgin olive oil', '2 tablespoons fresh chopped parsley', ""*Crushing the peppercorns can be done with a mortar and pestle. Or if you don't have a mortar and pestle, place the whole peppercorns in a small ziplock bag and place that bag inside another ziplock bag and smash with a hammer. Do this on a hard surface, if done on a wood surface, it can leave dents. The ziplock will also tear a bit, so take care not to lose the crushed pepper (why you double bag it)."", ""** Trader Joe's has great frozen uncooked, shrimp, shelled and de-veined with tails on. To defrost frozen shrimp, place in a bowl of ice water in the refrigerator.""]",10,"['1 Marinate the shrimp: Mix together the crushed garlic, salt, crushed peppercorns, lemon juice and brandy. Add the shrimp and marinate at least an hour or up to overnight in the fridge.', '2 Saut\\xc3\\xa9 the shrimp: Heat a heavy skillet over medium high heat and add olive oil. Add shrimp and garlic mixture and cook quickly, tossing shrimp. The longer the shrimp has been marinating, the less time it takes to cook.', 'Cook until the shrimp has turned opaque (generally only 2-3 minutes).', 'Garnish with chopped parsley.']",4
1266,Baked Shrimp in Tomato Feta Sauce Recipe,5,25,30,"['1 tablespoon extra virgin olive oil', '1 medium onion, chopped', '2 cloves garlic, minced', '2 14.5-ounce cans of diced tomatoes', '1/4 cup minced fresh parsley', '1 tablespoon minced fresh dill or 1 teaspoon dried dill', '1 to 1 1/4 pounds medium sized raw shrimp, peeled and deveined (can leave tails on), thaw if frozen', 'Pinch of salt, more to taste', 'Pinch black pepper, more to taste', '3 ounces feta cheese (about 2/3 cup, crumbled)']",10,"['1 Preheat oven to 425\\xc2\\xb0F.', '2 Saut\\xc3\\xa9 onions and garlic: Coat the bottom of a large, oven-proof skillet with oil and heat it on medium high heat. Stir in the onions and cook until softened, 3-5 minutes. Add the garlic and cook until fragrant, about 30 seconds more.', '3 Add tomatoes, simmer: Add the tomatoes and bring to a simmer, reduce heat and let simmer for 5-10 minutes, until the juices thicken up a bit.', '4 Add feta, shrimp, herbs, put in oven and bake: Remove from heat. Stir in the herbs, shrimp, feta cheese, and salt and pepper to taste. Place pan in oven and bake, uncovered, until shrimp are cooked through, about 10-12 minutes.', 'Serve immediately. Serve with crusty French or Italian loaf bread, pasta, or rice.']",5
1267,"Shrimp, Lemon, Spinach Linguine Recipe",15,30,45,"['8 ounces linguine pasta', 'Salt', '3 tablespoons extra virgin olive oil', '1 whole lemon, quartered lengthwise then thinly sliced, seeds removed', '1/2 cup sliced shallots', '1 tablespoon minced garlic', '1 pound peeled, deveined 26-30 count shrimp', '5 ounces baby spinach leaves', '1/4 cup freshly grated Parmesan cheese', 'Freshly ground black pepper']",10,"['1 Heat water for the pasta: Heat a large pot of salted water (2 quarts of water, 1 Tbsp salt) for the pasta.', '2 Brown the lemon slices: While the pasta water is heating, cook the lemon slices. Heat 2 Tbsp olive oil in a large saut\\xc3\\xa9 pan on medium high heat.', 'Add the thinly sliced lemons to the pan and cook until browned and softened, 7 to 8 minutes.', 'Remove from pan, set aside to cool. Once the lemon slices are cool, mince them.', '3 Start cooking the linguine: Once the pasta water is boiling, add the linguine pasta to cook.', '4 Saut\\xc3\\xa9 shallots and garlic: Add 1 Tbsp olive oil back to the pan you had used to cook the lemons. Heat on medium high heat. Add the sliced shallots. Cook until softened and lightly browned, about 4 to 5 minutes.', 'Add the garlic and cook a minute more.', '5 Cook the shrimp: Add the shrimp to the shallots and garlic and cook until pink on one side, then toss them to cook on the other side, about 2 minutes for each side.', '6 Add the spinach, lemon, some pasta water: Add the spinach and the minced lemon to the pan and toss to wilt the spinach. Add about 1/2 cup pasta water to the pan.', '7 Drain pasta, toss with shrimp and spinach: When the pasta is done, strain it and add it to the pan with the shrimp (if you have room, otherwise put everything in a separate bowl), toss to coat. Add salt and pepper to taste.', 'Serve immediately. Sprinkle with grated Parmesan cheese to serve.']",11
1268,Skillet Shrimp and Asparagus Recipe,15,15,30,"['1 tablespoon extra virgin olive oil', '1 tablespoon butter', '1 medium onion, quartered, thinly sliced (about 1 1/2 cups)', '4 cloves garlic, minced (about 4 teaspoons)', '1/2 pound small red skinned new potatoes, cut into 1/4-inch slices or small dice', 'Salt (to taste)', 'Pinch of black pepper', '1/2 cup water', '3/4 pound of asparagus, woody ends discarded, spears thinly sliced on the diagonal', '1 pound peeled and deveined shrimp (can leave tails on for presentation if you want), 16-20 count', '1 teaspoon lemon zest', '1 tablespoon lemon juice', '2 tablespoons minced chives or green onion greens']",13,"['1 Saut\\xc3\\xa9 onions and garlic:  Heat olive oil and butter in a large skillet on medium high heat. Add the sliced onions and cook for 2 to 3 minutes. Add the garlic, cook a minute more.', '2 Add potatoes, water, cover and cook: Add the potatoes and 1/2 cup water. Sprinkle with salt and pepper. Cover and cook for 5 minutes, until the potatoes are almost cooked through.', '3 Add asparagus: Add the thinly sliced asparagus, toss with the potato mixture, cover and cook for one minute.', '4 Add the shrimp, lemon juice, lemon zest, chives: Add the shrimp, lemon juice, lemon zest, and chives. Toss and cover and cook until shrimp is just cooked through, about 3 to 4 minutes. Add more salt or pepper to taste.']",4
1269,Cambodian Coconut Shrimp Soup Recipe,15,15,30,"['For the lemongrass paste', '3 stalks lemongrass (or the zest of 1 lime and 1 lemon, plus additional lime juice to taste)', '1 (3-inch) piece fresh turmeric (or substitute 1 tablespoon ground turmeric)', '1 (3-inch) piece fresh ginger', '1 shallot', '4 cloves garlic', '2 makrut lime leaves, finely sliced (optional)', 'For the soup:', '1 can (14-ounce) full-fat coconut milk, do not shake', '2 1/2 cups flavorful stock (fish, chicken, or vegetable)', '1 tablespoon fish sauce, such as Red Boat, plus more as needed', '1 tablespoon brown sugar', '3 medium zucchini, cut into 1-inch chunks', '8 ounces French green beans (haricots verts), trimmed and halved', '1 1/2 cups (9 ounces) cherry tomatoes, halved', 'Salt, to taste', '2 pounds shrimp, peeled and deveined', '1 large handful Thai basil leaves', 'To serve:', 'Cooked rice', 'Lime wedges']",21,"['1 Make the lemon grass paste: Peel away and discard the top outer layer of tough, fibrous leaves from the lemongrass, leaving the tender, lighter-colored inside layers. Cut this tender part into thin slices. Also peel and slice the turmeric, ginger, shallot, and garlic cloves.', 'Combine the lemongrass, turmeric, ginger, shallot, garlic, and lime leaves in a blender or food processor and process until the ingredients are finely chopped. Scrape down the sides of the blender as necessary. Set the paste aside.', 'This paste can be prepared in advance and kept refrigerated for up to a week.', '2 Separate the coconut cream from the milk: Do not shake the can of coconut milk. Open the top, and you should see a thick layer of coconut cream on top. Spoon this out of the can and transfer to a stock pot. Reserve the watery milk on the bottom.', ""If you don't see a clear layer of cream on top, then just add all the coconut milk at once."", '3 Cook the coconut cream and lemongrass paste: Over medium-high heat, bring the coconut cream to a simmer. Add the lemongrass paste and cook, stirring, for 1 to 2 minutes, or until the mixture is thick and fragrant.', 'Add the remaining coconut milk from the can, the stock, fish sauce, and brown sugar. Bring to a simmer.', '4 Cook the vegetables and shrimp: Add the zucchini and green beans to soup. Simmer for about 8 minutes, or until the vegetables are just barely tender.', 'Add the shrimp and the tomatoes, and cook for 3 to 4 minutes, or until pink and opaque. Stir in the basil leaves. Taste the soup and add additional salt, fish sauce, or brown sugar to taste.', '5 Serve: Ladle into bowls, and serve with rice and lime wedges. Leftovers will keep refrigerated for about 5 days.']",10
1270,"Shrimp with Olives, Tomatoes, and Orzo Recipe",10,25,35,"['8 ounces orzo pasta', '3 tablespoons extra virgin olive oil', '3 cloves garlic, minced', '1 pound ripe fresh tomatoes (about 4 medium tomatoes), chopped (about 3 cups)', '1 1/2 cups of chopped ripe black olives', '2 tablespoons capers (including caper juice)', '1/2 teaspoon salt', '1/2 teaspoon black pepper', '1 pound medium to large raw shrimp, peeled and deveined', '1 cup chopped fresh baby arugula (or 1/4 cup chopped fresh parsley)']",10,"['1 Cook the pasta: Put a pot of salted water (1 Tbsp of salt for 2 quarts of water) on to boil.When the pasta water is at a rolling boil, add the orzo. Once the water returns to a boil, the pasta should take about 8 to 10 minutes to cook to reach al dente (cooked but still a little firm to the bite).', 'While the water is heating and the pasta is cooking, cook the tomatoes and shrimp in the next steps.', '2 Cook the garlic and tomatoes: Heat 3 Tbsp oil in a large, wide saut\\xc3\\xa9 pan on medium heat. Add the garlic and cook until fragrant (about 30 seconds). Stir in the chopped tomatoes, increase the heat to medium high, and let cook for about 5 minutes.', '3 Add the olives, capers, salt, pepper: Stir the capers and chopped olives in with the tomatoes. Add 1/2 teaspoon each of salt and pepper.', '4 Add the shrimp: A few minutes before the orzo is ready, add the shrimp to the tomatoes and olives. Let the shrimp cook on one side for a couple minutes, then turn them over to cook for a minute or two on the other side.', 'Remove from heat as soon as the shrimp are almost cooked through.', '5 Drain the pasta, add to shrimp and tomatoes: When the pasta is al dente, drain it and stir it into the tomatoes and shrimp. Stir in the chopped arugula or parsley.']",7
1271,Shrimp with Zucchini Noodles and Lemon-Garlic Butter Recipe,30,15,45,"['4 to 5 medium zucchini', '1/2 to 1 teaspoon salt', '3 tablespoons butter', '2 cloves garlic, finely minced', '1 pound shrimp, peeled and deveined (I used 26/30 count shrimp)', '1/4 teaspoon black pepper', 'Zest from 1 lemon', '1 to 1 1/2 teaspoons fresh-squeezed lemon juice', 'Fresh chopped parsley, to garnish', 'Special equipment:', 'Vegetable peeler or mandolin', 'Large 12-inch skillet']",12,"[""1 Prepare the zucchini: Slice each zucchini down its length using a vegetable peeler or on a mandolin, creating long, thin ribbons. Stop when you get to the core, which doesn't peel well (and eat it as a snack!)."", 'Lay the noodles out on paper towels in a single layer and sprinkle them with salt. Leave them to \\xe2\\x80\\x9csweat\\xe2\\x80\\x9d for about 10 minutes.', '2 Melt the butter and steep the garlic: In a large skillet over medium heat, melt the butter. Tilt and swirl the pan gently to move the butter around. The butter will foam a bit, then begin to smell nutty and turn amber with small brown solids on the bottom.', 'Once this happens, immediately pour butter into a heat-proof bowl, jar, or cup. Use a spatula to scrape all of the browned bits into the bowl. Add the minced garlic to butter and set aside.', '3 Season the shrimp: Pat the cleaned shrimp with a paper towel to remove any excess moisture, then toss them with a heavy pinch of salt and 1/4 teaspoon pepper in a large bowl.', '4 Cook the shrimp: Wipe the skillet used to melt the butter clean. Return it to medium-high heat. When the skillet is hot (but not smoking) add just enough oil to coat the bottom of the pan.', 'Working in batches, cook the shrimp for about 2 minutes on each side. They should be pink and opaque, but not curled up too tightly. Transfer to a plate.', '5 Cook the zucchini noodles: Pat the excess moisture from the noodles. Place the skillet back over medium high heat, and add a bit of cooking oil (just enough to coat).', 'Toss the zucchini gently in the pan so that it just begins to lose its stiffness. You want it to be al dente, just like pasta. The whole process shouldn\\xe2\\x80\\x99t take more than 3 minutes.', 'Remove the pan from heat.', '6 Toss everything together and serve: Whisk lemon zest and juice into the brown butter and garlic. Off the heat, add the shrimp back to the pan with the zucchini and pour the lemon-garlic butter over top.', 'Toss to combine. Transfer to a serving platter or individual plates. Top with fresh parsley and serve.']",12
1272,Spring Shrimp Scampi with Peas and Mint Recipe,20,15,35,"['1 pound thin spaghetti', '3 tablespoons olive oil', '1 clove garlic, cut in half', '1 1/2 pounds large shrimp, peeled and deveined', '1/2 teaspoons salt, divided', '1/4 teaspoon black pepper', '1/2 teaspoon crushed red pepper, or more to taste', '1 cup (8 ounces) whole milk ricotta', '3 tablespoons chopped fresh parsley', 'Grated zest of 1 lemon', '1 1/2 cups (8 ounces) frozen peas, rinsed with cold water to defrost', '2 tablespoons whole fresh mint leaves']",12,"['1 Cook the spaghetti: Bring a large pot of salted water to a boil. Add the spaghetti and cook, stirring occasionally, for 8 minutes, or until the pasta is tender but still has some bite.', 'Scoop out 1 1/2 cups of starchy pasta cooking water with a heatproof measuring cup. Drain the spaghetti and, without rinsing, return it to the pan. Add 1/2 cup of the pasta cooking water and 1 tablespoon of olive oil; toss well and set aside. Reserve the remaining pasta cooking water.', '2 Cook the shrimp: In a skillet over medium-high heat, heat the remaining 2 tablespoons olive oil. When it is hot, add the garlic. Cook, stirring, for 1 minute. Add the shrimp, 1/2 teaspoon of the salt, black pepper, and crushed red pepper.', 'Cook, stirring constantly, for 2 minutes, or until the shrimp start to turn bright pink; they will not be fully cooked at this point. Scoop out and remove the garlic. Tip the shrimp and chili flakes into the pot with the pasta.', '3 Finish the dish: Set the pot of pasta over low heat. Add the ricotta, parsley, lemon zest, 1/2 teaspoon salt, and 1/2 cup of the remaining pasta cooking liquid.', 'Cook, stirring gently, until the liquid heats up and the shrimp are pink and cooked all the way through. Add more of the reserved pasta water if the mixture seems dry. Add the peas and mint and toss gently until the peas are hot.', '4 Serve: Divide among 4 shallow bowls and serve.']",7
1273,Baked Shrimp with Tomatillos Recipe,15,40,55,"['2 tablespoons extra virgin olive oil', '1 medium onion, chopped, about 1 cup', '1-2 jalapeno chiles, seeded, minced', '3 garlic cloves, thinly sliced', '1 lb tomatillos, chopped', 'Salt', '1/2 cup clam juice OR 1/4 cup water*', '1 pound shrimp, cleaned, deveined', '1 cup Cotija queso seco cheese (can substitute feta)', '1/4 cup chopped cilantro', 'Lime juice', 'Black pepper', 'Flour tortillas, to serve', 'An oven-proof saut\\xc3\\xa9 pan or cast iron pan', '*One time we made this we used tequila instead of clam juice, it was good too!']",15,"['1 Saut\\xc3\\xa9 the onions and jalape\\xc3\\xb1os: Heat oil in the pan you will use for baking. Add the onions and jalape\\xc3\\xb1os, cook for 5 minutes on medium high until the onions begin to brown. Add the garlic and cook a minute more.', '2 Add tomatillos: Add the tomatillos, reduce heat to medium and cook for 10 minutes, until the tomatillos are cooked through, but still hold their shape. Sprinkle salt over the tomatillos as they are cooking.', '3 Add clam juice: If using clam juice, add to pan, turn up the heat and reduce by half. If using water, just add the 1/4 cup of water without reducing.', '4 Add cheese and shrimp, bake in oven: Add the cheese and shrimp. Cook in a preheated 425\\xc2\\xb0F oven for 10 minutes.', ""5 Serve with cilantro, lime juice, black pepper: Remove pan from the oven. If using a pan with a handle, such as a cast iron frying pan, I recommend cooling the handle with ice for safety; it's so easy to forget that pan has just come out of the oven, and you grab the hot handle by mistake."", 'Right before serving, mix in the cilantro and sprinkle with lime juice and freshly ground black pepper.']",6
1274,Smoky Paprika Shrimp Skewers Recipe,40,8,48,"['2 tablespoons sweet paprika', '2 tablespoons smoked paprika', '1/2 teaspoon ground cumin', '2 garlic cloves, minced', '1/2 teaspoon Kosher salt', '1/2 teaspoon freshly ground black pepper', '2 Tbsp lime juice', '1/3 cup extra virgin olive oil', '1 pound of large shrimp, cleaned and peeled, tails on', 'Bamboo skewers']",10,"['1 Soak the skewers in water for at least a half an hour before grilling.', '2 Marinate the shrimp: In a large bowl whisk together the spices\\xe2\\x80\\x94the paprikas, cumin, garlic, salt, and pepper\\xe2\\x80\\x94and the lime juice and olive oil. Add the shrimp and toss to coat with the marinade. Keep chilled for half an hour to an hour.', '3 Grill the shrimp: Prepare grill for medium-high direct heat, or heat a grill pan. Thread the shrimp onto skewers (it helps to double thread with two skewers at a time to make it easier to turn over on the grill).', ""Baste the grill grates with some olive oil so that the shrimp don't stick to the grill."", 'Grill or cook the shrimp a few minutes per side (2-4, depending on the size of the shrimp), until the shrimp are just cooked through. Remove from grill and serve immediately.']",5
1275,"Ancho Chile, Shrimp, and Pasta Recipe",10,20,30,"['8 ounces long, thin pasta such as spaghetti or fettucini', 'Salt', '1/2 cup vegetable oil (grapeseed or canola)', '3 thinly sliced cloves garlic', '1 ounce (about 2 medium to large) dried ancho chiles, rinsed, seeded and deveined', '1/2 pound 21-25 count raw shrimp, peeled, deveined, and tails removed, the shrimp pieces cut into thirds', 'Black pepper', 'Freshly grated Parmesan', 'Lime or lemon juice, fresh squeezed']",9,"['1 Cook the pasta: Put a large pot of salted water on to boil for the pasta when you start this recipe. Once the water is boiling, add the pasta and cook until al dente.', 'While the water is coming to a boil and while the pasta is cooking, prepare the rest of the recipe as follows.', '2 Lightly brown the garlic: Heat oil in a small skillet on medium heat. Once the oil is hot, add sliced garlic. Cook until lightly browned, then remove with a slotted spoon to a large bowl.', '3 Fry sliced ancho chiles in oil: Thinly slice the ancho chiles (can chiffonade as you would with basil, just roll up into a cigar shape and slice crosswise). Add the sliced chiles to the hot oil and cook ONLY for 20 to 30 seconds.', 'Remove with a slotted spoon to the bowl with the garlic. Do not over-cook the chiles or they will get bitter.', '4 Cook shrimp in ancho chili oil: Add the raw shrimp to the pan with the now chile and garlic infused oil. Increase the heat to high, cook for a couple minutes, stirring frequently, until the shrimp is just turning pink. Remove from heat. Add the shrimp and oil to the bowl with the garlic and chiles.', '5 Combine pasta with shrimp, garlic, chiles, oil: Add the drained, cooked pasta to the bowl with the shrimp, garlic, chiles, and oil. Sprinkle with salt and black pepper and toss to combine.', '6 Serve: To serve, portion out into bowls, sprinkle with freshly grated Parmesan and a little lemon or lime juice.']",8
1276,Spicy Thai Soup with Shrimp Recipe,15,15,30,"['1/2 pound shrimp, peeled and deveined', '2 stalks lemongrass (see Recipe Note)', '6 cups water or shrimp stock', '4 cloves garlic, minced', ""2 Thai (bird's eye) chiles, sliced, or more to taste"", '1 lime, zested and juiced', '1 cup sliced button mushrooms', '1 teaspoon grated ginger', '1 teaspoon sugar', '2 teaspoons soy or fish sauce, or more to taste', 'To serve:', 'Cilantro leaves', 'Lime wedges']",13,"['1 Prepare the ingredients: If not already cleaned, peel and devein shrimp. (Shells can be used to make shrimp stock to use in this recipe instead of water.)', 'To prepare the lemongrass, cut off about 1 inch of the bottoms and 5 inches or so of the pointy tops. It should be about a foot long after you trim it. Peel off the tough outer layers until you reach the yellowish tender core.', 'Gently smash the lemongrass with the back of a knife, and tie each stalk into a knot to expose the various layers.', '2 Make the soup: Fill a medium pot with 6 cups water or shrimp stock. Add the lemongrass to the pot and cover. Place the pot over high heat, and bring to a boil. Reduce to a simmer and add the garlic, chiles, lime zest, mushrooms, ginger, sugar, and soy sauce (or fish sauce). Cook for 3 minutes.', '3 Cook the shrimp and adjust the seasoning: Add the shrimp to the pot and cook until pink and opaque, about 3 minutes. Add the lime juice.', 'Taste the soup and add more chiles, lime juice, and/or soy sauce as desired to adjust the spice, acidity, and saltiness, respectively.', '4 Serve the soup: Divide the soup among bowls and serve with cilantro leaves, more sliced chiles, and lime wedges.']",7
1277,Cauliflower Rice Bowl with Garlic Shrimp Recipe,15,15,30,"['1/4 cup olive oil, divided', '1/4 cup chopped red onion', '3 cups frozen cauliflower rice, store-bought or homemade', '1/4 cup lemon juice, divided', '1/4 teaspoon salt', '1/8 teaspoon ground black pepper', 'Finely grated zest of 1/2 lemon', '2 handfuls baby spinach leaves (about 2 cups, packed)', '8 cherry tomatoes, halved, or quartered if large', '2 tablespoons chopped parsley', '1 clove garlic, peeled and thinly sliced', '8 to 10 extra-large shrimp, peeled and deveined', '1/2 teaspoon paprika', '1/2 avocado, sliced (for garnish)']",14,"['1 Cook the onion and cauliflower rice: In a large skillet over medium heat, add 2 tablespoons of the oil. When the oil shimmers, add the chopped onion and cook, stirring, for 1 to 2 minutes, or until the onion softens.', 'Add the cauliflower rice and 1/4 cup water to the skillet. Cook, stirring often, for 5 minutes, or until the cauliflower loses its raw taste. Stir in 2 tablespoons of the lemon juice, salt, pepper, and lemon zest.', '3 Add the spinach and cherry tomatoes: Stir the spinach into the cauliflower and cook for 3 minutes, or until the spinach barely wilts. Stir in the tomatoes. Taste and add more salt and pepper, if you like. Remove from the heat and set aside while you cook the shrimp.', '4 Cook the shrimp: In a nonstick skillet large enough to accommodate the shrimp in one layer, add the remaining 2 tablespoons of oil and the garlic. Set the skillet over medium heat and cook for about 30 seconds, or just until the garlic sizzles. (Start by heating the garlic and oil at the same time in a cold pan to prevent the garlic from burning.)', 'Add the shrimp in one layer. Cook for 1 to 2 minutes on each side, or until the shrimp is opaque in the center. (Exact cooking time depends on the size of the shrimp.)', 'Remove the pan from the heat and sprinkle with the paprika. Stir in the remaining 2 tablespoons of the lemon juice and the parsley. Turn the shrimp to coat it well in the lemony, garlicky oil.', '5 Assemble the bowls: In two shallow bowls, divide the cauliflower rice. Top each with half the shrimp and garnish with slices of avocado. Serve warm or at room temperature.']",7
1278,Grilled Shrimp with Lemon Pepper Couscous Recipe,10,15,25,"['For the shrimp:', '1 pound large shrimp (31-35/pound) shelled', '1 tablespoon seafood dry rub', '1 tablespoon olive oil', 'Lemon Pepper Couscous:', '1 cup water', '1 tablespoon butter', '1 cup couscous', '1 teaspoon lemon pepper, or 1/2 teaspoon black pepper and 1 teaspoon lemon zest', '1 teaspoon fresh lemon zest', 'For the Saut\\xc3\\xa9ed Swiss Chard:', '1 bunch Swiss chard, stems removed', '1 tablespoon olive oil', '1/2 teaspoon lemon juice', '1/8 teaspoon table salt', 'Special equipment:', 'Long bamboo skewers']",17,"['1 Preheat the grill and make the rub: If using bamboo skewers, soak them in a bowl of water to prevent them from burning on the grill. Pre-heat the grill to medium-high heat, about 400\\xc2\\xb0F. In a small jar with a lid, toss together the seafood rub ingredients.', '2 Prepare the shrimp: Peel and devein shrimp if necessary. Then skewer shrimp on soaked bamboo skewers. Six shrimp per skewer is a good amount. Season shrimp liberally with seafood rub\\xe2\\x80\\x94you won\\xe2\\x80\\x99t use all of it.', '3 Oil the grill and grill the shrimp: Fold up a thick wad of paper towels. Using tongs, dip the paper towels in oil and rub the grill grates. Add the shrimp skewers to the freshly oiled grill grates. Cook for 2 minutes per side until they are just cooked through and have a few grill marks.', '4 Cook the couscous: In a small pot set over medium-high heat, bring water and butter to a simmer. When butter is melted, stir in couscous and remove from heat and cover with a lid. Let steam for five minutes to cook couscous. Then stir in lemon pepper and fresh lemon zest.', '5 Make the Swiss chard (optional Dad Add): Add olive oil to a large skillet over medium-high heat. When the oil shimmers, add Swiss chard and cook, stirring occasionally until Swiss chard wilts down\\xe2\\x80\\x94this should only take a couple of minutes. Add lemon juice and salt, toss to coat, and keep warm over low heat until ready to serve.', '6 Serve: Shrimp and couscous are best to serve right away. If you have leftovers, reheat shrimp in a skillet over low heat until warmed through. Do not microwave. Shrimp will keep in the fridge for a few days.']",6
1279,Skillet Shrimp Fajitas Recipe,10,15,25,"['  For the DAD ADD: Charred Serrano Salsa:', '2 serrano chiles', '1/2 cup medium red salsa, store-bought or homemade', '1/2 lime, juice only', 'Pinch of salt', 'For the shrimp fajita spice mix:', '2 teaspoons mild chili powder', '1 teaspoon kosher salt', '1 teaspoon ground black pepper', '1 teaspoon granulated onion', '1 teaspoon ground cumin', '1 teaspoon dried oregano', '1 teaspoon red pepper flakes, optional', 'For the fajitas:', '1 pound large shrimp, peeled and deveined (31/35 size)', '2 tablespoons olive oil, divided', '1 red pepper, sliced', '1 green pepper, sliced', '1/2 large red onion, sliced, about 1 cup', '10 medium flour tortillas', 'For the toppings:', 'Fresh avocado', 'Salsa', 'Fresh cilantro', 'Sour cream']",25,"['1 Make the salsa: Char the serrano chiles in a cast iron skillet over medium heat for 2 to 3 minutes per side, or grill over medium-high heat. Once cooked, cut the peppers in half and scoop out seeds. Then chop and stir into your favorite salsa along with lime and salt. It boosts the flavor and heat substantially!', '2 Season the shrimp: Mix up the spice mix of chili powder, kosher salt, black pepper, granulated onion, cumin, dried oregano, and optional red pepper flakes. Drizzle shrimp with 1 tablespoon of olive oil and toss with 2 tablespoons of spice mix. Stir well to combine and coat the shrimp.', 'Add 1 tablespoon olive oil to the peppers and onions, and sprinkle the remaining spice mix over them. Stir to coat.', '3 Cook the fajitas: To cook the fajitas on the stovetop, heat a large skillet over medium-high heat. If you\\xe2\\x80\\x99re grilling the fajitas, heat your grill to medium-high heat along with a grill pan.', 'Once hot, add veggies to the skillet or grill pan and cook for 5 to 6 minutes until vegetables soften and start to char in spots. Scoot the veggies to one side of the pan and add shrimp. Cook shrimp for 3 to 4 minutes, stirring regularly until they are cooked through. They will cook fast!', '4 Serve the fajitas: Smear the flour tortillas with some sour cream. Divide veggies and shrimp between tortillas (I like to serve 3 to 4 shrimp per tortilla). You can remove the tails prior to serving, or let each person remove their own tails. Top the fajitas with avocado, salsa,  fresh cilantro and/or sour cream.', 'Leftover fajitas filling will keep okay in the fridge for a day or two. I prefer to reheat in a skillet over medium-low heat until warmed through. I don\\xe2\\x80\\x99t recommend microwaving shrimp unless you want your microwave to forever smell like shrimp.']",7
1280,"White Bean, Tomato, and Shrimp Skillet Dinner Recipe",10,35,45,"['For the breadcrumbs (optional):', '2 tablespoons olive oil', '2 cups coarse bread crumbs, store-bought or homemade (see Recipe Note)', '1/4 teaspoon dried thyme', '1 pinch salt', '1 pinch ground black pepper', ' For the shrimp:', '2 tablespoons olive oil', '1 large fennel bulb', '1/2 onion, finely chopped', '2 cloves garlic, finely chopped', '1 celery stalk, finely chopped', '1/2 teaspoon dried thyme', '1/4 teaspoon salt', '1/4 teaspoon Aleppo, Maras, or other crushed red pepper', '2 15-ounce cans diced tomatoes', '2 15-ounce cans cannellini beans, rinsed and drained', '1/2 cup water, or as needed', '1 pound extra large (16 to 20 count) shrimp', 'Salt and pepper, to taste', '1/4 cup chopped parsley (for garnish)', '1 lemon, cut into wedges (for garnish)']",22,"['1 Toast the breadcrumbs (optional): In a large skillet over medium-high heat, heat 2 tablespoons of olive oil. Add the bread crumbs, thyme, salt, and ground black pepper. Cook, stirring constantly, for 5 to 6 minutes, or until the breadcrumbs are golden and crisp. Transfer to a bowl and wipe out the skillet with a paper towel.', '2 Prepare the fennel: If there are any brown spots on the outside of the bulb, use a vegetable peeler to remove them. Cut a sliver off the bottom of the fennel bulb, but leave the root intact to hold the wedges together. Slice off the stems close to the bulb, and reserve some of the fennel fronds for the garnish. Cut the fennel bulb into 8 wedges.', '3 Saut\\xc3\\xa9 the fennel: In the skillet over medium-high heat, heat 2 tablespoons of olive oil. Add the fennel wedges and cook for 5 to 6 minutes, turning them with tongs occasionally, until they are golden on the outside. Transfer the wedges to a plate.', '4 Cook the onions and seasonings: Return the skillet to the stove over medium heat, and add the onions, garlic, celery, thyme, salt, and crushed red pepper. Cook, stirring often, for 5 to 6 minutes, or until the vegetables soften.', '5 Add the tomatoes and simmer: Add the tomatoes, their juices, and 1/2 cup water to the pan. Bring to a simmer and nestle the fennel wedges into the tomatoes.', 'Cook for 12 to 14 minutes, turning the fennel with tongs occasionally, until the fennel is tender. If the liquid in the pan looks dry, add more water, a few tablespoons at a time.', '6 Add the beans and shrimp: Stir in the beans and return the stew to a simmer. Spread the shrimp on top, cover the skillet with a lid, and simmer at very low heat for 2 minutes.', 'With tongs, turn the shrimp over in the stew, cover the pan with a lid, and remove it from the heat. Let the shrimp cook in the residual heat for 2 to 3 minutes, or until they are opaque in the center.', '7 To serve: Transfer the stew to a serving dish, or serve it straight from the skillet. Sprinkle the breadcrumbs, parsley, and reserved fennel fronds over the top and finish it with a squeeze of lemon. Serve with additional lemon wedges.']",9
1281,Caprese Pasta Salad Recipe,10,15,25,"['1/2 pound small shaped pasta, such as orecchiette, farfalle, or campanelle', '1 tablespoon + 1/2 teaspoon Kosher salt', '1/3 cup olive oil', '3 to 5 garlic cloves, minced', '1 teaspoon freshly ground pepper', '1 pound (3 cups) cherry or grape tomatoes, halved', '8 ounces mozzarella, torn', '10 large fresh basil leaves, torn']",8,"['1 Cook the pasta: Bring a large pot of water to boil and add 1 tablespoon of kosher salt. Add the pasta and cook according to package instructions, or until the pasta reaches al dente stage. If the pasta is too soft or overcooked, it will break apart when mixed with the other ingredients.', '2 Make the sauce: In a large serving bowl, stir together the oil, minced garlic, pepper, and \\xc2\\xbd teaspoon kosher salt.', '3 Drain the pasta: When the pasta is done, drain it into a colander and tap it a few times to make sure you get most of the water off the pasta. Add the pasta to the bowl with the olive oil. Stir to coat.', '4 Bring it all together: While the pasta is cooling, slice the mozzarella in rounds, then tear those rounds into smaller pieces about the size of a nickel or a quarter, though they will range in shape and size. Don\\xe2\\x80\\x99t worry if the pasta isn\\xe2\\x80\\x99t completely cool. Just toss it a couple of times before you add the cheese. Add the torn cheese to the pasta. Slice the tomatoes in half, and tear the basil leaves, adding each as you go.', '5 To Serve: Give everything a quick stir to coat it in the olive oil, and you\\xe2\\x80\\x99re done! Serve cold, warm, or at room temperature.']",5
1282,Easy Saut\xc3\xa9ed Spinach Recipe,5,5,10,"['2 large bunches of spinach, about 1 pound', 'Extra virgin olive oil', '3 cloves garlic, sliced', 'Salt to taste']",4,"['1 Clean and prep the spinach: Cut off the thick stems of the spinach and discard. Clean the spinach by filling up your sink with water and soaking the spinach to loosen any sand or dirt. Drain the spinach and then repeat soaking and draining. Put the spinach in a salad spinner to remove any excess moisture.', '2 Saut\\xc3\\xa9 garlic: Heat 2 Tbsp olive oil in a large skillet on medium high heat. Add the garlic and saut\\xc3\\xa9 for about 1 minute, until the garlic is just beginning to brown.', '3 Add spinach to pan: Add the spinach to the pan, packing it down a bit if you need to with your hand. Use a couple spatulas to lift the spinach and turn it over in the pan so that you coat more of it with the olive oil and garlic. Do this a couple of times. Cover the pan and cook for 1 minute. Uncover and turn the spinach over again. Cover the pan and cook for an additional minute.', '4 Remove from pan and drain excess liquid: After 2 minutes of covered cooking the spinach should be completely wilted. Remove from heat.', 'Drain any excess liquid from the pan. Add a little more olive oil, sprinkle with salt to taste. Serve immediately.']",5
1283,Easy Swiss Chard Recipe,5,15,20,"['1 large bunch of fresh Swiss chard', '2 tablespoons extra virgin olive oil', '1 clove garlic, sliced', 'Pinch of dried crushed red pepper', '1/4 teaspoon of whole coriander seeds (optional)']",5,"['1 Prep the chard stalks and leaves: Rinse out the Swiss chard leaves thoroughly. Either tear or cut away the thick stalks from the leaves.', 'Cut the stalk pieces into 1-inch pieces. Chop the leaves into inch-wide strips. Keep the stalks and leaves separate.', '2 Saut\\xc3\\xa9 garlic and crushed red pepper flakes: Heat the olive oil in a saut\\xc3\\xa9 pan on medium high heat. Add garlic slices, crushed red pepper, and coriander seeds (if using), and cook for about 30 seconds, or until the garlic is fragrant.', '3 Add Swiss chard stalks: Add the chopped Swiss chard stalks. Lower the heat to low, cover and cook for 3 to 4 minutes.', '4 Add the chopped leaves: Add the chopped chard leaves, toss with the oil and garlic in the pan. Cover and cook for 3 to 4 more minutes. Turn the leaves and the stalks over in the pan.', 'If the chard still needs a bit more cooking (remove a piece and taste it), cover and cook a few more minutes.', 'Serve immediately.']",7
1284,Baked Acorn Squash with Butter and Brown Sugar Recipe,10,75,85,"['1 Acorn squash', '1 Tbsp Butter', '2 Tbsp Brown Sugar', '2 teaspoons Maple Syrup', 'Dash of Salt']",5,"['1 Preheat your oven to 400\\xc2\\xb0F (205\\xc2\\xb0C).', ""2 Prep the squash: If you have a microwave, microwave the squash for a minute each, to make it easier to cut. Stabilize the squash on a cutting board as best you can, stem end down if the stem is short enough, otherwise on the side. Using a sharp, sturdy chef's knife, carefully cut the acorn squash in half, from tip to stem. If on its side, the squash can rock back and forth, so take care as you are cutting it."", 'Use a sturdy metal spoon to scrape out the seeds and stringy bits inside each squash half, until the inside is smooth.', 'Take a sharp paring knife and score the insides of the acorn squash halves in a cross-hatch pattern, about a half-inch deep cuts.', ""Place the squash halves cut side up in a roasting pan. Pour 1/4-inch of water over the bottom of the pan so that the squash doesn't burn or get dried out in the oven."", '3 Add butter, salt, brown sugar, maple syrup: Rub a half tablespoon of butter into the insides of each half. Sprinkle with a little salt if you are using unsalted butter.', 'Crumble a tablespoon of brown sugar into the center of each half and drizzle with a teaspoon of maple syrup.', '4 Bake: Bake at 400\\xc2\\xb0F (205\\xc2\\xb0C) for about an hour to an hour 15 minutes, until the tops of the squash halves are nicely browned, and the squash flesh is very soft and cooked through.', ""It's hard to overcook squash, it just gets better with more caramelization. But don't undercook it."", '5 Remove from oven, spoon brown sugar butter sauce over squash: When done, remove the squash halves from the oven and let them cool for a bit before serving.', 'Spoon any buttery sugar sauce that has not already been absorbed by the squash over the exposed areas.']",11
1285,Mom\xe2\x80\x99s Stovetop Turkey Stuffing Recipe,30,150,180,"['Neck and giblets from 1 turkey to make a light stock (or 2 to 3 cups of chicken stock)', '1 cup walnuts', '1 loaf of day old French or Italian bread, cut into 3/4-inch cubes (about 10 to 12 cups)', '2 cups each, chopped onion and celery', '6 tablespoons unsalted butter', '1 green apple, peeled, cored, chopped', '3/4 cup currants or raisins', 'Several (5 to 10) chopped green olives (martini/pimento olives; pimento removed)', '1/4 cup chopped fresh parsley', '1 teaspoon poultry seasoning or ground sage (to taste)', 'Salt and freshly ground pepper (to taste)']",11,"[""1 Make turkey stock with giblets (or skip this step and use 2 to 3 cups chicken stock if you don't have giblets): Take the turkey giblets\\xe2\\x80\\x93heart and gizzard\\xe2\\x80\\x93and neck, and put them in a small saucepan. Cover with a few cups of water and add a little salt."", 'Bring to a simmer. Simmer for about an hour, uncovered. Strain the stock into a container for use with the stuffing. You should have 2 to 3 cups of stock.', 'Alternatively, you can use chicken stock or just plain water with this recipe.', '2 Prepare the walnuts: Place the walnuts in a small saucepan with enough water to cover them by an inch, and bring them to a boil. Boil them for 3 to 4 minutes. This will remove some of the tannins from the walnut skins. (The tannins can be bitter and also cause the stuffing to turn a dark color.)', 'Let the walnuts dry, then toast them by heating them in a frying pan on medium high heat for a few minutes, stirring until they are slightly browned (not burned). Or put them in the microwave on high until you can smell the aroma of them toasting, about a minute or two.', 'Let the toasted walnuts cool while you are toasting the bread, then roughly chop them.', '3 Toast the bread: Dry the cubed bread in the oven first. Spread the cubed bread on a baking pan and dry it in a 200\\xc2\\xb0F oven for 10 minutes. (If your cubed bread is already very dry, you can skip this.)', 'Heat a large saut\\xc3\\xa9 pan on medium heat. Melt 3 tablespoons butter in the pan, add the bread cubes, and stir to coat the bread pieces with the melted butter.', 'Then let them toast; only turn them when they have become a little browned on a side.', '4 Saut\\xc3\\xa9 onions and celery: In a large Dutch oven, saut\\xc3\\xa9 chopped onions and celery on medium high heat with the remaining 3 tablespoons butter until cooked through, about 5 to 10 minutes.', '5 Combine the stuffing ingredients: Add the bread, cooked chopped walnuts, chopped green apple, currants or raisins, olives, and parsley. Add one cup of the stock from cooking the turkey giblets or chicken stock (enough to keep the stuffing moist while you are cooking it). Add sage, poultry seasoning, salt, and pepper.', '6 Cook on low heat: Cover and turn heat to low. Cook for an hour or until the apples are cooked through. Check every 15 or 20 minutes or so and add water or stock as needed while cooking to keep the stuffing moist and keep it from sticking to the bottom of the pan.', ""You'll likely need to add at least one more cup of stock or water, if not two. The stuffing should not be crispy or crunchy, but softened, as it would be if it had been cooked entirely inside the turkey.""]",13
1286,How to Make Gluten-Free Biscuits Recipe,20,50,70,"['2 cups (about 300 g) gluten-free flour mix, preferably Bob\\xe2\\x80\\x99s Red Mill 1-to-1 Gluten-Free Baking Blend or another flour blend with xanthan gum', '1 tablespoon baking powder', '3/4 teaspoon baking soda', '2 tablespoons sugar', '1/2 teaspoon salt', '1/2 cup (8 tablespoons) very cold butter, cut into tablespoons and then cut in half, plus more to grease the pan', '3/4 to 1 cup cup cold buttermilk', '1 tablespoon melted unsalted butter', 'Special equipment:', '9-inch cast iron skillet, or 8x8 baking dish']",10,"['1 Combine dry ingredients: Mix flour, baking powder, baking soda, sugar, and salt in the bowl of a stand mixer fitted with a paddle attachment. ', '2 Add the butter: On the low speed, let the mixer break up the butter into smaller pieces; this should take about a minute. Stop the mixer and check; you still want visible pieces of butter about the size of marbles or even a little bigger. They will look like they are starting to flatten.', ""This dough is not a situation where we say the flour and butter should look like \\xe2\\x80\\x9cthe consistency of small peas.\\xe2\\x80\\x9d If some of the pieces haven't flattened, just press them between your fingertips to break them up a little bit\\xe2\\x80\\x94dime-sized pieces are fine."", '3 Add the buttermilk: Remove the bowl from the stand mixer and add 2 tablespoons of buttermilk. Using a fork, quickly mix the buttermilk into the flour to hydrate it.', ""Then, slowly mix in a scant 3/4 cup of buttermilk and combine with a fork until no streaks of flour remain. If the dough seems dry, add additional buttermilk a tablespoon at a time and incorporate before adding more. You don't want a wet dough."", '4 Gather the dough into a ball: On a floured surface, turn out the dough, which will look like a crumbly mess. It will come together when you begin to shape it into a ball. If for some reason (ambient humidity, variations in buttermilk thickness) the dough feels dry, add a couple of tablespoons of buttermilk to hydrate those dry bits.', '5 Fold the dough like a letter: Lightly press the dough (or roll it with a floured rolling pin) into a thick rectangular shape, about 4 inches by 6 inches. Fold one of the short ends of the dough toward the middle, and then the other, like a letter.', 'Rotate the dough 1/4 turn and roll it out, and fold it again into thirds. Repeat this process one more time, then wrap the dough in plastic wrap and refrigerate for 1/2 hour to an hour. (This process creates flaky layers; if you skip it, your biscuits will bake flat, like hockey pucks.) ', '6 Prep the oven and pan: Preheat the oven to 425\\xc2\\xb0F and prep a 9- or 10-inch cast iron pan or an 8x8 glass baking dish with either spray oil or grease with butter.', '7 Roll and cut out the biscuits: Remove the dough from the fridge and, using a rolling pin, gently roll it out to a rectangle about 6 inches by 9 inches and one inch thick. Using a 2 1/2-inch biscuit cutter that\\xe2\\x80\\x99s been lightly floured (this dough can be sticky), cut out about 6 biscuits by pressing the cutter straight down into the dough; if you twist them when you remove them, you\\xe2\\x80\\x99ll stunt their rise!', 'Reroll the scraps, reflouring the biscuit cutter if needed, and make more biscuits until all the dough is used up.', 'Transfer to the pan. You will have to nestle them close to each other, and that\\xe2\\x80\\x99s okay. You want them touching in order for them to rise better. Brush the tops with the melted butter.', '8 Bake: Bake the biscuits for 20 to 25 minutes until the tops look lightly brown around the edges. Check frequently to avoid burning.', '9 Cool and serve: Remove from the oven and brush the tops with melted butter. Let the biscuits cool in the pan for about 5 to 10 minutes before removing from the pan to a wire rack to cool completely. Try to wait the seemingly impossible 10 minutes before you eat one. They will continue to cook a little, firm up a little while cooling, and not burn your mouth. It\\xe2\\x80\\x99s all worth the wait.', 'These biscuits are best eaten warm out of the oven, but they do okay reheated in a toaster or low oven (300\\xc2\\xb0F) for up to 2 days. They get dried out pretty fast.']",15
1287,Baked Stuffed Artichokes Recipe,25,65,90,"['2 large globe artichokes', '4 slices lemon', '1 teaspoon lemon zest', '6 slices white bread', '1/2 cup grated Parmesan cheese', '1/2 cup chopped parsley', '6 cloves garlic, minced', '1 teaspoon fresh oregano, minced', '1/2 cup plus 2 tablespoons extra virgin olive oil', '1/8 teaspoon black pepper', '  1 bay leaf', '2 slices lemon', '2 cloves garlic, halved']",13,"['Bake for 1 hour at 375\\xc2\\xb0F (190\\xc2\\xb0C), or until a knife easily penetrates the heart of the artichoke or you can easily remove one of the outer petals. (Depending on the size of the artichoke baking time can vary from 50 minutes to 1 hour 30 minutes or longer.)', 'Remove the cover and broil for a minute or so, enough to get some browning on the top of the stuffing.', 'Remove artichokes to a serving dish to serve.']",3
1288,The Best Way to Boil Asparagus,5,5,10,"['1/2 pound asparagus (or up to a pound), thin, medium, or large', '1/4 teaspoon of salt', '1 garlic clove, cut in half (optional)', '1 strip of lemon peel (optional)']",4,"['1 Prep the asparagus: Snap or cut off any woody bottoms of the asparagus spears. If working with medium sized or large asparagus, if you want (for a fancy presentation) you can use a vegetable peeler to peel the outside of the lower inch or two of the asparagus.', '2 Heat water in a large skillet: Fill a large, wide skillet with about 3/4-inch of water. Add salt. Add the cut garlic and lemon peel if using. Bring the water to a boil on high heat.', ""3 Boil the asparagus: Add the asparagus in an even layer. If the water doesn't cover the asparagus, cover the pan. If using thin asparagus, cook only for 1 to 2 minutes. Medium asparagus, 5 minutes. Large asparagus 6 to 7 minutes."", '4 Rinse with cool water: Rinse briefly with cold water to stop the cooking and then transfer to a serving dish.', 'Sprinkle with salt and pepper, lemon juice and extra virgin olive oil or butter to serve.']",5
1289,Jalape\xc3\xb1o Cornbread Recipe,15,30,45,"['1 Tbsp canola oil', '1 cup cornmeal', '1 cup all purpose flour', '1 1/4 teaspoons baking soda', '1/2 teaspoon salt', '3/4 cup plain yogurt', '1/2 cup milk', '1 egg', '5 Tbsp unsalted butter, melted', '1/2 cup to 1 cup finely chopped, drained pickled jalape\\xc3\\xb1os or fresh jalape\\xc3\\xb1os (depending on how spicy you want your cornbread to be)', '1/2 cup fresh or frozen corn kernels', '1/2 cup grated Monterey jack or cheddar cheese']",12,"['1 Preheat the skillet: Put the canola oil in a 9 or 10 inch cast iron skillet and place the skillet in the oven. Heat oven to 400\\xc2\\xb0F with the skillet inside.', '2 Whisk together the dry ingredients: In a large bowl, whisk together the cornmeal, flour, baking soda and salt.', '3 Whisk together the yogurt, milk, egg: In a separate bowl, whisk together the yogurt, milk, and egg.', '4 Combine wet with dry and add the butter, chiles, corn, and cheese: Pour the wet ingredients into the bowl of dry ingredients and stir to combine.', 'Stir in the melted butter, the chopped jalape\\xc3\\xb1os, corn, and cheese.', '5 Pour batter into hot skillet: Once the oven has reached 400\\xc2\\xb0F and the skillet is hot, carefully remove the empty skillet from the oven (double up the pot holders, the handle is hot!).  Pour the cornbread batter into the skillet, and smooth the surface with a wooden spoon or spatula.', '6 Bake: Return the skillet to the oven and bake for 20 to 25 minutes, until lightly browned on top and a skewer inserted into the center comes out clean.', ""7 Let rest before cutting: Let the jalape\\xc3\\xb1o cornbread rest in the skillet for 10 to 20 minutes before cutting wedges and serving. Remember that the skillet is still very HOT. I recommend keeping a pot holder draped over the handle, or rubbing the handle with ice to cool it down. (I've burned my hand picking up a hot skillet; it's no fun.)"", ""Serving tip\\xe2\\x80\\x94drizzle with honey! There's plenty of butter in the batter, none extra needed.""]",9
1290,Oven Baked Sweet Potato Fries Recipe,10,20,30,"['2 pounds orange fleshed sweet potatoes (yams), about 3 large ones', '3 tablespoons extra virgin olive oil', '1 1/2 teaspoons kosher salt', '1 to 2 tablespoons spice or spice combination of your choice: chipotle powder, smoked paprika, Chinese five-spice, pumpkin pie spice, garam masala, Cajun seasoning, etc.']",4,"['1 Preheat oven and roasting pan: Preheat oven to 450\\xc2\\xb0F. (For more crispiness, preheat your oven to 500\\xc2\\xb0F.) Place a roasting pan or heavy duty baking sheet (one that can take high heat) in the oven to preheat.', '2 Peel and cut sweet potatoes into wedges: Peel the sweet potatoes and cut off the ends. Cut the potatoes in half lengthwise and then, if they are very long, in half crosswise. Cut each piece into 1/4 to 1/2-inch thick wedges. Alternately, you can slice the peeled sweet potato into disks either with a mandoline or a sharp knife.', '3 Toss with oil, salt, spices: Put the sweet potatoes into a large bowl and add the oil. Mix well to combine. Sprinkle with salt and spices of your choice. Use your hands to mix well, so all pieces are coated with oil and spices.', '4 Spread out onto preheated pan: Remove the preheated baking sheet from the oven. Carefully spread the sweet potatoes out in a single layer on the baking sheet. (Watch out, the pan is hot!)', '5 Bake: Bake for 15 to 25 minutes. After the first 10 minutes, remove the baking sheet from the oven and use tongs to turn over all of the sweet potato pieces.', 'Return to the oven and bake for another 5 to 15 minutes, or until they are well browned.', 'Cooking time depends on the temperature of the oven (500F will need less cooking time than 450F) and the size and thinness of the sweet potato wedges.', 'The browner they are, the crispier they will be, but there is a fine line between browned and burnt beyond edibility. Even if they get really dark, they should still be good because of the natural sugars of the sweet potatoes caramelizing. So watch carefully.', 'Let cool for 5 minutes before serving.']",9
1291,Creamed Spinach with Bacon Recipe,15,15,30,"['1 pound fresh spinach, about 2 large bunches, thoroughly cleaned', '3 to 4 strips of bacon, uncooked, finely chopped', '1 medium onion, finely chopped', '1 clove garlic, finely chopped (about 1 teaspoon)', 'A pinch of nutmeg', 'Salt and pepper to taste', 'For the b\\xc3\\xa9chamel cream sauce:', '2 tablespoons butter', '2 tablespoons all-purpose flour', '1 cup whole milk']",10,"['1 Blanch and chop the spinach: Blanch the spinach in a pot of boiling water until the spinach is wilted, about 30 seconds to 2 minutes. Drain and rinse in cold water to stop the spinach from cooking further.', 'Squeeze the spinach to remove all the moisture possible. Chop the spinach and set aside.', '2 Saut\\xc3\\xa9 the bacon, onions, garlic: Heat a large skillet on medium high. Add the chopped bacon and saut\\xc3\\xa9 until the bacon begins to render some of its fat.', 'Add the chopped onion and garlic. Saut\\xc3\\xa9 until onions are translucent.', '3 Make the b\\xc3\\xa9chamel sauce: Melt the butter in a small saucepan on medium/low heat until it just starts to bubble. Add the flour and cook, stirring until smooth, about 2 minutes.', 'Slowly add the milk, whisking continuously, cooking until thick.', '4 Finish the dish and serve: Combine spinach, bacon and onion mixture, and b\\xc3\\xa9chamel sauce into one pan. Add nutmeg, salt, and pepper to taste. Bring to a simmer, remove from heat and serve.']",7
1292,Green Beans with Almonds and Thyme Recipe,10,20,30,"['2 lbs of (fresh or frozen) green beans, trimmed', '1/4 cup (1/2 stick) butter', '1 Tbsp Dijon mustard', '1 teaspoon garlic salt', '2 Tbsp chopped fresh thyme', '1/3 cup slivered almonds, lightly toasted']",6,"['1 Boil the green beans: Cook the green beans in a large pot of boiling salted water (1 1/2 teaspoons of salt for every quart of water) until just crisp-tender, about 5 minutes.', '2 Shock the green beans in ice water: Drain the beans and transfer them to a large bowl of ice water, cooling them completely. (The ice water will shock the beans into a vibrant green color.)', 'Drain the beans well. At this point you can make the beans a day ahead and store in refrigerator.', 'Alternatively you can steam the beans for 5 minutes and proceed directly to the skillet.', '3 Saut\\xc3\\xa9 beans with butter and thyme: Melt the butter in a large, heavy skillet over medium high heat. Whisk in half of the fresh thyme (1 Tbsp), the Dijon mustard and garlic salt into the butter.', 'Add the beans to the skillet and toss until heated through, about 4 minutes. Transfer to a serving bowl.', '4 Sprinkle with toasted almonds and the remaining 1 Tbsp of thyme.']",7
1293,Grilled Tomatoes Recipe,10,5,15,"['2 firm, ripe tomatoes (not overly ripe or they will fall apart when you grill them), cut in half around the middle', 'Olive oil', 'Kosher salt (or fleur de sel if you can get it)', 'Freshly ground black pepper', '4 basil leaves, thinly sliced (roll them up like a cigar and then slice them to make nice thin slices)']",5,"['1 Remove watery pulp and seeds from tomatoes:  Standing over a sink, use your fingers to gently dislodge and remove the watery pulp and seeds. (Although the seeds and pulp contain a lot of flavor, when you grill the tomatoes they are going to be lost anyway.)', '2 Grill cut-side down: Preheat your grill on high heat for direct grilling. Use a grill basket or fine grill grate if you can, it will make it much easier to work with the tomatoes (or any other vegetables you grill).', 'Season the tomatoes with salt and pepper. Brush the cut side of the tomatoes with olive oil. Brush the grill grate or grill pan with olive oil.', 'Place the tomatoes, cut side down on the grill surface. Cover the grill and let cook for about 4 minutes. (Check after 2 minutes.)', 'Use a metal spatula to lift tomatoes off of the grill for serving.', '3 Serve: Place on a serving dish, cut side up. Drizzle a little more olive oil on the tomatoes. Sprinkle with just a little more salt and pepper. Sprinkle with thinly sliced basil.']",6
1294,Grilled Skirt Steak Skewers Recipe,60,20,80,"['For the marinade:', '1/3 cup extra virgin olive oil', '1/3 cup soy sauce', '1/4 cup honey', '2 cloves garlic, minced', '1 tablespoon red wine vinegar', '1-inch piece of ginger, sliced', '1/2 teaspoon red chili pepper flakes', '1/2 teaspoon freshly ground black pepper', 'Other ingredients:', '1 1/2 to 2 pounds skirt steak, trimmed of membranes and silver skin', 'Olive oil for grill grates', 'Special equipment:', '25-30 bamboo or wooden skewers for grilling']",14,"['1 Soak the skewers in water: If using bamboo or wooden skewers, place them in a dish and cover with water to soak.', '2 Make marinade: Place all marinade ingredients in a small bowl and stir to combine. Set aside.', '3 Cut skirt steak in strips across the grain: Lay the skirt steak horizontally out on a cutting board. Notice the grain of the steak that goes up and down.', 'Cut the steak into segments (along the grain of the meat), about 6 to 8-inches long.', 'Then, with each segment, turn the segment so the grain of the meat runs in a line from left to right, and cut thin strips (1/4 to 1/3-inch thick, 1 1/2-inch wide, 6 to 8-inches long), angling the knife, cutting across the grain.', '4 Marinate the steak slices: Place the steak slices in a non-reactive bowl or casserole dish. Toss with the marinade to coat. Chill and marinate for at least 30 minutes or up to 2 hours.', '5 Preheat grill, thread skewers: Preheat your grill, whether charcoal or gas, for high-direct heat. While the grill is preheating, thread the marinated skirt steak strips onto your pre-soaked skewers.', '6 Grill over high direct heat: When ready to grill, brush the grill grates with olive oil (helps to fold a paper towel, soak the towel in olive oil, and use long handled tongs to hold the soaked paper towel and spread oil on the grates).', 'You know your grill is hot enough when you can only stand to hold your hand 1 inch above the grill grates for one second.', 'Working in batches if necessary, lay the skirt steak skewers on the hot grill grates, perpendicular to the grates. Grill for 3 to 4 minutes per side, until cooked through.', 'Remove from grill and let sit for a few minutes before serving.']",11
1295,Grilled Chicken Satay with Peanut Sauce Recipe,20,8,28,"['For the chicken', '1/2 cup brown sugar', '1/4 cup unseasoned rice vinegar', '1/4 cup lime juice', '1/4 cup fish sauce', '2 tablespoons Sriracha', '2 tablespoons finely chopped peeled fresh ginger', '1 1/2 pounds skinless, boneless chicken breasts or thighs, cut into 1 1/2-inch-wide strips', 'Vegetable oil, for the grill', 'For the peanut dipping sauce', '1 tablespoon vegetable oil', '1 bunch scallions, finely chopped, including some of the green part', '3 tablespoons chunky peanut butter, preferably all-natural and sugar-free', '3 tablespoons hoisin sauce', '1 tablespoon sriracha, or to taste', '1/4 cup lime juice', '1/3 to 1/2 cup water', 'To serve', 'Cooked rice', 'Sliced cucumbers', 'Fresh pungent greens such as Thai basil or arugula']",21,"['1 Soak the bamboo skewers: If using bamboo skewers, soak them in warm water for 30 minutes.', '2 Marinate the chicken: In a bowl large enough to hold the chicken, stir together the brown sugar, vinegar, lime juice, fish sauce, sriracha, and ginger. Add the chicken strips and toss to coat.', 'Cover and marinate for at least 1 hour, or up to overnight. You can also marinate them in a resealable gallon-sized plastic bag to save space in the fridge, if you prefer. ', '3 Make the dipping sauce: In a skillet over medium heat, heat the oil. Add the scallions, and cook, stirring for 30 seconds or so, until wilted. Stir in the peanut butter, hoisin sauce, sriracha, lime juice, and 1/3 cup of the water.', 'Cook, stirring with a whisk, just until the peanut butter melts into the sauce and the sauce is blended. Add more water, one tablespoon at a time, until the sauce is the consistency of heavy cream. Taste and add additional hoisin, Sriracha, or lime juice to taste.', 'Transfer to a bowl to serve, or cool, transfer to an airtight container, and refrigerate for up to a week.', '4 Prepare the skewers: Thread 1 to 2 slices of the marinated chicken onto each skewer. Set them on a baking sheet.', '5 Prepare the grill: For charcoal grills: Light one chimney full of coals and when they are covered with ash, spread them out evenly. Allow the grill grates to heat for 5 minutes. With a pair of tongs, dip a folded square of paper towel in oil and generously oil the grates.', 'For a gas grill: Heat the grill on high heat for about 20 minutes. With a pair of tongs, dip a folded square of paper towel in oil and generously oil the grates.', '6 Grill the chicken: Grill the chicken for about 3 minutes per side, or until browned on both sides and the chicken is cooked through. Transfer to a platter and rest for 5 minutes before serving.', 'Serve as an appetizer with the dipping sauce, or with rice or cucumbers and greens for a meal.']",11
1296,Grilled Tuna Kebabs Recipe,20,75,95,"['1 1/2 pounds tuna, swordfish or sturgeon steaks', '1 red bell pepper', '1 green bell pepper', '1 small onion (sweet if available)', '6-10 large button mushrooms', '2 lemons, cut into wedges', 'Marinade Ingredients', '1/2 cup extra virgin olive oil', '2 tablespoon chopped onion', '1 tablespoon chopped fresh rosemary', '1 teaspoon salt', '1/2 teaspoon black pepper', '2 garlic cloves', 'Don\\\'t add vinegar or lemon to the marinade or you\\\'ll ""cook"" the fish!']",14,"['1 Cut into bite-sized pieces: Cut all the fish and veggies into similar-sized pieces; this helps everything lay flat when it is on the grill.', '2 Marinate the fish and vegetables: To make the marinade, pur\\xc3\\xa9e the onion, rosemary, garlic, salt and pepper in a food processor. Drizzle in the olive oil while pur\\xc3\\xa9eing, continue to pur\\xc3\\xa9e until smooth, about 1-2 minutes.', 'Coat the fish and veggies in the marinade. Set in the fridge for at least an hour and up to overnight.', '3 Thread onto skewers: When skewering the fish and vegetables, pierce the fish against the grain, and select pieces of veggies that are close to the same size as your fish. This is important, because if the pieces are different widths, some things will be charred and others undercooked.', ""You also want to be careful when loading up the skewers; it\\'s easy to stab yourself by accident!"", 'Alternate pieces of fish with pieces of various veggies, leaving a little space between everything. Don\\xe2\\x80\\x99t crowd the skewer, or the parts that are touching will cook too slowly.', 'Note that by threading the skewers with assorted veggies and fish, some things will be cooked more or less than others, as some things take longer to cook than others.', 'If you want all of your items to be cooked perfectly, use a separate skewer for the onions, one for the tuna, one for the bell peppers, etc. Put the onions and bell peppers down first because they take longer to cook.', '4 Grill on high, direct heat: Prepare the grill for high, direct heat. Clean the grates and wipe them down with a paper towel that has been dipped in vegetable oil. Lay the skewers on the grill.', ""Don\\'t move them until the fish pieces are well browned on one side, about 3-6 minutes."", 'Then using tongs, carefully turn the skewers over and cook them until they are seared on the other side.', 'Serve hot or at room temperature. Drizzle with lemon juice or serve with lemon wedges.']",12
1297,Rosemary Chicken Skewers with Berry Sauce Recipe,15,85,100,"['For the chicken:', '4-6 boneless chicken thighs or breasts (about 1 1/2 pounds), skin on or off', '2 tablespoons of chopped, fresh rosemary', '1/4 cup of dry white wine or vermouth', '1 teaspoon of pepper', '2 tablespoons of extra virgin olive oil', 'For the sauce:', '1 3/4 cup of fresh or frozen blackberries or boysenberries', '1 tablespoon of apple cider vinegar', '2 tablespoons of red currant jelly (or berry jam or jelly)', '1/4 teaspoon of ground nutmeg']",11,"['1 Marinate the chicken: Cut the chicken into 1 1/2 inch pieces and place in a bowl. Mix with the wine, oil, rosemary, and pepper. Cover and set aside to marinate in the refrigerator for one hour.', '2 Thread skewers, reserve marinade: Remove the chicken pieces from the marinade, reserving the marinade. Thread the chicken onto skewers and season generously with salt.', '3 Grill OR broil chicken: To grill, preheat the grill for direct high heat. Brush the grill grates with olive oil. Place chicken skewers on grill and cook for 8 to 10 minutes, 4 to 5 minutes per side. Place on a platter and cover with foil to allow the chicken to rest.', 'To broil, preheat the broiler. Place skewers on an oiled broiling pan, 5 to 6 inches away from the burner. Cook for 8 to 10 minutes, 4 to 5 minutes per side. Place on a platter and cover with foil to allow the chicken to rest.', '4 Simmer berries in marinade, press through strainer: Place the marinade and the berries in a sauce pan and simmer gently until the berries are soft. Press through a strainer and discard the pulp.', '5 Make the sauce: Return the juice and marinade mixture to the pan. Add the vinegar, jelly, and nutmeg and bring to a boil. Simmer, uncovered until it has reduced by about 1/3 to a light syrup-like consistency.', '6 Serve: To serve, plate the skewers and spoon the sauce over the chicken. Serve immediately.']",7
1298,Chicken and Pineapple Kabobs Recipe,20,40,60,"['For the lemon yogurt sauce:', '1/2 cup plain yogurt', '2 tablespoons olive oil', '1/2 lemon, juice only', '1/4 teaspoon salt', 'DAD ADD: Spicy Yogurt Sauce', '1/2 cup plain yogurt', '1 tablespoon sriracha chili sauce', 'For the kabobs:', '1/4 cup olive oil', '1/4 cup pineapple juice', '2 cloves garlic, minced', '1 tablespoon soy sauce', '1 teaspoon salt', '1 teaspoon ground black pepper', '1 1/2 pounds chicken (breast or thighs), cut into 1-inch pieces', '1 pineapple, peeled and chopped into 1-inch pieces', '1 green bell pepper, chopped into 1-inch pieces', '1 red bell pepper, chopped into 1-inch pieces', 'Couscous or rice, for serving', 'Special equipment:', 'Bamboo or metal skewers']",22,"['1 Make the sauces: In two separate small bowls, stir together the ingredients for the lemon yogurt and spicy yogurt sauces. If you aren\\xe2\\x80\\x99t using the spicy yogurt sauce, you might want to double the lemon yogurt sauce recipe.', '2 Marinate the chicken: Whisk together olive oil, pineapple juice, garlic, soy sauce, salt, and pepper in a medium bowl. Add chicken to bowl and stir to coat with the marinade. Let marinate for 20 to 30 minutes, or overnight.', '3 Heat a gas or charcoal grill to medium-high heat.', '4 Assemble the kabobs: Add the pineapple, peppers, and chicken to the skewers in any order you like, alternating between chicken, veg, and fruit. I like to have one piece of pineapple touching each piece of chicken to keep it moist.', 'Try to divide the ingredients evenly among the eight skewers.', '4 Grill the kabobs: Right before you add your kabobs to the grill, rub the grates with some oil to make sure the kabobs don\\xe2\\x80\\x99t stick.', 'Add the kabobs and let them cook for 5 to 6 minutes per side, until they get a nice char on them. Flip a few times until total grilling time reaches the 15-18 minute range.', 'Test a larger piece of chicken to ensure doneness. You can use an instant thermometer to make sure the chicken reaches 165\\xcb\\x9aF, or just cut into the piece a bit to check that it\\xe2\\x80\\x99s cooked through.', '5 Serve the kabobs: Remove from the grill immediately (so they don\\xe2\\x80\\x99t dry out). Serve grilled kabobs with yogurt sauce and either rice or couscous.', 'Leftover kabobs will keep great for a few days in the fridge, and you can reheat them on a medium-low grill or in a 350\\xcb\\x9aF oven until warmed through, about 5 minutes.']",10
1299,Tuscan Chicken Pasta Skillet Recipe,25,40,65,"['For the marinade:', '1/4 cup olive oil', '1 teaspoon kosher salt', '1/2 teaspoon ground black pepper', '1/2 teaspoon dried Italian seasoning', 'For the dinner:', '1 1/2 pounds boneless skinless chicken breasts', '2 tablespoons extra virgin olive oil', '12 ounces cherry tomatoes (about 2 cups), halved', '1 tablespoon minced garlic', '8 ounces spaghetti', '1/2 teaspoon kosher salt', '1 cup quartered marinated artichokes hearts, drained', '1/3 cup Kalamata olives, pitted and sliced', '1/4 cup freshly grated parmesan cheese', '6 basil leaves, thinly sliced', '2 teaspoons chopped fresh parsley (optional)']",17,"['1 Marinate the chicken: In a small bowl, combine 1/4 cup olive oil, 1 teaspoon salt, 1/2 teaspoon pepper, and Italian seasoning. Cut each chicken breast lengthwise to create 4 long, thin pieces. Place chicken in a shallow dish. Pour marinade over the chicken, turn to evenly coat. Let sit for 15 minutes before cooking.', '2 Cook the chicken: Heat a large high-sided skillet or saut\\xc3\\xa9 pan over medium-high heat. Add 2 tablespoons of olive oil. Once the oil is hot, add the chicken. Cook until the chicken is golden brown and fully cooked, about 6 to 8 minutes per side.', 'Transfer chicken to a cutting board to rest while cooking the pasta.', '3 Cook the pasta: Add tomatoes, garlic, spaghetti, 4 cups water, and 1/2 teaspoon salt to the skillet. Bring to a boil over high heat. Cook and stir frequently, until the pasta is tender and water has mostly evaporated\\xe2\\x80\\x94about 9 to 11 minutes. You want to have a small amount of water in the pan to create a light sauce.', 'Add more water if needed, 1/2 cup at a time for a softer pasta. Turn off the heat.  ', ""4 Finish and toss: Cut the chicken into 1/4-inch thick slices. Add the artichoke hearts, olives, Parmesan cheese, sliced chicken, and basil. Toss to combine. If you'd like a thicker sauce, you can add 1 or 2 tablespoons of butter. Taste and season with more salt and pepper as desired."", '5 Serve: Garnish pasta with parsley, then divide among plates and serve warm.']",7
1300,Gluten-Free Chocolate Chip Skillet Cookie Recipe,15,20,35,"['1/2 cup coconut oil, softened at room temperature (but not melted or liquidy)', '1/4 cup (54g) packed brown sugar', '3/4 cup (150g) granulated sugar', '1 tablespoon flax meal', '2 teaspoons pure vanilla extract', ""1 1/4 cup (170g) gluten-free flour blend, like Bob\\'s Red Mill (See Recipe Note)"", '1 teaspoon baking soda', '1 1/2 teaspoons cornstarch', '3/4 teaspoon salt', '3/4 cup (125g) bittersweet or semisweet chocolate chips (allergy-friendly, if needed)', 'Flaky sea salt (like Maldon), to top', 'Special equipment:', '1o-inch cast iron skillet']",13,"['1 Preheat the oven and prepare pan: Preheat the oven to 350\\xc2\\xb0F. Spray a 10-inch cast iron skillet with nonstick cooking spray.', '2 Prepare the flax ""egg"": Combine the flax with 2 1/2 tablespoons of water in a small bowl. Let stand for 7 to 10 minutes to thicken. (This will be used as an egg replacer in this recipe.)', '3 Combine the coconut oil and sugar: In the bowl of a stand mixer fitted with the paddle attachment (or using electric hand beaters), beat the coconut oil, brown sugar, and granulated sugar until smooth and combined. The mixture will be a little clumpy and grainy\\xe2\\x80\\x94that\\xe2\\x80\\x99s ok.', '4 Add the flax egg and vanilla: With the mixer running on low, slowly add the flax egg and vanilla and beat until combined, using a rubber spatula to scrape down the sides as needed.', '5 Add the dry ingredients: In a small mixing bowl, whisk together the flour, baking soda, cornstarch and salt. With the mixer on medium, slowly add the dry ingredients and beat until smooth. The dough will look like large pebbles at first, but keep beating and it will eventually become smooth and uniform in 2 to 3 minutes.', '6 Add the chocolate chips and transfer to the skillet: With a spatula, fold the chocolate chips into the batter, then scrape the mixture into the 10-inch cast iron skillet. Using your hands, press the dough evenly into the pan. Sprinkle the top with flaky salt.', '7 Bake the cookie: Bake for 20 to 22 minutes, or until outer edges are golden brown. The cookie will still feel soft and even a little wet to the touch, but it\\xe2\\x80\\x99ll firm up as it cools.']",7
1301,Skillet Chicken with Baby Bok Choy Recipe,10,20,30,"['1 cup chicken broth', '1 1/2 tablespoons soy sauce (or tamari, if gluten-free)', '1 tablespoon corn starch', '1 pound chicken breast cutlets or fillets', '2 tablespoons olive oil, divided', '1 pound (6 to 8 small heads) baby bok choy, halved lengthwise', '2 cloves garlic, chopped', '1 teaspoon sesame seeds (optional)']",8,"['1 Prepare the sauce and the chicken fillets: In a small bowl, whisk together the chicken broth, soy sauce, and corn starch. Season the chicken fillets lightly on both sides with salt and pepper.', ""2 Sear the bok choy: Heat one tablespoon of the olive oil in a large skillet over high heat. When the oil begins to shimmer and you see a wisp of smoke rise from the skillet, use a pair of kitchen tongs to add the bok choy to the skillet in a single layer, sliced side down. It's fine to crowd the pan for this recipe. Be careful as you add the bok choy since the oil will sputter a bit; wear oven mitts if needed."", 'Sear the bok choy until it has some color on the bottom, about 2 minutes, then turn over and sear on the other side for another 2 minutes. Transfer the cooked bok choy to a serving plate.', '3 Sear the chicken: Add the remaining tablespoon of olive oil to the pan. Add the chicken fillets to the pan. Sear the fillets for 4 minutes a side, until just cooked through and well browned. Transfer the cooked fillets to the serving plate on top of the bok choy.', '4 Make the sauce: Add the garlic to the skillet and stir just until fragrant, about 30 seconds. Give the broth/soy sauce mixture a final stir to mix in any cornstarch that has settled to the bottom of the bowl, then pour the mixture into the skillet. Use a wooden spoon to scrape up any browned bits from the bottom of the skillet. Simmer the sauce until thickened.', '5 To serve: Pour the sauce over chicken and bok choy. Sprinkle with sesame seeds, if desired. Serve with steamed rice.']",6
1302,Make-Ahead Skillet Baked Spaghetti Recipe,25,45,70,"['1 pound spaghetti', '3 tablespoons olive oil', '1 cup (3 ounces) shredded Parmesan, divided', '1/2 teaspoon salt, divided', 'Ground black pepper, to taste', '2 cloves garlic, finely chopped', '1 (10-ounce) yellow squash, cut into 3/4-inch pieces', '3 large eggs', '1 1/2 cups half-and-half', '1 1/2 cups (about 8 ounces) cherry tomatoes, halved', '1 large handful fresh basil', '6 ounces fontina, cut into small cubes', 'Special equipment:', '11- to 12-inch oven-safe skillet, like a cast iron skillet']",14,"['1 Preheat the oven to 350\\xc2\\xbaF. ', '2 Cook the spaghetti: Bring a large pot of heavily salted water to a boil. Add the spaghetti and cook, stirring occasionally, for 8 to 9 minutes, or until al dente. (Taste a strand of spaghetti to make sure it\\xe2\\x80\\x99s almost cooked but not soft, which is usually about 2 minutes before the package directions indicate.) Drain in a colander.', 'Return the pasta to the (now empty) pot and toss with 1 tablespoon of the oil and 1/2 cup of the Parmesan. Sprinkle with 1/4 teaspoon salt and some ground black pepper, to taste.', '3 Cook the squash: In a large (11- to 12-inch) ovenproof skillet, heat the remaining 2 tablespoons of the oil. Add the garlic and cook, stirring, for 30 seconds, until fragrant. Add the squash and cook, stirring occasionally, for 4 to 5 minutes, or until tender. Season with 1/4 teaspoon salt and some ground black pepper to taste.', '4 Mix it all together: Stir the cooked zucchini into the pot with the spaghetti. In a small bowl, whisk the eggs and cream. Add it to the pot with the pasta. Add the tomatoes, basil and fontina cubes. Mix thoroughly using tongs.', 'Transfer the spaghetti to the skillet used to cook the squash. At this point, the pasta can be baked right away, or it can be cooled, covered, and refrigerated for up to 24 hours.', '5 Bake the pasta: Sprinkle the remaining 1/2 cup of Parmesan over the pasta. Bake until the top is golden and the pasta is hot all the way through, 40 to 45 minutes for spaghetti baked right away, or 45 to 50 minutes for spaghetti made ahead and cold from the fridge.', 'Cool briefly and cut into slices to serve.']",8
1303,Quick and Easy Corned Beef Omelet Recipe,10,15,25,"['1 teaspoon olive oil', '1 tablespoon minced onion', '1/4 cup finely diced potatoes (from 1 small red or yellow potato)', '1/4 cup finely diced corned beef', 'A few pinches of salt', '1 teaspoon unsalted butter', '2 large eggs', '2 tablespoons milk', '2 tablespoons grated Parmesan cheese', 'Pinch of salt and pepper', 'Fresh parsley, garnish']",11,"['1 Make the corned beef hash: Warm the oil over medium heat, then add the potatoes and onions. Cook until the onions are translucent and the potatoes are cooked through, 5 to 7 minutes. Add the corned beef and a few pinches of salt, and cook until warmed through. Taste and add more salt if needed.', 'Transfer the corned beef hash to a clean plate or bowl.', '2 Start the omelet: Return skillet to medium heat and melt butter. Once butter is melted swirl it around so it coats the pan.', 'In a medium bowl, add the eggs and milk. Beat until well combined. Pour the scrambled eggs into the pan with the butter.', 'When eggs start to set, use a small spatula to push the cooked egg into the center, tilting the pan at the same time, allowing the uncooked egg to flow to the outside of the skillet. Repeat until the eggs are almost all cooked, but there is still a thin layer of uncooked egg on top. This should take no more than 2 minutes.', '3 Add the corned beef: Add the crisped corn beef hash to one side of the omelet along with grated Parmesan cheese and a pinch of salt and pepper.', '4 Finish the omelet: Fold the top of the omelet over the filling and cook for another 15 seconds. Carefully flip the omelet over.', '5 Dig in: Slide the omelet out onto a plate and garnish with parsley. Eat immediately.']",8
1304,Chinese 5-Spice Skillet Chicken with Green Beans and Peppers Recipe,17,32,49,"['  For the marinade:', '1 1/2 pounds boneless, skinless chicken tenders, tenderloin, or thinly sliced chicken breasts', '1 teaspoon fennel seeds', '1 teaspoon whole black peppercorns', '1 bay leaf', '1 teaspoon kosher salt', '1/2 tablespoon brown sugar, packed', '1 teaspoon Chinese 5-spice blend', 'Zest from 1 orange', '3 tablespoons orange juice', '2 teaspoons sesame oil', 'For the vegetables:', '1 pound fresh green beans, washed and trimmed', '1 large orange bell pepper', '1/2 large onion', '2 teaspoons soy sauce', '3 or 4 cracks of freshly ground pepper', 'Orange zest for garnish (optional)']",18,"['1 Grind the spices: In a spice grinder, combine the fennel seeds, whole peppercorns, and 1 bay leaf. Run the grinder until the spices are finely ground.', '2 Label the bag: If you are planning to freeze your meal for later, use a Sharpie to write the title of the recipe on a gallon-sized zip top bag so you can easily find it on SimplyRecipes.com when you want to cook it. Alternatively, write the cooking instructions on the bag, and date it.', '3 Combine the ingredients: Roll down the opening of the bag a little, just so you don\\xe2\\x80\\x99t accidentally get raw chicken juices on the outside or the zip top. Add the chicken, spices, orange juice, and sesame oil.', 'Remove as much air as possible, and seal the bag. Smoosh the chicken around so it\\xe2\\x80\\x99s coated in the marinade.', '4 Lay the chicken flat in the freezer and freeze for up to 6 months.', 'Alternatively, you could skip the freezer and let it marinade in the fridge for a couple of hours, or up to two days, and then cook it according to the directions below.', '5 Thaw the chicken before cooking: When ready to cook, take the chicken out of the freezer in the morning before you go to work, and it will be ready to cook by the end of the day.', '6 To prepare the vegetables: Trim the beans, slice the pepper into 1-inch strips, and dice the onion.', '7 Cook the chicken and vegetables: Set a large skillet over medium heat. Add the chicken and any marinade left in the bag. If any chicken is folded up, unfold it so it lays flat in the pan.', 'After 2 minutes, flip the chicken, and add the green beans, sliced pepper, onion, and 3 tablespoons of water. Cover and cook for 10 more minutes.', 'Lift the lid and check the chicken by slicing open a piece. If the juices run clear, the chicken is done. Remove the chicken from the pan to a plate (leaving the vegetables in the pan) and tent with foil to keep warm.', '8 Finish cooking the vegetables: Add soy sauce and a few cracks of freshly ground pepper to the vegetables. Gently stir the vegetables.', 'Cover and cook until the peppers are tender, and the beans are bright green but firm tender, about 5 more minutes.', '9 Serve: Nestle the chicken back into the pan and garnish with additional orange zest if you have it. Bring the skillet to the table and serve.']",14
1305,Southwest Skillet Chicken with Beans and Corn Recipe,15,20,35,"['For the marinade:', '1 1/2 pounds boneless skinless chicken tenders, tenderloin, or thinly sliced chicken breasts', '1 1/4 teaspoon kosher salt', '1 teaspoon ground cumin', '3/4 teaspoon chili powder', '1/2 teaspoon freshly ground black pepper', '1/2 tablespoon granulated sugar', '1/2 teaspoon ground coriander', '1/2 teaspoon smoked paprika', 'Zest from 2 limes', '1 1/2 tablespoons lime juice, from about half a lime', '2 cloves garlic, minced', '2 tablespoons vegetable oil', 'For the vegetables:', '2 teaspoons vegetable oil', '1 medium green pepper', '1 medium red pepper', '1/2 medium yellow onion', '1 cup frozen corn', '1 (15 oz) can black beans, drained and rinsed', 'Cilantro for garnish (optional)', 'Cooked rice or tortillas, to serve']",22,"['1 Label the bag: Use a sharpie to write the date and title of the recipe on a gallon-sized zip top bag so you can easily find it on SimplyRecipes.com when you want to cook it. Alternatively, write the cooking instructions on the bag, and date it.', '2 Combine the ingredients: Roll down the opening of the bag a little just so you don\\xe2\\x80\\x99t accidentally get raw chicken juices on the outside or the zip top. Add the chicken, spices, zest, lime juice, garlic, and vegetable oil.', 'Remove as much air as possible and seal the bag. Smoosh the chicken around so it\\xe2\\x80\\x99s coated in the marinade.', '3 Lay the chicken flat in the freezer and freeze for up to 6 months:', 'Alternatively, you could skip the freezer and let it marinade in the fridge for a couple of hours and up to two days, then cook it according to the directions below.', ' 4 Thaw the chicken before cooking: When ready to cook, take the chicken out of the freezer in the morning before you go to work, and it will be ready to cook by the end of the day.', '5 Prepare the vegetables: Dice the peppers, dice the onion, measure the corn, and drain and rinse the beans.', '6 Cook the chicken: Set a large skillet over medium heat add 2 teaspoons of vegetable oil. Once the oil shimmers, add the chicken and any marinade from the bag. If any chicken is folded up, unfold it so it lays flat in the pan. Cook the chicken for 5 minutes, then flip it.', '7 Add the vegetables: Add onions, corn, and peppers. Cover with a lid. Let everything simmer together for about 5 minutes.', 'Lift the lid and stir the meat and vegetables together. Cook uncovered for another 5 minutes.', 'Add the beans and cook for another 3 minutes until the beans warm through. The meat is cooked when you slice open a breast and the juices run clear.', '8 To serve: Put a chicken breast on each plate and top with vegetables. Spoon pan sauces over chicken. Season to taste with salt and pepper. Garnish with minced cilantro and serve with tortillas or rice.']",12
1306,Skillet Chicken and Rice Recipe,10,35,45,"['1 pound boneless skinless chicken breast, cut into slices 1/2-inch thick and 2-3 inches long', '2 tablespoons olive oil', '1/4 teaspoon salt', '1/4 teaspoon black pepper', '1 small yellow onion, diced', '2 cloves garlic, minced', '1 teaspoon dried oregano', '1 teaspoon dried basil', '1 1/2 cups long-grain white rice, rinsed well', '3-4 cups chicken stock', '1 cup frozen sweet peas', 'Fresh parsley, garnish']",12,"['1 Cook the chicken: Season your sliced chicken with salt and pepper. Heat the olive oil in a large (at least 12-inch) skillet over medium-high heat. Add the chicken and cook for 3 minutes per side, getting a decent sear on both sides. It\\xe2\\x80\\x99s okay at this point if your chicken isn\\xe2\\x80\\x99t cooked all the way through.', '2 Cook the onions: Remove chicken from the skillet and add onions and garlic. Cook for 2-3 minutes, softening veggies. Add dried oregano and basil to the skillet and stir together.', '3 Assemble the skillet and simmer: Stir in the rinsed white rice and nestle chicken pieces back in the skillet. Then add 3 cups of the chicken stock and stir gently to make sure chicken stock is evenly distributed. Bring to a simmer, turn heat down to low, cover, and cook for 15 minutes.', '4 Check the rice: After 15 minutes, check the skillet. If the rice is tender and the skillet is dry, then the dish is ready to serve. If the rice isn\\xe2\\x80\\x99t quite done and the skillet is dry, add another 1/2 cup of broth, re-cover the skillet, and continue to simmer for a few minutes. If the rice is cooked but there is still some stock in the skillet, uncover the pan and let the extra stock cook off for a few minutes.', 'When the rice seems just about done, add the frozen peas to the skillet. They will thaw quickly! ', '5 Serve! Garnish finished chicken and rice skillet with parsley.', 'Reheating leftovers: Leftovers keep great in the fridge for up to five days. Reheat in the microwave in 30-second bursts on high or in a skillet over medium-low heat with a splash of water. You can also freeze the chicken and rice for up to three months.']",7
1307,Green Cauliflower Rice Recipe,10,15,25,"['3 tablespoons water', '8 ounces (half of a 1-pound bag) frozen chopped spinach', '2 tablespoons olive oil', '1 bunch green onions, chopped', '1 pound cauliflower rice, homemade or store-bought, fresh or frozen', '1/2 teaspoon kosher salt', '1/4 teaspoon ground black pepper', '1/2 cup fresh chopped cilantro or flat leaf parsley']",8,"['1 Cook the spinach: In a microwave-safe bowl, sprinkle the water evenly over the spinach. Cover the bowl with a microwave-safe lid or plastic wrap, and microwave at high heat for 3-4 minutes, depending on the strength of your microwave, until the spinach is fully thawed and steaming hot.', 'Transfer the spinach to a colander or mesh strainer, and use the back of a spoon to squeeze out as much moisture as you can.', '2 Saut\\xc3\\xa9 onions: Heat the olive oil in a large skillet over medium heat. Add the green onions and saut\\xc3\\xa9 until they are softened and translucent, about 2 minutes.', '3 Cook the cauliflower rice: Add the cauliflower rice, salt, and pepper and saut\\xc3\\xa9 another 5 minutes, until the cauliflower is cooked through and you\\xe2\\x80\\x99re starting to see a little bit of browning on the green onions.', 'Add the spinach and saut\\xc3\\xa9 for 2 more minutes. Turn off the heat, then stir in the chopped herbs. Taste for seasoning, adding more salt and/or pepper if needed.', '4 Serve: Remove from heat and serve right away or cool to room temperature. Store in the fridge for up to 4 days, or in the freezer for up to 2 months.']",6
1308,Valerie Brunmeier\xe2\x80\x99s Cheesy Taco Pasta Skillet Recipe,5,28,33,"['For the Flavor Fiesta Taco Seasoning:', '1/4 cup chili powder', '2 tablespoons ground cumin', '2 teaspoons paprika', '2 teaspoons finely ground sea salt', '2 teaspoons freshly ground black pepper', '1 teaspoon granulated garlic or garlic powder', '1 teaspoon onion powder', '1 teaspoon dried oregano', '1/2 teaspoon red pepper flakes, or to taste (I used a pinch)', 'For the cheesy taco pasta skillet:', '1 pound lean ground beef', '1/2 cup chopped onion', '1 teaspoon minced garlic', '2 tablespoons Flavor Fiesta Taco Seasoning Mix', '2 cups low-sodium chicken broth', '1 (14.5 ounce) can diced tomatoes, undrained', '1 (8-ounce) can tomato sauce', '1 (15.5-ounce) can black beans, drained and rinsed', '1 (4-ounce) can mild diced green chiles', '8 ounces uncooked short dry pasta like fusilli, rotelli, elbows or penne', '1 cup frozen corn', '1 cup shredded Monterey Jack cheese, divided', '1 cup shredded cheddar cheeses, divided', 'For the garnish:', '1/4 cup sliced black olives', '1/4 cup chopped cilantro', '3 green onions, thinly sliced', 'Sour cream']",29,"['1 Assemble the seasoning mix: Combine the chili powder, cumin, paprika, sea salt, black pepper, garlic powder, onion powder, oregano, and chili flakes in a small bowl.', 'Note: This will make more than you need for this recipe. Store leftovers in a covered glass jar. ', '2 Cook the ground beef with onions and garlic: Place a large deep skillet or saut\\xc3\\xa9 pan with a lid over medium heat and add the ground beef, onion, and garlic. Cook for 5 to 6 minutes, stirring to break up the meat, until browned. Drain off as much of the excess grease from the skillet as possible and return it to the heat.', '3  Season and simmer: Add the fiesta taco seasoning mix and stir to combine it well with the beef. Add the broth, tomatoes, tomato sauce, black beans, chiles, and pasta. Bring the mixture to a boil, then reduce the heat to low. Cover and cook for 15 minutes.', '3 Add the corn and simmer: Remove the cover, stir in the corn, and simmer for an additional 3 to 4 minutes, until the sauce has been mostly absorbed.', '4 Stir in the cheeses: Turn the heat off and stir in half of the Monterey jack and cheddar cheeses. Sprinkle the remaining cheese over the top and cover the skillet for 2 to 3 minutes, until the cheese has melted. Top with the black olives, cilantro, and green onions.', '5 Garnish and serve: Garnish individual servings with sour cream, if desired. The pasta will keep for 3 to 4 days in the fridge in a covered container.']",7
1309,Easy Skillet Lasagna Recipe,10,45,55,"['2 cups whole milk or part-skim ricotta', '1/3 cup grated pecorino Romano cheese', '2 tablespoons olive oil', '3 medium onions, chopped (about 3 cups)', '4 garlic cloves, minced', '1 teaspoon dried basil', '1 teaspoon dried oregano', '1 (10-ounce) package frozen chopped spinach, thawed and squeezed dry', '1 (28-ounce) can crushed tomatoes', '1/2 teaspoon salt', '1/4 teaspoon ground black pepper', '8 ounces lasagna noodles, broken in half (across)', '6 ounces whole milk or part-skim mozzarella cheese, shredded']",13,"['1 Combine the ricotta and Romano cheeses in a bowl.', '2 Make the sauce: Heat the oil in a large skillet over medium heat. Add the onions and cook, stirring occasionally until lightly golden, 11 to 12 minutes. Stir in the garlic, basil, and oregano and cook, stirring, for 1 minute. Add the spinach and cook for 1 minute more. Add the tomatoes, salt, and pepper and 3 cups of water. Bring to a simmer.', '3 Add the noodles and simmer. Add the lasagna noodles and cook, stirring occasionally to submerge the noodles, until the sauce starts to thicken, about 10 minutes. Add 1 cup water, return to a simmer and cook, stirring occasionally, until the noodles are al dente and the sauce thickens, 12 to 14 minutes. Remove from the heat.', '4 Prep the oven: Position an oven rack about 4 to 5 inches below the heat source and preheat the broiler.', '5 Broil the top: Let the lasagna cool for 3 minutes. Spoon the ricotta mixture evenly over the top and spread it in an even layer. Top with the mozzarella and broil until the mozzarella melts and starts to brown, 1 to 2 minutes. Let the lasagna stand for 10 minutes before serving.']",5
1310,Korean Beef Skewers Recipe,10,8,18,"['For the steak:', '\\xc2\\xbc cup tamari or soy sauce', '\\xc2\\xbc cup mirin', '\\xc2\\xbc cup rice wine vinegar', '2 tablespoons sesame oil', '2 tablespoons gochujang or light miso', '1 1/2 pounds skirt steak (flap steak or flank steak works well here, too)', 'Canola or other neutral oil', 'To serve (optional):', '2 tablespoons sesame seeds', 'Cilantro or mint leaves', 'Kimchi', 'Extra gochujang', 'Cooked rice, optional', 'Nori (seaweed sheets), optional']",15,"['1 Whisk together the marinade: In a large bowl, combine the tamari (or soy sauce), mirin, rice wine vinegar, sesame oil, and gochujang (or miso) for the marinade. Whisk until the ingredients are well-combined.', '2 Marinate the steak for 20 to 30 minutes: Cut the skirt steak into 2-inch wide strips. Add the strips to the bowl of marinade and stir until evenly coated. Marinate the strips of beef for 20 to 30 minutes at room temperature. If you are using wooden skewers, soak them in water for at least 20 minutes.', '3 Preheat the grill for at least 20 minutes while the meat is marinating. The grill is hot enough when you can only hold your palm over the grill grates for a second or two.', '4 Grill the beef skewers: Thread meat onto the skewers and brush with oil. Grill the skewers for 4 minutes. Flip and grill another 3 to 4 minutes on the second side, until the steak reaches your preferred doneness.', '5 Serve the skewers: Sprinkle the skewers with sesame seeds and cilantro or mint, if using. Serve with rice, kimchi, nori, and extra gochujang']",5
1311,How to Cook Skirt Steak,8,15,23,"['1 pound skirt steak', '1 teaspoon kosher salt, as needed for seasoning', '1/2 teaspoon ground black pepper, as needed for seasoning', '2 tablespoons olive oil']",4,"['1 Cut the steak: If the skirt steak comes in a long strip, cut into 2 or 3 smaller pieces, 5 to 7 inches in length. This will allow them to fit better in the pan, and make them easier to slice later.', '2 Dry and season the steak: Thoroughly pat steaks dry with paper towels on each side. The surface should be very dry to help brown the surface of the meat. Generously season each side of the steaks with salt and pepper.', '3 Heat the pan: Heat a large 12-inch cast iron skillet over high heat for 3 minutes. Once hot, add the olive oil.', '4 Cook the steak: Use tongs to carefully add the steak to the pan, then press down firmly on the surface a few times for more contact. Sear the first side until browned, about 2 to 4 minutes, depending on the thickness of the meat. Flip and cook another 2 to 4 minutes. For medium rare doneness, cook steak until it reaches an internal temperature of 130\\xc2\\xbaF. Work in two batches if needed.', '5 Rest the steak: Transfer steak to a cutting board, loosely cover with foil, and allow to rest for 10 minutes before slicing.', '6 Slice and serve the steak: Hold the carving knife at a 45-degree angle, and then slice the steak across the grain, about 1/4-inch thick slices. Transfer skirt steak to a serving plate.']",6
1312,Slow Cooker French Toast Casserole Recipe,0,240,240,"['16-ounce French Brioche loaf, cut into 3/4-inch cubes (12 cups)', '1 tablespoon unsalted butter (softened)', '8 large eggs', '4 cups half-and-half', '2 tablespoons granulated sugar', '1 tablespoon brown sugar', '2 teaspoons pure vanilla extract', '1 1/2 teaspoons ground cinnamon', '1/4 teaspoon ground nutmeg', '1/4 teaspoon kosher salt', 'Powdered sugar, for sprinkling', 'Pure maple syrup, for topping', 'Special equipment:', '6-quart slow cooker']",14,"['1 Get ready: Set the oven rack to the center position and preheat the oven to 300\\xc2\\xbaF for toasting the bread. Grease the inside of a 6-quart slow cooker with the softened butter.', '2 Toast the bread: Spread the bread cubes in a single layer on a large sheet pan or two smaller pans. Bake for 20 minutes, stirring halfway through toasting. The bread should be lightly golden, dry, and crisp. Remove the bread cubes from the oven and let them cool for 10 minutes.', 'Once cool, transfer toasted bread to the slow cooker and arrange in an even layer.', '3 Make the custard: In a medium bowl, whisk the eggs. Add the half-and-half, granulated sugar, brown sugar, vanilla, cinnamon, nutmeg, and salt to the bowl with the eggs, and whisk to combine.', '4 Add the custard to the bread cubes: Pour the custard mixture over the bread. Press the bread into the liquid to submerge. Cover and transfer to the refrigerator for at least 60 minutes or up to 24 hours.', '5 Bring the casserole to room temperature: Remove the casserole from the refrigerator and bring it to room temperature for 30 minutes.', '6 Slow cook the casserole: Place the slow cooker insert into the slow cooker base, cover it with a lid, and cook it on the high setting for 2 1/2 to 3 1/2 hours, or on the low setting for 4 to 5 hours.', 'The casserole is ready when the custard is set in the center and puffy; it should not be runny or jiggle. It will shrink slightly once the heat is turned off. The center of the casserole should be above 175\\xc2\\xbaF when tested with a thermometer.', '7 To serve: Allow the casserole to rest for at least 15 minutes before serving. Serve warm, sprinkled with powdered sugar and drizzled with maple syrup.']",9
1313,Slow Cooker Moroccan Chicken Recipe,15,150,165,"[""2 pounds boneless, skinless chicken thighs, trimmed of excess fat (don't trim all the fat, just large pieces)"", '1/2 teaspoon kosher salt', '1 teaspoon paprika', '1 teaspoon ground ginger', '1 teaspoon ground cumin', '1 teaspoon ground coriander', '1 teaspoon turmeric', '1/2 teaspoon ground cinnamon', '1/2 teaspoon ground allspice', '1/4 teaspoon crushed fennel seeds', '1/8 teaspoon nutmeg', '1 red onion, roughly chopped, about 2 cups', '3 cloves garlic, minced (about 1 Tbsp)', '1 cup pitted green olives', '1/2 cup raisins', '1/2 fresh lemon, thinly sliced', 'Fresh cilantro or parsley for garnish']",17,"['1 Salt the chicken thighs: Sprinkle 1/2 teaspoon of salt over the chicken thighs. Let sit while you prep the other ingredients.', '2 Whisk the spices together: Whisk together the spices in a small bowl\\xe2\\x80\\x94the paprika, ground ginger, ground cumin, ground coriander, turmeric, cinnamon, allspice, crushed fennel seeds, and nutmeg.', '3 Layer onions, chicken, spices, garlic, olives, raisins, lemon slices in slow cooker: Place chopped onions at the bottom of a slow cooker bowl. Layer the chicken thighs on top of the onions. As you layer the chicken thighs, sprinkle them all over with the spice mix. (Use all of the spice mix.)', 'Add the garlic, green olives, raisins, and lemon slices.', '4 Cook in slow cooker: Cook on the high setting of the slow cooker for 2 to 2 1/2 hours, or 4 to 5 hours on the low setting (depending on your slow cooker brand). Towards the end of cooking, stir so that the lemons olives and raisins get mixed into the liquid. The chicken is done when it is fall apart tender.', 'Serve with couscous or rice (use rice if cooking gluten-free). Garnish with fresh cilantro and/or parsley.']",6
1314,Slow Cooker Beef Stroganoff Recipe,20,480,500,"['For the Stroganoff:', '1 1/2 pounds bottom round roast or chuck roast, cut into 2-inch chunks', '2 teaspoons salt', '1 teaspoon black pepper', '1 teaspoon garlic powder', '3 tablespoons all-purpose flour', '2 tablespoons vegetable oil', '3 cloves garlic, crushed', '1 medium white onion, diced', '8 ounces cremini mushrooms, sliced', '3 cups beef broth', '1 tablespoon Dijon mustard', '1 tablespoon Worcestershire sauce', '1 bay leaf', 'To finish:', '12 ounces egg noodles', '1 1/2 cups sour cream', '1 cup beef broth (optional, if needed)', '1 tablespoon fresh dill, chopped', '1 tablespoon fresh parsley, chopped', 'Special equipment:', '6-quart slow cooker']",22,"['1 Season the meat: In a medium-sized bowl, season the beef with the salt, pepper, and garlic powder. Allow the meat sit for a few minutes to absorb the spices while you prep the rest of your ingredients.', '2 Sear the meat: In a Dutch oven, or a pot with a heavy bottom, heat the vegetable oil over medium-high heat. While your oil is heating, add the all-purpose flour to the bowl with the seasoned meat. Toss the beef in the flour to coat it completely.', 'Once your oil is hot and you can see ripples on its surface, add half of the beef to pot. Keep the pot over medium-high heat in order to sear properly\\xe2\\x80\\x94you may want to open a window or turn on your stove vent because this can get smoky!', 'Sear the beef for 2 to 3 minutes, or until the beef releases easily from the pan and the bottoms look brown and crusty. Give the beef a toss with a wooden spoon and sear for an additional 2 to 3 minutes. You don\\xe2\\x80\\x99t need the meat to be cooked; you just need some good searing on the surface.', 'Transfer this batch of beef to a 6-quart slow cooker. Repeat the searing process with the remaining meat.', '4 Cook the onion and garlic: Once all of your meat has been seared and transferred to the slow cooker, add the onion and garlic to the hot pan. Cook over medium-high heat, stirring frequently, until the onions are glossy and translucent, 3 to 4 minutes.', '5 Deglaze the pan: Add 3 cups of the beef stock to the hot pot and use a stiff wooden spoon or spatula to scrape the browned bits from the bottom of the pan. Add the Dijon mustard and Worcestershire sauce to the pot and bring the mixture to a boil.', 'Carefully pour the mixture into the slow cooker to cover the beef chunks.', '6 Cook the stroganoff: Add the bay leaf and mushrooms to the slow cooker. Give everything a stir, cover, and cook on high for 4 hours or on low for 8 hours.', ""7 Cook the noodles: About 15 minutes before you're ready to eat, cook the egg noodles in a pot of boiling water. Drain and toss with a little melted butter or olive oil to keep them from sticking. Cover to keep warm until ready to serve."", ""Alternatively, you can cook the dry noodles directly in the slow cooker\\xe2\\x80\\x94stir them in about 15 minutes before you're ready to serve and let them cook along with the sauce. (Just note that the noodles can quickly overcook and become mushy, so plan on serving the stroganoff as soon as the noodles are ready.)"", '8 Finish the stroganoff: In a small mixing bowl, gradually add about a cup of the cooking liquid to the sour cream, stirring constantly to temper the cream and keep it from curdling. Add this mixture to the slow cooker.', 'If the stroganoff seems too thick for your liking at this point, add up to another cup of broth. If it seems to thin, let it simmer with the lid off until thickened.', '9 Garnish with herbs. Prior to serving, remove the bay leaf and stir in the chopped dill and parsley. Serve over noodles along with crusty bread and a green salad.']",14
1315,Green Beans with Tomatoes and Bacon Recipe,15,75,90,"['4 slices thick cut bacon (about 4 ounces), cut into 1-inch segments', '1/2 large onion, diced (about 3/4 cup)', '1 clove garlic, minced', '1 pounds of fresh, firm green beans (they should break when you bend them, not bend like a rubber band), stem ends trimmed', '1 14.5-ounce can whole tomatoes', '1 large sprig fresh thyme', 'Salt', 'Freshly ground black pepper', '1/8 to 1/4 teaspoon of cayenne']",9,"['1 Cook the bacon until fat begins to render: Place the bacon pieces on the bottom of a large, thick-bottomed pot. Heat on medium heat for several minutes until the bacon fat begins to render.', '2 Add onions, then garlic: Add the chopped onions to the bacon. Cook a few minutes until the onions are translucent. Add the garlic (if using) and cook a minute more. Drain off any excess fat.', '3 Add green beans, tomatoes, spices: Add the green beans to the pot. Add the whole, peeled, canned tomatoes and their juices. Add a sprig of thyme to the pot (if using). Sprinkle with salt, pepper, and cayenne.', '4 Cover and simmer: Cover the pot and lower the heat to low. Simmer for 45 minutes to 1 hour, until the beans are cooked through and tender, stirring occasionally.', 'Slow Cooker Instructions If you want to use a slow cooker for step 4, you can easily do so. Just put the cooked bacon and onions from steps 1 and 2, and the beans, tomatoes and spices into a slow cooker and cook on high for 2 to 3 hours, depending on your slow cooker, until the beans are completely tender and the tomatoes have broken down.', 'Serve!']",6
1316,Slow Cooker Turkey Stew with Mustard and Root Vegetables Recipe,10,300,310,"['4 turkey thighs, skin on, bone-in', 'Salt', '4 tablespoons extra virgin olive oil', '1 large yellow or white onion, roughly chopped', '1-2 large parsnips, peeled, cut into 1-inch pieces', '2-3 large carrots, peeled, cut into 1-inch pieces', '3 cups chicken or turkey stock', '2 tablespoons brown sugar', '1/3 cup yellow mustard', '1 heaping tablespoon dry mustard powder', '2 teaspoons chipotle or chili powder', '4-6 Yukon Gold or other yellow potatoes, peeled, cut into 1-inch pieces', '1 cup (packed) roughly chopped mustard greens, arugula, spinach, or parsley', '1/4 cup whole grain mustard']",14,"['1 Salt the turkey thighs well and set out at room temperature for 30 minutes.', '2 Sear the turkey thighs: Heat the olive oil in a large pan over medium-high heat for a minute or two. Pat the turkey thighs dry with a paper towel and set them skin side down in the hot oil to brown. Turn the heat down to medium. Let them brown well, at least 3-5 minutes, before turning.', 'Don\\xe2\\x80\\x99t crowd the pan, the meat needs air flow around it to brown properly. Cook the turkey in batches if needed.', 'When the thighs are browned, place them in a slow cooker or Dutch oven.', '3 Saut\\xc3\\xa9 the onions in the pan once the turkey has browned, then add them to the slow cooker or Dutch oven.', '4 Season the stock: While the turkey and onions are browning, place the stock in a medium pot and bring to a simmer. Whisk in the brown sugar, yellow mustard (reserve the whole grain mustard for the end of the recipe), mustard powder, chipotle and a little salt. Cook for a minute and add salt to taste. Depending on how acidic your mustard is you may need to add a little cider or white vinegar as well.', '5  Add the carrots and parsnips to the pot with the turkey and onions. Pour the sauce over everything until the liquid is about 3/4 of the way up the sides of the turkey and vegetables. Reserve any remaining sauce. Cover and simmer on low, or cover and turn the slow cooker on high.', '6 Cook in a slow cooker for 4 hours on high, or in a Dutch oven for 1 hour on simmer.', '7 Add the potatoes and a little more sauce, if you have any. Cover and cook another 1-2 hours in a slow cooker, or 30-45 minutes in the Dutch oven.', '8 Strip skin and bones from turkey meat: Before serving, remove the turkey pieces from the pot, strip off and discard the bones and the skin, return the turkey pieces to the pot.', '9 Add greens and mustard: Stir in the mustard greens, arugula, or other greens you are using. Stir in the whole grain mustard. Adjust seasoning, adding more salt, chipotle powder, and mustard to taste.']",11
1317,How to Make Granola in the Slow Cooker,5,150,155,"['1 tablespoon olive oil, coconut oil, or cooking spray for greasing the slow cooker', '2 cups raw and unsalted nuts and seeds', '4 cups old-fashioned rolled oats (not quick cooking oats; gluten-free, if needed)', '1 cup flaked unsweetened coconut', '1 teaspoon ground cinnamon', '1/4 teaspoon kosher salt', '1/3 cup coconut oil (melted) or olive oil', '1/3 cup honey or maple syrup', '1 tablespoon vanilla extract', '1/2 cups freeze-dried fruit or 1 cup dried fruit, chopped if the fruits are larger than raisins (Or use a delicious mix of both!)', 'Special equipment:', 'Slow cooker, 3 1/2 quart or larger']",12,"['1 Lightly spray or grease the inside of the slow cooker with oil.', '2 Add the ingredients to the slow cooker: Combine the oats, coconut, nuts and seeds, spices, and salt in the slow cooker and stir to combine.', 'Whisk together the oil, liquid sweetener, and vanilla extract. Pour over the dry ingredients and mix together.', '3 Slow cook the granola: Set the slow cooker to high and leave the lid a bit ajar. This will allow moisture to escape and encourage hot air to circulate.', 'Cook for 2 to 2 1/2 hours, stirring the mixture together thoroughly every 20 to 30 minutes. (For my decade-old slow cooker, the magic number for the total cooking time seems to be 2 hours and 15 minutes). Be aware that each slow cooker is different, so you may need more or less time.', 'Toward the end of cooking, keep a closer eye on it as the nuts and coconut may begin to burn if they\\xe2\\x80\\x99ve not been stirred enough. The granola is finished when it starts to smell fragrant and the ingredients take on a toasted color.', '4 Cool the granola: Spread the granola out onto a few cookie sheets lined with foil or parchment (for easy transfer later) to encourage cooling. The granola will crisp further as it cools, about 10 to 15 minutes. Once cool, stir in any dried fruit as desired.', '5 Store the granola: Place in an airtight container and store in a cool, dry place. Use within 2 weeks.']",8
1318,Slow Cooker Honey Buffalo Chicken Wings Recipe,10,360,370,"['4 pounds party wings broken into flats and drummettes (See how to break down party wings in this post)', '1 tablespoon brown sugar', '1 1/2 teaspoon garlic powder', '1 1/2 teaspoon onion powder', '1 1/2 teaspoon kosher salt', '1 1/2 tablespoon fresh ground black pepper', '1 teaspoon paprika', '1 teaspoon cumin', '1 teaspoon dried parsley', '1/4 to 3/4 teaspoon cayenne, depending on the spice level you want', '3/4 cup hot sauce, like Crystal or Frank\\xe2\\x80\\x99s', '1/2 cup honey', '1 tablespoon butter, melted', '1 tablespoon molasses', 'To finish:', '1 tablespoon chopped chives, optional', 'Carrot and celery sticks, for serving', 'Blue cheese or ranch dressing, for serving', 'Special equipment:', '6-quart slow cooker']",20,"['1 Combine the spices and sprinkle over the wings: Combine the brown sugar, garlic powder, onion powder, salt, pepper, paprika, cumin, parsley, and cayenne in a medium size bowl. Place wings in the pot of the slow cooker. Sprinkle dry rub over the chicken wings and toss to coat.', '2 Combine the sauce ingredients, then pour over the wings: Pour the hot sauce, honey, butter, and molasses into the same bowl you used for the spices. Stir with a fork to combine, then pour over the wings and toss to coat.', '3 Cook the wings: Set the slow cooker to the desired temperature. If high, cook for 2 1/2 hours. If low, cook for 3 1/2 hours.', '4 Reduce the sauce: Once the wings are done, remove the wings from the pot and pour the liquid into a large saucepan. Simmer on high heat, stirring occasionally for 10 to 12 minutes, or until the sauce has reduced to a thick glaze consistency. While the sauce is thickening, preheat the broiler.', '5 Toss wings in the glaze, then broil: Place a wire rack on a rimmed baking sheet. Once the sauce has thickened into a glaze, toss the wings in the glaze to coat, then place on the wire rack.', 'Broil for 3 to 4 minutes, or until the wings start to get crispy. Flip the wings and broil the other side for an additional 3 to 4 minutes.', '6 Garnish and serve: Garnish wings with chopped chives, if desired. Serve with carrot or celery sticks and blue cheese or ranch dressing on the side.']",7
1319,Saut\xc3\xa9ed Kale with Smoked Paprika Recipe,10,15,25,"['1 pound fresh kale, carefully rinsed, stems and center ribs cut away and discarded, leaves coarsely chopped', '2 tablespoons extra virgin olive oil', '1 medium onion, chopped (about 1 cup)', '1/2 teaspoon smoked paprika (also sold as Pimenton), sweet or hot', 'Pinch of dried crushed red pepper', 'Salt']",6,"['1 Blanch the kale: Bring a large pot (4 qts) of water to a boil. Add a Tablespoon of salt to the water. Add the chopped kale. Cook until wilted, about 5 minutes. Drain and set aside.', '2 Saut\\xc3\\xa9 onions, add smoked paprika and crushed red pepper: Heat olive oil in a large saut\\xc3\\xa9 pan on medium heat. Add the chopped onion and saut\\xc3\\xa9 until translucent, about 5 minutes. Stir in the smoked paprika and crushed red pepper.', '3 Add the kale and saut\\xc3\\xa9 for several more minutes. Sprinkle on more salt and smoked paprika to taste.']",3
1320,Swordfish with Smoked Paprika Recipe,10,10,20,"['3 tablespoons extra virgin olive oil', '1 pound swordfish or other firm, white fish', 'Salt', 'Flour for dusting', '2 garlic cloves, sliced thin', '1/4 cup pine nuts, toasted', '2 tablespoons white wine', '4 Roma or other paste tomatoes, seeded and diced', '1/4 cup chopped parsley', '2 teaspoons Spanish smoked paprika', 'Black pepper']",11,"['1 Prepare the swordfish: Remove the skin from the swordfish and cut it into cubes. Salt the fish well and dust the cubes in flour.', '2 Sear swordfish chunks: Heat the olive oil in a saut\\xc3\\xa9 pan large enough to hold all the swordfish chunks in one layer. Sear them well on at least two sides. Give the first side 1-2 minutes, then sear other sides for 30 seconds to 1 minute each.', 'When the swordfish is cooked, remove it to a bowl and reserve.', '  3 Make the sauce: Add the garlic slices to the pan used to saut\\xc3\\xa9 the fish and saut\\xc3\\xa9 30 seconds or so. The second the garlic begins to brown, add the tomatoes, parsley, white wine, pine nuts and paprika.', '  4 Add fish to sauce: Toss to combine and cook 1 minute, then add the swordfish back to the pan, toss to combine and cook another 30 seconds or so. Serve at once.']",5
1321,Savory Dutch Baby Pancake with Salmon and Fried Egg Recipe,10,20,30,"['For the Dutch baby:', '3 large eggs', '3/4 cup whole milk', '4 tablespoons unsalted butter, melted and divided', '1/2 cup all-purpose flour', '3 tablespoons buckwheat flour (or whole wheat flour)', '1/4 teaspoon fine salt (1/2 teaspoon if using Kosher salt)', 'For the topping:', '1 tablespoon unsalted butter', '4 large eggs', '4 ounces thinly sliced smoked salmon', '4 small ripe tomatoes, sliced', '4 tablespoons sour cream', '2 tablespoons chopped fresh parsley', '4 tablespoons chopped scallions, thinly sliced including some of the green part', 'Black pepper, to taste', 'Special equipment:', 'Large cast iron skillet']",18,"['1 Adjust an oven rack to the center position and preheat the oven to 450\\xc2\\xbaF. Set a 10-inch ovenproof skillet (such as cast iron) in the oven to heat. Heat for 15 minutes or until very hot.', '2 Make the batter: In a blender, blend the eggs, milk, 2 tablespoons of the melted butter, all-purpose flour, buckwheat flour and salt together until frothy and well mixed.', '3 Bake the pancake: Swirl the remaining 2 tablespoons of melted butter in the hot skillet and pour in the batter. Bake for 18 to 20 minutes, or until puffed and golden.', '  4 Meanwhile, fry the eggs: In a skillet over low heat, melt the butter for the topping. Swirl the pan to coat the bottom. Break the eggs into the skillet, and cover the pan.', 'Cook for 2 minutes, or until all but a thin rim of egg white around each yolk is opaque. Remove the pan from the heat, keep covered, and let sit for about 30 seconds to finish cooking. Remove the cover and keep warm.', '5 Serve the pancake: Slice the pancake into quarters and set each on a plate. Top each quarter with a fried egg, a slice of salmon, tomato slices, and a few dollops of sour cream. Sprinkle with parsley, scallions, and a few grinds of black pepper.']",6
1322,How to Make Easy Refrigerator Pickles,10,1445,1455,"['1 pound Kirby or other small cucumbers', '1 small sweet yellow onion', '1 cup apple cider vinegar', '1 cup water', '1/4 cup granulated sugar', '1 tablespoon kosher salt', '1 1/2 teaspoons pickling spice, homemade or store-bought', 'Special equipment:', '2 wide-mouth pint canning jars', 'Canning jar lids, plastic or metal', 'Mandoline, or sharp knife', 'Canning funnel (helpful, but not essential)']",12,"['1 Wash and dry the jars and cucumbers: Wash 2 wide-mouth pint jars and their lids in hot, soapy water. Set them aside to dry.', 'Rinse the cucumbers well under cold water, pat them dry, and then set them on a towel to dry completely.', '2 Slice the cucumbers and onion, then pack them in the jars: With a sharp knife or a mandoline slicer, slice the cucumbers and onion into slices 1/8- to 1/4-inch thick.', 'Firmly pack the cucumbers and onions into the jars, fitting in as many as you can without smashing the vegetables. Leave 1/2-inch or so of headspace at the top of the jars.', '3 Make the brine: In a small saucepan over medium-high heat, bring the vinegar, water, sugar, salt, and pickling spice up to a simmer. Stir occasionally and continue simmering until the sugar and salt are dissolved.', ""4 Pour the brine over the vegetables: If you have a canning funnel, use it here to make it easier to fill the jars. Carefully pour or ladle the hot brine into each jar, filling the jars until the cucumbers and onions are covered. It\\'s ok if a few small pieces poke out the top."", '5 Cool and refrigerate for 24 hours: Screw on the lids, then let the jars cool to room temperature (about an hour). The cucumbers will start off bright green, but will become darker and more ""pickle-colored"" as they cool.', 'Place them in the refrigerator. Wait at least 24 hours before eating the pickles in order to let the flavors develop. Use them within one month.']",8
1323,Molasses Spice Cookies Recipe,20,15,35,"['2 1/4 cups all-purpose flour', '2 teaspoons of baking soda', '1/2 teaspoon of salt', '1 teaspoon ground ginger', '1 1/2 teaspoons ground cinnamon', '1/4 teaspoon ground allspice', '3/4 teaspoon ground cloves', '3/4 cup (1 1/2 sticks) unsalted butter, softened', '1/2 cup dark brown sugar, packed', '1/2 cup granulated sugar, plus 1/3 cup for rolling cookies', '1 large egg', '1 teaspoon vanilla extract', '1/3 cup molasses']",13,"['1 Whisk together flour, baking soda, spices: Preheat oven to 375\\xc2\\xb0F. Vigorously whisk together the flour, baking soda, salt, cinnamon, ginger, cloves, allspice in a bowl and set aside.', '2 Prepare butter, sugar, and wet ingredients: Use an electric mixer and beat the butter for 2 minutes. Add the brown sugar, and 1/2 cup granulated sugar and beat until light and fluffy, about 3 minutes with mixer set at medium speed. Add egg, vanilla extract, and molasses. Beat until combined, about 30 seconds. Scrape down sides of bowl with a rubber spatula.', '3 Add dry ingredients to wet ingredients: Add dry ingredients and beat at low speed until just combined, about 30 seconds.', '4 Make dough balls, roll them in sugar: Place remaining 1/3 cup of granulated sugar in a shallow bowl. Working with 2 Tbsp of dough each time, roll dough into 1 3/4 inch balls. Roll balls in sugar and place on un-greased cookie sheets, spacing them 1 1/2 to 2 inches apart.', '5 Bake: Bake at 375\\xc2\\xb0F until the outer edges of the cookies begin to set and centers are soft and puffy, about 11 to 13 minutes. Cool cookies on sheets for 2 to 3 minutes before transferring them to cooling racks .', 'Do not overcook! The centers of the cookies should be somewhat soft and spongy when you take them out of the oven, otherwise they will end up hard and dry.', 'Optional Glaze', ""When cookies have cooled, lay out over a sheet of wax paper. Sift 1 1/4 cups of confectioner's sugar (powdered sugar) and then whisk with 2 Tbsp of milk until smooth. Dip spoon into glaze and dribble over cookies.""]",8
1324,Candied Walnuts Recipe,0,25,25,"['1/2 cup sugar', '1 1/2 cups raw walnut halves', '1/8 teaspoon coarse salt']",3,"['1 Toast the walnuts: Preheat oven to 350\\xc2\\xb0F. Use middle rack in oven. Lay walnuts out on a baking sheet in a single layer. Bake for 5 minutes, until slightly darker in color and fragrant.', 'If not quite toasted enough, toast for 1 or 2 more minutes. Be careful not to burn. Remove from oven and let cool in pan on a rack.', ""2 Get everything ready: You'll need to work quickly once the caramelized sugar is ready, so be sure to have everything prepped and ready to go."", 'Place the cooled walnuts in a bowl near the stove. Line a rimmed baking sheet with a silicon baking mat or parchment paper and place near the stove. Have two forks ready.', '3 Caramelize the sugar: Pour sugar into a medium saucepan with a thick bottom and place over medium heat. Stir with a wooden spoon as the sugar begins to melt.', 'Keep stirring until all the sugar has melted and the color is a medium amber, 5 to 10 minutes (exact timing will depend on your stovetop).', '4 Coat the walnuts in caramelized sugar: As soon as sugar has melted and the color is a medium amber, add the walnuts to the pan. Stir quickly and make sure each piece is coated with the sugar mixture.', 'As soon as the walnuts are coated with the sugar mixture, spread them out on the rimmed baking sheet. Use two forks to separate the walnuts from each other, working very quickly. Sprinkle the nuts with the salt.', '6 Cool and store: Let the walnuts cool completely. Transfer to an airtight container and store for up to a week.']",9
1325,Chocolate Chip Cookies Recipe,5,42,47,"['2 1/2 (350g) cups all-purpose four', '2 tablespoons nonfat milk powder', '1 teaspoon salt', '1 teaspoon baking soda', '3/4 cup (150g) granulated sugar', '3/4 cup (161g) dark brown sugar', '1 cup (2 sticks, or 8 ounces) unsalted butter, very soft', '2 large eggs', '1 teaspoon vanilla extract', '12 ounce bag (about 2 cups) semisweet chocolate chips', 'Special equipment:', 'Baking sheets', 'Silicon baking mat', 'Medium cookie scoop', 'Wire cooling rack']",15,"['1 Mix the dry ingredients: In a small mixing bowl, combine the flour, milk powder, salt, and baking soda and whisk to mix. Set aside.', '2 Mix the sugars and the butter: With an electric mixer or in a stand mixer with a beater attachment, beat together the granulated sugar, brown sugar, and softened butter on medium speed until combined, 30 to 60 seconds. Pick out any large pebbles of hard brown sugar that you see. Scrape down the sides of the bowl and the beaters.', '3 Mix in the eggs and vanilla: Add the two eggs and vanilla to the butter-sugar mixture and beat at medium speed until no clumps or streaks remain, 10 to 20 seconds. Scrape down the sides of the bowl and the beaters.', '4 Mix in the flour mixture: Add the flour mixture all at once. Beat on low speed just until no more dry streaks of flour are visible, 20 to 40 seconds. You may still see some flecks of milk powder -- this is fine.', '5 Mix in the chocolate chips: Add all of the chocolate chips and beat on low speed for just a few seconds until the chips are evenly incorporated.', '6 Chill the dough: Scrape down the sides of the bowl and the beater. Cover the bowl and refrigerate for at least 30 minutes or up to three days. (Or freeze in individual scoops for up to 3 months.)', '7 Heat the oven to 375F: Place a rack in the middle of the oven. Line two baking sheet with silicon baking mats or parchment.', 'I usually bake my cookies one sheet at a time to help them bake evenly. If you prefer, or are crunched for time, bake two sheets at a time with one sheet in the upper third of the oven and the other in the lower third of the oven.', '8 Scoop the dough: Use a medium cookie scoop (or a well-mounded tablespoon measure) to scoop the dough out onto one of the baking sheet. Space the cookies about 2 inches apart.', '9 Bake the cookies for 10 to 12 minutes: While the first batch bakes, scoop the cookies for the next batch.', 'The cookies are done when they look slightly puffed in the middle and are starting to turn toasty at the edges.', '10 Cool the cookies: Cool the cookies on the baking sheet for about 5 minutes, or until the puffed middle collapses down and the cookies have firmed a little. Transfer the cookies to a wire cooling rack to cool completely.', '11 Continue baking cookies in batches until all the cookie dough has been used.', '12 Enjoy! These cookies are at their crispiest best on the day they are made. Store leftovers in an airtight container; they will soften a little overnight but are still very delicious. They keep for about a week before becoming crumbly (at which point, I recommend crumbling them over ice cream!).']",14
1326,Baked Stuffed Jalape\xc3\xb1os Recipe,15,25,40,"['For the cream cheese filling version:', '12 jalape\\xc3\\xb1o peppers (see Recipe Note)', '1/4 cup minced onion', '1/4 cup chopped fresh cilantro', '3/4 cup cream cheese', '1 1/2 teaspoons cumin', '1 teaspoon salt (more or less to taste)', '2 ounces jack cheese, cut into 2 1/2-inch long batons', 'For the bacon and jack cheese filling version:', '12 jalape\\xc3\\xb1o peppers (see Recipe Note)', '1/4 cup chopped cooked bacon', '1/4 cup minced onion', '1/2 cup shredded jack cheese, plus another 2 ounces of jack cheese cut into 2 1/2-inch long batons', '1/4 cup chopped fresh cilantro', '1 1/2 teaspoons cumin', '1 teaspoon dried oregano']",16,"['1 Preheat the oven to 375\\xc2\\xb0F.', '2 Prepare the jalape\\xc3\\xb1os for stuffing: You can either slice the jalape\\xc3\\xb1os in half lengthwise or you can slice off the top one-third (lengthwise) of each jalape\\xc3\\xb1o to make a boat shape out of each pepper.', 'The halved jalape\\xc3\\xb1os will go further (twice as many stuffed peppers), but you can put more filling into the boat-shaped peppers. Your choice.', 'If you choose to make the boats, you can mince the tops and add them to the filling if you want some extra heat, or save them for another recipe.', 'In either case, scrape out all the seeds and ribs from each jalape\\xc3\\xb1o with a spoon (a grapefruit spoon works great).', '3 Mix together all the filling ingredients except the jack cheese batons.', '4 Stuff the jalape\\xc3\\xb1os: Pack the filling into the peppers and nestle a baton of jack cheese onto the filling of each one.', '5 Bake: Arrange the peppers on a foil-lined baking sheet and bake at 375\\xc2\\xb0F for 20 to 30 minutes, or until the cheese is bubbly and lightly browned, and the peppers are cooked.', 'Cool for 5 minutes before serving.']",9
1327,How to Make Fruit Leather,20,540,560,"['Fresh fruit (apricots, peaches, plums, berries, apples, pears, grapes)', 'Water', 'Lemon juice', 'Sugar (if needed)', 'Spices such as cinnamon and nutmeg (optional)']",5,"['1 Rinse, taste, and prep the fruit: Rinse the fruit. If you working with stone fruit, take out the pits, chop the fruit. If working with apples or pears, peel and core them, then chop. If working with grapes, de-stem them.', 'Taste the fruit before proceeding. Note how sweet the fruit is. If very sweet (ripe Concord grapes for example) you will not need to add any sugar. If still a little tart, you may need to add some sugar in the next step.', '2 Cook fruit with water, sugar, lemon juice, spices: Place fruit in a large saucepan. Add a half cup of water for every 4 cups of chopped fruit.', 'Bring to a simmer, cover and let cook on a low heat for 10-15 minutes, or until the fruit is cooked through. Uncover and stir.', 'Use a potato masher to mash up the fruit in the pan.', 'Taste the fruit and determine what and how much sugar, lemon juice, or spices to add.', 'Add sugar in small amounts (1 Tbsp at a time if working with 4 cups of fruit), to desired level of sweetness.', 'Add lemon juice one teaspoon at a time to help brighten the flavor of the fruit. Add a pinch or two of cinnamon, nutmeg, or other spices to augment the flavor.', 'Continue to simmer and stir until any added sugar is completely dissolved and the fruit pur\\xc3\\xa9e has thickened, another 5 or 10 minutes (or more).', 'Note if you are working with grapes - strain the juice out of the mashed grapes to make grape juice. Force what is left behind, after straining, through a food mill, to make the pur\\xc3\\xa9e for the next step.', '3 Pur\\xc3\\xa9e the cooked, mashed fruit: Put the pur\\xc3\\xa9e through a food mill or chinoise. Alternatively pur\\xc3\\xa9e it thoroughly in a blender or food processor.', 'Taste again and adjust sugar/lemon/spices if necessary. The pur\\xc3\\xa9e should be very smooth.', '4 Pour pur\\xc3\\xa9e into lined baking sheet: Line a rimmed baking sheet with sturdy plastic wrap (the kind that is microwave safe). Pour out the pur\\xc3\\xa9e into the lined baking sheet to about an 1/8 to 1/4 inch thickness.', ""5 Slowly dry out in oven at a very low temp: Place the baking sheet in the oven, try to keep any plastic wrap from touch the sides of the oven or the oven racks. Also try to make sure that the plastic wrap hasn't folded back over on top of the pur\\xc3\\xa9e. If this happens, the pur\\xc3\\xa9e won't dry out."", 'Heat the oven to a low 140\\xc2\\xb0F. If you have a convection setting, use it, it will speed up the process and help dry out the pur\\xc3\\xa9e. Let dry in the oven like this for as long as it takes for the pur\\xc3\\xa9e to dry out and form fruit leather.', 'We usually keep it in the oven overnight, so about 8-12 hours. The fruit leather is ready when it is no longer sticky, but has a smooth surface.', ""Alternatives to the oven. If you have a food dehydrator, this would be a great use of it. My mother suggested putting the tray in the weber grill, and leaving covered, in the sun all day. Sounds like a good trick, but I haven't tried it yet."", 'My parents remember the traditional way of making fruit leather was just to tent the tray with some cheesecloth and leave it outside in the sun on a hot day.', '6 Roll up in its plastic wrap to store: When the fruit leather is ready, you can easily peel it up from the plastic wrap.', 'To store it, roll it in its plastic wrap, put it in an airtight container and store in the refrigerator or freezer.']",20
1328,Grandma\xe2\x80\x99s Oatmeal Cookies Recipe,20,10,30,"['1 cup shortening', '1 cup brown sugar', '1 cup white sugar', '2 large eggs, well beaten', '1 tablespoon vanilla extract', '1 1/2 cup all-purpose flour', '1 teaspoon salt', '1 teaspoon baking soda', '1 tablespoon cinnamon', '3 cups old-fashioned rolled oats (we use Quaker Quick or Old Fashioned. Do NOT use instant.)', '3/4 cup chopped walnuts (use 1/2 cup if using raisins)', '1 cup raisins (optional)']",12,"['1 Preheat the oven to 350\\xc2\\xb0F.', '2 Make the cookie dough: Beat together the shortening and sugars. Add the eggs and vanilla extract, and beat well.', 'Whisk together the flour, salt, baking soda and cinnamon. Add to sugar and egg mixture and mix well. Add a tablespoon of water. Add raisins (if using) and nuts. Add oats last.', '3 Bake: Spoon out by heaping tablespoonfuls on to greased cookie sheets. Bake at 350\\xc2\\xb0F. Bake for 10 minutes. Remove to a wire rack.', '4 Cool completely. Cookies will keep for several days in an airtight container on the counter.']",5
1329,Blueberry Muffins Recipe,15,25,40,"['2 1/2 cups of all-purpose flour, plus 1 tablespoon for dusting the blueberries', '1 tablespoon baking powder (make sure your baking powder is still good! click to see how)', '1/2 teaspoon baking soda', '1/2 teaspoon salt', '8 tablespoons butter (1 stick), melted', '1 cup sugar', '2 large eggs', '1 1/2 cup plain sour cream', '2 tablespoons milk', '1 teaspoon vanilla extract', '1 teaspoon lemon zest', '1 1/2 cups blueberries, fresh or frozen (see Recipe Note)', 'Special equipment:', 'Standard 12-cup muffin tin']",14,"[""1 Preheat the oven and prep the muffin tin: Preheat your oven to 400\\xc2\\xb0F with a rack in the lower middle. Using a standard 12-well muffin pan, place a muffin liner in each well, or if you don't have muffin liners, grease the inside of the muffin pan wells with vegetable oil or butter."", '2 Toss the berries with flour: Place the blueberries in a bowl. Sprinkle 1 tablespoon of flour over them and gently toss to coat. (The flour will help keep the blueberries from sinking in the muffin as it cooks.)', '3 Mix the dry ingredients: In a mixing bowl, whisk together the dry ingredients\\xe2\\x80\\x94the flour, baking soda, baking powder, and salt.', '4 Mix the wet ingredients separately: In a large mixing bowl, place the sour cream, sugar, eggs, milk, melted butter, lemon zest, and vanilla (the wet ingredients). Whisk together until smooth.', '5 Make the batter: Add the dry ingredients to the butter/sugar/egg mixture a third at a time and mix until just incorporated.  Do not over mix!', 'Gently fold the blueberries into the mixture.', ""6  Portion out the muffins: Distribute the dough equally among the cups. You'll need to fill them very high to use all of the batter in 12 muffins, which is fine. They won't spill. If you still have too much dough, start filling another tin."", '7 Bake the muffins: Place the muffins in the oven and bake at 400\\xc2\\xb0F until the muffins are golden brown, about 20 minutes. (If the muffins are getting too brown, tent with foil.) Test with a bamboo skewer to make sure the centers of the muffins are done.', '8 Cool and serve: Let the muffins cool in the muffin pan for 2 to 3 minutes, then remove them from the pan. Let cool another 10 minutes before eating.']",9
1330,No Bake Chocolate and Peanut Butter Cookies Recipe,10,23,33,"['1 1/2 cups sugar', '1/2 cup unsalted butter', '1/2 cup milk', '1/4 cup cocoa powder', '1/2 cup creamy peanut butter', '1 teaspoon vanilla extract', '1/4 teaspoon kosher salt', '3 cups rolled oats (gluten-free, if needed)', 'For the peanut butter drizzle (optional):', '3 tablespoons creamy peanut butter', '2 teaspoons coconut oil', 'Special equipment:', 'Medium cookie scoop']",13,"['1 Line a baking sheet with parchment and set to the side.', '2 Make and mix the cookie base: In a medium saucepan over medium heat, combine the sugar, butter, milk, and cocoa powder. Cook until the sugar and butter are melted, stirring to combine.', 'Bring the mixture to a boil, and then continue to boil for 1 minute.', 'Pour the mixture into a large mixing bowl and stir in the peanut butter, vanilla, and salt. Stir in the rolled oats.', '3 Scoop the cookies: Using a medium cookie scoop, scoop and place the cookie dough on the lined parchment baking sheet. If you don\\xe2\\x80\\x99t have a cookie scoop, use a tablespoon measure and scoop well-mounded tablespoons of dough for each cookie.', 'You can either leave them the shape of the scoop or shape them by gently rolling and flattening between your palms.', ""4 Make the peanut butter drizzle (optional): If you'd like to add the peanut butter drizzle, melt the peanut butter and coconut oil together in the microwave for 30 seconds. Stir to combine, then drizzle over the cookies using a spoon."", ""Skip this drizzle if you're planning to pack up the cookies for eating on the go; the drizzle softens a little when the cookies are at room temperature, which can make them a little messy when eating on the go."", '5 Refrigerate for 20 minutes to firm up the cookies and set the drizzle. Transfer to an airtight container.', 'Cookies will keep for about a week at room temperature, or a month if refrigerated. If you added the peanut butter drizzle, keep refrigerated so the drizzle stays firm.']",10
1331,Orange-Spiced Whole Wheat Muffins Recipe,20,20,40,"['For the muffin topping:', '1/4 cup chopped walnuts', '1/4 cup granulated sugar', '1 teaspoon cinnamon', 'For the muffins:', '1 1/2 cup (195g) whole wheat pastry flour', '1 cup (130g) all-purpose flour', '1 1/2 teaspoons baking powder', '1/2 teaspoon baking soda', '3/4 cup (164g) granulated sugar', '1/4 teaspoon kosher salt', '2 teaspoons cinnamon', '3/4 teaspoon ground cloves', '3/4 teaspoon ground ginger', '1/4 teaspoon nutmeg', '2 teaspoons orange zest (from about 1 large orange)', '2 large eggs, beaten', '1 1/4 cups buttermilk', '1/4 cup applesauce', '5 tablespoons butter, melted', '1 teaspoons vanilla extract', '3/4 cup chopped walnuts']",22,"['1 Prep the pans and oven: Line a muffin tin with cupcake liners. Preheat oven to 400\\xc2\\xb0F.', '2 Make the muffin topping: In a small bowl, combine 1/4 walnuts, 1/4 cup granulated sugar, and 1 teaspoon cinnamon. Set aside.', '3 Combine the flours and spices: In a large bowl, whisk together whole wheat pastry flour, all-purpose flour, baking powder, baking soda, granulated sugar, salt, cinnamon, cloves, ground ginger, nutmeg, and orange zest.', '4 Make the batter: In a small bowl, whisk together eggs, buttermilk, applesauce, melted butter, and vanilla extract. Add the wet ingredients to the dry ingredients and stir to combine. The batter should be mostly combined with a few streaks of flour.', 'Add 3/4 cup walnuts, stir until incorporated. Do not overmix the batter; it will result in dense muffins.', ""5 Fill the muffin cups: Fill muffin cups to the top with batter\\xe2\\x80\\x94don't worry, this is exactly how full you want them. Sprinkle with walnut and cinnamon sugar topping."", '6 Bake the muffins: Bake for 18 minutes until the muffins have crested over the pan and a toothpick inserted in the center comes out clean. They may show a combination of loose sugar and melted sugar.', 'The muffins should release from the just fine, but they may touch in a few places on the sides. Not to worry. Just use a knife to cut them apart before lifting them out of the pan. If the muffins are difficult to release from the pan, run a knife horizontally between the muffin top and the top of the muffin pan, taking care not to cut through the body of the muffin.', 'Serve warm with a pat of butter and a drizzle of honey. Or just eat them. Either way.', 'Store in an airtight container on the countertop for up to five days or freeze in a zip-top plastic bag. They will keep in the freezer for up to three months.']",10
1332,How to Harvest and Roast (in shell) Sunflower Seeds Recipe,5,45,50,"['1 cup raw in-shell sunflower seeds', '2 1/2 Tbsp kosher salt, or 2 Tbsp table salt*', '1 quart water', '* Add more or less salt to taste, up to 1/4 cup Kosher salt for 1 quart of water.']",4,"['1 Boil sunflower seeds in salted water: Place sunflower seeds, salt, and water into a medium saucepan. Bring to a boil. Reduce to a simmer and simmer for 15 to 20 minutes.', '2 Spread seeds on a sheet pan on roast: Drain the water from the seeds and spread the seeds out in a single layer in a sheet pan. Place in a 400\\xc2\\xb0F oven on the top rack and roast for 10 to 15 minutes.', 'Starting at about 10 minutes, I recommend taking a few out of the oven to test. If they are not roasted yet to your satisfaction, return them to the oven for another 2 to 5 minutes.', 'Keep checking every few minutes until they are dry enough and roasted to your satisfaction.', 'The seeds can quickly go from done (dry and easy to bite to open) to charred (browned on outside and black on the inside). So as the time gets closer, keep an eye on it.']",5
1333,Golden Cheddar Cheese Crisps Recipe,15,10,25,"['6 ounces sharp cheddar (about 2 cups grated)', '1/4 cup all-purpose flour', '1 teaspoon paprika', '1/8 teaspoon baking powder', 'Pinch of cayenne pepper, to taste (optional)', '1 tablespoon unsalted butter, at room temperature', '1 tablespoon black sesame, poppy, coriander, or cumin seed']",7,"['1 Heat the oven to 350F. Line two baking sheets with parchment paper. Using the large holes of a grater, grate the cheese.', '2 Make the crisp mix: In a bowl, combine the flour, paprika, baking powder, and cayenne. Add the butter, and mix with a fork or your fingers until blended in. Stir in the seeds. Add the grated cheese and toss with your hands to combine.', '3 Form and bake the crisps: Mound tablespoon-size portions of the cheese mixture on the baking sheets, spaced 2 inches apart. Flatten them slightly with the back of the spoon.', ""It's not absolutely necessary, but you can also use a 2-inch round cookie cutter as a mold to keep the cheese tidy if you like. Place the cutter on the baking sheet and drop a spoonful of cheese mix into it. Lift the cutter, level the cheese, and repeat until you have made all the crisps."", '4 Bake for 9 to 12 minutes, or until golden. Let the crisps cool completely on the baking sheets. Lift the edge of the parchment to lift the crisps off the baking sheet, then peel them off. Store in an airtight container.']",5
1334,Tempura Fried Calamari Recipe,75,25,100,"['1 pound cleaned squid', '1 egg yolk', '1 cup ice cold sparkling water (the colder the better)', '1/8 teaspoon baking soda', '1 teaspoon salt', '1/4 cup cornstarch', '3/4 cup rice or regular flour plus more for sprinkling on squid', 'Peanut oil or canola oil for frying', 'Special equipment:', 'A deep fryer']",10,"['1 Slice the squid tubes into rings: Slice the squid tubes into rings about 1/2-inch to 3/4-inch wide. Leave the tentacles whole.', '2 Heat oil in a deep fryer or large heavy pot: This recipe was designed for a deep-fryer, but you can also fill a large, heavy-bottomed pot (keep a lid nearby, for safety reasons) halfway with oil, about 3 inches deep. Heat the oil to 360-370\\xc2\\xb0F.', '3 Mix dry ingredients: While the oil is heating, mix all the dry ingredients together well.', '4 Mix sparkling water with egg yolk, then mix with dry ingredients: Once the oil has reached 360\\xc2\\xb0F, take the sparkling water out of the refrigerator and mix it with the egg yolk. Immediately mix it in with the dry ingredients.', 'Mix quickly. Do not worry if there are clumps or lumps. Over-mixing may cause the batter to become chewy when cooked.', '5 Sprinkle squid pieces with flour. Use a small sieve to lightly dust the squid pieces with rice flour or regular flour. This will help the batter adhere to the squid.', '6 Dip squid pieces in batter and fry in hot oil: Working in small batches at a time (about 6 pieces), dip the squid pieces in the batter. Pick them up one by one and gently put them in the hot oil. (Note if your fingers are coated with the batter, it will help protect them from splatter.)', 'When the squid pieces are in the oil, use a chopstick or the handle of a wooden spoon to dislodge any squid pieces that may have become stuck from the bottom of the pot or fryer. Fry for 45 seconds to 1 minute, and remove to paper towels to drain.', 'Note that when done, they will NOT be golden brown, but more of a pale yellow or tan.', 'Repeat with the rest of the squid. Working in batches will help keep the oil temperature from falling too far while you are frying the squid.', '6 Serve immediately: Serve immediately with lime or lemon wedges, soy sauce, ponzu sauce, Tabasco or another hot sauce.', 'Once the cooking oil has completely cooled (after about 2 hours), strain it through a paper towel-lined sieve, and save it to reuse the next time you want to deep fry seafood.']",12
1335,Giant Ginger Cookies Recipe,20,29,49,"['4-1/2 cups all-purpose flour', '4 teaspoons ground ginger*', '2 teaspoons baking soda', '1-1/2 teaspoons ground cinnamon*', '1 teaspoon ground cloves*', '1/4 teaspoon salt', '1-1/2 cups butter (3 sticks), room temperature', '2 cups granulated sugar', '2 eggs', '1/2 cup molasses (unsulfured)', '3/4 cup coarse sugar or granulated sugar (for rolling)', '* Can substitute the ground ginger, cinnamon, and cloves for an equal amount of pumpkin pie spice.']",12,"['1 Combine the dry ingredients: In a medium bowl whisk together flour, ground ginger, baking soda, ground cinnamon, ground cloves, and salt.', '2 Make the dough: In a large mixing bowl beat the butter to soften it. Then slowly add the sugar, beating until well combined, scraping down the sides of the bowl when necessary. Beat in the eggs (one at a time) and the molasses. Mix in the flour mixture, using a wooden spoon.', '3 Preheat oven to 350\\xc2\\xb0F.', '4 Arrange balls of dough on cookie sheet: Using 1/4 cup of dough at a time, the the dough into 2-inch balls. Roll the dough balls in sugar. Place the balls of dough about 2-1/2 inches apart on an un-greased cookie sheet.', '5 Bake: Bake in a 350\\xc2\\xb0F oven for 12 to 14 minutes or until cookies are light brown and puffy. Cool on cookie sheet for 2 minutes, then transfer the cookies to a wire rack to cool completely.', 'Store in a tightly covered container at room temperature for up to 3 days or in the freezer for up to 3 months.']",6
1336,Holiday Spice Granola Recipe,15,25,40,"['1/2 cup maple syrup', '1/3 cup coconut oil', '1 tablespoon vanilla extract', '1 teaspoon ground cinnamon', '1 teaspoon ground ginger', '1/2 teaspoon salt', '1/4 teaspoon ground cloves', '5 cups old-fashioned rolled oats (not instant; use gluten-free oats, if needed)', '2/3 cup flax seeds', '2/3 cup pumpkin seeds', '1/2 cup whole almonds', '1/2 cup cashews', '1/3 cup chia seeds', '1 /2 cup dried cranberries', '1/2 cup diced dried apricots']",15,"['1 Heat the oven to 350F. Line a rimmed baking sheet with a piece of parchment paper that is about 1 inch larger all around than the baking sheet.', '2 Make the syrup: In a saucepan over medium heat, stir together the maple syrup, coconut oil, vanilla, cinnamon, ginger, salt, and cloves. Stirring occasionally, cook for 2 minutes, or until the syrup is warm and fluid, and the salt dissolves.', '3 Mix the granola: In a large bowl, combine the oats, flax seeds, pumpkin seeds, almonds, cashews, and chia seeds. Pour the warm syrup over the nuts and grains. Stir to coat them thoroughly. Spread evenly on the baking sheet.', '4 Bake the granola: Bake for 15 minutes, then remove the pan from the oven. Grasp the corners of the parchment paper and pull them toward the center to mound the granola in a pile. Stir with a large spoon and spread the granola out again in one layer.', 'Return to the oven for 5 minutes. Remove and mound the granola in the center again. If it still looks pale in places, give it another stir, spread it back out, and return the pan to the oven to toast for 3 or 4 minutes more. (Total baking time is 20 to 25 minutes.) Leave on the baking sheet to cool completely.', '5 Add fruit and store the granola. Scatter the cranberries and apricots over the cooled granola and stir to combine. Transfer the granola to an airtight jar or tin, and store at room temperature for several weeks.']",6
1337,Chocolate Cranberry Zucchini Muffins Recipe,15,25,40,"['1 cup (150g) all-purpose flour', '1 cup (110g) almond flour', '1/3 cup (28g) unsweetened Dutch process cocoa powder', '1 1/2 teaspoons baking powder', '1/2 teaspoon baking soda', '1 teaspoon ground cinnamon', '1/2 teaspoon salt', '2 large eggs', '1/3 cup (113g) honey', '1/4 cup (50g) olive oil', '1/4 cup buttermilk', '1 teaspoon vanilla extract', '3 cups grated zucchini (3 to 4 medium zucchini; see Recipe Note)', '1 cup fresh or frozen whole cranberries', '2 tablespoons coarse sugar, such as turbinado sugar', '3 tablespoons chopped green pistachios', 'Special equipment:', '12-cup muffin tin']",18,"['1 Adjust a rack to the middle position of the oven, and heat oven to 400F.', '2 Prepare the muffin tin: Generously butter the cups and rims of a standard 12-cup muffin tin, or line the tin with paper cupcake liners. Have on hand a 21/2-inch ice-cream scoop.', '3 Combine the dry ingredients: In a large bowl, whisk together the all-purpose flour, almond flour, cocoa powder, baking powder, baking soda, cinnamon, and salt.', '4 Add the wet ingredients: Make a large well in the center of the bowl and break the eggs into it. Add the honey, oil, buttermilk, and vanilla. Beat with a fork to mix thoroughly. With a spatula, stir until the flour is well incorporated.', '5 Stir in the zucchini and cranberries.', '6 Scoop into the muffin cups: Using the ice cream scoop, fill each muffin cup, rounded side up, with about 1/3 cup batter.', '  Sprinkle the muffins with the turbinado sugar and pistachios, and set the tin on a baking sheet.', '7 Bake for 23 to 25 minutes, or until a toothpick inserted into the center of a muffin comes out with just a few crumbs.', '8 Set the muffin tin on a rack to cool for 10 minutes. Remove the muffins from the pan and cool on the rack.']",9
1338,Morning Glory Muffins Recipe,20,25,45,"['3/4 cup (90g) all-purpose flour', '3/4 cup (85g) whole wheat flour', '3/4 packed cup (160g) light brown sugar, packed', '1/2 teaspoon salt', '1 1/2 teaspoons baking soda', '1/4 teaspoon baking powder', '2 teaspoons ground cinnamon', '1/4 teaspoon ground nutmeg', '1/4 teaspoon ground allspice', '3 large eggs', '3/4 cup (149g) canola oil', '1/4 cup (85g) honey', '1 teaspoon vanilla extract', '2 medium carrots, grated (about 1 1/4 cups)', '1 small apple, peeled, cored, and grated (about 1/2 cup)', 'Zest from one medium orange', '1/2 cup golden or dark raisins', '1/2 cup walnuts, chopped', 'Special equipment:', '12-cup standard muffin tin']",20,"['1 Preheat the oven to 400\\xc2\\xb0F. Line a 12-cup muffin pan with paper cups or grease with butter.', '2 Combine the dry ingredients: In a bowl, whisk together the flours, sugar, salt, baking soda, baking powder, cinnamon, nutmeg, and allspice to combine. Use a spoon to smash apart any remaining brown sugar lumps. (If you shake the bowl, any lumps will rise to the surface.)', '3 Make the batter: In a large bowl, stir the eggs to break them up. Add the canola oil, honey, vanilla, carrots, apple, orange rind, raisins, and walnuts. Stir thoroughly. Stir in the dry ingredients until well blended.', 'Divide the batter among the muffin cups, filling them almost to the top. Tap the muffin pan once, hard, on the counter to settle any air pockets.', '4 Bake the muffins for 22 to 25 minutes, or until they are firm and a toothpick inserted into the middle emerges clean. Set the muffins on a wire rack to cool. Muffins keep well for several days stored in an airtight container.']",5
1339,BBQ Bacon Jalape\xc3\xb1o Poppers Recipe,30,40,70,"['For the bacon:', '12 ounces (8 to 12 slices) thick-cut smoked bacon', '1 1/2 tablespoons barbecue sauce', 'For the filling:', '8 ounces plain cream cheese, softened to room temperature', '1 cup (about 3 ounces) coarsely shredded sharp cheddar cheese', '1 1/2 tablespoons minced fresh chives', '1 large clove garlic, minced', '2 tablespoons barbecue sauce', '12 medium-sized jalape\\xc3\\xb1os', 'Extra minced fresh chives to garnish', '1 cup sour cream, to serve (optional)']",12,"['1 Preheat oven to 375\\xc2\\xbaF. Line a baking sheet with aluminum foil. Lay a few layers of paper towels on top of a cooling rack and place near the oven.', '2 Glaze and bake the bacon until crispy: Arrange the bacon in a single layer on the baking sheet. Brush with 1 1/2 tablespoons of barbecue sauce.', 'Transfer to the oven and bake until crisp and caramelized, 15 to 20 minutes (begin checking around 15 minutes; the bacon could take up to 20 minutes to fully crisp depending on the brand and thickness).', 'Remove the bacon from oven and drain for a few minutes on paper towels, then transfer to a plate to finish cooling. The pieces will stick to the paper towels if left for too long.', '3 While bacon cooks, prepare the filling: Combine cream cheese, cheddar cheese, chives, garlic and barbecue sauce in a small mixing bowl.', '4 Prepare the jalape\\xc3\\xb1o peppers: Wear gloves for this step if you are sensitive to pepper heat. Cut the jalape\\xc3\\xb1os in half lengthwise. Use a spoon to scoop out the seeds. You can leave the stems on (they make nice handles for eating!) or trim them off.', 'Arrange all the jalape\\xc3\\xb1os cut-side up on a platter or baking sheet.', '5 Stuff the peppers: Chop or crumble the bacon into small bits, then fold into the cream cheese mixture. Using a spoon, fill each of the jalape\\xc3\\xb1o halves with a big dollop of the cream cheese mixture, mounding slightly.', 'At this point, the poppers can be covered and refrigerated until ready to grill, up to 24 hours.', '6 Prepare your grill: For gas grills, heat the grill with the burners set to high and preheat for 10 minutes. When ready to grill, reduce the burners to medium.', 'For charcoal grills, fill a grill chimney with charcoal and light it. When the coals are hot (they should be covered with a layer of fine gray ash) empty the coals into the grill and push them to one side of the grill to make higher heat and lower heat cooking zones. Set the grate in place and cover the grill. Preheat the grate for 5 minutes.', ""7 Grill the poppers: Brush grill grates with oil to prevent sticking. If you're using a charcoal grill, cook over the low-heat cooking zone."", ""Using tongs, place the poppers on the grill so they lay across the grates and don't fall through. If any of the poppers is leaning to the side, prop it up against a neighbor so the cheese filling doesn't start to melt out as the poppers cook."", 'Grill until the poppers are seared on the bottoms and the cheese filling is hot and bubbling around the edges, about 10 minutes. Be careful of overcooking or the peppers will become too soft.', '8 Serve the poppers right away: Using tongs and a spatula in tandem to scoop up the poppers, remove from the grill and transfer to a platter. Serve immediately alongside sour cream, if desired. Discard the stems as you eat.']",15
1340,Mushroom Caviar Recipe,10,10,20,"['3 Tbsp butter', '1/2 pound cremini mushrooms, wiped clean and finely chopped (or pulsed a few times in a food processor)', 'Salt and pepper', '1/2 cup of minced shallots', '1 Tbsp dry white wine (e.g. Sauvignon Blanc) optional', '1 garlic clove, minced', '2 Tbsp pine nuts', '2 Tbsp sour cream', '2 teaspoons lemon juice', '1 Tbsp chopped parsley', 'A couple dashes of cayenne pepper, to taste']",11,"['1 Saut\\xc3\\xa9 mushrooms, shallots, and garlic: Melt butter in a large skillet on high heat. Add the mushrooms and shallots. Saut\\xc3\\xa9 for 5 minutes stirring frequently. Sprinkle lightly with salt and pepper while cooking.', 'Once the mushrooms have cooked for about 5 minutes, add the garlic and a tablespoon of dry white wine (if using). Cook for an additional minute and remove from heat.', '2 Toast the pine nuts: While the mushrooms are cooking, heat a small skillet on high heat. Add the pine nuts. Cook, stirring frequently, until they begin to get a little toasted. (Keep your eyes on the nuts, they can burn pretty quickly.)', 'As soon as they begin to toast, remove the pan from the heat and put the pine nuts into a small bowl. Set aside.', '3 Once the mushrooms have cooled down a bit, mix in the pine nuts, lemon juice, sour cream, and parsley. Add more salt and pepper, if needed, to taste. Sprinkle on cayenne pepper, to taste. Chill before serving.', 'Spoon onto a large butter lettuce leaf and serve with crackers. (Use rice crackers for gluten-free option.)']",6
1341,Gluten-Free Chocolate Banana Cupcakes Recipe,20,20,40,"['1 3/4 cups (240g) gluten-free flour blend (see Recipe Note)', '1/3 cup plus 1 tablespoon (30g) unsweetened dairy-free cocoa powder', '1 1/2 teaspoons baking soda', '1/2 teaspoon kosher salt', '1 cup (200g) granulated sugar', '1 large ripe banana', '1/2 cup coconut oil (or other your oil of choice), liquid at room temperature', '1 cup freshly brewed coffee, cooled to room temperature (use decaf if you\\xe2\\x80\\x99d like)', '2 teaspoons pure vanilla extract', '2 tablespoons apple cider vinegar', '1/2 batch Vegan Chocolate Frosting']",11,"['1 Preheat the oven to 350\\xc2\\xb0F and prepare the pan: Line a 12-cup muffin tin with paper liners.', '2 Mix the dry ingredients: In a medium mixing bowl, whisk together the gluten-free flour, cocoa powder, baking soda, salt and sugar.', '3 Mix wet ingredients: In a separate medium mixing bowl, mash the banana with a fork or potato masher, and add the coconut oil, cooled coffee, vanilla and apple cider vinegar. Whisk until combined. (There may be small chunks of banana in the mixture, which is perfectly fine.)', '4 Mix the cupcake batter: Add the wet ingredients into the flour mixture and stir thoroughly to combine using a wooden spoon or rubber spatula. Portion out the batter into the cupcake liners, filling each almost to the top.', '5 Bake cupcakes for 18 to 20 minutes, or until cupcakes spring back ever so slightly when pressed in the center. Cool for 10 minutes in the pan, then transfer cupcakes to a wire rack to cool completely.', '6 Frost cupcakes: Once cool, frost cupcakes with Chocolate Fudge Frosting.', '7 Serve, or store: Cupcakes can be served immediately. Cupcakes can also be stored in an airtight container for up to 5 days if unfrosted, or for 2 days once frosted.']",7
1342,Edamame Avocado Dip Recipe,10,10,20,"['12 to 16 ounces shelled edamame, fresh or frozen', '1/2 cup, packed, roughly chopped fresh cilantro, including stems', '1/2 cup plain yogurt', '1 avocado, peeled, pitted, roughly chopped', '1/2 cup water', '1/4 cup lime or lemon juice', '1-2 teaspoons salt', '5 shakes of Tabasco (less or more to taste)', '3 drops of dark sesame oil (more to taste)']",9,"['1 Cook the edamame: Bring 2 quarts of well salted water (2 tablespoons salt) to a boil. Add the shelled edamame. Return to a simmer and cook for 5 minutes, or until cooked through and tender. Drain with cold water.', '2 Blend the edamame with the remaining ingredients: Place drained cooked edamame in a food processor. Pulse several times. Add the chopped cilantro. Pulse again.', 'Add the remaining ingredients, and pulse until well pur\\xc3\\xa9ed. Add more water if you want a smoother consistency. Adjust seasonings (salt, Tabasco, lime, sesame oil).', 'Serve with pita, chips, crostini, or a vegetable platter.']",4
1343,Soda Bread Biscuits Recipe,10,12,22,"['3 cups all purpose flour', '1/4 cup to 1/2 cup of sugar (depending on how sweet you want them)', '1 teaspoon baking soda', '1 teaspoon Kosher salt', '1/2 cup (1 stick) unsalted butter, room temperature', '2 teaspoons caraway seeds*', '1/2 to 1 cup of raisins*', '1 1/4 cups buttermilk**', '*These add-ins are entirely optional. You could just do plain biscuits, or add in a teaspoon of orange zest, lemon zest, or a couple tablespoons of chopped candied ginger, or a teaspoon of minced rosemary. Have fun with it!', '**You can substitute the 1 1/4 cups buttermilk with 1 cup 3 Tbsp of regular whole milk mixed with 1 Tbsp of white vinegar.']",10,"['1 Preheat oven, prepare muffin pan: Preheat oven to 425\\xc2\\xb0F. Butter a standard muffin pan.', '2 Combine dry ingredients: In a large bowl, vigorously whisk together the flour, sugar, baking soda, and salt.', '3 Cut butter into flour, add mix-ins: Cut the butter into tablespoon sized pieces into the bowl of flour. Using your (clean) fingers, work the butter into the flour, schmooshing (technical term) the butter between your fingers and mixing with the flour until the mixture resembles a coarse meal.', 'If you are using raisins, caraway seeds, or any other add-ins, mix them into the mixture now.', '4 Add buttermilk and form dough: Make a well in the center of the flour. Pour the buttermilk into the center of the well. Use a wooden spoon to gently mix the flour into the buttermilk until the flour is moistened with the buttermilk.', 'Then use your hands to form the mixture into a loose, shaggy, slightly sticky ball of dough.', ""The dough should be a little sticky, if it's too dry, add a tablespoon more of buttermilk. If it's just too wet to handle, add a sprinkling more of flour. Do not over-mix!"", 'And at this point work quickly. As soon as the acidic buttermilk interacts with the alkaline baking soda, bubbles will form and leavening will start.', '5 Divide dough among wells of muffin tin: Break off 12-equal portions of the dough and place them in the wells of the muffin tin.', '6 Bake: Put in the oven and bake for 12-13 minutes at 425\\xc2\\xb0F, until the tops are nicely browned. Remove from the oven and let cool for a couple minutes in the pan. Remove the biscuits from the muffin tin to a rack to cool for a few minutes more.', 'Serve with butter and jam.']",11
1344,Asparagus Souffl\xc3\xa9 Recipe,10,75,85,"['1 pound asparagus spears, bottom ends trimmed and discarded, thick spears peeled, spears cut into 1-inch pieces', 'Salt', '1/4 cup chopped shallots', '1 clove garlic, chopped', '1 teaspoon fresh thyme, chopped, or 1/2 teaspoon dried', '4 tablespoons unsalted butter', '1/2 cup finely ground dry breadcrumbs', '3 tablespoons cake flour (can substitute all purpose flour)', '1 1/4 cup whole milk', '1/4 teaspoon ground nutmeg', 'Pinch dry ground mustard', 'Pinch ground cumin', 'Pinch ground ginger', 'Freshly ground black pepper', '1/2 cup grated Gruyere cheese (can substitute Parmesan, but frankly I prefer the Gruyere)', '3 egg yolks, lightly beaten', '5 egg whites', '6 8-ounce ramekins']",18,"['1 Blanch the asparagus: Blanch the asparagus for 2 minutes in boiling salted water (1 1/2 teaspoons of salt for every quart of water). Drain. Rinse in cold water to stop cooking. Set aside to let cool.', '2 Cook the shallots, garlic, thyme in butter: Melt 1 tablespoon of butter in saucepan on medium heat. Add shallots, garlic, and thyme. Cook gently until soft, do not let brown. About 4 to 5 minutes. Remove from heat.', '3 Pur\\xc3\\xa9e asparagus and shallots: Pur\\xc3\\xa9e asparagus and shallot together in a blender. Measure out 1 1/4 cup of pur\\xc3\\xa9e.', '4 Prep the ramekins: Butter 6 8-ounce ramekins. Coat well with the breadcrumbs, reserving any leftover bread crumbs.', '5 Make a thick b\\xc3\\xa9chamel sauce: Over medium-low heat, melt 3 tablespoons butter in a medium sized saucepan. Add the cake flour and whisk to completely incorporate the flour into the butter, continue to stir for a couple of minutes. Do not let brown.', 'Very slowly, add the milk to the mixture, little by little, whisking constantly.', 'Stir in 1/2 teaspoon of salt, the nutmeg, cumin, mustard, ginger, and some fresh ground black pepper.', 'Lower the heat to low and let cook for 15 minutes, stirring occasionally to keep the mixture from sticking to the pan.', 'After 15 minutes, remove the b\\xc3\\xa9chamel from the heat and stir in the cheese.', '6 Make the souffl\\xc3\\xa9 base: Combine the b\\xc3\\xa9chamel and the asparagus mixture in a large mixing bowl (if you have a mixing bowl with a pour lip on the side, use it, it will make it easier to pour out later). Taste the mixture and adjust the seasonings. The souffl\\xc3\\xa9 base should be well-seasoned.', 'Stir in the egg yolks until well combined.', 'At this point you can make ahead the souffl\\xc3\\xa9 mixture. Refrigerate to store for up to two days. Return to room temperature before proceeding.', '7 Preheat oven to 400\\xc2\\xb0F.', '8 Prepare to make a water bath (a bain marie). Have ready a 9x12 baking dish with at least 2 inch sides. Put on a kettle of water to boil.', '9 Beat the egg whites: Add a pinch of salt to the egg whites and using a very clean mixer, beat the egg whites to firm but soft, almost stiff, peaks. (Make sure there are no traces of egg yolk or shell in your egg whites before starting.) Do not over-beat. Over-beating results in stiff peaks that are dry, somewhat reminiscent of styrofoam.', '10 Fold egg whites into asparagus mixture: Use a rubber spatula to first fold in one quarter of the beaten egg whites into the asparagus mixture, then the remaining three-quarters. Use a light touch to keep from deflating the egg whites.', '11 Fill ramekins, place in bain marie: Fill ramekins with the mixture up to a quarter-inch from the top. If you want, sprinkle leftover breadcrumbs on top.', 'Place the ramekins in the bain marie baking dish. Place baking dish on the middle rack in the oven.', 'Pour boiling water into the baking dish around the ramekins until the water comes up halfway the sides of the ramekins.', ""12 Bake: Bake for 10 minutes at 400\\xc2\\xb0F, reduce the heat to 350\\xc2\\xb0F and bake for about 15 minutes more, until puffed up and golden brown. Don't open the oven door until the souffl\\xc3\\xa9 is just about done, or it may fall."", 'Make ahead instructions: You can serve the souffl\\xc3\\xa9s immediately or you can serve them later. To proceed for serving them later, let the souffl\\xc3\\xa9s sit in the bain marie for 15 minutes. Then use run a sharp knife around the edges and invert the individual souffl\\xc3\\xa9s to a buttered baking sheet.', 'Cool to room temperature, wrap in plastic and store in the refrigerator for up to 2 days. Return to room temperature before re-baking. Heat oven to 400\\xc2\\xb0F, bake the souffl\\xc3\\xa9s on a buttered baking sheet, not in ramekins, for 7-8 minutes, and serve.']",22
1345,Summer Minestrone Soup Recipe,20,30,50,"['1 tablespoon extra virgin olive oil', '1/2 cup diced onion (about 1/2 onion)', '1/2 cup sliced leeks, white and light green parts only (see How to Clean Leeks), about 1/2 leek', '1/2 cup diced celery (about one celery rib)', '1/4 cup diced red bell pepper (about 1/4 of one bell pepper)', '3 cloves garlic, minced (about 1 Tbsp)', '6 cups chicken stock (can use good quality vegetable stock for vegetarian option)', '1 bay leaf', '1 teaspoon fresh thyme leaves (or 1/2 teaspoon dried thyme)', '1 teaspoon kosher salt (add more salt if using unsalted stock)', '2 cups large dice zucchini (or other summer squash such as crookneck or pattypan)', '1 cup fresh green beans, trimmed and cut into 1-inch lengths', '2 roma tomatoes, diced', '1/2 cup cooked small white beans', '1/2 cup dry ditalini or any small pasta (omit for gluten-free option)', 'Fresh basil for garnish', 'Grated Parmesan cheese for garnish (optional)']",17,"['1 Saut\\xc3\\xa9 onions, leeks, celery, bell pepper, garlic, in olive oil: Heat 1 Tbsp of olive oil in a large, thick-bottomed pot on medium high. Add the diced onion, leeks, celery, and bell pepper.', 'Cook for 8 to 10 minutes until softened, lowering the heat to medium to prevent browning.', 'Add the minced garlic and cook for a minute more, until fragrant.', '2 Add stock, seasonings, beans, pasta, vegetables, then simmer: Add the chicken stock, bay leaf, thyme, and salt to the pot. Increase heat to bring to a simmer, then add the zucchini, green beans, tomatoes, white beans, and pasta.', 'Heat to a simmer again and lower the heat to maintain a steady simmer. Cook for 10 minutes until the vegetables and the pasta are cooked through.', '3 Garnish with basil and Parmesan: Garnish with thinly sliced fresh basil and grated Parmesan cheese to serve.']",6
1346,Creamy Tortellini Soup with Sausage and Spinach Recipe,15,55,70,"['1 teaspoon olive oil', '1 pound mild Italian sausage, removed from casings if purchased in links', '1 large yellow onion, diced', '8 ounces mushrooms, diced', '1 teaspoon salt, divided', '2 large carrots, diced', '2 cloves garlic, minced', '2 quarts chicken stock', '1 pound fresh or frozen cheese tortellini', '10 ounces baby spinach, kale, chard, or other green (torn into the size of baby spinach, if necessary)', '1 15-ounce can cannellini beans', '2 teaspoons cider vinegar', '1/2 cup heavy cream or whole milk']",13,"['1 Cook the sausage: Warm a teaspoon of oil in a large soup pot over medium-high heat, and add the sausage. Cook the sausage until completely browned, breaking it up into crumbles as it cooks. When browned, remove the sausage from the pan with a slotted spoon and set aside.', '2 Cook the vegetables: Drain all but a tablespoon of fat from the pan (add more oil if you don\\xe2\\x80\\x99t have quite a tablespoon). Add the onions and a half teaspoon of salt, and cook until the onions are translucent and beginning to brown, about 5 minutes.', 'Add the mushrooms and another half teaspoon of salt. Cook until the mushrooms have released all their moisture and are cooked through, another 5 minutes. Add the carrots and cook until they look softened around the edges, another 2-3 minutes. Stir in the garlic and cook until fragrant, 30 seconds.', '3 Bring the soup to a simmer and add the tortellini: Pour a cup of chicken stock into the pot and scrape any browned bits from the bottom of the pot. Return the sausage to the pot and add the remaining stock. Bring to a rapid simmer over high heat, then reduce the heat to a medium.', 'Add the tortellini and cook according to package instructions.', '4 Puree the beans: In a medium sized bowl, add the drained beans, 1/2 cup water, and apple cider vinegar. Puree using an immersion blender (or you can do this in a food processor or countertop blender).', '5 Finish the soup: When the tortellini is done, add the greens and stir until wilted. Stir in the pureed beans and heavy cream (or milk). Taste and add salt, pepper, or another splash of cider vinegar as needed to perk up the flavors. Serve.', 'LEFTOVERS! This leftover soup will keep for about 5 days in the fridge and is best reheated gently over low heat on the stovetop or in the microwave. The tortellini will gradually soften, the longer the leftovers sit.', 'If you\\xe2\\x80\\x99d like to freeze any portion of the soup, cook the tortellini separately and freeze the soup without it. When ready to serve, cook more tortellini in boiling water and add to each bowl when serving.']",9
1347,Chicken Udon Soup with Bok Choy Recipe,10,15,25,"['4 ounces dried udon noodles', '1 teaspoon toasted sesame oil', '2 tablespoons vegetable oil', '2 tablespoons finely chopped fresh ginger', '1 large garlic clove, finely chopped', '4 cups chicken stock', '1 tablespoon low-sodium soy sauce', '1/2 teaspoon salt, or more to taste', '2 cups shredded cooked chicken', '4 tablespoons gochujang (Korean chili paste)', '4 scallions, finely sliced', '4 to 5 (5 ounces) baby bok choy, halved and thinly sliced lengthwise', '2 large handfuls (about 2 ounces) baby spinach leaves', 'For garnish:', '1/2 cup cilantro leaves']",15,"['1 Cook the noodles: In a large pot, bring 3 quarts of water to a boil. Add the udon noodles and cook for 10 to 12 minutes, or until tender. Drain in a colander, and rinse under cool running water to remove surface starch. Add the sesame oil and toss. Set aside.', '2 Make the broth: In the same pot you used to cook the noodles, heat 1 tablespoon of vegetable oil over medium heat. Add the ginger and garlic, and saut\\xc3\\xa9, stirring constantly, for 1 minute.', 'Add the broth, soy sauce, and 1/2 teaspoon salt and bring to a boil. Taste and add more salt, if you like. Turn off the heat and start the chicken.', '3 Warm the chicken in the gochujang: In a small skillet over medium heat, heat the remaining 1 tablespoon of vegetable oil. Add the shredded chicken meat and cook for 1 to 2 minutes, or until hot.', 'Add the gochujang to the skillet. Cook and stir for another 2 to 3 minutes, or until the sauce evaporates and the chicken starts to brown.', 'Add 1 to 2 tablespoons of the soup broth to release the brown bits on the bottom of the pan and stir in the scallions. Remove from heat.', '4 Finish the soup: Return the broth to a simmer and add the bok choy. Cook for 2 minutes, or until crisp-tender. Stir in the spinach and noodles and cook for a minute or two, until the spinach wilts and the noodles are hot.', '5 Serve the soup: Divide the soup among four bowls. Top each bowl with the chicken. Sprinkle with cilantro, and serve.']",8
1348,Black Bean Soup Recipe,20,105,125,"['1 pound dried black beans (about 2 cups), rinsed, soaked in 4 quarts of water overnight or 6 hours, drained', '1 pound smoked ham shank or hock', '2 bay leaves', '5 cups water', '1/8 teaspoon baking soda', '1/2 teaspoon salt', '4 tablespoons extra virgin olive oil', '1 large yellow onion, chopped fine (2 cups)', '1 medium sweet potato, chopped into 1/2-inch pieces (2 cups, chopped) (can substitute 2 large carrots)', '1 carrot, chopped fine (1/2 cup)', '1 celery rib, chopped fine (1/2 cup)', '1 teaspoon salt', '4 medium garlic cloves, minced', '1 tablespoon ground cumin', '2 teaspoons chili powder', '2 cups chicken stock (add 2 teaspoons of salt if using unsalted stock)', '1 tablespoon molasses', '1 red bell pepper, roughly chopped', '3 to 4 tablespoons lime juice (can substitute lemon juice)', 'Salt', 'To serve:', 'Chopped fresh cilantro', 'Sour cream', 'Avocado, peeled and chopped']",24,"['1 Cook the beans with the ham hock/shank: Place beans and ham shank or hock in a 4-quart, thick-bottomed pot. Add 5 cups water, bay leaves, salt and baking soda. Bring to a boil, reduce heat to a low simmer. Cover and let cook 1 hour 15 minutes to 1 hour 30 minutes, until beans are tender. Remove bay leaves.', 'Pressure cooking instructions: If you have a pressure cooker, you can save time by putting the un-soaked dry beans and the ham shank into a pressure cooker. Add 5 cups of water, 2 bay leaves, baking soda, and salt. Cook at high pressure for 20 minutes, do a natural release of pressure for 10 minutes before releasing the pressure. Remove the bay leaves.', '2 Remove ham shank, cut up ham meat: Remove ham shank or hock from the pot. Cut ham meat away from the bone and cut into small, bite-sized pieces, set aside.', '3 Cook onions, celery, carrot sweet potato, add spices: While the beans are cooking, heat olive oil in a large 6- to 8-quart thick-bottomed pot on medium high until the oil is hot, but not smoking.', 'Add the onions, celery, carrot, sweet potato, and 1/2 teaspoon of salt. Cook, stirring occasionally, until lightly browned and softened, 10 to 15 minutes.', 'Reduce heat to medium, add the cumin, chili powder, and garlic, cook for an additional 2 minutes, stirring constantly.', '4 Add beans, liquid, molasses, bell pepper to onion mixture: Once the beans are tender, add the beans, their cooking liquid, chicken stock, molasses, and bell pepper to the pot with the onion mixture.', 'Bring to a boil then reduce heat to a simmer. Cook, stirring occasionally, for 20 to 30 minutes.', '5 Pur\\xc3\\xa9e a third of the soup: Using an immersion blender, pur\\xc3\\xa9e about a third of the soup. Or remove about 3 cups of the soup to a blender and pur\\xc3\\xa9e it, return it to the soup.', '6 Serve: Return the reserved ham pieces to the soup to serve. Add 3 tablespoons of lime juice. Adjust seasonings. If on the sweet side, add a bit more lime juice. Add more salt to taste.', 'Serve with garnishes.', 'Note that the soup may continue to thicken. If you would like it thinner, just add some water to desired consistency.']",12
1349,Butternut Squash Soup Recipe,15,45,60,"['For the soup:', '1 medium yellow onion, chopped (about 1 cup)', '1 celery rib, chopped (about 3/4 cup)', '1 carrot, chopped (about 3/4 cup)', '2 tablespoons unsalted butter', '1 butternut squash, peeled and chopped (6 to 8 cups), seeds discarded (see How to Peel and Cut a Butternut Squash)', '1 large tart green apple, peeled, cored, chopped (squash to apple ratio should be 3:1)', '3 cups chicken stock or broth (or vegetable broth)', '1 cup water', 'Pinches of nutmeg, cinnamon, cayenne, salt and pepper', 'For the garnish (optional):', 'Fresh parsley, chopped', 'Chives, chopped', 'Dash of smoked paprika', 'Sour cream']",15,"['1 Saut\\xc3\\xa9 onion, carrot, celery in butter: Heat a large thick-bottomed pot on medium-high heat. Melt the butter in the pot and let it foam up and recede. Add the onion, carrot, and celery and saut\\xc3\\xa9 for 5 minutes. Lower the heat if the vegetables begin to brown.', '2 Cook the soup: Add the butternut squash, apple, broth, and water. Bring to boil. Reduce to a simmer, cover, and simmer for 30 minutes or so, until the squash and carrots have softened.', '3 Pur\\xc3\\xa9e the soup: Use an immersion blender to pur\\xc3\\xa9e the soup, or work in batches and pur\\xc3\\xa9e the soup in a stand blender.', '4 Add seasonings: Add pinches of nutmeg, cinnamon, and cayenne. Add salt and pepper to taste.', 'Garnish with chopped fresh parsley or chives and, if you want, a dollop of sour cream.']",5
1350,Albondigas Soup (Mexican Meatball Soup) Recipe,15,50,65,"['2 tablespoons extra virgin olive oil', '1 large onion, chopped', '1 large garlic clove, minced', '2 quarts of chicken stock or beef stock', '1 quart of water', '1/2 cup of tomato sauce', '1/2 pound of green beans, strings and ends removed, cut into 1 inch pieces', '2 large carrots, peeled and sliced', '1/3 cup of raw white rice', '1 pound ground beef', '1/4 cup (loosely packed) chopped fresh spearmint leaves', '1/4 cup (loosely packed) chopped parsley', '1 egg', '1 1/2 teaspoon salt', '1/4 teaspoon black pepper', 'A dash of cayenne (optional)', '1 1/2 cup of frozen or fresh peas', '1 teaspoon of dried oregano, crumbled, or 1 tablespoon fresh chopped oregano', 'Salt and pepper', '1/2 cup chopped fresh cilantro']",20,"['1 Make the soup base with onion, garlic, broth, tomato sauce, carrots and green beans: Heat oil in large heavy-bottomed pot (5-qt) over medium heat. Add onion and cook until tender, about 5 minutes. Add the garlic and cook a minute more. Add stock, water, and tomato sauce. Bring to boil and reduce heat to simmer. Add carrots and string beans.', '2 Prepare the meatballs: Mix rice into meat, adding mint leaves and parsley, salt and pepper. Mix in raw egg. Form mixture into 1-inch meatballs.', '3 Add meatballs to soup, let simmer, add peas: Gently add the meatballs to the simmering soup, one at a time. Cover and let simmer for 1/2 hour.', 'Add the peas towards the end of the 1/2 hour. Add a few pinches of oregano and sprinkle with salt and pepper, and a dash of cayenne, to taste.', 'Garnish with chopped fresh cilantro.']",5
1351,Carrot Ginger Soup Recipe,15,30,45,"['3 tablespoons butter', '1 1/2 pounds carrots (6-7 large carrots), peeled and sliced thin', '2 cups chopped white or yellow onion', 'Salt', '1 teaspoon minced ginger', '2 cups chicken stock or vegetable stock', '2 cups water', '3 large strips of zest from an orange', 'Chopped chives, parsley, dill or fennel for garnish']",9,"['1 Saut\\xc3\\xa9 onions and carrots: Melt the butter in a soup pot over medium heat and cook the onions and carrots, stirring occasionally, until the onions soften, about 5 to 8 minutes. Do not let the onions or carrots brown. Sprinkle a teaspoon of salt over the carrots and onions as they cook.', '2 Add stock and water, ginger, and strips of orange zest. Bring to a simmer, cover, and cook until the carrots soften, about 20 minutes.', ""3 Remove the strips of orange zest! It's easy to forget this step, and if you forget and pur\\xc3\\xa9e the soup with the strips of zest still in it, the soup may be too bitter for your taste."", '4 Pur\\xc3\\xa9e soup: Pur\\xc3\\xa9e the soup with a stick blender, or working in small batches, pour the soup into a blender and pur\\xc3\\xa9e until completely smooth. Only fill the blender bowl a third full with the hot liquid and keep one hand pressing down on the cap of the blender to keep it from popping off.', 'Add more salt to taste.  (You will need more salt if you are using homemade unsalted stock or unsalted butter.)', 'Garnish with chopped chives, parsley, or fennel fronds.']",6
1352,Cream of Mushroom Soup Recipe,15,40,55,"['4 tablespoons extra virgin olive oil', '4 tablespoons butter', '2 pounds (900 g) cremini (or button) mushrooms, cleaned, roughly chopped or sliced 1/8-inch thick', 'Small handful shiitake mushrooms (chopped)', '3/4 cup minced shallots (6 ounces, 170 g)', '3 cloves garlic, minced (3 teaspoons)', '1 teaspoon kosher salt', '3/4 teaspoon dried tarragon', '4 cups (1 liter) chicken stock (or vegetable stock for vegetarian option)', '1/2 cup (120 ml) heavy cream', '1/2 teaspoon freshly ground black pepper (more or less to taste)']",11,"['1 Saut\\xc3\\xa9 the mushrooms: Heat olive oil on medium high heat in a 5-6 quart thick-bottomed pot. When the oil is hot, swirl in the butter. Once the butter has melted, add the mushrooms, stir to coat with the olive oil and butter.', 'Cook the mushrooms on medium high heat until they are lightly browned and have released most of their water, about 10 minutes.', 'Remove 1 cup of the cooked mushrooms from the pot and set aside (they will be added back in later).', '2 Add shallots, garlic: Reduce heat to medium. Add the minced shallots and the garlic to the pot, stir to combine, cook for about a minute.', '3 Add salt, tarragon, stock: Add the salt, dried tarragon, and the stock to the pot. Increase the heat to medium high, bring to a simmer and cook, uncovered, for 10 minutes. Remove from heat.', '4 Pur\\xc3\\xa9e soup: Using an immersion blender or working in batches with a standing blender, pur\\xc3\\xa9e the soup until smooth.', 'Then return to the pot. (If the soup is too thick for you, add some water or more stock to thin the soup to the desired level of thickness.)', '5 Stir in cream and reserved mushrooms: Whisk the cream into the soup and add the black pepper. Adjust salt and pepper to taste. Stir in the reserved cooked mushrooms.']",8
1353,Fish Stew with Ginger and Tomatoes Recipe,10,20,30,"['4 small (15 ounces, 443 g) red potatoes', '2 tablespoons olive oil', '3 tablespoons finely grated fresh ginger', '1 clove garlic, crushed', '1 can (14 to 16 ounces, 400 to 453 g) diced tomatoes', '1/2 teaspoon sugar', '1/2 teaspoon salt, or more to taste', '1/4 teaspoon black pepper, or more to taste', '1/4 teaspoon crushed red pepper', '3 cups (700 ml) chicken stock', '2 pounds (.90 kg) boneless firm-fleshed white fish, such as haddock, halibut, hake, flounder, pollock, whiting, or other local fish (it\\xe2\\x80\\x99s okay if the skin is still on)', '2 tablespoons chopped fresh parsley']",12,"['1 Prepare the potatoes: Without peeling, slice the potatoes into 1/4-inch rounds. Steam them over boiling water in a vegetable steamer, tightly covered, for 10 minutes, or until tender. Set aside.', '2 Make the tomato sauce: Meanwhile, In a Dutch oven or other large pot over medium heat, heat the oil and add the ginger, garlic, tomatoes and their liquid, sugar, salt, black pepper, and red pepper. Cook, stirring, for 3 minutes. Add the stock, bring to a boil, lower the heat, and simmer for 10 minutes, or until the flavors mellow.', 'Add the potatoes and return the sauce to a boil. Simmer 2 minutes.', '3 Add the fish: Cut the fillets into 3-inch pieces. Add them to the sauce and press them down into the pan to submerge them in the liquid. Cover the pan and cook for 5 minutes, or until the fish is opaque and flakes easily with the tip of a knife.', '4 Serve: Taste for seasoning and add more salt and black pepper, if you like. Sprinkle with parsley before serving.']",5
1354,"Farro, Mushroom, and Spinach Soup Recipe",10,25,35,"['3 tablespoons olive oil', '2 pounds mixed mushrooms, sliced (such as white mushrooms, crimini, Portobello or shiitake)', '1 teaspoon dried thyme', '2 tablespoons low-sodium soy sauce', '2 bunches scallions, thinly sliced', '1 1/4 cups pearled (quick-cooking) farro (about 6 ounces)', '1/2 cup white wine', 'Salt and pepper, to taste', '3 cups chicken stock or vegetable stock', '4 large handfuls baby spinach leaves', '1/2 cup freshly grated Parmesan', '1/2 cup chopped fresh parsley', 'Extra Parmesan (for garnish)']",13,"['1 Cook the mushrooms and scallions: In a stockpot or large saucepot over medium-high heat, heat the oil. Add the mushrooms and cook, stirring often, for 10 minutes, or until the mushrooms release their juices and turn golden brown.', 'Stir in the thyme, soy sauce, and scallions, and cook for 2 minutes longer.', '2 Add the farro, wine, salt, and pepper and simmer for 5 minutes, or until the wine has reduced.', '3 Stir in the stock and bring to a simmer. Reduce the heat to low, cover the pot and cook for 10 minutes, or until the farro is tender (taste one of the grains to check). Uncover, turn the heat up to high, and cook for 2 to 3 minutes to reduce the liquid to the consistency of a thick stew. (If the farro looks dry, add a little more stock at this point.)', '4 Stir in the spinach and parsley. Cook for 30 seconds, or until the spinach wilts. Stir in the 1/2 cup Parmesan.', 'Taste, and season with more salt and pepper, if you like. Ladle into bowls and sprinkle a little Parmesan on top.']",6
1355,Old-Fashioned Peach Pie Recipe,45,105,150,"['1 full recipe Perfect Pie Crust (2 single crusts)', '3 pounds fresh or frozen ripe peaches, peeled and sliced (about 8 cups sliced peaches; see Recipe Note)', '1/2 cup sugar', '1/2 teaspoon cinnamon (optional)', '1 to 2 teaspoons lemon juice', 'Tiny pinch of kosher salt', '4 tablespoon cornstarch', '1 large egg', '1 tablespoon milk', 'Sanding sugar or any coarse sugar', 'Special equipment:', '9-inch pie plate', 'Pie crust shield (optional)']",13,"['1 Prepare the pie dough through dividing the dough into two disks and chilling: Instructions for preparing your pie dough can be found here.', '2 Roll out the bottom crust: Remove one of the chilled disks of pie dough from the refrigerator and let it stand a few minutes at room temperature until it is pliable.', 'Roll the dough out into a large circle, about 11 to 12 inches in diameter. Fit the dough into the pie plate and refrigerate while you prepare the filling. Don\\xe2\\x80\\x99t bother trimming the edges just yet; leave it until the end.', ""3 Make the peach filling: In a large mixing bowl combine the peeled and sliced peaches, sugar, cinnamon, lemon juice, and salt, folding gently to combine. Taste one of the peaches and add additional sugar for sweetness or lemon juice for tartness if you think it's necessary."", 'Sprinkle the corn starch evenly over stop and gently stir to mix it in.', 'Spread the filling into the chilled pie crust and place the entire thing back into the refrigerator to chill.', '4 Roll out the top crust (and lattice weave, if desired): Remove the second pie crust (and third, if using; see Recipe Note) from the fridge. For a simple rolled-out top crust, roll the pie crust into a 9-inch circle and transfer it to the top of the chilled pie. Slash vents in a few places using a sharp knife.', 'For a lattice crust, like the one pictured, and roll out the dough into a wide rectangle. Cut evenly-sized strips of dough -- I like to use a pizza wheel to cut the strips and a ruler as a guide (the width of most rulers is also a good width for the strips of lattice). Weave the strips into a lattice top for the pie.', 'Trim the edges of the top crust and the bottom crust, leaving enough bottom crust to cover the edge of the top crust neatly. Crimp the dough to seal the edges.', '5 Chill the assembled pie in the refrigerator for at least 30 minutes.', '6 While the pie chills, preheat the oven to 400\\xc2\\xb0F. Place an oven rack in the bottom third of the oven. Line a baking sheet with aluminum foil to catch any pie leakage. Whisk the egg and tablespoon of milk together.', '7 Bake the pie: Remove the chilled pie from the fridge and brush the top with the egg-milk mixture. Sprinkle with sanding sugar. Place the pie on the prepared baking sheet.', 'Bake the pie in the bottom third of the oven for about 1 hour, or until the filling is bubbling in the center of the pie.', ""8 Remove from the oven and cool completely on a wire rack before serving. If you'd like to serve warm pie, let the pie cool completely and the warm briefly in the oven before serving. (Or warm individual slices in the microwave.)""]",14
1356,Chicken Fried Steak Recipe,20,20,40,"['4 quarter-pound cube steaks (pre-tenderized) or round steaks', 'A sprinkling of salt for pre-salting the meat', '2 cups flour, for breading', '2 teaspoons Kosher salt, for breading', '1 1/2 teaspoons garlic powder', '1/2 teaspoon cayenne', '2 large eggs, beaten', '1/2 cup milk', 'Canola oil, peanut oil, extra virgin olive oil, or other fat for frying', 'Gravy:', '3 tablespoons pan drippings', '3 tablespoons flour', '1/4 cup whipping cream', '1 3/4 cups milk', 'Salt', 'Freshly ground black pepper']",16,"['1 Pound steaks to an even thinness: If you are using round steak instead of the pre-tenderized cube steak, you will need to pound the steaks thin or they will be way too chewy. (Already tenderized cube steaks can also use some meat mallet attention to get more thin.)', 'Place each steak between two pieces of plastic wrap. Using a meat mallet, rubber mallet, rolling pin, or empty wine bottle, beat the steak until it is very thin, less than 1/4-inch.', 'As you beat the steak, you will want to turn over often, and spread out the plastic wrap which tends to wrinkle as you work.', '2 Salt meat, warm the oven: Sprinkle a little salt over the meat. Preheat the oven to 200\\xc2\\xb0F.  In the oven put a wire rack over a baking sheet. This will keep the finished steaks warm and dry while you cook the gravy.', '3 Dredge steaks in flour, egg, and flour again: Prepare two wide, shallow dishes such as a pyrex casserole dish. In the first  whisk together the eggs and milk. In the second, whisk together the flour, salt, cayenne, and garlic powder.', 'Working one at a time, dredge a steak into the flour. Using the heel of your hand, press the flour into both sides of the steak.', 'Lift up the steak, shake off the excess flour and dip the steak into the egg wash, coating it on both sides.', 'Lift the steak out of the egg wash, shake off the excess egg wash, and then dredge the steak again in the flour. Again, press the flour into the steak on both sides.', 'Set aside on a plate. Repeat with remaining steaks.', ""4 Fry the steaks: Pour enough oil in a large frying pan to cover the bottom by 1/4-inch. Heat the oil to 350\\xc2\\xb0F or when you drop a little flour into the oil it sizzles. If the oil doesn't sizzle it isn't ready, if it burns, the oil is too hot, reduce the heat."", 'Working one at a time, lay a flour-egg-coated steak into the hot oil. Gently shake the pan a little to wash a little hot oil on the top of the steak. Or you can use a metal spoon to spoon some of the oil over the steak. This sets the coating.', 'Fry until you see the edges of the steak turn golden brown, about two minutes. Carefully turn the steak over in the pan, and fry for two more minutes.', 'Once both sides of the steak are golden brown, tip the steak up with a metal spatula to drain the excess oil. Remove it from the pan and place if on the wire rack in the oven to keep warm. Repeat with the remaining steaks.', '5 Make a roux with fat and flour: Turn off the heat of the pan. Pour out all but about 3 tablespoons of fat from the pan. Whisk in 3 tablespoons of flour and turn the heat on to medium.', ""Let the flour mixture cook until it's the color of milk chocolate, about 4 to 5 minutes, stirring constantly."", '6 Stir in milk and cream to make gravy: When the flour fat mixture is smooth and a lovely milk chocolate color, slowly add the milk and cream, whisking constantly. Note that the mixture will seize up initially, and will loosen as you whisk in more liquid.', ""Add milk to your desired thickness for gravy. If the gravy is too thick for you, add more milk. If it's too thin, let it cook longer."", 'Season with salt to taste. Season with lots of black pepper, to taste.', '7 Serve: Serve chicken fried steak with the gravy and a side of mashed potatoes.']",19
1357,Smothered Turkey Wings Recipe,10,160,170,"['Turkey Wings:', '6 whole turkey wings (about 5 pounds), or 7 turkey wings without the tips', '1 Tbsp extra virgin olive oil', 'Salt', 'Stock:', '2 Tbsp extra virgin olive oil', '1 carrot, chopped', '1 half onion, chopped', '1 celery rib, chopped', '3 cups water', '1/2 teaspoon salt', 'Gravy:', '3 Tbsp butter', '3 Tbsp flour', '3 cups of turkey stock (that you make in step...)', '1/2 teaspoon yellow mustard', '1/2 teaspoon salt', '1/4 teaspoon pepper', '1/2 teaspoon dried thyme', '1/4 cup cream']",20,"['1 Prep the turkey wings: Use poultry sheers or a sharp knife to separate each turkey wing into 3 segments\\xe2\\x80\\x94drumette, flat, and tip. Set aside the tips for making stock.', '2 Slow roast the turkey wings: Place turkey wing drumettes and flats, skin side up, onto a rimmed baking sheet or roasting pan. Toss with olive oil. Sprinkle with salt.', 'Cover with aluminum foil and put into a 275\\xc2\\xb0F oven for 2 1/2 hours.', '3 Make the stock: While the turkey wing drumettes and flats are roasting, make stock with the tips. Heat 2 Tbsp olive oil in a medium, thick-bottomed pot on medium high heat. Add the turkey wing tips and let them brown on all sides.', 'Add the chopped carrot, onion, and celery, and saut\\xc3\\xa9 them for a few minutes with the wings.', 'Add 3 cups of water, enough to cover the wings and vegetables, and salt. Bring to a boil on high heat, then reduce to a low simmer on the lowest setting. Cover and let simmer while the wings roast in the oven, a couple of hours.', '4 Strain the stock: When the wings are close to being done, strain the stock so you can start making the gravy. Remove and discard the largest solids from the pot. Then strain the rest of the stock through a fine mesh strainer. Reserve the stock for the next step.', '5 Make the gravy: Make a roux by melting 3 Tbsp butter in a medium sized, thick-bottomed pot, on medium heat. Add the flour and whisk to combine. Let the roux cook and bubble for a minute or so.', 'Slowly whisk in the turkey stock you made in steps 3 and 4, whisking constantly to break up any lumps.', 'Whisk in the mustard, salt, pepper, and thyme. Whisk in the cream. Let simmer on low heat to thicken.', '6 Broil the wings to brown them: After 2 1/2 hours of slow cooking in the oven, the turkey wings should be fall apart tender (if not, you can leave them in longer until they are).', 'Remove the foil and place the wings on a rack a few inches under the broiler. Broil for 5 minutes or so, until the wing skin gets somewhat browned.', ""7 Scrape the wing roasting pan drippings into the gravy: You don't have to do this, but it will add even more flavor to your gravy. If the drippings are really stuck to the pan, place the roasting pan on your stovetop and turn on the burners under the pan."", 'Add a cup of water to the pan and use a metal spatula to scrape up the drippings. Pour them off into the pot with the gravy.', 'To serve, pour the gravy over the wings. Serve with a side of mashed potatoes, root vegetables, or cauliflower.']",15
1358,Buttermilk Fried Chicken Recipe,10,510,520,"['3 pounds of chicken parts (thighs, drumsticks, wings, breasts), skin-on, bone-in', '2 cups buttermilk (can also use plain yogurt thinned with a little milk)', '1 large onion, sliced', '1/4 cup chopped mixed fresh herbs (parsley, thyme, tarragon) or a teaspoon each of the dried herbs.', '1/2 teaspoon paprika', '1/2 teaspoon cayenne pepper', '2 cups flour', '1/2 teaspoon garlic salt', '1/2 teaspoon onion salt', '1 teaspoon cayenne pepper', 'Salt and pepper', '2 cups canola oil, rice bran oil, or peanut oil']",12,"['1 Marinate chicken in buttermilk mixture: Mix the buttermilk, sliced onion, herbs, paprika, and cayenne in a large bowl. Put the chicken pieces in the buttermilk mixture and coat completely. Marinate overnight (at least 8 hours).', '2 Drain chicken, prepare bag with flour and seasonings: Place chicken pieces in a colander and let drain of excess buttermilk mixture. In a large paper or plastic (sturdy) bag, mix flour with garlic salt, onion salt, cayenne, salt and pepper.', '3 Heat oil in thick-bottomed pan: Heat 2 cups of oil in a large, heavy-bottomed skillet (cast iron, stainless steel, or anodized aluminum\\xe2\\x80\\x94something that can take the heat) on medium high heat until a pinch of flour starts to sizzle when dropped in the hot oil (but not so hot that the pan is smoking), about 350\\xc2\\xb0F. Remember when working with hot oil, always have a pan lid close by.', '4 Coat chicken pieces with flour: Place chicken pieces in bag with flour mixture and shake until thoroughly coated.', '5 Fry the chicken: Working in batches, add the chicken pieces to the hot oil in the pan and fry on one side for 12-15 minutes, until golden brown, and then use tongs to turn the pieces over and fry for another 10-12 minutes, again until golden brown.', '', 'Be careful to keep the oil hot enough to fry the chicken, but not so high as it burns the chicken.', '6 Remove to rack to drain of excess oil: Use tongs to remove chicken from pan. Place on a rack over a cookie sheet or broiling pan for the excess oil to drain. Add more salt and pepper to taste.']",8
1359,White Chicken Chili Recipe,10,165,175,"['2 (15-ounce) cans white beans, drained OR 1/2 pound dry white beans', '1 tablespoon extra virgin olive oil', '1 medium onion, chopped, about 1 1/2 cups', '1 clove garlic, minced, about 1 teaspoon', '2 teaspoons ground cumin', '1/4 teaspoon cayenne pepper', '1/8 teaspoon ground cloves', '2 4-ounce cans chopped green chilies', '1 1/2 teaspoons dried oregano', '1 jalape\\xc3\\xb1o or serrano pepper, finely chopped (optional)', '2 pounds boneless, skinless chicken thighs (can use breast meat, but thighs will work better), trimmed of excess fat and diced into 1/2- to 3/4-inch pieces', '3 cups chicken stock', '1 1/2 cups grated Monterey Jack cheese', 'If cooking dry beans:', '1 1/2 teaspoons salt', '1 clove garlic', '1 bay leaf']",17,"['1 If using dry beans, cook them first: Place the beans in a medium pot and cover with a couple inches of hot water, about 2 quarts. Add 1 1/2 teaspoons salt, 1 chopped garlic clove, and one bay leaf. Heat on high to bring to a simmer, cover, and reduce heat to very low to maintain a low simmer.', 'Cook for 2 to 3 hours or until the beans are cooked through and tender (note that cannelli beans will cook faster than navy beans, and older dry beans will take longer to cook than newer). Drain.', '2 Saut\\xc3\\xa9 onions with seasonings: In a large thick-bottomed pot, saut\\xc3\\xa9 onions in olive oil on medium high heat until tender, about 4 minutes. Add the garlic, cumin, cloves, and cayenne and cook a minute more. Add the green chiles and dried oregano. Add the minced jalape\\xc3\\xb1o or serrano chile if using.', '3 Add chicken and stock, and simmer: Add the chicken and chicken stock. Increase the heat to high, bring to a simmer, reduce the heat to low, cover and maintain the simmer for 20 minutes, until the chicken is cooked through.', '4 Add cooked beans: Add the drained cooked beans and cook for 15 minutes more. Taste for seasonings and add more salt to taste. Depending on how salty your chicken stock and beans are, you may need to add a teaspoon or more.', '5 Serve with toppings and tortillas or chips: Serve topped with grated cheese. Garnish with cilantro, chopped fresh tomato, salsa, chopped scallions, and/or guacamole. Serve with fresh warmed flour tortillas or tortilla chips.']",6
1360,Beef Tacos de Lengua (Beef Tongue Tacos) Recipe,15,225,240,"['1 3-4 lb beef tongue', '2 large onions, peeled', 'The cloves from 1 head (yes an entire head) of garlic, peeled and crushed', '6-7 bay leaves', '1 Tbsp of peppercorns', '2 Tbsp salt', 'Vegetable oil', 'Corn tortillas (2 to 3 per person)', 'Salsa verde*', 'Avocados', 'Cilantro', 'Chopped red onion', 'Thinly sliced radishes for garnish', '* Bottled or canned salsa verde can be found in the Hispanic section of markets. To make homemade salsa verde, remove husks from 1 lb of tomatillos, place tomatillos in a pan, cover with water, simmer until cooked through, about 5 minutes. Place tomatillos, 1/3 cup chopped onion, 1/4 cup cilantro leaves, 2 teaspoons of lemon or lime juice, a jalape\\xc3\\xb1o or serrano chile pepper, and about a teaspoon of salt in a blender. Blend until smooth, add more salt to taste.']",14,"['1 Simmer the tongue: Fill a large (12-quart if you have one) stock pot two-thirds full with water. Add the tongue, onions, crushed garlic cloves, bay leaves, peppercorns, and salt.', 'Bring to a boil, reduce to a simmer, cover, and cook for 3 hours, until the tongue is soft to the touch and tender.', '2 Remove the skin-like covering: Remove tongue from water and let cool for a couple of minutes.', 'Notice the light colored skin-like covering over most of the tongue. Using your fingers, and/or a sharp small knife, remove this covering and discard.', ""Notice the rough patch of meat where the tongue would attach to the bottom of the mouth. Arturo removes this patch (as does his mother when she prepares tongue) because it is a little rough. It's perfectly edible though, so keep it attached if you want."", '3 Slice and saut\\xc3\\xa9 the tongue: Slice the tongue in 1/4-inch slices. (If you are not preparing the whole tongue for tacos, you can return whatever tongue you do not slice to the cooking water to soak.)', 'Heat a little oil in a frying pan on medium high and saut\\xc3\\xa9 the slices on both sides until they are lightly browned.', '4 Dice: Remove from pan and slice first into strips, then crosswise again so that you end up with small cubes.', '5 Assemble the tacos: Soften tortillas either by cooking on the stove-top until pockets of air appear in them, or in the microwave (about 10 seconds per tortilla).', 'Place a large spoonful of meat in the center of a tortilla. Add a spoonful of salsa verde and some chopped avocado, onion, and chopped fresh cilantro. Garnish with radish slices.']",10
1361,Twice Baked Southwestern Sweet Potatoes Recipe,15,30,45,"['4 medium sweet potatoes, about 1/2 pound each', '1 tablespoon olive oil', '1/2 medium red onion, diced', '1/2 green bell pepper, diced', '1 cup black beans, rinsed well', '1/2 cup sweet corn, fresh or frozen', '1 cup crumbled queso fresco', '1/4 teaspoon salt', '1/4 teaspoon black pepper', 'Fresh cilantro, chopped, for garnish', 'DAD ADD: Primo Tex-Mex Ingredients', 'Browned chorizo', 'Pickled jalape\\xc3\\xb1os', 'Sour cream', 'Diced scallions']",15,"['1 Cook the sweet potatoes: If you have time, bake the sweet potatoes in the oven. Poke some holes in them with a fork and bake them at 375\\xc2\\xb0F for 45 to 60 minutes until they are very tender and give easily to a fork poke. Also, the skin should get dry and crackly.', 'Option two, if you are in a hurry, is to microwave the sweet potatoes. Poke holes in them with a fork and microwave them for two 5-minute intervals on high. They will be very hot after they come out, and the skin won\\xe2\\x80\\x99t be quite as good as the baked version, but it works well for this recipe.', '2 Make the filling:  In a medium skillet over medium heat, add olive oil, followed by onions, bell pepper, black beans, and sweet corn. Season with salt and pepper and cook for 4 to 5 minutes until the vegetables soften, but aren\\xe2\\x80\\x99t browned at all. Remove from heat.', '3 Stuff the sweet potatoes: When sweet potatoes are cool enough to handle, split them open with a knife and use a fork to mash up the sweet potato flesh. I recommend opening up the sweet potatoes by slicing horizontal slits near each end of the sweet potato, which will make it easier to spread open.', 'Once the sweet potato flesh is mashed, add some queso fresco to each potato and divide the saut\\xc3\\xa9ed filling among the potatoes. Stuff them full! Top with any extra cheese you might have.', '4 Bake the sweet potatoes: Bake the sweet potatoes for 20 minutes at 350\\xc2\\xb0F.', '5 Serve: Serve sweet potatoes with Dad Add ingredients or just a sprinkle of chopped fresh cilantro.', 'Leftover stuffed sweet potatoes will store well in the fridge for 4 to 5 days and reheat best in the oven.']",8
1362,"Pasta with Eggplant, Feta, and Mint Recipe",15,25,40,"['1/2 pound (225 g) of spaghetti or any other long thin Italian pasta (linguini or fettuccini)', 'Salt', '3/4 pound (340 g) globe eggplant, peeled and cut into 1/2 to 3/4-inch cubes (about 2 1/2 cup of cubed eggplant)', '5 tablespoons extra virgin olive oil, divided', '1 medium red onion, cut in half lengthwise and thinly sliced crosswise (about 1 1/2 cups)', '3 cloves garlic, minced (1 tablespoon)', '2 cups fresh baby spinach (3 ounces, 85 g), roughly chopped', '5 to 6 mint leaves (spearmint), minced', '2 ounces (57 g) feta cheese, crumbled', 'Freshly ground black pepper']",10,"['1 Heat salted water for pasta: Put a large pot of salted water (1 Tbsp of salt for every 2 quarts of water) on to boil. While the pasta water is heating, start cooking the eggplant.', '2 Saut\\xc3\\xa9 cubed eggplant: Heat 3 tablespoons of extra virgin olive oil in a large skillet (preferably non-stick that can handle high temperatures) on high heat.', 'When the oil is shimmering hot, add the cubed eggplant. (Add one cube first to make sure the pan is hot enough. If the eggplant sizzles, it is.) Toss to coat with the hot oil. Brown on all sides.', 'While cooking, sprinkle with 1 1/2 teaspoons of kosher salt. Browning the eggplant should take 8 to 10 minutes. When the eggplant is browned on all sides, remove it from the pan to a bowl, set aside.', '3 Start cooking sliced red onion: Add the remaining 2 tablespoons of extra virgin olive oil to the pan. Heat oil on high heat. When the oil is hot, add the sliced red onion, toss to coat with the olive oil. Reduce heat to medium.', '4 Cook pasta: Put the pasta in the boiling pasta water. Return to a boil, boil uncovered at rolling boil until al dente, cooked through but still a little firm to the bite, about 10 minutes, depending on your package of dry pasta. While the pasta is cooking, continue with the onions.', '5 Add garlic to red onion, then spinach, then eggplant, and mint: Cook the red onion until softened but not browned. Add the minced garlic, cook a minute more.', 'Add the spinach leaves and cook until just wilted. Return the cooked eggplant to the pan and add the mint. Toss to combine. Remove from heat.', '6 Toss pasta with eggplant mixture: When the pasta is ready, scoop out a cup of the pasta cooking water and set aside. Then drain the pasta and add the drained cooked pasta to the saut\\xc3\\xa9 pan with the eggplant, onions, and spinach.', 'Add about 1/2 cup of pasta water to the pan with everything. Toss to combine. If you need a little more pasta water, add a little more.', '7 Add most of the crumbled feta cheese to the pasta and eggplant and toss everything to combine.', 'Serve garnished with the remaining crumbled feta cheese and sprinkle generously with freshly ground black pepper.']",12
1363,Spaghetti Squash and Chard Saut\xc3\xa9 Recipe,20,80,100,"['One 3 to 4 pound spaghetti squash', '3 to 4 tablespoons extra virgin olive oil', '1 tablespoon minced garlic', '1/4 teaspoon chili pepper flakes', '1 teaspoon minced fresh rosemary', '1/4 cup chopped fresh parsley', '1 large bunch of chard, center rib removed, leaves chopped', '2 teaspoons apple cider vinegar', 'Salt and pepper to taste', '3/4 cup freshly grated Parmesan cheese']",10,"['1 Bake the spaghetti squash: Preheat your oven to 375\\xc2\\xb0F. Use a very sharp paring knife and poke the spaghetti squash all over, at least an inch deep, about 12 cuts (this is to prevent the pressure from building up as the squash cooks).', 'Place the squash in a roasting pan or rimmed baking sheet and bake in the oven for one hour. Remove from the oven and let rest for a few minutes. Then cut the squash in half, lengthwise.  (If the squash is not easy to cut, return it to the oven for another 15 minutes.)', 'Scoop out the seeds, discard (or save to roast later - see roasted pumpkin seeds recipe).', '2 Scrape out the spaghetti squash strands: Use a fork to scrape the inside flesh of the squash into long thin strands. Place the  spaghetti squash strands in a large bowl and set aside.', '3 Heat oil, saut\\xc3\\xa9 garlic, chili pepper flakes, rosemary: Heat olive oil in a large saut\\xc3\\xa9 pan on medium heat.  Add the garlic, chili pepper flakes, and rosemary and cook for about 30 seconds, until fragrant. Do not let the garlic brown.', '4 Add spaghetti squash, then chard and parsley: Add the spaghetti squash to the pan and toss to coat with the oil and garlic mixture.  Add the chopped fresh chard leaves and parsley and toss with the spaghetti squash.  Cook until the chard leaves have wilted, a few minutes.', '5  Remove from heat and sprinkle on vinegar. Add the grated Parmesan and toss to coat. Add salt and pepper to taste.']",7
1364,Cheesy Spaghetti Squash Casserole Recipe,60,45,105,"['1 tablespoon olive oil plus more for the baking dish', '1 spaghetti squash, about 3 pounds', '2 teaspoons salt', '1/2 teaspoon ground black pepper', '1 onion, finely chopped', '1 clove garlic, minced', '1/2 cup jarred roasted red peppers, thinly sliced', '2 tablespoons chopped fresh sage leaves', '3 eggs', '1 cup whole milk', '3 tablespoon flour', '1 1/2 cups (5 ounces) grated Jarlsberg or baby Swiss cheese', '1/2 cup (2 ounces) finely grated Parmesan', 'Special equipment:', 'Baking sheet', 'Immersion blender or countertop blender', 'Baking dish']",17,"['1 Preheat the oven to 425\\xc2\\xbaF. Line a baking sheet with parchment. Brush or spray a shallow 2-quart baking dish with oil.', '2 Roast the squash: Cut the squash in half lengthwise and scrape out the seeds. Sprinkle with 1/4 teaspoon salt and 1/8 teaspoon pepper. Place on the baking sheet with the cut sides down. Bake for 30 to 40 minutes, or until the squash is tender when pierced with the tip of a paring knife.', 'Remove from the oven and turn the squash so the cut sides are facing up. Return the squash to the oven and bake for another 5 minutes to dry out any excess liquid. (The squash won\\xe2\\x80\\x99t necessarily look dry.) Remove and let cool.', '3 Cook the other ingredients: In a large skillet set over medium heat, add 1 tablespoon of oil. Once the oil begins to shimmer, add the onions, 1/4 teaspoon salt, and 1/4 teaspoon pepper. Cook, stirring occasionally, for 5 minutes or until softened.', 'Stir in the garlic, red pepper slices, and sage. Cook and stir for another minute. Transfer to a large bowl.', '4 Make the egg mixture: In a blender (immersion or countertop), pulse the eggs, milk, flour, 1/2 teaspoon salt and 1/8 teaspoon pepper 3 to 4 times, or until the mixture is smooth.', '5 Mix it all together: With a fork, flake the squash strands into the bowl on top of the onions. Add 1 teaspoon salt and mix until combined. Add the egg mixture, grated Jarlsberg cheese, and 1/4 cup of the Parmesan to the squash. Stir to combine.', '6 Bake the casserole: Transfer the squash mixture to the baking dish and sprinkle it with the remaining 1/4 cup Parmesan. Bake for 40 to 45 minutes.', '7 Serve: Let rest for 10 to 15 minutes before serving as a side dish or a vegetarian main.']",9
1365,Cream of Spinach Soup Recipe,15,40,55,"['1 cup chopped onion', '2 tablespoons butter', '2 cups chopped fresh spinach - packed - (or 1 10-oz package frozen spinach, thawed)', '3 medium potatoes, peeled and quartered (about 1 pound)', '1 1/2 cups chicken broth (or vegetable broth for vegetarian option)', '1 1/2 cups water', '2 chicken bouillon cubes (or vegetable bouillon cubes for vegetarian option)', '2 cups half-and-half', '1/2 teaspoon salt', '1/8 teaspoon pepper', '3/4 cup sour cream', 'Optional: chopped chives and/or ground allspice for garnish']",12,"['1 Cook the chopped onion: In a large saucepan over medium heat, saut\\xc3\\xa9 onion in butter for 4 minutes or until translucent.', '2 Build the soup: Add potatoes, chicken broth, water, and bouillon cubes. Bring to a boil. Reduce heat to low, cover and simmer for 20 minutes or until the potatoes are tender.', 'Add spinach and cook for 2 to 4 minutes longer until spinach is tender.', '3 Pur\\xc3\\xa9e the soup, whisk in half-and-half: Working in batches, pur\\xc3\\xa9e soup mixture in a blender. Return to saucepan. Whisk in half-and-half, salt and pepper.', '4 Whisk in sour cream: Over low heat, bring to just before simmering. Whisk in the sour cream. You may want to use an immersion blender to get the sour cream fully incorporated.', 'This soup can be served hot or chilled. Garnish with chopped chives, sprinkles of allspice, or a dollop of sour cream.']",6
1366,"Italian Egg Drop Soup, Stracciatella Recipe",10,10,20,"['4 cups chicken stock (lightly salted)', '1 large egg', '4 teaspoons finely grated, lightly packed Parmesan cheese (if you have coarsely grated Parm, grind it up to a finer consistency in a food processor)', '1 Tbsp panko breadcrumbs (toasted for added flavor) or semolina flour (optional, you can skip if you want, you can also use ground puffed rice if cooking gluten-free)', 'Pinch of freshly ground black pepper', 'A handful of spinach leaves, sliced into 1/2-inch ribbons (can also use chard, arugula, sorrel, or any tender green)']",6,"['1 Place stock in a 2-quart saucepan and bring to a simmer.', '2 In a medium bowl whisk together the egg, Parmesan cheese,  breadcrumbs (if using), and black pepper.', '3 Once the stock is simmering, stir in the sliced spinach.', '4 Pour/scrape the cheese egg mixture into the simmering stock, do not stir. After a few seconds, stir the egg mixture into the soup.  Cook at a gentle simmer for another minute.', 'Taste the soup and add more salt and pepper if you wish.', 'Serve immediately.']",6
1367,Spinach with Sesame and Garlic Recipe,10,5,15,"['3 tablespoons toasted (dark) sesame oil', '1 tablespoon minced garlic', '1 pound fresh spinach (if using mature spinach, soak in water to clean, drain, squeeze out excess water, remove and discard large stems, roughly chop leaves)', '1 tablespoon sugar', '1 tablespoon soy sauce (use gluten-free soy sauce for gluten-free version)', 'Salt to taste', '1 tablespoon toasted sesame seeds']",7,"[""1 Toast the sesame seeds: If you haven't already toasted the sesame seeds, do that first. Heat a stick-free skillet on medium high. Add raw sesame seeds and use a spatula or wooden spoon to stir."", 'The seeds may make a popping noise and jump up, almost like popcorn. They will toast very quickly, so stir constantly until they begin to brown and smell like they are toasted.', 'Remove from pan into a separate bowl as soon as they are done.', '2 Cook garlic and spinach in sesame oil: Heat 2 tablespoons of the sesame oil in a large skillet over medium heat. Once the oil is hot, add the garlic. As soon as the garlic begins to sizzle, add the spinach and cook, stirring occasionally, until the spinach is completely wilted. Turn the heat to low.', '3 Add sugar and soy sauce: Stir in the sugar and soy sauce. Remove from the heat. Add salt to taste.', 'Serve hot, warm, room temperature, or cold, drizzled with the remaining sesame oil and sprinkled with sesame seeds.']",6
1368,Green Goddess Mac and Cheese Recipe,15,45,60,"['8 ounces baby spinach', '1 bunch parsley, tough stems removed, about 1 cup packed of leaves', '1/2 pound (2 cups) dry elbow macaroni pasta', 'Salt for pasta water', '1 Tbsp cream', '3 Tbsp butter', '1 clove garlic, minced', '3 Tbsp flour', '2 1/2 cups milk', '1 1/2 cups shredded white sharp cheddar cheese', '1/2 cup shredded Parmesan cheese', '1 teaspoon herbs de provence (or dry tarragon or Italian herb mix)', '1 teaspoon ground black pepper', '1 teaspoon Worcestershire sauce and/or 2 finely chopped anchovies', '1/2 teaspoon dry mustard', '1 teaspoon lemon juice', 'Salt to taste']",17,"['1 Blanch spinach and parsley: Bring a large pot of water to a boil. Add the spinach and parsley and blanch for 1 minute. Use a slotted spoon to remove the wilted spinach and parsley to a bowl of ice water. (Do not discard the blanching water, you will use it to cook the macaroni.)', 'Strain the spinach and parsley. Wrap in paper towels and squeeze out excess moisture.', '2 Use blanching water to cook macaroni: Return blanching water to a boil. Add salt to the pasta water, 1 Tbsp salt for every 2 quarts of water. Add the macaroni pasta and cook until very al dente. (If the box of macaroni says to cook it 7 minutes, cook it 5. It will continue to cook and absorb moisture once you mix it with the sauce.)', 'Drain the macaroni, rinse with cold water to stop the cooking, and set aside.', '3 Pur\\xc3\\xa9e spinach with cream: While the macaroni is cooking, in a food processor, pur\\xc3\\xa9e the cooked spinach mixture with the tablespoon of cream until smooth. Set aside.', '4 Make roux with butter, garlic, flour: Melt 3 Tbsp butter in a thick-bottomed pot on medium high heat. Add the minced garlic and cook for 20-30 seconds. The butter should bubble and foam. Add the flour and whisk to form a paste. Lower the heat to medium and cook for 1 to 2 minutes.', '5 Slowly add milk: Slowly add the milk, whisking as you add it to break up any clumps of flour. Increase the heat to medium high and let the mixture come to a simmer, continue to whisk.', 'Lower the heat to medium low and let cook until the sauce is thick enough to coat the back of a spoon.', '6 Add dry mustard, pepper, herbs, Worcestershire: Stir in the dry mustard, black pepper, herbs, and Worcestershire sauce if using.', '7 Add the cheeses: Whisk in the 1 1/2 cups of grated white sharp cheddar and 1/2 cup grated Parmesan. Stir until the cheese has melted and the sauce is smooth.', '8 Add pur\\xc3\\xa9ed spinach and parsley: Stir the pur\\xc3\\xa9ed spinach and parsley into the sauce. If using finely chopped anchovies, you can add them in now. Taste the sauce for salt. Add more if needed.', ""9 Add cooked macaroni: Stir in the cooked drained macaroni pasta. The pasta will continue to absorb liquid as it sits in the sauce, so don't be alarmed if the mac cheese seems really loose (the macaroni will continue to absorb moisture as it sits). Stir in lemon juice."", 'At this point you can eat as is, or you can put into a casserole, top with a little more cheese and broil it for 5-10 minutes.']",13
1369,Turkey Meatball Soup with Spinach and Orzo Recipe,15,25,40,"['For the meatballs:', '2 slices white bread or 1 soft dinner roll (about 3-inches across), left out overnight', '1/4 cup whole or reduced-fat milk (60 ml)', '1 large egg', '1/4 cup grated Parmesan cheese (32 g)', '1 pound ground turkey, preferably dark meat or at least 85% lean', '1 teaspoon salt', '1/2 teaspoon black pepper', '2 tablespoons chopped fresh parsley', '2 tablespoons olive oil', 'For the soup:', '2 tablespoons olive oil', '2 stalks celery, halved lengthwise and thinly sliced', '3 medium carrots, thinly sliced', '1/2 teaspoon salt', '1/4 teaspoon ground pepper', '8 cups chicken stock (2000 ml)', '1/2 cup orzo pasta (70 g)', '5 ounces baby spinach, with any long stems removed (165 g, or 8 loosely packed cups)', '1 cup grated Parmesan (128 g), for serving']",20,"['1 Make the meatball mixture: Shred the bread or roll with your fingers into 1/2-inch pieces. In a bowl, combine the bread or roll, milk, egg, Parmesan, turkey, salt, pepper, and parsley. With a clean hand, work the mixture until it is well blended.', '2 Shape meatballs: With wet hands, shape 2 teaspoons of the mixture into a small walnut-sized meatball (1 1/2-inches across). Repeat, making 30 to 34 meatballs total.', '3 Brown the meatballs (optional): In a nonstick skillet over medium heat, heat 1 tablespoon of the olive oil. When it is hot, add half the meatballs and cook for 3 minutes, or until they are browned on the bottom. Turn and cook 2 minutes more, until browned on the other side. Remove from the pan. (The meatballs will not be cooked through.)', 'Cook the remaining meatballs in the remaining 1 tablespoon olive oil in the same way.', '4 Make the soup: In a soup pot, heat the oil. Add the celery, carrots, salt, and pepper. Cook, stirring often, for 8 minutes. Add the stock and bring to a boil. Add the meatballs and orzo. Return the soup to a boil, lower the heat, and cover the pan.', 'Simmer for 15 minutes, stirring occasionally, or until the meatballs are cooked through and the orzo is tender (cut the meatballs in half to check them; taste the orzo).', '5 Cook the spinach: Add the spinach to the soup and cook 2 minutes more, or just until it wilts.', '6 Serve the soup: Taste the soup for seasoning and add more salt and pepper, if you like. Ladle into bowls and sprinkle with Parmesan.']",8
1370,"Pasta with Spinach, Mushrooms, and Brown Butter Recipe",10,20,30,"['2 tablespoons unsalted butter', '2 tablespoons olive oil', '1 1/2 pounds mushrooms, sliced (See Recipe Note)', '1/4 teaspoon salt', '1/8 teaspoon black pepper', '1/2 pound small shaped pasta, such as orecchiette, bowties, campanelle, or shells', '5 ounces (4 to 5 large handfuls) baby spinach leaves', '2 tablespoons lemon juice', 'Finely grated zest of 1 lemon', '1/2 cup freshly grated Parmesan (for garnish)', '1/4 cup chopped fresh parsley (for garnish)']",11,"['1 Cook the pasta: Bring a large pot of salted water to a boil. Cook for 8 to 10 minutes, or until al dente (check the package for specific times for your chosen pasta).', 'Scoop out 1 cup of the pasta cooking water and drain the pasta in a colander. Set aside.', '2 Meanwhile, make the brown butter: In a small stainless steel or other light-colored skillet over medium heat, melt the butter. Cook, stirring constantly, until the butter solids on the bottom turn light brown and the butter smells nutty. Immediately remove the pan from the heat and set aside.', 'For a full tutorial on making brown butter, see this post.', '  3 Cook the mushrooms: In a large skillet over medium-high heat, heat the oil. Add the mushrooms, and cook, stirring often, for 10 minutes, or until the mushrooms release their juices and turn golden brown. Sprinkle with salt and pepper.', '4 Finish the pasta: Add the drained pasta to the skillet with the mushrooms and toss over medium-high heat. Stir in half the spinach and 1/4 cup of the pasta water into the pasta and cook until the spinach begins to wilt. Add the remaining spinach, and stir until all the spinach wilts. If the pasta seems dry, stir in 1 to 2 tablespoons of the remaining pasta cooking water.', 'Stir in the browned butter, lemon juice and lemon zest and toss. Taste and add more salt and pepper, if you like.', '5 Serve the pasta: Spoon the pasta into shallow bowls and sprinkle the parsley and Parmesan on top. Grind a little fresh black pepper over each bowl.']",8
1371,Greek Meatloaf with Spinach and Feta Recipe,15,75,90,"['For the meatloaf mixture:', 'Vegetable oil spray (for the pan)', '1 tablespoon olive oil', '2 cloves garlic, finely chopped', '5 packed cups (5 ounces) baby spinach leaves', '2 large eggs', '1 cup panko breadcrumbs', '3/4 teaspoon ground cinnamon', '3/4 teaspoon ground coriander', 'Finely grated zest of 1 lemon', '1 teaspoon kosher salt', '1/4 teaspoon black pepper', '1/2 cup chopped parsley', '2 pounds ground beef', '1/4 pound block of feta, cut into 1/2-inch cubes', 'For the glaze', '2 tablespoons pomegranate molasses', '2 tablespoons ketchup', '2 tablespoons chopped pistachios (for garnish)', '2 tablespoons chopped parsley (for garnish)', 'Special equipment:', '9-by-5-inch loaf pan', 'Rimmed baking sheet']",23,"['1 Preheat the oven: Place a rack in the middle of the oven and preheat the oven to 350\\xc2\\xbaF. Spray a 9-by-5-inch loaf pan with vegetable oil spray.', '2 Cook the spinach and garlic: In a large pan, combine the oil and garlic. Set the pan over medium heat. When the garlic sizzles, cook and stir it for 30 seconds.', 'Add the spinach to the pan, and cook, stirring, for 1 to 2 minutes, or until it wilts. Let cool.', '3 Make the meatloaf mixture: In a large bowl, stir together the eggs, panko, cinnamon, coriander, lemon zest, salt, and pepper. Stir in the parsley and the cooked spinach.', 'Add the beef and stir until combined. Add the feta cubes and stir gently to keep the cubes in large pieces.', '4 Make the glaze for the meatloaf: In a small bowl, mix the ketchup and pomegranate molasses.', '5 Bake the meatloaf: Transfer the meat mixture to the loaf pan and smooth the top. Set the pan on a baking sheet and bake for about 45 to 50 minutes.', 'Remove from the oven and pour the glaze over the top of the meatloaf. Return and bake for another 10 to 15 minutes, or until an instant-read thermometer registers 160\\xc2\\xbaF when inserted into the center of the loaf. Continue baking for a few more minutes if the meatloaf is not quite done.', '6 Cool the meatloaf: Let the meatloaf cool in the pan for at least 10 minutes. Run the side of a knife around the edge of the pan.', 'Carefully lift the meatloaf from the pan with a thin spatula and transfer to a serving platter. Sprinkle the chopped pistachios and parsley over the top.', '6 Serve: Slice and serve with a green vegetable and baked potatoes, if you like. Leftover will keep for 3 to 4 days in the refrigerator.']",11
1372,Cheesy Hash Brown Egg Bites Recipe,20,35,55,"['4 cups shredded potatoes, from 2-4 peeled russet potatoes, squeezed of moisture', '4 tablespoons salted butter', '1 teaspoon kosher salt, divided', '3/4 teaspoon freshly ground black pepper, divided', '1/2 cup shredded cheddar cheese', '10 large eggs', '1/4 cup milk', '1/4 cup chopped scallions, from about 2 stalks', '1 (10-ounce) package frozen spinach, thawed and squeezed']",9,"['1 Preheat oven to 450\\xc2\\xb0 F', '2 Prepare the muffin tin: Grease a standard 12 well muffin tin generously with cooking spray.', '3 Make the Hash Brown Cups: In a medium bowl, combine shredded potatoes, shredded cheese, melted butter, 1/2 teaspoon salt, and 1/2 teaspoon black pepper.', '4 Press and bake the hash brown cups: Using your fingers, a spoon or even a shot glass to help form the cups, press the mixture firmly and evenly into the bottoms and up the sides of each well.', 'Bake until brown and crispy, about 20 minutes, and remove from the oven.', '5 Reduce the oven to 375\\xc2\\xb0 F', '6 Prepare the egg mixture: In a large bowl, whisk the eggs, milk, and 1/2 teaspoon salt and 1/4 teaspoon pepper until thoroughly combined. Stir in the chopped scallions and thawed and squeezed spinach. Make sure to break up any lumps of spinach.', '7 Bake: Using a 1/4 cup measuring cup, ladle the egg mixture into the muffin tins with the hash brown cups. Bake until eggs have puffed and set, about 15-17 mins.', '8 Serve: Let cool slightly and then use a knife or a small rubber spatula to loosen the edges of each hash brown cup, gently remove and serve.']",9
1373,Slow Cooker Spinach Feta Dip Recipe,10,90,100,"['2 bunches fresh spinach or 10 ounces frozen spinach', '1 tablespoon olive oil', '1/8 teaspoon kosher salt', '8 ounces cream cheese', '1/2 cup sour cream', '6 ounces feta cheese, crumbled', '1/4 teaspoon garlic powder', 'Pita chips or sliced veggies, for serving', 'Special equipment:', '3- to 4-quart slow cooker (see Recipe Note)']",10,"['1 Prep the spinach: If you are using fresh spinach (my preference), trim off any long stems and add the spinach to a large skillet over medium heat with olive oil. Season with a pinch of salt and cook until spinach is completely cooked down, and all the liquid has cooked off.', 'If you are using frozen spinach, thaw it completely in the microwave, then press the spinach between bunches of paper towels to press out as much liquid as possible. Add the thawed spinach to a skillet with olive oil, and season with salt and pepper. The spinach won\\xe2\\x80\\x99t wilt like fresh spinach, but it\\xe2\\x80\\x99s good to season it anyway and cook off any extra water.', '2 Add ingredients to a slow cooker: Combine the cream cheese, feta cheese, sour cream, garlic powder, and cooked spinach in a 3- to 4-quart slow cooker. Cook on high for 60 minutes, then turn to low for 30 minutes more, stirring a few times to make sure the dip is cooking evenly.', '3 Keep warm until serving: Turn to the Warm setting to keep dip warm until serving. If dip separates slightly, stir it well to recombine.', 'Serve the dip with pita chips or sliced veggies.']",5
1374,Yellow Split Pea Soup Recipe,15,180,195,"['2 tablespoons olive oil', '1 large onion, finely chopped', '1 stalk celery, finely chopped', '1 clove garlic, finely chopped', '1 (1-inch) piece fresh ginger, finely chopped', '1/4 teaspoon black pepper, or to taste', '1 jalapeno or other hot pepper, cored, seeded, and finely chopped', '1 teaspoon ground turmeric', '1 teaspoon ground cumin', '1 teaspoon ground coriander', '1 pound (2 1/4 cups) yellow split peas', '2 quarts (8 cups) water, or more if needed', '1 bay leaf', '1/2 teaspoon salt, or to taste', 'Juice of 1/2 lemon (about 4 tablespoons), or more to taste', '1/2 cup yogurt or sour cream, to serve (optional; omit if making a vegan soup)', '2 tablespoons chopped fresh cilantro, to serve', '3 tablespoons roasted, salted pepitas, to serve']",18,"['1 Cook the root vegetables and seasonings: In a soup pot over medium heat, warm the oil. When the oil is hot, add the onion, celery, garlic, ginger, and pepper. Cook, stirring often, for 8 minutes, until the onions are looking translucent and softened.', '2 Add the hot pepper and spices: Stir in the jalapeno or other hot pepper, turmeric, cumin, and coriander. Cook, stirring constantly, for 2 minutes.', '3 Stir in the split peas. Continue stirring until they are coated all over with spices.', '4 Pour in the water and bring to a boil, stirring. Add the bay leaf.', '5 Simmer the soup: Cover the pot and let the soup bubble gently for 1 1/2 hours, until most of the split peas have fallen apart and are tender.', 'Stir the soup occasionally. If the soup looks like it has broken down at this point, add the salt, stir and cook for another half an hour until the soup looks thick and creamy then move on to step 6.', 'If your split peas still feel firm cook for an additional 30-60 minutes (2 1/2 -3 hours total cooking time) before adding the salt. Add more water if the soup seems too thick.', '6 Taste the soup for seasoning: Once the split peas are tender, add the lemon juice, plus additional salt and black pepper to taste. Stir to combine.', '7 Serve the soup: Ladle into bowls and garnish with yogurt or sour cream, cilantro, and pepitas.']",9
1375,Butternut Squash with Walnuts and Vanilla Recipe,10,30,40,"['1 butternut squash, about 2 pounds, peeled, seeds removed, flesh cut into 1-inch cubes (see how to cut and peel a butternut squash)', '3 bay leaves (if boiling the squash)', '1 tablespoon extra virgin olive oil (if roasting the squash)', 'Salt', '1 heaping cup of walnuts (can substitute pecans or pine nuts)', '2 to 3 tablespoons butter', '2 teaspoons grated ginger', '1 to 2 teaspoons vanilla extract', 'Lemon juice', '1/2 teaspoon dried thyme', 'Black pepper to taste']",11,"['1 Roast or boil the cubed squash: ', 'If roasting: Preheat oven to 400\\xc2\\xb0F. Coat the cubed squash with a little olive oil and spread out onto a baking tray. Sprinkle with salt and roast until the cubes begin to brown, about 20 minutes. Remove from oven.', 'If boiling: Put 4 cups of water into a medium-sized pot and add the bay leaves. Bring to a simmer. Add the squash to the pot. Boil, covered for 10 minutes. Drain.', '2 Toast the walnuts: Heat a large saut\\xc3\\xa9 pan over medium-high heat and toast the walnuts. Stir frequently or they will burn. Once they they start to brown, and you can smell the aroma of toasted walnuts, remove from heat.', '3 Melt the butter: Melt the butter in the pan with the walnuts over medium-high heat. Toss the walnuts to coat with butter, then add the squash. Toss them to coat with butter.', '4 Add the grated ginger, vanilla extract, black pepper, a little salt and dried thyme and toss once more. Turn off the heat and squeeze some lemon juice over everything. Taste for salt and lemon and add more to taste.', 'If you want this to be a bit more luxurious, mix in another tablespoon of butter or two before serving.']",7
1376,Three Sisters Casserole with Cornbread Topping Recipe,35,25,60,"['For the cornbread topping:', '1 1/4 cups yellow cornmeal', '1/2 cup all-purpose flour (or your favorite all-purpose gluten-free flour blend)', '2 teaspoons baking powder', '1 teaspoon kosher salt', '2 tablespoons unsalted butter, melted', '1/2 cup whole milk', '1/2 cup water', 'For the filling: ', '3 tablespoons extra virgin olive oil', '1 yellow onion, diced (about 1 cup)', '4 cloves garlic, minced', '1 pound butternut or kabocha squash, peeled and cut into 1-inch cubes (about 2 cups)', '1 (15-ounce) can diced fire-roasted tomatoes', '2 tablespoons tomato paste', '1 teaspoon ground coriander', '1 1/2 teaspoons ground cumin', '1/2 teaspoon chili powder', '1/4 teaspoon smoked paprika', '1/2 teaspoon kosher salt', '3/4 cup vegetable broth', '1 cup fresh or frozen corn kernels', '1 (15-ounce) can kidney beans, rinsed and drained', '2 cups chopped greens (such as spinach or kale)']",24,"['1 Preheat the oven to 350\\xc2\\xb0F. Spray a 9x13-inch baking dish with non-stick cooking spray and set aside.', '2 Make the filling: In a large, high-sided skillet or Dutch oven, warm the olive oil over medium heat until it\\xe2\\x80\\x99s shimmering and add the onions. Cook until translucent, about 4 to 5 minutes. Add the garlic and cook for an additional minute.', 'Add the squash, tomatoes, tomato paste, spices, and salt. Stir in the broth and bring mixture to a boil.', '3 Simmer the filling: Cover the pot and reduce heat to low. Simmer for 15 to 18 minutes, or until squash is tender.', '4 Make the cornbread topping while the filling simmers: In a medium mixing bowl, whisk together cornmeal, flour, baking powder, and salt. Using a wooden spoon, slowly stir in the butter, milk, and water; mix only until just combined. Set aside and let it sit for ten minutes or so, while the filling simmers.', '5 Add the rest of the ingredients to the filling: Stir in the corn, beans, and greens into the filling, and continue cooking, covered, for 3 to 5 minutes, until mixture has thickened slightly and all the ingredients are incorporated.', '5 Transfer to baking dish and bake: Scrape the filling into the prepared pan and top with generous biscuit-sized clumps of cornbread topping (this can be rustic and uneven).', 'Bake for 20 to 25 minutes, or until filling is bubbling and topping is golden brown.', '6 Serve: Remove from the oven allow to cool for 5-10 minutes before serving.']",9
1377,Calamari Stewed with Tomatoes Recipe,15,80,95,"['2 pounds cleaned calamari (squid), tubes sliced into rings and tentacles roughly chopped', '4 tablespoons extra virgin olive oil', '1 sliced onion', '1 fennel bulb, chopped', '3 garlic cloves, chopped', '2 tablespoons tomato paste', '1/4 cup Sambuca or other anise-flavored liquor', '1 cup red wine', '1 28-ounce can of crushed tomatoes', 'Salt and pepper', '1/2 cup parsley, chopped', '1/4 cup fennel fronds, chopped']",12,"['1 Saut\\xc3\\xa9 onions, fennel, garlic: Heat the olive oil in a large pot over medium-high heat. When the oil is hot, add the onions and fennel. Stir to coat with oil and saut\\xc3\\xa9, stirring occasionally, until it begins to color, about 5-6 minutes. Sprinkle some salt over it.', 'Add the garlic cloves and tomato paste and stir well to combine. Cook this for another 2-3 minutes, stirring once or twice.', '2 Add the red wine, stir well, and increase the heat to high. Boil until the liquid is reduced by half.', '3 Add the Sambuca or other anise-flavored liquor, and the crushed tomatoes.', '4 Stir in the calamari and bring the pot to a gentle simmer. Simmer for at least 1 hour. After an hour, taste a piece of calamari; It should be tender. If it\\xe2\\x80\\x99s not, keep simmering. Check for tenderness every 15 minutes afterward.', '5 Season to taste with salt and pepper: Once the calamari is tender, taste the stew for salt and pepper, adding if needed. Add the chopped parsley and fennel fronds. Stir well to combine and serve.']",6
1378,Hot Dogs with Sriracha and Asian Slaw Recipe,20,15,35,"['Coleslaw:', '1 Tbsp creamy peanut butter', '6 Tbsp vegetable oil', '1 teaspoon toasted (dark) sesame oil', '4 Tbsp seasoned rice vinegar (if seasoned rice vinegar is not available, add a teaspoon or two of sugar to regular rice vinegar)', 'A sprinkle of salt', 'A sprinkle of sugar', '4 cups thinly sliced cabbage (Napa, green, purple, or a combination)', '3/4 cup grated carrots', '1/4 cup chopped fresh cilantro', '3 thinly sliced green onions', '2 Tbsp toasted sesame seeds', 'Hot Dogs:', '4-6 hot dogs', '4-6 buns', 'Sriracha hot sauce', 'Chinese mustard']",17,"['1 Make the dressing for the cole slaw: Mix the peanut butter in a medium bowl with the vegetable oil and sesame oil until smooth. Whisk in the seasoned rice vinegar, then add salt and sugar to taste.', ""2 Prep the cole slaw: In a large bowl, toss the sliced cabbage, grated carrots, cilantro, green onions and sesame seeds together. Don't mix in the dressing until you are ready to cook the hot dogs."", '3 Cook the hot dogs as you like (boil, grill or fry):', '3a: To boil the hot dogs: put hot dogs in a saucepan and add enough water to cover them with an inch of water. Bring to a boil, reduce to a simmer and cook for a couple minutes.  All you need to do is to heat the hot dogs thoroughly, because they are packaged already cooked.', '3b: To grill the hot dogs: preheat heat your grill on high, direct heat.  Right before placing the hot dogs on the grill, lower the heat to medium (if using a gas grill) and place the hot dogs perpendicular to the grates. If using a charcoal grill, sear the hot dogs first on the hot side of the grill to get grill marks, then move them to a less hot side of the grill. Turn the hot dogs occasionally so that all sides get cooked.', '3c: To fry the hot dogs: score the hot dogs 3 times on each side, slicing about 1/4 inch deep. Place a little vegetable oil in the fry pan, heat on medium high. Add the hot dogs and cook, turning every minute, until lightly seared and cooked through.', '4 Toast the buns: Toast the buns in a toaster or in the frying pan alongside the hot dogs or on the grill.', '5 Serve: To serve, spread some Chinese mustard on the bun. Put the hot dog in the bun, sprinkle with sriracha sauce, and top with coleslaw.']",8
1379,Corned Beef and Cabbage Recipe,10,150,160,"['Corned Beef (baked)', '3 pounds corned beef (in package)', '10 whole cloves', '1/4 cup hot sweet honey mustard', '2 tablespoons brown sugar', 'Corned Beef (boiled)', '3 pounds corned beef (in package, including spice packet)', 'Cabbage (saut\\xc3\\xa9ed)', 'Extra virgin olive oil and butter', '1 medium yellow onion, chopped', '1 cloves garlic, minced', '1 large head of cabbage, sliced into 3/8-inch to 1/2-inch wide slices', 'Salt', 'Cabbage (boiled)', '1 large head of cabbage, sliced into 3/8-inch to 1/2-inch wide slices', 'Additional vegetables such as a couple carrots (cut to 1 inch pieces) or several new potatoes (quartered)']",16,"['Corned Beef (Baked)', '1 Lightly boil to remove excess salt: Take the corned beef from the package and discard the spice packet. Note that one side of the roast should have a layer of fat, the other side should have distinct lines indicating the grain of the beef.', 'Corned beef can be very salty, especially when baked. To remove some of the salt before cooking, place it in a pot fat side up. Cover with water, bring to a boil, and discard the water. Repeat to remove even more salt.', ""2 Top with cloves, honey mustard, brown sugar: Preheat oven to 350\\xc2\\xb0F. Lay the corned beef, fat side up, on a large piece of heavy duty, wide, aluminum foil (you may have to get creative with the way you wrap the beef if your foil isn't wide enough)."", 'Insert the cloves into the top of the slab of corned beef, evenly spaced. Spread the top with the hot sweet honey mustard. Sprinkle brown sugar over the top.', '3 Wrap in foil and bake: Wrap the corned beef with foil in a way that allows for a little space on top between the corned beef and the foil, and creates a container to catch the juices. Place foil-wrapped corned beef in a shallow roasting pan and bake for 2 hours at 350\\xc2\\xb0F.', '4 Add more honey mustard, broil: Open the foil wrapping, spread a little more honey mustard over the top of the corned beef, and broil it for 2-3 minutes, until the top is bubbly and lightly browned.', '5 Slice: Let rest for 5 to 10 minutes, then place on cutting board. Pull out and discard the cloves.', 'Lift the corned beef up to see which direction the grain of the meat is.  Then cut the meat at a diagonal, across the grain of the meat, into 1/2-inch thick slices.', 'Serve immediately.', 'Corned Beef (Boiled)', '1 Place corned beef in a large (6 to 8 quart) pot. Cover the beef with an inch water. Add the contents of the spice packet to the water. Bring to a boil, reduce heat to a simmer.', 'Simmer for 2-3 hours, until the corned beef is fork tender. Remove from pot to a cutting board. (Reserve cooking liquid for boiling cabbage, if you plan to boil and not saut\\xc3\\xa9 the cabbage.)', 'Cut slices across the grain, into 1/2-inch thick slices. Serve.', 'Cabbage (Saut\\xc3\\xa9ed)', '1 Heat 2 Tbsp olive oil (enough to well coat the pan) on medium high to high heat in a large, wide pot (8-quart if available) or large, high-sided saut\\xc3\\xa9 pan. Add chopped onions, cook for a couple of minutes, then add garlic.', '2 Add a third of the sliced cabbage to the pan. Sprinkle with a little salt and stir to coat with oil and mix with onions.', 'Spread out the cabbage evenly over the bottom of the pan and do not stir until it starts to brown. If the heat is high enough, this should happen quickly. The trick is to have the burner hot enough to easily brown the cabbage, but not so hot that it easily burns.', 'When the bottom of the cabbage is nicely browned, use a metal spatula to lift it up and flip it, scraping the browned bits as you go.', '3 Once the cabbage in the pan has browned on a couple of flips, add another third of the cabbage to the pan. Mix well, then spread out the cabbage and repeat. Add a bit of butter to the pan for flavor, and to keep the cabbage from sticking too much to the pan. Once this batch has cooked down a bit and browned, add the remaining third of the cabbage and repeat.', 'Serve with the corned beef. Serve with boiled new potatoes. Can be made ahead and reheated.', 'Cabbage (Boiled)', '1 Once you have removed the corned beef from the pot, add the cabbage and any other vegetables (carrots, new potatoes) to the pot. Taste the liquid. If it is too salty, add more water to the pot. Raise the heat until the liquid is simmering well. Simmer until the cabbage and any other vegetables are cooked through, 15-30 minutes.', 'Place vegetables in a serving bowl, add a little of the cooking liquid to the bowl.']",24
1380,Watercress Soup Recipe,15,40,55,"['3 tablespoons butter', '2 cups white or yellow onion, chopped', 'Salt', '1 cup white wine, chicken stock, or vegetable stock (wine or veg stock for vegetarian version)', '1 pound potatoes, peeled and cut into chunks', '6 cups water', '6 cups fresh watercress, about 1/2 pound, chopped, stems included', '1/2 teaspoon black pepper', 'About 6 tablespoons sour cream, stirred in, or for garnish']",9,"['1 Cook the onions: In a large pot, heat the butter until frothy, then cook the onions over medium heat until soft and translucent, about 5 minutes. Salt the onions as they cook.', '2 Add potatoes, wine/stock, simmer: Add the wine or stock, potatoes and water and bring to a boil. Turn the heat down to low, cover the pot and simmer until the potatoes are soft, about 30 minutes.', '3 Add watercress: Add the watercress to the pot. Stir well and cook for 2 minutes.', ""4 Pur\\xc3\\xa9e the soup: Turn off the heat and pur\\xc3\\xa9e the soup with an immersion blender. If you don't have an immersion blender, pour the soup in batches into a blender and transfer the blended soup to a clean pot. Be careful when blending hot liquids to only fill the bowl a third of the way, and to hold down the blender's lid while you pur\\xc3\\xa9e the soup."", ""5 Season and garnish to serve: Add salt to taste, then add the black pepper. You can either stir the sour cream into the whole batch of soup, or serve a tablespoon in the center of each person's bowl.""]",5
1381,Irish Lamb Stew with Bacon Recipe,15,120,135,"['2 1/2 pounds lamb shoulder or shoulder blade chops, bone-in, trimmed of excess fat', '6 slices bacon, thickly cut', '2 pounds potatoes (Yukon gold preferred), peeled, quartered', '2 large onions, quartered', '2 large carrots, peeled and cut into 2-inch segments', '1 turnip, peeled and cut into 1-inch pieces', '2 heaping tablespoons pearl barley (omit for gluten-free version)', '1 tablespoon chopped fresh thyme or 1 teaspoon dried thyme', 'Salt and freshly ground black pepper', '1 quart of water or lamb stock, warmed']",10,"['1 Cook the bacon: Heat a large (6-quart), thick-bottomed Dutch oven on medium heat. Layer the bacon on the bottom of the pan and cook the slices gently, a few minutes on each side, until much of the fat has been rendered out, and the slices have browned lightly.', 'Place the cooked bacon strips on a paper-towel-lined plate to absorb the excess fat. Chop the bacon and set aside.', '2 Brown the lamb in bacon fat: Remove all but 2 tablespoons of bacon fat from the pan (do not pour the removed fat down the drain or it will clog the drain pipes). Increase the heat to medium high.', 'Working in batches as to not crowd the pan, brown the lamb pieces on all sides, taking care not to stir the lamb pieces so they can get sufficiently browned.', '3 Arrange the meat and vegetables in the pan in layers: Start first with a layer of lamb, then add a layer of potatoes, onions, turnips, carrots, and chopped bacon. Add another layer of lamb and then another of vegetables. Add the barley, thyme, black pepper and a teaspoon of salt.', '4 Add water or stock to the pot, and bring to a boil. Reduce the heat to a bare simmer. Let simmer, covered, but with the lid slightly ajar, for 1 1/2 to 2 hours, until the meat is fork tender and falling off the bones.', '5 Skim any excess fat from the stew. Use tongs to pick out and remove bones. Adjust seasonings, adding salt and pepper to taste.']",7
1382,Parsnip Soup with Leeks and Parsley Recipe,10,45,55,"['2 tablespoons butter', '3 leeks, white and pale green parts only, sliced lengthwise, cleaned, sliced crosswise into 1/4-inch slices', '2 tablespoons extra virgin olive oil', '1 1/2 to 2 pounds parsnips, peeled and chopped', '2 strips lemon zest, 1 x 2 inches each', '1-2 teaspoons salt', '4 cups chicken stock (use vegetable stock for vegetarian option)', '2 cups water', '2 cups finely chopped fresh parsley (reserve a little for garnish)', '1 tablespoon lemon juice', 'Pepper to taste']",11,"[""1 Cook leeks in butter: Heat butter in a 4 to 6 quart pot on medium heat. Add the chopped leeks, toss to coat with the butter. When the leeks are heated enough so they begin to sizzle in the pan, lower the heat to low and cover the pan. Cook until soft, but don't let the leeks brown."", '2 Add parsnips, oil, salt, stock, water, zest: Add the parsnips and olive oil, and toss to coat. Sprinkle on the salt. Add the stock and water. Add the strips of lemon zest.', 'Bring to a boil and reduce to a low simmer. Cover and cook until the parsnips are completely tender, at least 30 minutes.', '3 Remove and discard the lemon zest. Add the parsley. Pur\\xc3\\xa9e the soup until smooth, either by using an immersion blender or by working in batches with a stand-up blender. If using a standing blender, fill the bowl no more than halfway, hold the cover on the blender bowl, and start blending at the lowest speed. Return the pur\\xc3\\xa9ed soup to the pot.', '4 Stir in lemon juice and add more salt to taste, if needed.', 'Garnish with freshly ground black pepper, a little olive oil, and chopped parsley or chives.']",6
1383,Grilled Marinated Flank Steak Recipe,10,140,150,"['Marinade Ingredients', '1/3 cup extra virgin olive oil', '2 cloves garlic, minced', '2 tablespoon red wine vinegar', '1/3 cup soy sauce', '1/4 cup honey', '1/2 teaspoon freshly ground black pepper', 'Other ingredients', '2 pounds flank steak']",9,"['1 Marinate the steak: Combine the marinade ingredients in a large non-reactive bowl.', 'Place steak in the bowl and turn so that it is completely coated with the marinade. (You can also place the steak and marinade in a freezer bag and place it in a bowl.)', 'Chill and marinate for at least 2 hours and up to overnight.', '2 Prepare your grill for high, direct heat with one part of the grill for lower, indirect heat. The grill is hot enough when you hold your hand about an inch over the hot side and you can only hold it there for about a second.', ""3 Grill the steak: Remove the steak from the marinade and gently shake off the excess marinade from the steak (but make sure there is still a coating of it, you'll want the oil on it to help keep the steak from sticking to the grill)."", 'If you want, sprinkle generously on all sides with coarse salt and freshly ground pepper. The salt and pepper will help form a savory crust on the steak.', 'Place steak on the hot side of the grill. Grill for a minute or two on each side to get a good sear, then move the steak to the cooler side of the grill, cover and cook a few minutes more until done to your liking.', ""How do you know when the steak is done? One way to tell is to poke it with your fingertips. While the steak is still raw, test it with your fingers; it will be quite squishy. That's what a very rare steak feels like. Touch the tip of your nose and that's what a very well done steak feels like. Here's a visual guide, the finger test to check the doneness of steak."", 'Otherwise use a good meat thermometer (I recommend a thermapen.)  Pull the steak off the grill at 120 to 125\\xc2\\xb0F for rare, 130-140\\xc2\\xb0F for medium rare, and 145\\xc2\\xb0F for medium.', '4 Rest the steak: When the steak has cooked to your preferred level of doneness, remove from the grill and place on a cutting board. Cover with aluminum foil to hold in the heat while the steak rests for 10 to 15 minutes.', '5 Slice across the grain: Notice the direction of the muscle fibers of the steak; this is called the grain of the meat. Flank steak is a very lean cut that will be tough and chewy unless you cut it in a way that breaks up the muscle fibers.', 'So, cut the steak across the grain of the meat, at a steep diagonal, so that the slices are wide. I find it easiest to use a long serrated bread knife for this, but any long sharp knife will do.', 'If you want, you can take the excess marinade and bring it to a boil, simmer for several minutes, and serve with the flank steak. Great also with salsa or horseradish sauce.']",13
1384,Santa Maria Style Tri Tip Recipe,60,35,95,"['1 tri-tip roast, also known as triangle steak, a bottom sirloin cut (anywhere from 2 1/2 pounds to 4 pounds), look for one well-marbled with fat', 'Santa Maria Rub (enough for a 4 pound roast)', '1 Tbsp Kosher salt', '1 Tbsp finely ground black pepper', '1 Tbsp garlic powder', '1 Tbsp onion powder', '1 teaspoon cayenne', '1 Tbsp dried oregano', '1 teaspoon dry rosemary (or fresh, finely minced)', '1/2 teaspoon dry sage']",10,"['1 Mix rub and massage into roast: Mix the rub ingredients together in a bowl.', 'Place the roast in a roasting pan or a baking pan with edges (this will help keep the rub from getting all over the floor).', 'Sprinkle the rub on the meat on all sides, and massage the rub into the meat.', '2 Cover and let sit at room temp for an hour. Cover the roast with foil or plastic wrap and let it sit at room temp for an hour to take the chill off and allow the rub to work its magic on the roast.', '3 Prepare grill: Prepare your grill for hot direct heat on one side, and indirect heat on the other. (By the way, if you are working with a wood-fired grill, Santa Maria BBQ traditionally uses red oak wood.)', '4 Sear the roast on all sides, 3-4 minutes per side. Carefully watch the roast during this process as one side of the roast is typically quite fatty and as the fat heats up it can drip down and cause flare-ups. Keep moving the tri-tip away from the flame if flare-ups occur.', '5 Move roast to cool side of grill, fat side up: Once the tri-tip is seared on all sides, move it away from direct heat and place it fat-side up on the grill rack.', 'If you are using a gas grill with a top rack, I recommend placing the roast on that rack, with an aluminum tray on the bottom rack underneath to catch the fat drippings.', 'If you are grilling on charcoal or wood, you may want to turn the roast over every few minutes, for more even heating.', 'Try to maintain a grill temperature of 250\\xc2\\xb0F to 300\\xc2\\xb0F.', '6 Cover to finish cooking: Cover the grill and cook until the temperature of the interior of the tri-tip reaches 120\\xc2\\xb0F for a rare roast, 130\\xc2\\xb0F for medium-rare and 140\\xc2\\xb0F for medium.', 'At this point the meat will take anywhere from 20 to 40 minutes to cook, depending on how hot your grill is, how well done you want it, and the size of the cut.', 'Note that the interior temperature will continue to rise at least 5\\xc2\\xb0F after you take the roast off the heat.', '7 Tent roast with foil to let it rest: Once the roast reaches temperature, remove it from the grill and let it rest, loosely tented with foil, for 10-15 minutes.', 'Slice across the grain to serve.']",15
1385,Filet Mignon with Red Wine Sauce Recipe,10,20,30,"['2-4 filet mignon steaks, 1 to 2 inches thick*', 'Salt', 'Extra virgin olive oil or canola oil', '3-4 Tbsp unsalted butter, divided', '2 cups full bodied red wine (we used a favorite Zinfandel)', 'Black pepper to taste', '*If you have thicker steaks, you can butterfly them and cook on the stovetop as directed here, or you can sear them on the stovetop and finish them in a 350\\xc2\\xb0F oven for 10 minutes or more, until the center of the steaks are done to your liking.']",7,"[""1 Prepare the steaks: Your steaks should already be trimmed of the tough silver skin. If not, cut away any gristly bits. If your steak has the chain attached and you don't want to serve it, cut it away and save for another purpose."", '2 Let sit at room temperature: Allow the steaks to come to room temperature for at least 30 minutes and up to 90 minutes, depending on the thickness of the steaks. Just before getting ready to cook, pat the meat dry with paper towels, then coat with oil. Salt well.', '3 Sear the steaks on one side: Heat 2 tablespoons of oil in a cast iron pan on high heat for 1 minute. Swirl to coat the pan. Put the steaks in the hot pan and immediately turn the heat down to medium to medium high (depending on your stovetop, medium on a high BTU gas range is about medium high on most electric ranges). Sear untouched for at least 3 minutes, up to 6 minutes for a 2-inch thick steak.', '4 Cook the other side: Flip the steaks and cook for another 2-5 minutes, depending on how thick the steak is and how rare or well done you like your meat.', 'You can use the finger test to test the doneness of your steak. Or you can use a meat thermometer inserted into the thickest part of the steak (120\\xc2\\xb0F to 125\\xc2\\xb0F for rare, 130\\xc2\\xb0F to 135\\xc2\\xb0F for medium rare, 140\\xc2\\xb0F to 145\\xc2\\xb0F for medium).', 'Remove from the pan, loosely tent with foil and allow to rest while you make the sauce.', '5 Make the wine sauce with pan juices: Pour the wine into the pan and turn the heat to high. Boil this furiously until it is reduced by 3/4, about 10 minutes. Add any juices the steaks have released while resting.', 'Turn off the heat and wait until the wine has stopped bubbling. When it has, add the tablespoons of butter, one tablespoon at a time. Swirl each tablespoon into the sauce until it is completely incorporated before adding the next tablespoon of butter.', 'Add salt to taste and serve the sauce with the steak. Sprinkle freshly ground black pepper over the meat when you serve it.']",9
1386,Hanger Steak with Shallots Recipe,10,20,30,"['1 tablespoon canola oil or extra virgin olive oil', '4 hanger steaks, 6-8 ounces each (trimmed of main gristle running through center)', 'Salt and freshly ground pepper', '2 tablespoons unsalted butter', '6 medium shallots, thinly sliced', '2 tablespoons red wine vinegar', '1/2 cup red wine', '2 tablespoons finely chopped Italian parsley']",8,"['1 Sear the steaks on all sides: Heat oil in a large heavy-bottomed skillet or saut\\xc3\\xa9 pan over high heat. Pat the steaks dry with a paper towel and season them with salt and pepper.', ""When the pan is hot, place the steaks into the pan, and brown them on all sides. (Do not move the steak pieces until they have browned on one side, if you move them, they won\\'t brown easily.)"", '2 Cook until done to your preference, remove from pan: Continue to turn them until they are cooked to your preference, 6 minutes total for medium-rare (the steaks will continue to cook as they rest), a few minutes longer for more well done.', 'Transfer the steaks to a warm dish and cover them with foil and let them rest while you prepare the sauce.', '3 Make the sauce: Reduce the heat to medium, add a tablespoon of butter and the shallots. Season with salt and pepper and cook, stirring frequently until the shallots are softened, about 3 to 5 minutes.', 'Add the vinegar and cook until it boils away, then add the wine.', 'Bring the wine to a boil and let reduce to about half. Remove pan from heat, stir in the remaining tablespoon of butter and the chopped parsley.', '4 Slice steaks across the grain to serve: To serve, cut each steak across the grain into thin slices. Fan the slices out on a warm dinner plate. Drizzle the warm shallot sauce over the meat and serve immediately.']",8
1387,Grilled Flank Steak with Mushrooms Recipe,15,25,40,"['2 pounds flank steak', 'Salt', 'Extra virgin olive oil', 'Black pepper', ""2 pounds mixed mushrooms (if you can, make sure the assortment includes some shiitake mushrooms, they're especially flavorful), cleaned, roughly chopped"", '2 tablespoons butter', '1/2 cup minced shallots (or onions)', '1 cup red wine (or beef broth)', '1 tablespoon minced fresh rosemary']",9,"['1 Salt the steak: Salt the steak well and let it come to room temperature.', '2 Dry saut\\xc3\\xa9 the mushrooms: Heat a large saut\\xc3\\xa9 pan on medium high heat. Add the mushrooms to the pan, as is (no butter or oil). Stir the mushrooms occasionally, and shake the pan a bit. You should hear the mushrooms squeak when they move in the pan. (See our article and video on How to Dry Saut\\xc3\\xa9 Mushrooms).', 'Continue to cook until the mushrooms release their moisture. Add a large pinch of salt and stir to combine.', '3 Finish the mushrooms: Add the butter, rosemary and shallots. Stir to combine and saut\\xc3\\xa9 over medium-high heat for 2-3 minutes, stirring often.', 'Add the red wine (you can substitute beef broth) and boil until the sauce has reduced by half. Turn off the heat.', ""4 While the mushrooms cook, prepare the grill for high direct heat: If you are using a gas grill, turn it on, cover it, and let it heat up for at least 10 minutes. (You want the grill to be very hot, which can difficult to do on a gas grill if the grill hasn't pre-heated long enough.)"", 'If you are using a charcoal grill, get the coals very hot. The grill is hot enough when you put your hand about an inch over the grill and you can only hold it there for 1 second.', 'When the grill is hot, clean the grill grates with a wire scraper and then moisten a paper towel with olive oil. Using tongs, wipe down the grill grates with the oil-soaked towel.', '5 Sear the flank steak on one side: While the grill is heating up, massage olive oil into the steak. You want the steak well coated. When the grill is hot enough, place the steak on a hot part of the grill.', 'Sear for 4-6 minutes without moving. If you want a cross-hatch pattern of grill marks, about halfway through grilling, gently lift up a corner of the steak with tongs to check for grill marks, if you have them, pick up the steak and put it back down on the grill at a 90\\xc2\\xb0 angle (a quarter turn) from where it had been.', '6 Flip and grill steak on other side: Turn the steak over. Touch it to test for doneness (see the finger technique for checking for doneness). You might only need a couple minutes on this side, depending on how thick your flank steak is.', 'Flank steak is best rare or medium rare; it becomes tough if it gets too well done. Try to undercook the meat just a little, as it will continue to cook a bit while it is off the heat resting.', 'When the flank steak is almost done, take it off the heat and let it rest. Grind black pepper over it.', '7 Finish the mushrooms. Turn the burner on high and boil down the liquids almost to a glaze. Add any meat juices that have accumulated with the resting flank steak. Taste for salt and add any if needed.', '8 Slice the steak and serve with mushrooms: If you have a large steak, it may be easier to first cut it in half along the grain of the steak fibers. Then slice it thinly, on an angle, across the grain. Serve immediately with the mushrooms', 'P.S. If you happen to end up with leftover mushrooms you can throw them into some scrambled eggs for breakfast.']",16
1388,Easy Broiled Steak,5,1448,1453,"['2 tablespoons balsamic vinegar', '2 tablespoons soy sauce', '2 tablespoons extra virgin olive oil', '1 teaspoon kosher salt', '1 teaspoon ground black pepper', '1 teaspoon ground coriander', '1 teaspoon garlic powder', '1/2 teaspoon smoked paprika', '1 1/2 pounds (four 6-ounce) sirloin, ribeye, or strip steaks, about 1 inch thick']",9,"['1 Combine the marinade ingredients: In a small bowl or jar, stir together the vinegar, soy sauce, olive oil, salt, pepper, coriander, garlic powder, and smoked paprika.', '2 Marinate the steaks: Place the steaks in a gallon zip-top bag or a lidded container that just fits the steaks\\xe2\\x80\\x94you want them to get cozy with the marinade. Pour the marinade over the steaks, turning them to coat the steaks on all sides. Close the bag or container, pushing as much air out as possible. Refrigerate and marinate the steaks for at least 2 hours, or up to 24 hours.', '3 Heat your broiler: Preheat your oven broiler to 550\\xc2\\xbaF (or as high as your broiler goes) with the oven rack in its highest position (about 4 to 6 inches from the broiler element), and line a baking sheet with aluminum foil.', '4 Dry the steaks: Pat the steaks dry with paper towels and place them on the lined baking sheet. Patting the steaks dry is very important\\xe2\\x80\\x94you don\\xe2\\x80\\x99t want a bunch of extra marinade on the steaks and the sheet pan, as it will just burn under the broiler.', '5 Broil the steaks: Broil the steaks for 4 minutes on the first side, then use a pair of tongs to flip them and broil for 4 minutes more on the second side. Use a digital thermometer to test for doneness.', 'I aim for around 130\\xc2\\xbaF in the center for medium-rare to medium steaks\\xe2\\x80\\x94they\\xe2\\x80\\x99ll continue to cook a bit after you take them out of the oven. If the steaks are not yet done, flip and broil for an additional minute, and test again. (I usually end up broiling my steaks for 4 to 6 minutes per side, depending on their thickness.)', 'If the steaks are already charred after 4 minutes per side, but still undercooked in the middle, lower the oven rack a rung for the remainder of cooking, or even just turn the oven off and use the carryover heat to finish cooking the steaks for another minute or two.', '6 Rest and Serve: Transfer the steaks to a cutting board. Let them rest for about 5-7 minutes. Then plate and serve with your favorite side.']",8
1389,Garlic Herb Steak Bites Recipe,10,15,25,"['For the steak bites:', '1 1/4 pounds steak, trimmed of fat and cut into 1/2-inch cubes', '2 tablespoons olive oil', '1 teaspoon garlic powder', '1 teaspoon kosher salt', '1 teaspoon black pepper', '2 tablespoons unsalted butter', '2 tablespoons fresh minced parsley', 'For the DAD ADD: Steak Bite Grilled Cheese', '6 to 8 cooked steak bites, chopped', '2 slices Swiss cheese', '1 tablespoon mustard', '2 slices sandwich bread', 'Olive oil or butter for cooking']",14,"['THE DAD ADD: Steak Bite Grilled Cheese', 'Add a drizzle of olive oil to a small skillet over medium-low heat. Smear two pieces of bread with a little mustard. Add the bread, mustard side up, to the skillet to coat it with olive oil. Add a slice of cheese to the bread, top with the chopped steak bites, and top with a second slice of cheese. Add the second piece of bread to finish the sandwich.', 'Cook sandwich over medium-low heat until the cheese is melted and the bread is browned on both sides. Slice in half and serve while warm!']",3
1390,Kentucky Burgoo Recipe,15,190,205,"['3 tablespoons vegetable oil', '3-4 pounds pork shoulder or country ribs, cut into large pieces (3 to 4 inches wide)', '2-3 pounds chuck roast, stew meat, or other inexpensive cut of beef, cut into large pieces (3 to 4 inches wide)', '3-5 chicken legs or thighs (bone-in)', '1 green pepper, chopped', '1 large onion, chopped', '2 carrots, chopped', '2 celery ribs, chopped', '5 garlic cloves, chopped', '1 quart chicken stock or broth', '1 quart beef stock or broth', '1 28-ounce can of crushed tomatoes', '2 large potatoes (we used russets)', '1 bag of frozen corn (about a pound)', '1 bag of frozen lima beans (about 14 ounces)', 'Salt and pepper', '4-8 tablespoons Worcestershire sauce', 'Tabasco or other hot sauce on the side']",18,"['1 Brown the meats: Heat vegetable oil on medium-high heat in a large soup pot (at least 8 quart size). Salt the meats well on all sides. When the oil is shimmering hot, working in batches brown all the meats.', 'Do not crowd the pan or the meat will steam and not brown well. Do not move the meat while browning a side. Let the meat pieces get well seared.', 'Remove the browned meats to a bowl.', '2 Saut\\xc3\\xa9 onions, carrots, celery, green pepper: Add the onions, carrots, celery and green pepper to the pot and brown them. If necessary, add a little more oil to the pot.', 'After a few minutes of cooking, sprinkle salt over the vegetables.', '3 When the vegetables are well browned, add the garlic and cook for 30 seconds more, until fragrant.', '4 Add back the meats, and the chicken and beef broths and the tomatoes, stir to combine. Bring to a simmer, cover, reduce the heat and simmer gently for 2 hours.', '5 Remove the meat pieces, strip from bones, cut into smaller pieces, return to pot: Uncover and remove the meat pieces. Strip the chicken off the bone and discard skin if you want.', 'Break the larger pieces of meat into smaller, more manageable pieces. The reason you did not do this at first is because the meats stay juicier when they cook in larger pieces.', 'Return all the meat pieces to the pot and bring it up to a strong simmer.', ""6 Add potatoes: Peel and cut the potatoes into chunks about the same size as the meat pieces (if using new potatoes, you can skip the peeling, but russets you'll want to peel). Add them to the stew and cook them until they are done, about 45 minutes."", '7 When the potatoes are done, add the Worcestershire sauce, mix well and taste for salt. Add more Worcestershire sauce to taste if needed.', '8 Add the corn and lima beans. Mix well and cook for at least 10 minutes, or longer if you\\xe2\\x80\\x99d like. Here is the point where you decide whether you want a burgoo that\\xe2\\x80\\x99s been hammered into a thick mass or a stew with bright colors in it. It\\xe2\\x80\\x99s your call.', 'To serve, taste one more time for salt, and add either Worcestershire or salt if you want. Serve with crusty bread or cornbread and a bottle of hot sauce on the side.']",14
1391,Chicken and Dumplings Recipe,15,45,60,"['For the chicken and vegetables:', '3 to 3  1/2 pounds chicken thighs and breast parts, skin-on, bone-in, trimmed of excess fat', '2 teaspoons butter or extra virgin olive oil, or a combination of both', 'Salt', '1 quart chicken stock (homemade is best)', '2 to 3 celery stalks, trimmed and cut into 1/2-inch pieces (about 2 cups)', '3 medium carrots, peeled and cut into 1/2-inch pieces (about 2 cups)', '1 large onion, roughly chopped (about 2 cups)', '1/3 cup all-purpose flour', '1 teaspoon dried thyme', '1/4 cup dry sherry or vermouth (optional)', '1 tablespoon heavy cream (optional)', '3/4 cup frozen peas, thawed', '1/4 cup minced fresh parsley leaves', 'Ground black or white pepper', 'For the dumplings:', '2 cups (250 g) cake flour (can sub all-purpose flour, but use cake flour if you have it, your dumplings will be fluffier)', '2 teaspoons baking powder', '3/4 teaspoon salt', '2 tablespoons butter, melted', '3/4 cup milk', '1/4 cup minced fresh herb leaves such as parsley, chives, and tarragon (optional)']",22,"['1 Heat the chicken stock to a gentle simmer in a medium pot.', '2 Brown the chicken: In a large 8-quart or larger thick-bottomed pot, heat the butter or olive oil over medium-high heat. Pat dry the chicken pieces and sprinkle with salt.', 'Working in batches, brown the chicken pieces, placing the pieces skin-side down first; this will render out fat you will use to build the stew later.', '3 Poach the chicken in the stock: Once the chicken pieces are browned on all sides, remove them from the large pot, and turn off the heat. Remove and discard the skin from the chicken pieces and put the chicken pieces into the pot of simmering stock.', 'Poach the chicken in the stock until cooked through, about 20 minutes or so.', 'Remove the chicken pieces and set on a tray to cool for a few minutes. When the chicken pieces are cool to touch, pull the meat off the bones and cut into 2-inch chunks. Set aside.', '4 Cook the vegetables until softened: Return the heat on the large pot to medium-high. When the pot is hot, add the onion, celery, carrot and thyme and saut\\xc3\\xa9 until soft, but not browned, about 4 to 5 minutes.', '5 Add the flour and stir well. The flour will absorb the fat in the pot and will stick a little to the bottom. Reduce the heat to medium-low and stir the flour vegetable mixture constantly for 2 to 3 minutes. Do not let it burn.', '6 Add sherry, slowly add stock: Get a ladle ready and have the pot of simmering chicken stock nearby. Add the sherry to the flour vegetable mixture. It will sputter and seize up.', 'Add a ladle of hot chicken stock to and stir well. It will be goopy. Add another ladle, then another, stirring all the while, until the broth comes together.', 'Add the rest of the chicken stock and the reserved chicken meat. Increase the heat and bring to a simmer, then reduce the heat to maintain a gentle simmer while you make the dumplings.', '7 Make the dumpling batter: Whisk together flour, baking powder, and salt in a medium bowl. Add (optional) chopped fresh herbs. Add melted butter and milk to the dry ingredients.', 'Gently mix with a wooden spoon until mixture just comes together. (Note: do not over-mix or your dumplings will turn out too dense.)', '8 Add dumplings to the stew: Drop dumpling batter into the simmering stew by heaping teaspoonfuls, over the surface of the stew. (Note that the dumplings will easily double in size as they cook.) Cover and simmer until dumplings are cooked through, about 15 minutes.', 'Once you have covered the pan, do not uncover and peek while the dumplings are cooking! In order for the dumplings to be light and fluffy, they must steam, not boil. Uncovering the pan releases the steam.', 'If after 15 minutes the dumplings are still not cooked through (use a toothpick or skewer to test), then cover pan again and cook for another 5 to 10 minutes.', '9 Finish the stew: Gently stir in peas, parsley, and cream, if using. Add more salt to taste. Ladle portions of meat, sauce, vegetables, and dumplings into soup plates and serve. Note that the stew will continue to thicken the longer it sits.']",17
1392,Spicy Vegetarian Chili Recipe,20,70,90,"['1 1-pound (450g) eggplant, cut into 1-inch cubes', '5 tablespoons extra virgin olive oil', '2 yellow onions, chopped', '3 cloves garlic, minced', '2 medium zucchini, chopped', '2 large red bell peppers, cored, seeded, diced', '1 to 2 jalape\\xc3\\xb1o peppers, seeded, finely minced (Taste and check the heat of the jalape\\xc3\\xb1os. If very hot only use one, if mildly hot, use two. Wash hands with soap and water after handling. Do not rub eyes.)', '1 28-ounce (794g) can Italian plum tomatoes, coarsely chopped, including liquid (or 2 pounds fresh plum tomatoes, peeled and chopped)', '1 tablespoon ground cumin', '1-2 tablespoons chili powder', '2 tablespoons chopped fresh chopped oregano or 2 teaspoons dried', '1 teaspoon fennel seeds', '1 1/2 cup cooked white beans (1 15-ounce or 425g can), drained and rinsed', '1 1/2 cup cooked kidney beans (1 15-ounce or 425g can), drained and rinsed', 'Zest of one lemon', '3 Tbsp lemon juice', '1 teaspoon sugar (use raw, beet, or coconut sugar for vegan version)', '1/3 cup chopped fresh cilantro (can sub parsley if you have an aversion to cilantro)', 'Salt and freshly ground black pepper to taste']",19,"['1 Roast the cubed eggplant: Preheat oven to 350\\xc2\\xb0F (175\\xc2\\xb0C). Scatter eggplant cubes in a shallow roasting pan and slather with 2 tablespoons of olive oil. Cover the pan with aluminum foil and bake for about 30 minutes, stirring once during the cooking. Remove from the oven and set aside.', '2 Saut\\xc3\\xa9 the onions, garlic, peppers: While the eggplant is roasting, start on the rest of the vegetables. In a large (5-6 quart) thick-bottomed Dutch oven, heat 3 tablespoons of olive oil on medium heat. Add the onions and cook until translucent, about 4 minutes. Add the garlic and cook until fragrant, about a minute more.', 'Add the red bell peppers, zucchini, and jalape\\xc3\\xb1o chili peppers. Cook for about 5 more minutes, stirring occasionally.', '3 Add the tomatoes, spices, chili, and roasted eggplant: Add the tomatoes to the pot along with any liquid that may have been in the can (if using canned). Add oregano, cumin, and fennel seeds. Add chili powder to desired heat. Stir in the eggplant cubes (carefully as to not break them up), and simmer for 20 minutes over low heat.', '4 Add the beans, lemon, sugar, cilantro, salt, pepper: Add the white beans and kidney beans, lemon zest, lemon juice, sugar, and chopped cilantro. Add salt and freshly ground pepper to taste. Simmer for 5 minutes.', '5 Serve with garnishes: Serve with sour cream, grated cheddar cheese, and chopped green onions.']",6
1393,Jamaican Goat Curry Recipe,30,180,210,"['1/4 cup vegetable oil', '6-8 Tbsp curry powder', '1 Tbsp allspice (see step 1)', ""3 pounds goat (can use lamb or beef if you can't find goat)"", 'Salt', '2 onions, chopped', '1-2 habanero or Scotch bonnet peppers, seeded and chopped', 'A 2-inch piece of ginger, peeled and minced', '1 head of garlic, peeled and chopped', '1-2 15-ounce cans coconut milk', '1 15-ounce can of tomato sauce or crushed tomatoes', '1 Tbsp dried thyme', '3-4 cups water', '5 Yukon gold potatoes, peeled and cut into 1-inch chunks']",14,"['1 Make the curry powder: If you can find Jamaican curry powder, definitely use it. If not, use regular curry powder and add the allspice to it. You will need at least 6 tablespoons of spices for this stew, and you can kick it up to 8-9 depending on how spicy you like it.', '2 Cut and salt the goat meat: Cut the meat into large chunks, maybe 2-3 inches across. If you have bones, you can use them, too. Salt everything well and set aside to come to room temperature for about 30 minutes.', '3 Heat the curry powder in oil: Heat the oil in a large pot over medium-high heat. Mix in 2 tablespoons of the curry powder and heat until fragrant.', '4 Brown meat in curried oil: Pat the meat dry and brown well in the curried oil. Do this in batches and don\\xe2\\x80\\x99t overcrowd the pot. It will take a while to do this, maybe 30 minutes or so. Set the browned meat aside in a bowl. (When all the meat is browned, if you have bones, add them and brown them, too.)', '5 Cook onions, habanero, ginger, garlic: Add the onions and habanero to the pot and saut\\xc3\\xa9, stirring from time to time, until the onions just start to brown, about 5 minutes. Sprinkle some salt over them as they cook. Add the ginger and garlic, mix well and saut\\xc3\\xa9 for another 1-2 minutes.', 'Put the meat (and bones, if using) back into the pot, along with any juices left in the bowl. Mix well.', '6 Add coconut milk, tomatoes, curry powder, water, thyme, then simmer: Pour in the coconut milk and tomatoes and 5 tablespoons of the curry powder. Stir to combine. If you are using 2 cans of coconut milk, add 3 cups of water. If you\\xe2\\x80\\x99re only using 1 can, add 4 cups of water. Add the thyme.', 'Bring to a simmer and let it cook until the meat is falling-apart tender, which will take at least 2 hours. Longer if you have a mature goat.', '7 Add potatoes: Once the meat is close to being done \\xe2\\x80\\x93 tender but not falling apart yet \\xe2\\x80\\x93 Add the potatoes and mix in. The stew is done when the potatoes are. Taste for salt and add some if it needs it.', '8 Skim fat: You might need to skim off the layer of fat at the top of the curry before serving. Do this with a large, shallow spoon, skimming into a bowl. Also, be sure to remove any bones before you serve the curry.', 'The stew is better the day after, or even several days after, the day you make it.', 'Serve with Jamaican rice and peas, a coconut rice with kidney beans.']",12
1394,Turkey Stew with Peppers and Mushrooms Recipe,15,30,45,"['4 tablespoons extra virgin olive oil', '1 large onion, sliced, abut 2 cups', '2-4 bell peppers of various colors, sliced thinly', '2 large cloves garlic, minced', 'A few dashes cayenne pepper', '1 tablespoon paprika', '1 1/2 to 2 pounds skinless, boneless turkey thigh or breast, cut into large chunks', '4 ounces mushrooms, sliced', '1 14-ounce can of plum tomatoes with juice', '1 tablespoon Worcestershire sauce', '1 tablespoon lemon juice', '1 teaspoon fresh rosemary, minced', 'Freshly ground black pepper to taste', 'Salt', '2 teaspoons cornstarch', '3/4 cup plain (full fat is best, anything less will likely curdle*) yogurt', ""*To help prevent curdling, don't skip the cornstarch, use full fat yogurt, and add to dish only when the sauce has cooled below a simmer.""]",17,"['1 Saut\\xc3\\xa9 the onions, peppers, garlic with paprika: Heat 2 tablespoons of the olive oil on high heat in a large saut\\xc3\\xa9 pan. Add the onions and peppers and saut\\xc3\\xa9 them until they begin to soften and lightly brown.', 'Add the paprika, and the garlic and cook for 30 seconds more, until the garlic is fragrant. Remove the peppers, onions, and garlic from the pan and set aside.', '2 Saut\\xc3\\xa9 mushrooms and turkey, return peppers and onions to pan: Heat the remaining 2 tablespoons of oil over high heat. Add the mushrooms and the turkey to the pan. Sear the mushrooms and turkey over high heat, stirring often, for 3-4 minutes, until the turkey and mushrooms begin to brown.', 'Reduce the heat to medium, return the peppers-and-onion mixture to the pan and mix well.', '3 Add tomatoes, Worcestershire, lemon juice, rosemary, black pepper: Squeeze the tomatoes to break them up, and add them with their juices to the pan, along with the Worcestershire sauce, lemon juice, rosemary and black pepper. Mix well, reduce the heat to medium-low, cover the pan and simmer for 15-20 minutes.', '4 Add yogurt with cornstarch: Stir the cornstarch into the yogurt and add to stew. Cook over low heat (do not let simmer or boil), stirring occasionally, until sauce thickens a little.', 'Serve with rice, polenta, or mashed potatoes.']",7
1395,Stewed Okra and Tomatoes Creole Style Recipe,15,45,60,"['2 ounces bacon, sliced crosswise into 1/4-inch wide slices (lardons)', '1 cup diced onion (about 1 medium onion)', '1 cup diced bell pepper (about 1 bell pepper)', '1/2 cup diced celery (about one rib)', '1 teaspoon chopped garlic (about 1 clove)', '1 teaspoon kosher salt', '1 15-ounce can of whole peeled tomatoes and their juices', '1 pound (16-ounces) of frozen or fresh okra, whole or thickly sliced, trimmed of tough tops if whole, defrosted if frozen', '1/2 teaspoon black pepper', '1 teaspoon fresh thyme', '1 pinch of cayenne', '1 pinch cinnamon', '1 scant pinch of ground cloves (watch it on the ground cloves, a little goes a long way, and you can easily overdo it!)', '1/2 cup water']",14,"['1 Cook bacon lardons until lightly browned: Place the bacon lardons in a thick-bottomed pot (3 or 4 quart). Heat on medium and cook until the bacon is lightly browned and much of the fat has rendered out.', '2 Add onions, celery, bell pepper, then garlic: Once bacon has browned, add the onions, celery, and bell pepper. The bacon should have rendered enough fat to cook the vegetables, but if not, add a tablespoon of olive oil to the pot.', 'Cook over medium high heat until onions, celery, and bell peppers are lightly browned, about 8-10 minutes.', 'Add the garlic and cook for a minute more.', '3 Add remaining ingredients, water, then simmer: Add the tomatoes, okra, and salt to the pot. Add the black pepper, cayenne, thyme, cinnamon, and cloves. Stir to combine.', 'Add 1/2 cup of water.', 'Cover and simmer for 20 to 25 minutes.', 'Add more salt and pepper to taste.']",8
1396,Sustenance Stew with Sweet Potatoes and Swiss Chard Recipe,20,30,50,"['For the cauliflower rice:', '2 medium heads cauliflower, cut into florets (See How to Cut and Core Cauliflower)', '1/4 cup (60ml) extra-virgin olive oil', '1 teaspoon salt, plus more to taste', 'For the stew:', '1 tablespoon grapeseed oil or extra-virgin olive oil', '1 medium yellow onion, roughly chopped', '2 teaspoons minced garlic (about 2 cloves)', '3 cups (720ml) vegetable broth', '2 (14.5-ounce/411g) cans whole tomatoes with their juice', '1 1/2 tablespoons minced fresh ginger', '1/4 teaspoon red pepper flakes', '4 cups (570g) peeled and roughly diced orange-flesh sweet potatoes', '3 cups (210g) chopped broccoli florets', '4 cups (120g) Swiss chard, stalks removed, leaves cut into ribbons (about 1 large bunch)', '1/3 cup (43g) roasted almond butter', '1/2 cup (14g) loosely packed finely chopped cilantro', '1 medium avocado, pitted, peeled, and sliced', '1/2 cup (80g) sliced raw almonds', 'Optional Boosters:', '1/4 cup (35g) shelled hemp seeds', '1 tablespoon chia seeds (black or white)', '1/4 cup (10g) pea greens', 'Special equipment:', 'Blender']",25,"['1 Make the cauliflower rice: Preheat the oven to 375\\xc2\\xb0F (180\\xc2\\xb0C). Line a large baking sheet with a silicone liner or parchment paper.', 'Put the cauliflower florets in a food processor and pulse about 5 times, until the cauliflower has the texture of couscous. You may have to process in two batches. Transfer the cauliflower to a large bowl and stir in the oil and 1 teaspoon of salt until well combined.', 'Transfer the \\xe2\\x80\\x9crice\\xe2\\x80\\x9d to the prepared baking sheet and bake for 15 minutes. Stir with a spatula', 'or wooden spoon and continue to roast for another 15 minutes, until the \\xe2\\x80\\x9crice\\xe2\\x80\\x9d begins to brown. Set aside until ready to serve.', '2 Make the stew: In a large pot over medium heat, warm the oil and saut\\xc3\\xa9 the onion and garlic with a pinch of salt for about 5 minutes, until the onion is soft and translucent.', 'Meanwhile, add the broth, tomatoes, ginger, and red pepper flakes to your blender and pulse a few times on low until rustically chopped and combined but not blended. Stir this broth mixture along with the chopped sweet potatoes in with the saut\\xc3\\xa9ed onion.', '3 Simmer the stew: Increase the heat to high and bring the mixture to a boil. Lower the heat to medium, add 1/2 teaspoon of salt, and simmer, uncovered and stirring occasionally, for about 15 minutes, until the sweet potato is just tender.', '4 Finish the stew: Add the broccoli and simmer for another 5 minutes. Stir in the chard and almond butter and simmer for another 5 minutes, until the chard is just wilted.', 'The broth should be absorbed and you should have a creamy vegetable dish. Stir in the cilantro and tweak the salt to taste.', '3 Serve the stew: To serve, spoon equal amounts of the cauliflower rice into bowls and spoon the stew next to or over the \\xe2\\x80\\x9crice.\\xe2\\x80\\x9d Top with the avocado and sliced almonds and sprinkle with the hemp seed and chia seed boosters. Finish by topping with the pea greens booster.']",10
1397,Braised Turkey Legs Recipe,10,120,130,"['2 turkey legs and 2 thighs, about 4 lbs', '1 tablespoon extra virgin olive oil', '1 cup finely chopped yellow onion', '1 cup of finely chopped celery', 'Salt, pepper, and cayenne', '2 cups water or other braising liquid (dry white wine or stock)', 'Cornstarch', 'Parsley, chopped, about 1/4 cup', 'Optional 3 cups chopped or quartered potatoes, carrots, turnips, rutabagas, and/or parsnips']",9,"['1 Brown turkey legs and thighs: Sprinkle turkey thighs and legs with salt and pepper. Heat 1 Tbsp olive oil in a large saut\\xc3\\xa9 pan with high sides on medium high heat. Add the turkey legs and thighs to the pan and sear until browned on all sides, about 5-8 minutes.', '2 Add chopped onion and celery to form a nest under the turkey pieces. Saut\\xc3\\xa9 an additional 5 minutes.', '3 Braise until tender: Add 2 cups of braising liquid - either water, stock, wine, or a combination. Bring to a simmer. Lower the heat and cover. Simmer covered, on low heat, for an hour and a half, or until the turkey is so well cooked and tender that the meat easily falls off of the bones.', '4 Remove the turkey meat from the pan and remove the bones, taking special care to remove the many small narrow bones of the legs. Remove the skin.', '5 Cook the potatoes and root vegetables (optional): Add the vegetables to the pan with the turkey braising liquid. Sprinkle with salt and pepper. Bring to a simmer on medium high heat. Lower the heat and cover the pan. Cook covered, until done, about 20 minutes. When done, remove the vegetables from the pan so you can reduce the remaining liquid to make a sauce.', '6 Make the sauce: Increase the heat to high and bring the remaining liquid in the pot to a boil. Reduce the liquid remaining in the pan by half to intensify some of the meat juices for added flavor.', 'Take a teaspoon of cornstarch and dissolve in a 1/2 cup of water. Add cornstarch mixture a little at a time to sauce, adding more liquid, until the sauce achieves the desired body.', 'Adjust seasoning. Add salt and pepper if needed, add a little cayenne or Tabasco sauce. If the sauce is too sweet, add a little vinegar or lemon. Add parsley.', '7 Add the turkey and vegetables back to the pan with the sauce. Serve immediately over rice or bread or with the vegetables if you have chosen to make them.']",9
1398,Eggplant Green Curry Recipe,10,20,30,"['Vegetable oil', '2 Japanese eggplants, cut into bite-sized pieces', '1 red bell pepper, seeded, sliced into sticks', '1 can of bamboo shoots', '2 1/2 tablespoons green curry paste', '1 can coconut milk', '3 makrut lime (kaffir lime) leaves', '1 lemongrass stalk, cut into three pieces and bruised', '1 tablespoon fish sauce', '1 tablespoon brown sugar', '1/4 cup Thai Basil or Sweet Basil leaves', '1-3 Thai chilies, depending on your heat preference', 'Lime for garnish (optional)']",13,"['1 Stir-fry the eggplant: Place a tablespoon of vegetable oil in a wok or deep pan over high heat. Add eggplant and stir-fry until skin becomes lightly brown and blistered, and the eggplant insides begin to soften and get a slight sear, about 3 to 4 minutes.', ""The eggplant will absorb the oil, if some of the eggplant pieces don't get any, add a little more oil."", 'Remove from heat and set aside in a bowl.', '2 Heat curry paste, add half of the coconut milk: Place another tablespoon of vegetable oil in the wok heat over medium heat. Add the curry paste - be careful, as it will cause the oil to spit - and saut\\xc3\\xa9 over medium heat until fragrant, about 20 to 30 seconds.', 'Add half of the coconut milk and mix, simmer for 2 to 3 minutes.', '3 Add the lemongrass, makrut lime leaves, fish sauce, brown sugar, and remaining coconut milk and bring to a boil.', '4 Add the bamboo shoots, cooked eggplant, and bell pepper. Cook for 4 to 5 minutes until softened a bit.', '5 Stir in basil and chilies and remove from heat.', 'Serve over rice with lime wedges on the side.']",9
1399,Easy Vegetable Fried Rice Recipe,15,15,30,"['3 tablespoons vegetable oil, divided', '1 cup chopped broccoli (crowns and stems)', '1 cup chopped carrots', '1 cup shredded cabbage', '1 cup diced zucchini', '1/2 cup thinly sliced bell pepper, cut into 1-inch pieces', '1 cup frozen shelled edamame or peas', '3 large eggs, beaten', 'Salt and freshly ground pepper to taste', '3 cups cooked and cooled white or brown rice', '1 tablespoon peeled and minced fresh ginger', '2 teaspoons finely minced garlic', '1/4 cup low-sodium soy sauce, plus more for serving or 3 tablespoons regular soy sauce and 1 tablespoon water, plus more for serving', '1 tablespoon sesame oil (regular or spicy)', '1/2 cup thinly sliced scallions, white and light green parts, plus more for garnish', 'Special equipment:', 'Wok or large skillet']",17,"['1 Cook the veggies: Heat a wok or a large skillet over high heat until very hot. Add 1 tablespoon of oil, and then the broccoli, carrots, cabbage, zucchini, peppers, and edamame.', ""Stir often until the vegetables are crisp-tender, about 4 minutes (they will get another few minutes to cook at the end of the stir fry so it's ok if they're still crunchy right now). Transfer them to a plate and set aside."", '2 Scramble the eggs: Season the beaten eggs with a little salt and pepper. Heat 1 more tablespoon of oil in the same wok or skillet over high heat. Add the beaten eggs and scramble quickly, just about 1 minute. When they are just cooked through, slide them out onto the plate with the vegetables.', '3 Stir fry the rice: Return the wok to the burner over high heat, add the remaining tablespoon of oil, then add the cooled rice . Stir fry, stirring occasionally, until it is lightly browned in spots, about 5 minutes.', ""Add the ginger and the garlic to the rice, and stir until they're fragrant, about 1 minute. Add the soy sauce, sesame oil, and 1/2 cup scallions."", '4 Finish the stir fry: Return the vegetables and eggs to the wok with the rice. Cook, stirring often, until everything is combined and hot and the vegetables are just tender, about 3 minutes. Taste and adjust the seasonings with salt and pepper, if needed.', '5 Garnish and serve: Sprinkle the additional scallions over the top, and serve right away, passing soy sauce on the side for those who want a bit more.']",7
1400,Mushroom Stir Fry with Peas and Green Onions Recipe,15,15,30,"['Glaze', '1/4 cup chicken or vegetable stock (use vegetable stock for vegetarian option)', '1 tablespoon honey', '1 teaspoon soy sauce (use gluten-free soy sauce if cooking gluten-free)', 'Sauce', '1/2 cup chicken or vegetable stock (use vegetable stock for vegetarian option)', '3 tablespoons soy sauce (use gluten-free soy sauce if cooking gluten-free)', '1/4 cup honey', '1 tablespoon rice vinegar', '1 tablespoon shaoxing cooking wine or cooking sherry', '1 tablespoon cornstarch', 'Stir-Fry', '4 garlic cloves, sliced thinly', '1 tablespoon grated ginger', '2-5 dried red chilies, roughly chopped OR 1/4-1/2 teaspoon dried chili flakes', '3 tablespoons sesame, grapeseed, or other high smoke-point oil', '2 lbs. of mixed mushrooms (oyster, crimini, button, shiitake, and/or enoki), roughly chopped or quartered (you want bite-sized pieces)', '1 1/2 cups of snow peas or snap peas, de-stringed', '8 green onions, chopped', 'Toasted sesame seeds (optional)']",20,"['1 Make the glaze and the sauce: Make the glaze by whisking together the stock, honey, and soy sauce in a bowl and set aside. Make the sauce by whisking together the stock, soy sauce, honey, rice vinegar, cooking wine or sherry, and the cornstarch in a bowl and set that aside as well.', '2 Saut\\xc3\\xa9 mushrooms, add glaze: Place 1 tablespoon of oil in a large skillet or a wok over high heat. When the oil is glistening and a bead of water evaporates in under a second, add the mushrooms and toss.', ""Allow the mushrooms to cook for a few minutes until they start to squeak and give up their water (you'll see their water in the pan). When they do add the glaze. Allow the glaze to boil off, stirring occasionally, about 5-6 minutes."", ""When barely any more liquid remains take the mushrooms off the heat and set them aside in a bowl. There may be bits of sugar caramelized to the side of the pan, don't fret about it."", '3 Cook garlic, ginger, chilies: Reduce the heat to medium and add the remaining 2 tablespoons of oil. Add the garlic, ginger, and chilies and cook until fragrant, about 30 seconds.', '4 Add snow peas and onions: Add the snow peas and green onions and toss for about 30 more seconds.', '5 Add back mushrooms: Increase heat to high. Add the sauce and allow the mixture to come to a boil. The sauce will thicken considerably.', 'Add the mushrooms back to the mixture and cook for about 20 more seconds. Take off the heat.', 'Serve over rice and garnish with sesame seeds if using.']",9
1401,Teriyaki Chicken Lettuce Wraps Recipe,10,25,35,"['For the teriyaki sauce:', '1/4 cup (60 ml) low-sodium soy sauce (or tamari, for gluten-free)', '3 tablespoons water, divided', '2 tablespoons mirin', '2 tablespoons honey', '2 medium cloves garlic, minced', '1 teaspoon grated fresh ginger', '1 teaspoon cornstarch', 'For the chicken filling:', '2 tablespoon olive oil, divided', '1/2 cup diced red onions (1/4 of a large red onion, or 1/3 of a small one)', '1 pound (450 g) ground chicken', 'Kosher salt', '1 medium zucchini, diced', '1 medium red bell pepper, seeded and diced', '1 scallion, thinly sliced', '1/2 teaspoon sesame oil', 'For serving:', '1 head butter lettuce, leaves separated and rinsed', 'Roasted peanuts, chopped', 'Chopped cilantro', 'Thinly sliced scallions']",22,"['1 Prepare the teriyaki sauce: Combine the soy sauce, 2 tablespoons of the water, mirin, honey, minced garlic, and grated ginger in a saucepan. Bring everything to boil over medium heat.', 'Dissolve the cornstarch with the remaining tablespoon of water and add to the teriyaki sauce. Reduce heat to medium-low, and let the sauce simmer until it starts to thicken, about 30 seconds to a minute.', 'Turn off the heat and allow the sauce to cool. The sauce will thicken a little more as it cools. You should have about 1/2 to 3/4 cup of sauce.', '2 Cook the chicken: Heat 1 tablespoon of olive oil in a saut\\xc3\\xa9 pan over high heat. Add half of the diced red onions and cook until they start to soften, about 2 minutes. Add ground chicken and a pinch of kosher salt. Using your spatula, break up chicken into smaller pieces. Stir occasionally until the chicken is cooked through, 5 to 7 minutes. Transfer the chicken to a clean plate.', '3 Cook the vegetables: Quickly wipe down the pan and heat another tablespoon of olive oil over medium heat. Add the remaining diced red onions and cook until they soften, about 2 minutes. Add the zucchini and red pepper, and cook, stirring occasionally, until the peppers start to soften, 3 to 4 minutes. Stir the sliced scallions and cooked chicken into the pan with the cooked vegetables.', '4 Add the teriyaki sauce: Drizzle 6 tablespoons of the prepared teriyaki sauce and 1/2 teaspoon sesame oil into the pan and stir. Save the rest of the teriyaki sauce for drizzling over wraps. Turn off heat, taste, and adjust seasonings if needed.', '5 To serve: Place several spoonfuls of filling onto a lettuce leaf. Top with chopped peanuts, cilantro, scallions, and an extra drizzle of teriyaki sauce, if desired. Leftover teriyaki sauce will keep for about a week in the refrigerator.']",7
1402,Baby Bok Choy with Cashews Recipe,10,5,15,"['2 Tbsp extra virgin olive oil', '1 cup chopped green onions, including green ends', '3 cloves garlic, chopped', '1 pound baby bok choy, rinsed, larger leaves separated from base, base trimmed but still present, holding the smaller leaves together', '1/2 teaspoon dark sesame oil', 'Salt', '1/2 cup chopped, roasted, salted cashews']",7,"['1 Saut\\xc3\\xa9 onions, garlic, bok choy: Heat olive oil in a large saut\\xc3\\xa9 pan on medium high heat. Add onions, then garlic, then bok choy. Sprinkle with sesame oil and salt.', '2 Cover, and let the baby bok choy cook down for approximately 3 minutes. (Like spinach, when cooked, the bok choy will wilt a bit.)', '3 Remove cover. Lower heat to low. Stir and let cook for a minute or two longer, until the bok choy is just cooked.', '4 Gently stir in the roasted cashews.']",4
1403,Seared Sugar Snap Peas Recipe,15,10,25,"['2 tablespoons extra virgin olive oil', '1 pound sugar snap peas, strings removed', '3-4 scallions or green onions, sliced on the diagonal', 'Salt', 'A pinch of sugar', 'Zest of a lemon', '3 tablespoons chopped fresh mint', 'Black pepper to taste', 'Lemon juice to taste']",9,"['1 Saut\\xc3\\xa9 sugar peas: Heat a large saut\\xc3\\xa9 pan on high heat for 1 minute. Add the olive oil to the hot pan and heat it until it shimmers, about 1-2 minutes. Add the sugar peas and toss to coat with the oil. Sprinkle salt over them and toss again. Allow to cook, undisturbed, for 1 minute.', '2 Add green onions and sugar: Add the green onions and sprinkle with a pinch of sugar. Toss to combine. Let cook for 1 minute. Toss and cook untouched again, this time leaving everything undisturbed for 2 minutes.', '3 Turn off the heat, mix in the lemon zest and mint, then add black pepper and lemon juice to taste. Serve at once.']",3
1404,Sichuan Style Stir-Fried Chinese Long Beans Recipe,5,10,15,"['1/2 pound Chinese long beans, trimmed and cut into 3 inch segments', '1 tablespoon peanut oil', '4-6 dried chilies, preferably Sichuanese, roughly chopped', '1 teaspoon whole Sichuan peppercorns, lightly crushed', '1/4 teaspoon salt', '1/2 teaspoon sugar', '3 teaspoons sesame oil', 'Splash of soy sauce (use gluten-free soy sauce for gluten-free option)']",8,"['1 Add a tablespoon of peanut oil to a wok or a large saut\\xc3\\xa9 pan over medium heat and swirl until hot. Add chilies and peppers and stir-fry briefly until fragrant.', ""2 Add the long beans and stir-fry vigorously for 3-4 minutes (you don't want the spices to burn, if they start to then turn down the heat a bit). Season with salt and sugar and stir-fry a few seconds more to mix it all together."", '3 Remove from heat. Stir in the sesame oil and soy sauce. Serve immediately.']",3
1405,Chicken Mango Lettuce Wraps Recipe,10,15,25,"['1 pound ground chicken (I use ground chicken thighs for more flavor)', '2 teaspoons soy sauce (use gluten-free soy sauce if cooking gluten-free)', '1 teaspoon cornstarch (or potato or rice starch)', '1 teaspoon cooking oil (peanut oil or canola)', '2 green onions, chopped', '4 ounces fresh shiitake mushrooms, sliced', '2 teaspoons seasoned rice vinegar', '1/2 teaspoon toasted sesame oil', '1 large mango, diced (see How to Cut a Mango)', '1 head of butter lettuce, rinsed, leaves separated']",10,"['1 Place the ground chicken, soy sauce, and cornstarch in a large bowl. Mix to combine.', '2 Saut\\xc3\\xa9 shiitake mushrooms and green onions: Heat a wok or a large saut\\xc3\\xa9 pan on medium heat.  Once the pan is hot, add the oil. Add the green onions and sliced shiitakes. Let cook for about a minute.', '3 Add chicken mixture: Increase the heat to high, and add the ground chicken, soy sauce, cornstarch mixture.  Use a wooden spoon to break up the ground chicken and spread around the pan.  Stir fry in this way for 5 to 7 minutes until the chicken is cooked through.', '4 Add seasonings and mango: Add the seasoned rice vinegar, sesame oil, and diced mango.  Remove from heat. Adjust seasonings (rice vinegar, sesame oil, soy sauce) to taste.', '5 Scoop spoonfuls into the cups formed by the lettuce leaves to serve.', 'Options - stir in a small spoonful of chili sauce, or add a few chili pepper flakes to the oil as it is heating. Top with some fresh cilantro leaves. Experiment with other meats such as lamb, turkey, beef, or pork. Try subbing out the mango with mandarin orange slices.']",6
1406,Summer Squash Green Chile Stir Fry Recipe,10,15,25,"['1 tablespoon extra virgin olive oil', '1 cup coarsely chopped red onion', '1 large green chile (Anaheim, Hatch, or Poblano), seeded and chopped', '1 large pinch ground cumin', '2 cloves garlic, minced', '2 cups chopped zucchini and/or yellow summer squash (about 12 ounces)', '1/2 cup fresh or frozen corn (fire roasted frozen corn works great)', '1 small tomato, diced', '1 large pinch dried oregano', '3/4 teaspoon salt', '1/4 cup chopped cilantro', 'Juice of half a lime']",12,"['1 Saut\\xc3\\xa9 onions, green chiles, garlic, cumin in olive oil: Heat olive oil on medium high heat in a large, relatively stick-free skillet (recommend cast iron or hard anodized aluminum).', 'Add onions and chiles and saut\\xc3\\xa9 until softened and slightly browned, about 3 to 4 minutes.', 'Add the garlic and cumin, and cook a minute more.', '2 Add zucchini and summer squash: Add the zucchini and summer squash. Continue to cook on medium high heat for another 3 to 4 minutes.', '3 Add corn, tomatoes, oregano, salt: Once the squash has begun to cook and the pieces no longer have that raw look to them, add the corn and the tomatoes.', ""Note you don't want to over-cook the squash. If you do, it will start releasing a lot of water and become mushy. So you want to add the corn and tomatoes while squash is still firm, but just barely cooked."", 'Sprinkle with oregano and salt. Cook for another minute or two.', 'Serve immediately. Garnish with cilantro and lime.']",8
1407,Three Teacup Chicken Recipe,5,15,20,"['1/4 cup soy sauce (use gluten-free soy sauce for gluten-free version)', '1/4 cup rice vinegar', '1/4 cup sugar', '1 1/2 Tablespoons Shaoxing wine or dry sherry', '1 Tablespoon sesame oil', '6 garlic cloves, smashed', '8 1/4-inch-thick slices of peeled ginger', '6 scallions, chopped', '1 teaspoon Sichuan peppercorns or 1 diced red chili pepper(optional)', '2 lbs. chicken breast or thighs cut into bite-sized pieces', '2 star anise or pinch of anise seed (optional)', '1/2 cup water']",12,"['1 Make the braising liquid: In a bowl combine the soy sauce, rice vinegar, sugar, and Shaoxing wine together and mix well. Set aside.', '2 Saut\\xc3\\xa9 garlic, ginger, scallions, peppercorns: Heat a wok or large saut\\xc3\\xa9 pan on high heat until a drop of water will evaporate within 1-2 seconds. Place the oil in the wok and swirl. Add the garlic, ginger, scallions, and Sichuan peppercorns/chili pepper if using and stir-fry for 30 seconds or until fragrant.', '3 Add the chicken and stir-fry until no pink on the surface remains (you just want to sear the outside nicely).', '4 Add the braising liquid and star anise or anise seed if using and cook for 1 minute ensuring that the chicken is well coated in the braising liquid.', '5 Add the water and cover and cook for 4 more minutes or until the chicken is cooked through and no pink remains.', '6 Serve immediately over rice with hearty amounts of the broth. Garnish with a little extra chopped scallion.']",6
1408,Cauliflower Fried \xe2\x80\x9cRice\xe2\x80\x9d Recipe,30,15,45,"['8 ounces extra firm tofu, cut into 1/2-inch cubes', '1/2 teaspoon sesame oil, divided', '1/4 teaspoon white pepper, divided', '1/2 teaspoon kosher salt, divided', '1 head cauliflower (about 2 1/2 pounds)', '2 tablespoons vegetable oil, divided', '2 large eggs, whisked', '1 teaspoon minced garlic', '1 teaspoon minced ginger', '1/4 cup finely diced red onion', '1/2 cup carrots, 1/4-inch dice', '1/2 cup red bell pepper, 1/4-inch dice', '1/2 cup peas, frozen and defrosted', '1 tablespoon soy sauce', '2 tablespoons green onions, thinly sliced']",15,"['1 Prepare the tofu: Line a sheet pan with paper towels. Spread the tofu in an even layer on the paper towel, then place another paper towel on top, lightly press to soak up excess moisture.', 'After 15 minutes and when the cubes feel dry on the surface, transfer the tofu to a bowl and toss with 1/4 teaspoon sesame oil, 1/8 teaspoon white pepper, and 1/4 teaspoon kosher salt.', '2 Make the cauliflower rice: Use a knife to remove the outer leaves and cut the cauliflower florets from the stem. Cut florets into 1- to 1 1/2-inch sized pieces.', 'Add half of the florets to a food processor. Pulse 5 times in 1-second increments until pieces the size of cooked rice are formed. Scrape down the sides of the bowl as needed. Transfer to a large bowl. Remove any large floret pieces that do not get processed and process them with the next batch.', 'Repeat with processing the remaining cauliflower florets. When finished with both batches, you should have about 5 to 6 cups of cauliflower rice.', '3 Cook the tofu: Heat a wok or large skillet over medium-high heat. Once hot add 1 tablespoon of vegetable oil. Carefully add the seasoned tofu in a single layer, cook for 3 minutes, stirring every minute. The tofu should be lightly browned on the surface. Transfer tofu to a plate.', '4 Scramble the eggs: Add the whisked eggs to the wok, use a quick stirring motion to cook and break the eggs into small scrambled pieces. Transfer eggs to the plate with the tofu.', '5 Stir-fry the vegetables: Add 1 tablespoon of vegetable oil and 1/4 teaspoon of sesame oil to the wok. Add the garlic, ginger, and onions. Stir and cook for 1 minute. Add the carrots and bell peppers, stir-fry for 2 minutes. Add the peas and cook for 1 minute.', '6 Stir-fry the cauliflower rice: Add the cauliflower rice to the wok with the vegetables, stir to combine. Spread into an even layer and allow to cook for 2 minutes without moving. Stir and cook until cauliflower is tender, about 5 minutes.', '7 Add the seasonings: Add the soy sauce and 1/8 teaspoon white pepper, stir to combine. Save a few green onions to garnish the dish and add the remaining green onions to the wok, along with the tofu and scrambled eggs. Stir to combine.', 'Taste the cauliflower fried rice and adjust seasonings as desired. Top with reserved green onions and serve hot.']",11
1409,Easy Pork Fried Rice with Frozen Vegetables Recipe,5,20,25,"['3 cups cooked rice, fresh or frozen', '10 ounces lean pork loin, diced into 1/2-inch cubes', '1/4 teaspoon salt', '1/4 teaspoon black pepper', '1/4 cup vegetable oil, divided', '1/2 white onion, chopped', '2 cloves garlic, minced', '2 inches fresh ginger, minced or grated', '1 cup frozen carrots and peas', '3 large eggs, scrambled', '1 tablespoon soy sauce', 'For the Chili Sesame Oil (Dad Add):', '2 tablespoons toasted sesame oil', '1 teaspoon chili oil', '1/4 teaspoon red pepper flakes', 'Pinch of sesame seeds']",16,"['1 Prepare the rice: If using freshly-cooked rice, spread onto a baking sheet and let cool for 10-15 minutes. You can also stick the rice in the fridge to cool it quickly.', 'If using frozen rice, thaw the rice just enough so the grains can be separated.', '2 Cook the pork: Heat a large skillet or wok over medium-high heat and add a tablespoon of oil. Season the pork cubes with the salt and pepper. Add the pork cubes to the skillet and cook, stirring occasionally, until pork is cooked through, 3-4 minutes. Remove from the skillet.', '3 Cook the vegetables: Pour another tablespoon of oil into the skillet. Add the chopped onion, garlic, and ginger. Cook for a minute until fragrant and then add the frozen carrots and peas. Cook for 2-3 minutes or until the onions have softened and the frozen vegetables are warmed through. Remove from the skillet.', '4 Make the Chili Sesame Oil (optional): While the vegetables cook, in a small bowl stir together the toasted sesame oil, chili oil, red pepper flakes, and sesame seeds. If you have the time, very gently warm this oil mixture in a small pan over low heat for a few minutes. Be careful not to make it so hot that the spices burn.', '5 Finish the fried rice: Add the remaining two tablespoons of vegetable oil to the empty skillet. Turn your heat to medium (your skillet or wok should still be hot), add rice and spread it out in an even layer. Let the rice fry for 1-2 minutes or until it has some color. Then stir the rice, push it to the edges, and form a well in the center of the skillet.', 'Pour the eggs into the well. Let sit for a minute until they begin to cook, then stir just the eggs until they are 90% cooked. Once they are mostly cooked, stir the rice and eggs together to combine, then immediately stir in the cooked pork, vegetables, and soy sauce.', 'Toss or stir to combine well. Garnish with scallions and Chili Sesame Oil if using. Serve immediately.', 'LEFTOVERS! Leftovers will keep in the fridge for 5-7 days and can be reheated in the microwave on high heat until steaming hot. I recommend adding a tablespoon of water to each serving when you microwave it to rehydrate the rice a bit.', 'Once the pork fried rice is cool, you can scoop it into freezer-safe storage bags and store for up to three months.']",10
1410,How to Make Vegetable Stock,15,120,135,"['1 ounce dried mushrooms*', '4 tablespoons extra virgin olive oil', '4 cups chopped onion', '2 cups chopped celery', '3 cups chopped carrot', '1 cup chopped fennel bulb (optional)', 'Salt', '2 large garlic cloves, smashed (can leave skins on)', '1 tablespoon tomato paste', '1 tablespoon fresh rosemary', '2 teaspoons dried thyme', '1 teaspoon black peppercorns', '4 bay leaves', '1/2 cup chopped parsley', '*If you want to use fresh mushrooms instead, use about 5-6 ounces, thickly slice them, and dry saut\\xc3\\xa9 them first in a separate pan, until they are lightly browned and have given up some of their moisture. Then add in with the rest of the vegetables.']",15,"['1 Rehydrate dried mushrooms: Place the dried mushrooms in a large bowl and pour 1 quart of boiling water over them. Set aside.', '2 Brown the onions, celery, carrots, fennel: Heat the olive oil over high heat in a large stockpot. Add the chopped onions, celery, carrots, and fennel (if using) and stir to coat. Sprinkle with salt. Cook over high heat for several minutes, stirring only occasionally.', 'Given that there are so many vegetables, and they have a high moisture content, it may take more heat and longer time to brown than you would expect. Cook until the vegetables begin to brown.', '3 Add garlic and tomato paste: Add the garlic and tomato paste and stir to combine. Cook, stirring often, for 2-3 minutes, or until the tomato paste begins to turn a rusty color.', '4 Add the mushrooms and their soaking water, the rosemary, thyme, onion skins (if using), peppercorns, bay leaves, parsley and 4 additional quarts of water.', 'Bring to a simmer and then drop the heat until you just get a bare simmer. The surface of the stock should just barely be bubbling. Cook for 1 1/2 hours.', '5 Strain the stock: Using a spider skimmer or slotted spoon, remove all the big pieces of vegetable and mushroom. Discard or compost.', 'Set up a large bowl or pot with a sieve set over it. Line the sieve with a paper towel or coffee filter and pour the stock through it.', ""When you have about half the stock poured through, stop, let what's in the strainer filter through, and change the paper towel; the old one will be gunked up with debris. Filter the rest of the stock."", '6 Pour into jars and chill or freeze: To store, pour into glass jars and refrigerate for up to a week, or freeze. If you freeze in glass jars, leave at least an inch and a half of headroom so the stock can expand without breaking the glass of the jar.']",10
1411,Microwave Strawberry Jam Recipe,5,45,50,"['2 1/2 cups hulled and quartered strawberries (from about 1 pound)', '2 teaspoons orange zest', '2 Tbsp lemon juice', '1/2 cup sugar (can reduce to 1/4 cup if you would like your jam less sweet)', 'Special equipment:', 'An 8-cup Pyrex measuring cup OR a large microwave safe bowl (no metal)']",6,"['1 Toss berries with orange zest, lemon juice, sugar: Place the quartered strawberries, orange zest, lemon juice, and sugar in a large microwave-safe bowl (at least 10 cup capacity) or 8-cup Pyrex measuring cup.', 'Gently toss to combine so that the strawberries are well coated with the sugar. Let sit for 30 minutes at room temp to macerate.', '2 Microwave in 5 min intervals: Place bowl with strawberries on a plate (to catch possible overflow) in your microwave oven. Cook on high for intervals of 5 minutes each, gently stirring after each 5 minute interval.', 'In my 1650 Watt microwave, I use 3 intervals of 5 minutes each for a total of 15 minutes. If you have a lower powered microwave, you may need to cook longer, or if you have a higher powered microwave, you may need less time.', ""Pay attention so that the mixture doesn't overflow. If it bubbles up too much and begins to overflow, put the mixture in a larger (microwave safe) bowl and continue."", 'The jam mixture will be ready when the liquid in it thickens slightly and gets syrupy. Because it is hot, it will not be thick like regular jam. As it cools it should thicken.', '3 Pour into jar, let cool, then chill: Pour the hot jam into a jar. Let cool to room temperature then store in the refrigerator.', 'If the jam is too loose and watery even after it has chilled, it may need to be microwaved for several minutes longer.', 'If you want your jam to be shelf stable, use the full amount of recommended sugar (1/2 cup), use sterilized jars and lids, and leave 1/4 inch headspace from the top of the jar. Otherwise, store in the refrigerator, or freeze (leaving an inch headspace in the jar to account for the expansion of the liquid as it freezes into ice).']",9
1412,Strawberry Mousse with White Chocolate Recipe,15,45,60,"['1 \\xc2\\xbd pounds of strawberries', '2 Tbsp fresh lemon juice, divided', '8 ounces white chocolate, finely chopped', '1 \\xc2\\xbc teaspoon unflavored gelatin (about half a small envelope)', '2 cups heavy cream', ""2 Tbsp powdered (confectioner's) sugar""]",6,"['1 Make strawberry pur\\xc3\\xa9e: Clean and hull the strawberries. Starting with about half of the strawberries (3/4 pound), quarter them and pur\\xc3\\xa9e them in either a blender or food processor.', 'Press the pur\\xc3\\xa9e mixture through a mesh sieve with the back of a spoon into a bowl. You want to end up with 1 cup of pur\\xc3\\xa9e.', 'Stir in 1 Tbsp of the lemon juice and set aside.', '2 Slice remaining berries: With the remaining 3/4 pound or so of berries, slice as many as to fill up 2 cups, and set aside.', ""3 Melt the white chocolate: Melt white chocolate in a double boiler, or a stainless steel bowl set over simmering water (make sure the simmering water doesn't actually touch the bottom of the bowl.)"", 'Stir until smooth, set aside.', '', '4 Soften the gelatin: Put 1/4 cup of cold water into a small bowl. Sprinkle the gelatin powder over the water and let sit for 5 minutes.', '', '5 Dissolve gelatin mixture into heated cream and powdered sugar: Put 1/4 cup of the cream into a small saucepan on medium heat. Whisk in 2 tablespoons of the powdered sugar and bring to a simmer. Stir in the water gelatin mixture until dissolved.', '6 Combine with melted chocolate: Pour this mixture into the bowl with the melted white chocolate and whisk until smooth.', '7 Stir in 3/4 cup of the pur\\xc3\\xa9ed strawberries, reserving the remaining 1/4 cup.', '8 Make whipped cream: Using an electric mixer with the whisk attachment, beat the remaining 1 3/4 cup of cream on medium-high speed until medium peaks form. (It helps if your cream is very cold.)', '9 Incorporate whipped cream into mousse base, chill: Stir a  third of the whipped cream into the chocolate mixture.', 'Using a large rubber spatula, gently fold the remaining whipped cream into the mixture.', 'Refrigerate for 1 hour.', '10 Incorporate sliced strawberries into mousse: Stir the remaining 1 Tbsp of lemon juice into the reserved sliced berries. Fold the sliced berries into the mousse.', '11 Spoon mousse into serving cups and refrigerate for at least another hour, preferably several hours, or even over night (cover with plastic wrap).', '12 Top with reserved strawberry pur\\xc3\\xa9e: When you are read to serve the mousse, pour a dollop of the reserved strawberry pur\\xc3\\xa9e onto each serving. Add a few slices of strawberries as garnish.']",19
1413,Strawberry Ice Cream Recipe,45,140,185,"['For the ice cream base', '2 cups heavy cream', '2/3 cup whole milk', '1 vanilla pod, split and seeds scraped, or 1 tsp vanilla extract', 'Pinch salt', '6 egg yolks', '1/2 cup sugar', 'For the strawberry sauce and puree', '1 pound strawberries, hulled and cut into small pieces (with roughly the diameter of a dime)', '3/4 cup granulated sugar', '1 tablespoon lemon juice', 'Special equipment:', 'Immersion blender, or other blender', 'Potato masher', '2-quart ice cream machine']",15,"['1 Freeze the ice cream bowl: Place the ice cream maker churning bowl, plus a separate mixing bowl large enough to contain your custard, in the freezer the day before you want to make ice cream. (Most manufacturers recommend that the churning bowl be frozen for 24 hours before making ice cream; the mixing bowl can go in while you are prepping the custard base.)', '2 Warm the cream, milk, and vanilla: Pour the cream and milk into a medium saucepan set over medium low heat. Scrape the vanilla seeds from the pod and add to the milk mixture, along with a pinch of salt.', 'Slowly bring to a gentle simmer, until you see small bubbles around the edges of the pan. Stir occasionally. This will take about 15 to 18 minutes. Remove from heat, and let the vanilla infuse the cream for 15 minutes. (If using vanilla extract, add it now.)', '3 Combine the eggs and sugar with the milk: In a separate bowl, beat the yolks and sugar together with a whisk until the mixture is thick and pale.', 'Place the milk mixture back over medium-low heat and warm to just below a simmer. The cream should be warm to the touch, and small bubbles around the edge are just beginning to form. (The mixture needs to be warm to temper the eggs in our next step.', 'In a slow, thin, steady stream, pour the milk mixture into the egg sugar mixture, whisking the entire time. Continue until all the liquid is combined. Don\\xe2\\x80\\x99t rush this; otherwise you will end up with scrambled eggs.', '4 Cook the custard: Return the custard (vanilla bean pod and all), to the pan and place it over low heat. Stir gently with a spatula until the custard thickens to the consistency of maple syrup, about 8 minutes. When ready, it will coat the back of a spoon, and if you draw your finger through it, the mark will remain.', '5 Chill the custard: As soon as the custard thickens, remove from heat. Remove the mixing bowl from the freezer, and transfer the custard to the bowl. Allow the custard to cool to room temp, then cover and place in the fridge.', 'This is now the base for your ice cream. It can be made one week ahead of time and kept covered in the fridge.', '6 Make the strawberry sauce: Place half of the sliced strawberries in a saucepan with half of the sugar and all of lemon juice. Place over medium heat and bring to a gentle boil. Stir occasionally and watch the pot, as the berries will foam up and could boil over.', 'After 10 minutes, lightly smash the cooking berries with a potato masher. Continue cooking the mixture, stirring occasionally, until the volume is reduced by half. This should take about 8 minutes. The sauce is ready when the syrup is a deep red, and thick like honey. Remove from heat. Transfer to a bowl, cover, and refrigerate.', '7 Make the fresh berry puree: Combine the remaining sliced berries and remaining sugar in a blender or food processor, or using an immersion blender. Puree until you have a thin sauce. Transfer to a bowl, cover, and refrigerate.', '9 Churn the ice cream: Remove vanilla pod from the cooled custard base. Stir in the cooled strawberry sauce and fresh strawberry puree.', 'Transfer to ice cream maker and churn according to the manufacturer\\xe2\\x80\\x99s instructions. When ready, it will be the consistency of soft serve ice cream.', '10 Eat immediately as soft serve, or freeze to harden: The ice cream can be served immediately if desired. To harden to a scoopable consistency, transfer the ice cream to a loaf pan or other freezer-safe container, press a piece of parchment paper over the top, and cover it with a lid. Place in the freezer for at least 2 hours. When ready, scoop onto your favorite cone.', 'This ice cream will keep for about a month before starting crystallize.']",16
1414,Strawberry Mascarpone Tart Recipe,90,35,125,"['Tart Shell', '1 recipe pie dough (see P\\xc3\\xa2te Bris\\xc3\\xa9e recipe, increase sugar to 1 1/2 teaspoons)', 'OR', '1 sheet of puff pastry, thawed', '1 egg, whisked', 'Filling and Glaze', '2 lbs strawberries, stemmed and quartered', '1/2 cup granulated sugar', '1 Tbsp orange zest, divided', '1 teaspoon lemon juice', '12 ounces mascarpone cheese (can also use 8 ounces mascarpone mixed in with 4 ounces of ricotta or 4 ounces of whipped cream)', '1/2 teaspoon vanilla', ""1/3 cup confectioner's sugar (powdered sugar)"", ""1 Tbsp balsamic vinegar (substitute a teaspoon of lemon juice if you don't have balsamic)""]",14,"['1a Using Pie Dough Roll out the pie dough and line a 10-inch tart pan with the dough. Prick the bottom of the shell all over with the tines of a fork. Freeze for 20 minutes.', 'Preheat oven to 375\\xc2\\xb0F. Line the tart shell with aluminum foil or parchment paper. Fill at least two-thirds with pie weights - dried beans, rice, or ceramic or metal pie weights.', 'Bake initially for 15 minutes, then remove from oven, let cool enough to handle, and remove the aluminum foil or parchment paper and pie weights. Return to oven and cook until lightly browned at the edges, about 20 more minutes. Let cool completely.', '1b Using Puff Pastry Roll out puff pastry sheet to 15x5 inches or 12x12 inches. Place on a baking sheet. Fold the edges over to form a border. Prick bottom of pasty with tines of a fork. Chill for 20 minutes.', 'Preheat oven to 400\\xc2\\xb0F. Use a pastry brush to brush on egg wash over exposed surfaces. Place in hot oven and cook until nicely browned all over, about 15 minutes. Remove from oven to a rack, let cool completely.', '2 Macerate strawberries in sugar: Gently combine strawberries, half of the orange zest, and the granulated sugar in large bowl so that the strawberries are coated with sugar. Let sit to macerate for 30 minutes.', ""3 Make mascarpone base: Mix together the mascarpone cheese, confectioner's sugar, the remaining orange zest, lemon juice and the vanilla in a medium bowl until well combined. Refrigerate until needed."", '4 Make strawberry balsamic glaze: After the strawberries have macerated for 30 minutes, place a sieve over a bowl and drain the liquid out of the strawberry mixture into the bowl.', 'Take that strawberry liquid and put it in a small saucepan. Add a tablespoon of balsamic vinegar to the saucepan, and bring to a boil on medium high heat.', 'Boil until the liquid has reduced to the consistency of syrup, remove from heat and let cool.', '5 Assemble the tart: Spread the mascarpone mixture over the bottom of the tart shell.', 'Arrange the strawberries on top of the mascarpone mixture. Use a pastry brush to brush on the balsamic glaze.']",12
1415,Strawberry Oatmeal Muffins Recipe,20,25,45,"['1 1/4 cups old fashioned oats', '1 cup plain yogurt', '1/2 pound strawberries', '2 teaspoons granulated white sugar', '1 teaspoon balsamic vinegar', '2 eggs', '1/2 cup (1 stick) unsalted butter, melted', '1/2 cup brown sugar (packed)', '1 teaspoon vanilla extract', '1 cup all purpose flour', '1 Tbsp baking powder', '1/2 teaspoon baking soda', '1/4 teaspoon salt', '1/4 teaspoon finely ground black pepper', '1/2 teaspoon cinnamon']",15,"['1 Mix the oats and plain yogurt together in a large bowl.', '2 Prep then macerate strawberries with sugar and balsamic: Rinse and core the strawberries. Roughly chop the strawberries (I cut them in quarters lengthwise and then make one or two crosswise cuts). You should have about 1 1/2 cups of chopped strawberries. Place in a small bowl.', 'Sprinkle with white sugar and balsamic vinegar. Gently stir to coat the strawberries with the sugar and vinegar.', '3 Preheat oven, prep muffin tin: Position a rack in the middle of the oven and preheat oven to 400\\xc2\\xb0F. Prepare a 12-well muffin tin by coating with butter or lining with paper muffin cups.', '4 Whisk together in a medium bowl the flour, baking powder, baking soda, salt, finely ground black pepper, and cinnamon.', '5 Add the eggs, melted butter, brown sugar, and vanilla extract to the oatmeal and yogurt mixture. Stir until just incorporated.', '6 Stir flour mixture into oatmeal mixture: Use a wooden spoon to gently stir the flour mixture into the oatmeal. Stir until just incorporated and the flour is moistened. Do not over-mix! Or your muffins will end up rubbery. The batter should be rather lumpy, not smooth.', '7 Gently fold in the strawberries, including any of the sugary vinegary liquid the strawberries have been sitting in.', '8 Spoon the batter evenly into the muffin tin wells or cups.', '9 Bake at 400\\xc2\\xb0F until the tops are browned and the muffin bounces back when you gently press on the top with your finger tips, about 20 minutes. A bamboo or metal skewer inserted into the center should come out clean.', 'Let cool for a couple minutes in the muffin tin before removing to serve.']",11
1416,Fresh Strawberry Pie Recipe,45,160,205,"['1 9-inch pie crust, homemade or store-bought', '3 pounds (about 4 pints) strawberries, hulled', '3/4 cup sugar', '2 teaspoons low-sugar or no-sugar powdered pectin (like Sure-Jell)', '2 tablespoons cornstarch', '2 tablespoons lemon juice', '1 to 2 tablespoons water', 'Special equipment:', '9-inch pie plate', 'Pie weights']",10,"['1 Blind bake the crust: Roll out the crust and ease it into a 9-inch pie plate. Trim and crimp the edges, then refrigerate for at least a half hour.', 'Line the pie crust with parchment paper or foil, then fill with pie weights or dry beans. Bake for 20 minutes at 350F. Remove the pie weights and continue baking for 10 to 15 minutes until the crust is lightly golden. (For full blind-baking instructions, see this post. If using a store-bought pie crust, follow the directions on the package for blind baking.)', 'Cool the pie crust completely before assembling the pie.', '2 Prepare the strawberries: Cut in half 15 of the largest strawberries (about 1 pound) and set aside for the top of the pie.', 'Cut the remaining strawberries into thin slices.', '3 Make the glaze: In a blender, puree 2 cups of the sliced berries with the sugar, pectin, cornstarch, and lemon juice until smooth. Transfer to a saucepan and set over medium high heat.', 'Stir the glaze constantly until the mixture comes to a rolling boil. Once at a full rolling boil, boil for 1 minute. The glaze should be easy to stir and slightly thickened. If it seems like the the glaze is thickening to more of a jelly-like consistency remove it from heat immediately.', ""Transfer the glaze to a large bowl using a spatula and allow to cool for 20 minutes. Scoop out and set aside 1/4 cup of the glaze; you'll use this for the top of the pie."", '4 Fill the pie: Stir the remaining sliced strawberries into the bowl of glaze until evenly coated. Spoon the filling into the pie. Level it so that all the slices lay flat, like shingles. Arrange the reserved, halved strawberries on top.', 'Thin the reserved glaze with 1 to 2 tablespoons of water, and brush it over the pie.', '5 Refrigerate for 1 hour, or until the glaze is set. The pie is best served on the day it is made. Texture of the pie as you slice it will be loose, with some berries tumbling out as you serve.']",11
1417,Strawberry Frozen Yogurt Recipe,10,105,115,"['3 cups de-stemmed sliced fresh strawberries', '3 Tbsp lemon juice', '2/3 cup to 1 cup sugar (depending on how sweet you want the result, and how sweet your strawberries are to begin with)', '1/4 teaspoon salt', '1/2 cup whole milk', '1 1/2 cups full fat yogurt (if use low or non fat, then add 2 Tbsp cream)']",6,"['1 Cook strawberries with lemon juice, salt, sugar, and mash: Place the strawberries, lemon juice, salt, and sugar in a medium saucepan. Heat on medium heat, stirring, until the sugar has completely dissolved.', 'Use a potato masher to mash up the strawberries as the mixture is heating.', 'As soon as all of the sugar has completely dissolved, remove from heat and let sit for 10 minutes.', '2 Stir in milk, yogurt, then chill: Stir in the milk and yogurt, until completely incorporated. Place the mixture in the refrigerator, and chill for at least an hour, preferably several hours, until completely cold, before proceeding.', '3 Process in ice cream maker: Process the mixture in your ice cream maker 20 to 25 minutes. Eat immediately or keep in freezer until served.']",5
1418,Seared Halibut with Berry Compote and Roasted Vegetables Recipe,10,30,40,"['For the halibut and vegetables:', '1 1/2 pounds mixed marbled potatoes, halved lengthwise', '1 pound asparagus, tough ends trimmed away', '6 tablespoons extra virgin olive oil, divided', '4 6-ounce boneless halibut filets', 'Salt and ground black pepper', 'For the compote:', '1 cup red wine', '1/4 cup balsamic vinegar', '2 tablespoons honey', '1 1/2 cups Well\\xe2\\x80\\xa2Pict strawberries, coarsely chopped']",11,"['1 Preheat oven: Heat oven to 425\\xc2\\xb0 F and line a large rimmed baking sheet with parchment paper or a silicone baking mat.', '2 Roast the veggies: In a large bowl, toss potatoes with 2 tablespoons olive oil and a generous sprinkle of salt and pepper. Turn potatoes out onto the prepared baking sheet and roast for 15 minutes, or until golden brown.', 'While the potatoes are roasting, place the asparagus in the same bowl that the potatoes were in and drizzle with 1 tablespoon of olive oil. Generously sprinkle with salt and pepper. After the 15 minutes roast time for the potatoes, remove pan from oven, and push potatoes to one side of the pan with a heatproof spatula.', 'Add the asparagus onto the other side of the baking sheet. Place the pan back in the oven and roast for an additional 12-15 minutes (depending on thickness of stalks), or until asparagus and potatoes are tender.', '3 Make the compote: While the veggies are cooking, place the wine, vinegar, honey, and 3/4 cup of the strawberries in a medium pot over medium-high heat. Simmer for 10-15 minutes, or until mixture has been reduced by half.', 'The liquid will still be thin. Add the reserve 3/4 cup of strawberries to the warm compote and set aside.', '4 Cook the halibut: Pat the halibut dry with paper towels and season with salt and pepper on both sides.', 'In a large nonstick skillet, warm the remaining 3 tablespoons olive oil over medium-high heat until shimmering \\xe2\\x80\\x94 you want the pan really hot before adding the halibut. Sear the fish for 3-5 minutes on one side. Then flip and cook for an additional 5 minutes (although this will vary depending on thickness of filet), or until the center of the fish springs back when you touch it. It should also flake easily with a fork.', '5 Serve: Serve halibut with a side of roasted potatoes and asparagus, and a generous spoonful of compote.']",9
1419,Turkey Stroganoff Recipe,10,15,25,"['1/2 pound button or cremini mushrooms, sliced', '3 Tbsp butter', '1/2 cup finely chopped onion', '3/4 lb leftover cooked turkey meat, dark or light meat, roughly chopped into bite sized pieces', '1/2 cup leftover turkey gravy (or chicken or turkey stock)', '1/8 teaspoon nutmeg', '1 Tbsp of chopped fresh thyme or 1 teaspoon dry thyme (important, do not omit)', '1 cup of sour cream at room temperature (can substitute plain, full-fat yogurt)', 'Salt to taste (you will need more salt than you expect)', 'Black pepper to taste', '1/2 lb egg noodles, cooked']",11,"[""1 Saut\\xc3\\xa9 the mushrooms: Heat a large saut\\xc3\\xa9 pan on medium-high heat for 1 minute. Add the mushrooms and dry saut\\xc3\\xa9 them (cook them without oil), shaking the pan frequently so they don't stick, for 3 to 5 minutes, until the mushrooms release their water and begin to brown."", '2 Add butter and onions: Add the butter and onion and cook, stirring occasionally, for about 4 minutes, until the onions begin to brown. Sprinkle salt over everything.', '3 Add turkey and spices: Add the turkey meat and gravy and stir to combine. Cook for a minute or two, and sprinkle on the thyme, black pepper and nutmeg.', '4 Add sour cream: Turn off the heat and add the sour cream. You may want to add a few tablespoons of water to thin the sauce. Mix in the sour cream thoroughly. Do not let the sauce come to a simmer or boil or it may curdle!', 'Adjust seasonings to taste. In particular, depending on how salty your gravy was, you may need to add salt. More than you think.', 'Serve immediately over egg noodles.']",6
1420,Hot Dog Stroganoff Recipe,5,15,20,"['1 tablespoon butter (more if needed)', '6 standard sized hot dogs (plan 1-2 per person, or fewer if you are serving kids), sliced into 1/4-inch to 1/2-inch thick slices', '1 cup chopped yellow onion', '2/3 cup sour cream', '1/3 cup of water', '1 tablespoon chopped fresh parsley (optional)']",6,"['1 Saut\\xc3\\xa9 onions and sliced hot dogs in butter: Melt butter in a large skillet (cast iron works well for this purpose) on medium high heat. Add the chopped onions and sliced hot dogs.', 'Cook, stirring occasionally, until the onions and the hot dogs are nicely browned, 5-10 minutes.', '2 Add the sour cream and water, stir until creamy. Heat until steamy.', '3 Serve: Serve with cooked egg noodles, elbow macaroni, or favorite pasta. Sprinkle with chopped fresh parsley.']",4
1421,Pressure Cooker Cajun-Spiced Stuffed Peppers Recipe,10,30,40,"['4 small- to medium-sized bell peppers, any color', '3/4 pound 93% to 96% lean ground beef', '3/4 cup corn kernels (fresh or frozen)', '1 cup cooked rice (any variety)', '3/4 cup diced red onion', '1 1/2 teaspoons Cajun seasoning blend', '1/2 teaspoon dried oregano leaves', '1/2 teaspoon paprika', '3/4 teaspoon kosher salt', 'To serve:', '1/2 cup shredded mozzarella cheese', '2 tablespoons chopped parsley or cilantro', 'Special equipment:', '6-quart pressure cooker', 'Wire metal trivet with handles', '7-inch round cake pan (2 to 3 inches tall)']",16,"['1 Prepare the bell peppers: Cut off the tops of the bell peppers and discard (or save for another purpose). Use your hands to remove any seeds and white membranes so the peppers are clean and ready for stuffing.', '2 Make the filling and stuff the peppers: In a mixing bowl, combine the beef, corn, rice, red onion, and seasonings. Use your hands to mix everything together well, and then spoon the filling into the peppers, packing it in firmly.', 'As you stuff the peppers, place them next to each other in the cake pan, sitting upright like cups.', '3 Pressure cook the peppers: Pour a cup of water into the inner pot of a 6-quart electric pressure cooker. Use the wire metal trivet to lower the cake pan into the pot. It should be resting on top of the trivet, a little bit above the water.', 'Secure the lid on the pressure cooker and make sure the lid is set to its \\xe2\\x80\\x9cSealing\\xe2\\x80\\x9d position. Select the \\xe2\\x80\\x9cManual\\xe2\\x80\\x9d or \\xe2\\x80\\x9cPressure Cook\\xe2\\x80\\x9d setting, and set the time to 15 minutes at high pressure. The pot will take about 10 minutes to come up to pressure, and then the cooking time will begin.', '4 Release the pressure: When the cooking program ends, perform a quick pressure release by moving the pressure vent to its \\xe2\\x80\\x9cVenting\\xe2\\x80\\x9d position.', 'When the pressure has fully released, open the pot and sprinkle the peppers with the cheese and chopped fresh herbs.', '5 Serve the stuffed peppers: Wearing a pair of heatproof mitts, lift the trivet with the cake pan out of the pot. Don\\xe2\\x80\\x99t worry if some liquid has settled in the cake pan. Use a pair of serving spoons to remove the peppers from the pan and transfer to individual plates. Serve hot.', 'Note: These stuffed peppers are best served right away, or cooled and reheated later in the microwave. Do not keep warm on the pressure cookers Warm setting or by covering the cooked peppers with foil, since this causes the peppers to overcook and split when served.']",9
1422,Olive-Stuffed Roasted Mini-Pepper Crostini with Caramelized Onions Recipe,20,50,70,"['24 (1/4-inch thick) slices of baguette', '2 small red onions, peeled, thinly sliced (2 to 3 cups)', '3 tablespoons extra virgin olive oil', '1 tablespoon balsamic vinegar', '1/4 teaspoon salt', '1 cup water or stock', '12 mini (2- to 3-inch) red, yellow, and orange sweet peppers', '1 tablespoon capers, rinsed and drained', '12 cherry tomatoes, halved', '24 black or green California Ripe Olives, drained and halved', 'Several sprigs of fresh thyme', 'Special equipment:', '9x13-inch baking dish']",13,"['1 Preheat the oven to 450\\xc2\\xb0F. Set one oven rack in the upper third of the oven and another rack in the lower third.', '2 Toast the bread: Spread the baguette slices in a single layer on a baking sheet. Place on the top rack of the oven and toast in the oven for 4 minutes. Remove from oven and let cool to room temp.', '3 Line the baking dish with onions: Place the thinly sliced onions in a 9x13-inch baking dish and toss with 2 tablespoons of olive oil.', 'Spread the onions out over the bottom of the pan. Sprinkle with 1 tablespoon balsamic vinegar and 1/4 teaspoon of salt.', 'Pour 1 cup of water or stock onto the onions in the baking dish.', '4 Prepare the mini peppers: Cut the peppers in half lengthwise through the stem. Pull out and discard the seeds.', 'Set pepper halves on top of the sliced onions in the baking pan, hollow side facing up.', '5 Stuff the peppers: Sprinkle 3 to 4 capers inside each pepper half. Distribute the olive halves and cherry tomato halves among the pepper cavities.', 'Place a few thyme sprigs among the peppers.', 'Drizzle the peppers with the remaining 1 tablespoon of olive oil.', '6 Roast the peppers:  Cover the pan with aluminum foil. Bake in the oven at 450\\xc2\\xb0F for about 30 minutes on the lower shelf of the oven, or until the peppers are soft.', 'Remove the foil and return the peppers to the top shelf of the oven for 10 to 15 more minutes, until the peppers have started to brown at the edges.', 'If the bottom of the pan becomes dry at any time, pour in a little more water. Remove the pan from the oven and remove the thyme sprigs.', '7 Assemble the crostini: Move one of the peppers aside in the roasting dish to reveal the caramelized onions below. Place a forkful of onions on a toasted bread slice. Top with the pepper. Repeat until all of the crostini have been topped with peppers.', 'Serve warm or at room temperature. Garnish the platter with a few sprigs of fresh thyme.']",15
1423,Sausage Stuffed Zucchini Recipe,15,60,75,"['2 tablespoons extra virgin olive oil', '1/2 pound Italian sausage, removed from casing', '1 large zucchini, 12 to 14 inches long (about 1 1/4 to 2 pounds) or 3 to 4 medium zucchini', '1 cup chopped onion', '3 cloves garlic, finely chopped', '2 slices bread, pulsed in food processor or blender to make fresh breadcrumbs (about 1 cup)', '2 medium tomatoes, chopped', '1/4 cup chopped fresh basil', '1/2 teaspoon dried oregano, or 2 teaspoons chopped fresh oregano', '3/4 cup shredded Parmesan cheese', '1 large egg, lightly beaten', '3/4 teaspoon salt (less or more to taste)', '1 teaspoon ground black pepper']",13,"['1 Preheat oven to 375\\xc2\\xb0F.', '2 Cook the sausage: Heat 1 tablespoon of olive oil in a medium skillet on medium heat. Add the sausage, and gently cook until it is mostly (but not completely) cooked through.', 'Stir frequently and break up the sausage into smaller pieces while it cooks. Remove to a large bowl and set aside.', ""3 Prep the zucchini: Cut the zucchini in half. Use a metal spoon to scoop out the insides of the zucchini, leaving the zucchini shell about 1/4-inch thick. Remove and discard any thick seeds from the insides you've scooped out."", 'Chop up about a cup of the remaining zucchini flesh. (Whatever remains beyond a cup use for another purpose, discard, or compost.)', '4 Cook the onions and garlic: You should have 1 tablespoon of fat in the pan (rendered from the sausage). If not, add more olive oil so that you have at least a tablespoon of fat in the pan, and heat on medium-high heat. Add the onions and cook until softened. Add the garlic and cook 30 seconds more.', 'Add the chopped zucchini and cook a minute or two more, remove from the skillet and add it to the bowl of sausage.', '5 Make the stuffing: Add the rest of the stuffing ingredients to the sausage and onions.', '6 Stuff the zucchini and bake: Place the zucchini halves in a baking dish and add the stuffing. (At this point you can make ahead, cover with plastic wrap and refrigerate until ready to bake.) Add 1/4-inch of water to the bottom of the pan, which will help zucchini cook evenly and prevent the bottom of it from drying out too much in the oven.', 'Bake at 375\\xc2\\xb0F for 40 minutes. Let sit to cool briefly before serving.']",10
1424,Taco-Stuffed Zucchini Boats Recipe,20,25,45,"['For the taco filling:', '2 tablespoons olive oil', '1 pound ground beef', '1/2 red onion, minced', '1 jalape\\xc3\\xb1o, seeds removed and green parts minced', '4 teaspoons chili powder', '1 teaspoon dried oregano', '1 teaspoon garlic powder', '1 teaspoon black pepper', '1/2 teaspoon salt', 'For the zucchini:', '4 medium zucchini, halved lengthwise', '2 tablespoons olive oil', '6 ounces queso fresco', 'Scallions, for garnish', 'Sour cream, for garnish', 'Diced red or orange bell pepper, for garnish']",17,"['1 Make the taco filling: Heat two tablespoons of olive oil in a medium skillet over medium heat. Add the ground beef and cook until browned, 5 to 6 minutes. Add the diced red onion and jalape\\xc3\\xb1o, along with all spices, and cook for about 5 more minutes.', 'Remove the taco filling from the heat and let it cool slightly. If there seems to be a lot of liquid in the mixture, drain it on paper towels before using. You could make this filling a day or two in advance; refrigerate until needed.', '2 Prep the zucchini for stuffing: Preheat a gas or charcoal grill to medium heat (350\\xc2\\xb0F to 400\\xc2\\xb0F). Cut the zucchini in half lengthwise and brush the cut sides with two tablespoons of the olive oil.', 'Place the zucchini on the grill, cut side down, and grill for 5 to 6 minutes. Remove from the grill. Once the zucchini are cooled slightly, use a spoon to scoop out the centers of the zucchini, leaving enough around the edges so they aren\\xe2\\x80\\x99t flimsy.', '3 Stuff and grill the zucchini: Use a slotted spoon to divide the taco filling between the zucchini halves, stuffing them full. Then crumble the queso fresco over each stuffed zucchini half.', 'Return zucchini to the grill, placed upright like a boat, and cook for another 6 to 7 minutes, until the zucchini is tender when pierced and the cheese is bubbling and melted.', '  4 Garnish and serve:  Remove the zucchini from the grill and garnish with a drizzle of sour cream, diced bell pepper, and diced scallion. Serve while warm.', 'Leftovers keep fine for a few days and can be reheated in a 350\\xc2\\xb0F oven until warmed through, or, if you\\xe2\\x80\\x99re in a rush, microwaved for one minute on high.']",8
1425,Pesto Stuffed Zucchini Recipe,10,60,70,"['2 cups of day old cubed bread*', '1 tablespoon butter', '2 tablespoons pine nuts', '1 very large zucchini (about 2 pounds), otherwise known as a baseball bat zucchini', '1/4 cup prepared basil pesto', '1/4 cup grated Parmesan cheese', '4 ounces fresh mozzarella, cut into cubes', 'A handful of cherry tomatoes, roughly chopped', 'Salt', ""*The bread should be a little dry, this way it will toast better. If you don't have day old or slightly dry bread, cut up fresh bread and lay out on a baking sheet. Heat in a 200\\xc2\\xb0F oven for 10 minutes.""]",10,"['1 Toast croutons: In a medium skillet, melt butter on medium to medium high heat. Add the slightly dry cubed bread, toss to coat at least some of the sides in a little butter.', 'Lay out in a single layer cook, without moving the croutons, until one side is lightly browned, then toss and let cook a little more so a few more sides get a little brown. Remove from pan and let cool to touch.', '2 Toast pine nuts: While the croutons are browning, heat a small skillet on high. Add the pine nuts and cook until they begin to brown (do not walk away, once they start browning they can easily go from brown to burnt!).', 'When they start to brown, remove them from the pan into a small bowl.', '3 Combine croutons, Mozzarella, pesto, Parmesan, tomatoes, pine nuts: Place the croutons and Mozzarella in a medium bowl. Toss with the pesto. Add the grated Parmesan, chopped cherry tomatoes, toasted pine nuts, and toss some more.', '4 Stuff the zucchini boats: Heat the oven to 375\\xc2\\xb0F. Cut the zucchini in half lengthwise. Scoop out the inner flesh with a metal spoon, leaving 1/4 to a 1/2-inch thickness in the zucchini boats.**', '5 Bake in oven: Place the zucchini boats in a roasting pan. Sprinkle the inside of the boats with salt. Fill the boats with the stuffing mixture.', ""Pour a cup or so of water into the bottom of the roasting pan (so that zucchini doesn't dry out on the outside), to about 1/4 inch depth."", 'Bake for 45 minutes at 375\\xc2\\xb0F.', '**In this recipe we are not using the zucchini flesh that we have scooped out. You can easily freeze it for later use with zucchini recipes such as zucchini bread, zucchini muffins, or zucchini cake. Or you can chop some of it up and mix it in with the stuffing mixture.']",10
1426,Cornbread Stuffing with Green Olives and Pecans Recipe,45,40,85,"['3/4 cup pecans', '1 batch cornbread (homemade or store-bought, 8- to 10-inch pan size, or enough to make about 8 cups cubed)', '4 tablespoons (1/2 stick) unsalted butter, plus extra for buttering the baking dish', '1 large yellow onion, finely chopped', '4 stalks celery, finely chopped', '2 tablespoons chopped fresh sage', '2 tablespoons chopped parsley', '1 teaspoon dried thyme', '1/2 teaspoon salt, plus more to taste', '1/4 teaspoon ground black pepper, plus more to taste', '3/4 cup California green ripe olives, drained and roughly chopped', '3/4 cup dried cranberries', '2 large eggs', '1 cup chicken or vegetable stock', '1/2 cup half and half', 'Special equipment:', '9x13-inch baking dish']",17,"['1 Preheat the oven to 350\\xc2\\xbaF. Butter a 9x13-inch baking dish.', '2 Toast the pecans: Scatter the pecans on a baking sheet and toast in the oven until slightly darkened and fragrant, 10 to 15 minutes.', 'Transfer the pecans to a cutting board and roughly chop while still warm. Set aside until needed.', '3 Cut the cornbread into cubes and toast: Use a serrated knife to cut the cornbread into roughly 1/2-inch cubes. Be gently as you slice to avoid crumbling the cubes. You should have about 8 cups cubed.', 'Transfer the cubes and any crumbs the baking sheet used to toast the pecans. Toast for 15 to 20 minutes, stirring partway through, until the cubes look golden around the edges and feel dry to the touch.', '4 Meanwhile, cook the vegetables: In a large skillet over medium heat, melt the butter. Add the onions and celery, and cook for 5 minutes.', 'Add the sage, parsley, thyme, salt, pepper, olives, and cranberries. Cook for 3 to 4 minutes longer, or until the vegetables soften and the herbs are very aromatic. Let cool for 10 minutes.', '5 Mix the stuffing: Gently stir the cooked vegetable mixture into the bowl with the cornbread cubes. Stir in the pecans.', 'In a small bowl, whisk the eggs, stock and cream together. Pour over the stuffing and toss gently to combine, using your hands if necessary to avoid crumbling the cornbread too much. The stuffing should feel evenly moist; sprinkle with additional chicken stock as needed.', 'Transfer to the baking dish.', '5 Bake for 35 to 40 minutes, or until the top is brown and crisp.', '6 Serve: Serve the stuffing while warm. Stuffing can also be made a day or two ahead and warmed in the oven before serving.']",12
1427,Thanksgiving Stuffing with Sausage and Apples Recipe,30,40,70,"['For the toasted bread:', '8 cups (1 pound) sourdough loaf, 1/2 inch cubed', '3 tablespoons olive oil', '1 teaspoon kosher salt', '1/2 teaspoon freshly ground black pepper', 'For the stuffing:', '1 pound country sausage \\xe2\\x80\\x93 pork or turkey', '6 stalks celery (2 cups), diced', '2 large Gala apples, cored and diced small', '1 medium onion (1 cup), diced', '2 tablespoons chopped fresh sage', '2 teaspoons dried thyme leaves', '1/4 teaspoon freshly ground pepper', '1 tablespoon apple cider vinegar', '1/2 teaspoon kosher salt', '2 cups low sodium chicken stock']",16,"['1 Toast the bread cubes: Preheat oven to 425\\xc2\\xb0F. On a large baking sheet, spread the bread cubes. Drizzle with olive oil, salt, and pepper. Use your hands to toss and coat the bread. Toast in the oven for 10 minutes, until the cubes have toasted slightly and take on a little color. When ready, they will still be tender and squishy on the inside, but toasty and stiff on the outside. Cool, then transfer to a large mixing bowl.', '2 Prepare your baking dish: Butter a 9x13-inch baking dish and set it aside.', '3 Cook the stuffing ingredients: Heat a large skillet over medium-high heat. Add sausage, breaking it up as you go. Let it brown and release some moisture. This should take about 5 to 7 minutes.', 'Add celery, apples, onion, sage, thyme, and pepper to the pan. Scrape up any browned bits (fond), from the sausage. Saut\\xc3\\xa9 for about 10 to 12 minutes, stirring only occasionally, because you want the fruit and vegetables to take on a little color as well.', 'Once the vegetables have browned just a bit, and softened, add the apple cider vinegar. Stir to coat and cook for one minute more. Taste the dish along with a piece of the toasted bread. Decide if it needs more salt. If so, add it now. Add the stock and scrape up any remaining fond on the bottom of the pan. Give everything a good stir.', '4 Combine everything together: Carefully, pour skillet contents over the bread in the mixing bowl. Stir to combine, then pour everything into the prepared baking dish.', '5 Cover and bake: Spray one side of the foil with cooking spray or brush with oil to prevent any of the stuffing from sticking to the top.', 'Cover the baking dish with the aluminum foil oil side down, then place in the oven for 20 minutes. After 20 minutes, remove the foil, and continue baking for 20 additional minutes. When it\\xe2\\x80\\x99s ready, the stuffing will look moist but have a nice crispy texture on top, and a golden color.']",8
1428,Lofthouse-Style Soft Frosted Sugar Cookies Recipe,30,191,221,"['For the dough:', '3 3/4 cups (510g) all-purpose flour', '1 1/2 teaspoons baking powder', '1/2 teaspoon baking soda', '1/2 teaspoon kosher salt', '1 cup (227g) unsalted butter, softened', '1 1/2 cups (300g) granulated sugar', '2 large eggs', '2 teaspoons vanilla extract', '1 cup (227g) sour cream', 'For the frosting:', '1 cup (227g) unsalted butter, softened', '4 cups (455g) powdered sugar', '1 tablespoon vanilla extract', '1/2 teaspoon kosher salt', '1 to 2 tablespoons milk', 'Food coloring, for coloring the frosting', 'Sprinkles for decorating']",18,"['1 Combine the dry ingredients: Whisk the flour, baking powder, baking soda, and salt together in a bowl and set to the side.', '2 Make the cookie dough: In the bowl of a stand mixer, beat butter and sugar together until light and fluffy, about 3 minutes. Beat in the eggs one at a time, scraping down the bowl after each addition.', 'Beat in the vanilla and sour cream until combined. Then, in two separate additions, beat in the flour, scraping the bowl after each addition. This will create a soft and fluffy dough.', '3 Fold the dough briefly in the bowl: Using a stiff rubber spatula, fold the dough a few times inside the bowl \\xe2\\x80\\x93 scoop down the side of the bowl and underneath the batter, then lift up and fold the dough over on itself. Give the bowl a quarter turn and repeat. Repeat this a few times until the dough is smooth.', '4 Chill the dough: Press a piece of plastic wrap against the surface of the dough and refrigerate the dough for at least three hours so it firms up, or up to overnight. (Transfer the dough to a separate bowl if you need the mixing bowl for something else.)', ""5 Preheat the oven: Once the dough has chilled and you're ready to bake, preheat the oven to 350\\xc2\\xb0F with a rack in the center position. Line two baking sheets with parchment paper."", '6 Shape the cookies: Lightly flour the counter. Using a medium (1 1/2 tablespoon) cookie scoop, scoop out some of the dough and drop on the counter. Gently roll the dough against the counter and between your hands to form a round ball. Brush off any excess flour and place the ball on the cookie sheet.', 'Repeat scooping and rolling more cookie dough balls until the sheet pan is filled, spacing the cookies several inches apart. Cover the remaining dough and return it to the refrigerator.', '7 Press the cookies flat: Dip the bottom of a drinking glass in flour and use it to press the cookies on the cookie sheet to about 1/4-inch thick. Re-flour the drinking glass as needed to prevent sticking.', '8 Bake the cookies: Bake the first tray of cookies in the center of the oven for 11 to 13 minutes. When done, the cookies should be slightly puffed, dry on the top, pale around the edges, and (when lifted with a thin spatula) barely golden on the bottoms.', 'Let them cool for 5 minutes on the tray before transferring them to a wire rack to cool.', 'Shape and bake the remaining cookies like the first.', '9 Make the frosting: Using the paddle attachment, beat the butter in the bowl of a stand mixer until creamy. Add half of the powdered sugar, the vanilla, and the salt, and beat on low to combine for a minute. Add the remaining powdered sugar and 1 tablespoon of milk, and beat for an additional minute.', 'The frosting should be fluffy, pale, and spreadable. If it is more stiff than you like, beat in an additional tablespoon of milk.', 'To color the frosting pink (or any other color), add a few drops of food coloring and mix to combine. (I used about 2 drops each of deep pink and red food gel for my cookies.)', '10 Frost the cookies: Spread the frosting on the cooled cookies and decorate with sprinkles.', '11 Store the cookies: These cookies keep well in an airtight container at room temperature for up to 3 days, separated by layers of parchment so they don\\xe2\\x80\\x99t stick to each other.']",17
1429,Spring Vegetable Tortellini Soup with Pesto Recipe,20,15,35,"['1 tablespoon extra-virgin olive oil', '1 medium onion, chopped', '2 cloves garlic, chopped', '1 cup sliced carrots', '6 cups low-sodium vegetable broth', '8 ounces fresh or frozen tortellini, any variety', '1 cup snap peas, cut into thirds', '1/2 cup fresh or frozen English peas', '1 cup 3/4-inch pieces asparagus, woody ends removed', '2 tablespoons fresh lemon juice', '1 to 2 teaspoons kosher salt', 'Freshly cracked black pepper', '1/3 cup herb pesto, either store-bought or homemade']",13,"['1 Saut\\xc3\\xa9 the onions and garlic: Heat the olive oil in a medium pot over medium heat. Add the onion and garlic and saut\\xc3\\xa9 until tender, being sure not to brown them, about 5 minutes.', '2 Build the soup: Add the carrots and broth and turn the heat to high. When the broth boils, add the tortellini, snap peas, English peas, and asparagus. Continue to boil until the tortellini is just barely al dente. The time will vary depending on the brand, so read the package instructions.', '3 Season the soup: Add the lemon juice, several cracks of black pepper, and 1 to 2 teaspoons salt, as needed (some broth is saltier than others, so adjust according to taste).', '4 Serve: Ladle the soup into bowls and top with a spoonful of pesto. Serve immediately.']",4
1430,"Zucchini, Eggplant, Tomato Gratin Recipe",20,70,90,"['3 tablespoons extra virgin olive oil', '2 cups sliced yellow onion (1 large onion)', '1 cup of sliced red, orange, or yellow bell peppers', '1 long eggplant (a slender eggplant like a Japanese eggplant, not a large globe, about 1/2 pound)', '1 large zucchini (about 10 to 12 inches long, 1 1/2 inch diameter, about 1/2 pound), or other summer squash', '2 medium sized tomatoes', '3 cloves of garlic, peeled and smashed', '1 1/2 teaspoons salt', '2 tablespoons chopped fresh parsley', '2 ounces Provolone cheese, sliced or grated', '3 tablespoons grated Parmesan cheese']",11,"['1 Saut\\xc3\\xa9 the onions and peppers: In a large saut\\xc3\\xa9 pan heat 2 Tbsp of the olive oil on medium high heat. Add the sliced onions and cook until lightly browned, stirring frequently, about 10 minutes.', 'Add the sliced bell peppers and continue to cook with the onions until the bell peppers are softened and the onions are well browned, about 5 to 6 minutes more.', 'When done, transfer the onions and bell peppers into a large gratin pan or casserole dish.', '2 Slice the eggplant, zucchini, and tomato in similar sized rounds: While the onions and peppers are cooking, slice the eggplant and zucchini in 1/4-inch thick round slices.', ""You'll also want to slice the tomato into 1/4-inch thick slices, but depending on how big your tomato is, you may need to cut the tomato in half or in quarters first."", 'All of the sliced vegetable pieces should be about the same size to make it easier to layer them in an attractive manner.', '3 Layer the eggplant, zucchini, tomato rounds on top of the onions, bell peppers as garlic: Preheat the oven to 350\\xc2\\xb0F (175\\xc2\\xb0C). Spread the cooked onions and bell peppers in an even layer at the bottom of the gratin dish. Place the mashed garlic on top of the onions and peppers.', 'Arrange the slices of the eggplant, zucchini, and tomato on top of the cooked onions and peppers, alternating the vegetables, in an attractive pattern, stacking them and fanning them across the surface of the dish.', '4 Top with salt, parsley, cheeses, olive oil: Sprinkle with salt and parsley. Top with Provolone and Parmesan cheeses.', 'Drizzle the remaining tablespoon of olive oil around the perimeter, where the vegetables meet the side of the dish.', '5 Cover with foil and bake, broil uncovered to finish: Cover with foil (it helps to grease the underside of the foil with a little olive oil so that the cheese as it melts does not stick to the foil).', 'Bake for 40 minutes at 350\\xc2\\xb0F (175\\xc2\\xb0C). Remove the foil. Turn on the broiler and broil for 5 minutes or until nicely browned.']",12
1431,Cheesy Summer Squash Saut\xc3\xa9 Recipe,5,15,20,"['2 pounds summer squash and/or zucchini, sliced', '1 green bell pepper, seeds removed, sliced', '2 smallish tomatoes or one large tomato, peeled and cut into wedges', '1/2 yellow onion, peeled and sliced', '1 clove of garlic, chopped', 'Extra virgin olive oil', '5 or 6 slices of cheese - jack or cheddar', 'Basil, either dry or chopped fresh', 'Salt and pepper']",9,"['1 Saut\\xc3\\xa9 onions, garlic, squash, and bell pepper: Put onion, garlic, squash, bell pepper into a large saucepan with a couple of tablespoons of olive oil. Put on high heat and brown the vegetables slightly to develop flavor.', 'As you are browning, sprinkle either dried basil or chopped fresh basil on the vegetables.', '2 Add cheese: When vegetables are slightly browned, remove from heat, add the slices of cheese, and cover the pan.', '3 Cook the tomatoes: In a separate stick-free fry pan, put the tomatoes and cook at medium hi heat for about 5 minutes, stirring occasionally. You want to let the juice from the tomatoes evaporate some.', '4 Combine: After 5 minutes, add the tomatoes to the rest of the vegetables and stir. Salt and pepper to taste.']",5
1432,"Pasta with Artichoke Hearts, Sun Dried Tomatoes, and Toasted Almonds Recipe",10,15,25,"['1 pound fusilli pasta (use gluten-free pasta for gluten-free version)', 'Salt', '1 14-ounce jar marinated artichoke hearts, drained, hearts cut into eighths, about 1 1/2 cups', '1/2 cup sun-dried tomatoes packed in oil, removed from oil (reserve oil), chopped', '1 cup chopped toasted almonds', '1 teaspoon lemon zest', '1 tablespoon lemon juice', '1/4 teaspoon black pepper', '1/2 cup chopped fresh parsley leaves, loosely packed, more or less to taste', '2 tablespoons extra virgin olive oil']",10,"['1 Cook the pasta, al dente: Bring a large pot of well salted water to a vigorous boil. Add the pasta to the boiling water and let cook, uncovered, at a full boil, for the amount of time specified on the pasta package, minus about 2 minutes. Test, the pasta should be cooked through, but still firm to the bite, al dente.', 'While the pasta is cooking, prep the other ingredients.', '2 Place the cut marinated artichoke hearts, the chopped sun-dried tomatoes, the toasted almonds, and lemon zest in a large bowl.', '3 Drain pasta, add to artichoke hearts: When the pasta is done, drain it, and add the pasta into the bowl with the artichoke hearts and sun-dried tomatoes. Toss gently to mix.', '4 Season with lemon juice, pepper, parsley, oil: Sprinkle lemon juice, parsley, and black pepper over the pasta, toss to mix.', 'Add 1 to 2 tablespoons of the sun-dried tomato oil to the pasta, and 1-2 tablespoons of olive oil. Toss to mix. Taste and adjust seasonings.', 'At this point you can make ahead and reheat to serve.', 'Serve warm.']",8
1433,Cauliflower Gnocchi with Creamy Sun-Dried Tomato Sauce Recipe,35,25,60,"['1 batch cauliflower gnocchi (or regular gnocchi), homemade or store-bought', '1 tablespoon olive oil', '1/4 cup finely chopped shallots', '1 tablespoon minced garlic', '2/3 cup julienned sun-dried tomatoes, oil drained', '1/2 cup unsalted vegetable stock', '1 cup half-and-half', '1/2 teaspoon sea salt', '1 teaspoon chopped fresh oregano, plus more for garnish  (or 1/2 teaspoon dried)', '1 tablespoon roughly chopped basil, plus more for garnish ( or 1 1/2 teaspoons dried)', 'Black pepper for garnish', '1/4 cup shaved Pecorino Romano cheese']",12,"['1 Bring a medium pot of lightly salted water to a boil. While this comes to a boil, make the sauce.', '2 Make the sauce: Heat a large saut\\xc3\\xa9 pan over medium-low heat. Add 1 tablespoon of olive oil to the pan. Once the oil is hot, add in shallots and garlic, saut\\xc3\\xa9 until fragrant and shallots are softened, 1 to 2 minutes. Add in 1/2 cup of the sun-dried tomatoes, and saut\\xc3\\xa9 for 30 seconds. Pour in the vegetable stock, half-and-half, and sea salt. Stir to combine.', 'Turn heat to medium-high. Simmer and stir occasionally until the sauce reduces and thickens, about 3 to 5 minutes.', '3 Cook the gnocchi: Your water should now be boiling. Carefully add the gnocchi and cook until they float to the surface, 3 minutes. Use a slotted spoon to drain the gnocchi and transfer directly to the skillet with the sauce.', 'Stir the cooked gnocchi, oregano, and basil into the sauce. If needed, continue to simmer and the sauce for a few additional minutes until it coats the gnocchi.', '4 Serve: Season gnocchi with black pepper, and top with the remaining sun-dried tomatoes, oregano, basil, and Pecorino Romano cheese.', 'Store the gnocchi in an air-tight container for up to 3 days in the fridge, reheating in 30 second intervals in the microwave, stirring in between.']",7
1434,BBQ Grilled Chicken Wings Recipe,5,90,95,"['3 pounds chicken wings', 'Salt', '2 tablespoons vegetable oil', 'For the sauce:', '1/2 cup (8 tablespoons or 1 stick) unsalted butter', '12 tablespoons hot sauce (Crystal, Texas Pete, Tabasco, etc)', '2 teaspoons Worcestershire sauce', '1 teaspoon salt', '1 teaspoon sugar', '1 teaspoon garlic powder', '1 teaspoon black pepper']",11,"['1 Make the sauce: Mix all of the ingredients together in a small pot set over low heat and stir constantly until the butter melts. Do not let it boil.', 'Once the butter melts, whisk the sauce vigorously off the heat and set aside. It should remain liquid throughout the cooking process. If it starts to solidify, heat it up just enough to melt it, whisking all the time.', ""2 Cut whole wings into parts: If you have whole chicken wings, you'll want to cut them into parts. (Here's How to Break Down Chicken Wings.) Using a sturdy chef's knife or poultry shears, cut off the wing tips and either discard or reserve (we usually freeze) for making chicken stock. Then use your knife or shears to separate the drumettes from the flats (the mid-joint wings)."", '3 Heat the grill: Prepare a gas or charcoal grill for low, indirect cooking.', '4 Grill the wings: Toss the wings with the vegetable oil and the salt, and arrange in one layer on the grill set over indirect low heat. If you are using charcoal or wood, it will be very difficult to do this, so set your fire on one side of the grill and arrange the wings on the other side, away from the direct heat.', 'You want them to cook slowly, with little or no sizzle. Cover the grill and cook like this for 30 minutes.', '5 Paint wings with sauce, continue to grill low and slow: Turn the wings and paint with the Buffalo wing sauce. Close the grill and cook for another 30 minutes. Repeat the process, until the wings are done to your liking, this time painting the wings every 15 minutes or so. Make sure you have a little leftover sauce to toss the wings with at the end.', '6 Serve immediately.']",8
1435,Buffalo Chicken Lasagna Recipe,30,45,75,"['4 tablespoons (1/2 stick) unsalted butter', '1/4 cup all-purpose flour', '1 quart whole milk', '8 ounces blue cheese crumbles', '1/2 teaspoon kosher salt', 'Ground black pepper', '4 cups cooked, shredded chicken', '1 cup hot sauce', '8-ounce package oven-ready lasagna noodles', '8 ounces shredded mozzarella cheese', 'Special equipment:', '9x13-inch (3 quart) baking dish']",12,"['1 Preheat the oven to 400\\xcb\\x9aF.', '2 Make the bleu cheese sauce: Make a roux by melting the butter in a saucepan over medium heat; add the flour and cook, stirring occasionally, until bubbly and slightly golden, 1 to 2 minutes.', 'Slowly whisk the milk into the butter-flour mixture. At first, the mixture will seize up and look crumbly, but will smooth out as you keep adding milk and whisking.', 'Once all the milk is added, bring to a simmer. Whisk frequently, scraping along the bottom of the pan, so as not to burn.', 'Cook until the mixture has thickened slightly and seems creamy, 10 to 15 minutes. Remove from the heat and add the blue cheese, salt, and a few grinds of black pepper. Stir until the cheese has melted. Taste and add additional salt and pepper as needed.', '3 In a separate bowl, toss the chicken with the hot sauce until evenly coated.', '4 Assemble the lasagna: Spread a few spoonfuls of cheese sauce over the bottom of a 9x13-inch (3-quart) baking dish. Arrange a single layer of pasta sheets on top of the sauce. Layer with a third of the shredded chicken mixture, about 1 cup of the blue cheese sauce, and then about 1/2 cup of mozzarella cheese.', 'Repeat this process 2 more times. Finish with a final layer of noodles, the remaining blue cheese sauce, and the remaining mozzarella.', '5 Bake the lasagna: Cover the dish with foil and bake for 35 minutes. Remove the foil and bake until bubbling and lightly browned around the edges, about 10 minutes more.', 'Cool about 15 minutes before serving.']",10
1436,Cacio e Pepe Chicken Wings Recipe,15,45,60,"['Canola, vegetable, or peanut oil, for frying', '3 pounds chicken wing sections, drumettes and flats', '1 tablespoon ground black pepper', '2 teaspoons kosher salt', '3/4 teaspoon garlic powder', '3/4 cup freshly grated Parmesan cheese', '6 tablespoons unsalted butter', 'Chopped fresh parsley, for serving (optional)', 'Ranch or blue cheese dressing, for serving']",9,"['1 Heat the oil: Fill a cast iron or other heavy-bottomed skillet with 1/2 inch of oil, place over medium heat, and heat the oil to 350\\xc2\\xb0F.', '2 Fry the chicken wings: Meanwhile, pat the chicken dry with paper towels, season with the salt, garlic powder, and 1 teaspoon of the ground black pepper.', 'Working in batches so as not to overcrowd the skillet, gently add the wings and fry, flipping about halfway through, until golden all over, about 15 minutes. Transfer the wings to a wire rack set inside a baking sheet; fry the remaining wings.', '3 Season the wings: Place the butter in a large, microwave-safe bowl; microwave in 30 second increments until the butter has melted. Add the fried chicken wings to the bowl along with 1/2 cup Parmesan cheese and the remaining 2 teaspoons black pepper; toss until the wings are evenly coated.', '4 Garnish and serve: Transfer the wings to a platter, top with the remaining 1/4 cup Parmesan cheese (or more if you want it extra cheesy), sprinkle with some chopped parsley (if using), and serve with the dipping sauce of your choice.']",5
1437,Sweet Potato Hash Browns Recipe,5,15,20,"['1/2 pound sweet potato (about half a large sweet potato), peeled and grated through the large grates of a box grater', '4 Tbsp butter', 'Salt', 'Pepper']",4,"[""1 Melt 2 Tbsp of butter in a cast iron pan on medium high heat. (If you don't have a cast iron pan, use a thick-bottomed skillet.) Note that you want the heat high enough so that the butter bubbles, but not so high that it browns or burns before you put the sweet potato in the pan."", '2 Working in batches if necessary (use 2 Tbsp of butter per batch), scoop large spoonfuls of grated sweet potatoes into the pan forming small mounds. Gently press to spread the mounds out a bit. Sprinkle with salt and pepper. (If using salted butter you may be able to skip the salt.)', '3 Cook undisturbed until they are nicely browned on one side, about 4 to 5 minutes, then carefully turn them over with a metal spatula to brown on the other side, 4 to 5 minutes more.', '4 When done, place on a cookie sheet in a warmed oven to keep warm until ready to eat. Serve with fried eggs and bacon!']",4
1438,Creamy Sweet Potato Soup Recipe,15,50,65,"['2 tablespoons butter', '1 medium onion, chopped (about 1 cup)', '2 celery ribs, chopped', '1 medium leek, white and light green parts only, sliced (see How to Clean Leeks)', '1 clove garlic, chopped (1 teaspoon)', '1 1/2 pounds (about 2 large) orange-flesh sweet potatoes (a.k.a. yams), peeled, cut into 1-inch pieces (about 5 cups)', '4 cups chicken stock (use vegetable broth for vegetarian option)', '1 cinnamon stick', '1/4 teaspoon ground nutmeg', '1/4 cup heavy cream', '3/4 cup milk', 'Salt', 'Pepper', '1/4 cup sour cream or plain yogurt']",14,"['1 Cook the onions, celery, leeks, and garlic: Melt the butter in a large, thick-bottomed pot over medium-high heat. Add the chopped onions and saut\\xc3\\xa9 for 3 to 4 minutes, then add the celery and leeks and saut\\xc3\\xa9 for 5 more minutes until softened. Add the garlic and cook a minute more.', '2 Make and simmer the soup: Add the sweet potatoes, chicken stock, cinnamon stick, and nutmeg. Increase the heat to high and bring to a boil. Reduce to a simmer, and simmer uncovered until the sweet potatoes can be easily pierced with a fork, about 20 minutes.', '3 Blend the soup: Remove the cinnamon stick. Use an immersion blender to pur\\xc3\\xa9e the soup or work in batches and pur\\xc3\\xa9e the soup in a standing blender.', '4 Finish the soup: Add the cream and milk to the soup. Heat on medium until the soup is heated through. Add salt and pepper to taste.', 'Sprinkle with more black pepper and swirl some water-thinned sour cream or plain yogurt over the soup to serve.']",5
1439,Sweet Potato and Black Bean Tacos Recipe,10,30,40,"['For the roasted sweet potatoes:', '1 to 2 medium sweet potatoes, cut into 1/2-inch cubes (about 2 cups cubed)', '2 tablespoons neutral cooking oil (such as grapeseed or canola)', '1/2 teaspoon kosher salt', '1 teaspoon chili powder', '1/2 teaspoon ground cumin', 'For the beans:', '2 tablespoons neutral cooking oil (such as grapeseed or canola)', '1/2 medium yellow onion, diced (about 1/2 cup diced)', '1/2 teaspoon kosher salt, plus more to taste', '1 clove garlic, minced', '1 jalape\\xc3\\xb1o, stemmed, seeded, and minced', '1 15-ounce can black beans, drained and rinsed', 'Apple cider vinegar or water, as needed', 'To serve:', '10 to 12 corn tortillas', '1/2 cup tomatillo salsa verde, homemade or store-bought', '1 ripe avocado, sliced thin', 'Fresh cilantro, roughly chopped', 'Lime wedges', '1/4 cup crumbled cotija cheese']",21,"['1 Preheat oven to 425\\xc2\\xb0F.', '2 Roast the sweet potatoes: In a medium-sized bowl, toss the sweet potatoes, 2 tablespoons oil, salt, cumin, and chili powder. Spread on a baking sheet in an even layer. Bake 15 minutes, then use a spatula to flip and stir the sweet potatoes. Roast another 15 minutes or until sweet potatoes have puffed up and have crisp, roasted edges.', '3 Make the black beans: While the sweet potatoes roast, heat 2 tablespoons oil in a medium saucepan over medium heat. Add the onions and 1/2 teaspoon salt, and saut\\xc3\\xa9 until soft and translucent, 5 to 7 minutes. Add the garlic and jalape\\xc3\\xb1o, and saut\\xc3\\xa9 2 minutes more. Fold in beans.', 'Cook, stirring occasionally, until the beans are soft and seasoned, about 10 to 15 minutes. If beans seem dry or bottom of pan starts to sizzle, add a splash of apple cider vinegar or water as needed. Taste and add salt as needed.', '4 Warm the tortillas: Briefly heat the tortillas one or two at a time in a dry skillet until warm. Transfer to a plate and cover with a towel to keep warm. Alternatively, warm a stack of 5 or fewer tortillas a time in the microwave, covered with a damp paper towel, in 30 second bursts until warmed through.', '5 Serve the tacos: Layer tacos with sweet potatoes and black beans. Serve with avocado slices, salsa, minced cilantro, and cotija cheese, letting everyone top their own tacos.']",6
1440,Holiday Spiced Sweet Potatoes (Yams) Recipe,2,65,67,"['3 to 4 pounds red-fleshed sweet potatoes (yams)', '1/4 cup (packed) brown sugar', '4 Tbsp butter', '1 Tbsp lemon juice', '2 teaspoons orange zest', '3/4 teaspoon ground cinnamon', '3/4 teaspoon ground allspice', '3/4 teaspoon ground nutmeg', '1/2 teaspoon kosher salt', 'Freshly ground black pepper']",10,"['1 Bake the sweet potatoes: Preheat oven to 400\\xc2\\xb0F. Pierce the sweet potatoes all over with the tines of a fork (this is to help release pressure as the potato cooks).', 'Put the potatoes on a foil-lined roasting pan or thick, rimmed baking sheet. Bake until the sweet potatoes are completely tender, about 50 minutes to an hour or more. Remove from oven and let sit until cool enough to touch.', '2 Remove the cooked sweet potato flesh from the skins: Cut the sweet potatoes lengthwise and scoop out the insides into a large bowl.', '3 Mix with brown sugar, butter, lemon juice, orange zest, spices: Stir in the brown sugar, butter, lemon juice, orange peel, cinnamon, allspice, nutmeg, and salt.', 'Use an electric mixer (or by hand with strong arms) to beat the sweet potatoes until they are completely smooth.', ""Sprinkle with a little ground black pepper to taste. Then taste! (But don't eat them all, even though you will be tempted.)""]",6
1441,Roasted Sweet Potato Soup Recipe,10,30,40,"['1 pound garnet sweet potatoes, peeled and cut into 1 1/2-inch cubes', '2 large shallots, peeled and cut in half lengthwise', '2 tablespoons extra virgin olive oil', '1/2 teaspoon kosher salt', '1 teaspoon ground thyme', '1/4 teaspoon of cumin seeds (or ground cumin)', '3 cups chicken stock', '1/8 teaspoon black pepper', '2 tablespoons sour cream or plain yogurt (Greek or regular, omit for paleo version)']",9,"['1 Preheat oven to 450\\xc2\\xb0F.', '2 Prepare the sweet potatoes: Place sweet potato cubes and shallots in a large bowl. Drizzle with oil. Sprinkle with salt, thyme, and cumin. Toss so all pieces are well coated with olive oil and seasonings.', '3 Roast the sweet potatoes: Spread the sweet potatoes and shallots out on a foil or silicone lined baking sheet. Roast for 25 minutes or until cooked through and nicely caramelized and browned around the edges. Remove from oven.', '4 While the sweet potatoes are roasting, heat chicken stock in a saucepan on the stovetop until steamy.', '5 Blend the sweet potatoes: Place the cooked sweet potatoes and shallots in a blender and add the hot chicken stock. Pur\\xc3\\xa9e until smooth.', 'NOTE: when blending hot liquids, fill the blender bowl no more than a third full, and start with short pulses. So, depending on the size of your blender you may need to work in batches. Or use an immersion blender.', '5 Serve: Taste for seasoning, add more salt and pepper to taste. Serve in bowls with a dollop of sour cream (if using). Leftovers will keep for about a week, or freeze for up to three months.']",7
1442,Sweet Potato Casserole with Pecans Recipe,30,35,65,"['For the filling:', '2 1/2 pounds sweet potatoes', '1/2 cup milk', '1/3 cup maple syrup', '1 large egg', '1/2 teaspoon ground cinnamon', '1/4 teaspoon ground ginger', '1/4 teaspoon freshly grated nutmeg', '1/4 teaspoon salt', 'Zest from 1 medium orange', 'For the crumble topping:', '3/4 cup chopped pecans', '1/2 cup all-purpose flour', '1/2 cup dark brown sugar', '4 tablespoons unsalted butter, softened to room temperature', '1/2 teaspoon ground cinnamon', 'Special equipment:', '2-quart baking dish', 'Food processor']",19,"['1 Preheat oven to 350F. Butter a 2-quart baking dish and set aside.', '2 Cook the sweet potatoes: Peel the sweet potatoes and cut them into 2-inch chunks. Place the chunks in a large pot and fill it with enough water to cover the potatoes.', 'Bring everything to boil, then reduce to a simmer and cook for 15 minutes, or until the sweet potato chunks can be easily pierced with a fork. Drain the sweet potatoes and let them cool for 5 minutes.', ""2 Working in batches, transfer sweet potatoes to a food processor and blend to make a smooth puree. Makes about 4 cups of puree. (At this point, the puree can be refrigerated for several days until you're ready to make the casserole.)"", '3 Make the sweet potato filling: Scoop all of the sweet potato puree into a bowl. Mix in the milk, maple syrup, egg, cinnamon, ginger, nutmeg, salt, and orange zest.', 'Pour the sweet potato puree into the prepared baking dish and spread to an even layer.', '4 Make the crumble topping: In a separate bowl, mix the pecans, flour, brown sugar, butter, and cinnamon together for the crumble topping. It should form large floury clumps. Sprinkle crumble over the sweet potatoes.', '5 Bake the casserole for 30 to 35 minutes, until the topping is a nice golden brown. Let the casserole cool for 10 minutes before serving.']",8
1443,Baked Sweet Potato Taquitos Recipe,15,20,35,"['For the filling:', '1/2 pound sweet potatoes, peeled and shredded (about 2 cups)', '1 (15-oz) can black beans, drained and rinsed; liquid reserved (or about 2 cups homemade beans)', '2 teaspoons garlic powder', '2 teaspoons chili powder', '1/2 teaspoon fine sea salt', '6 tablespoons minced fresh cilantro', '24 6-inch corn tortillas', '4 tablespoons olive oil for brushing', 'For the dip:', '1 cup creamy vegan cashew \\xe2\\x80\\x9ccheese\\xe2\\x80\\x9d sauce', '1/2 cup lightly packed chopped cilantro', '2 cloves garlic, crushed', '1/2 teaspoon sea salt', 'To serve:', 'Cilantro', 'Minced red onion']",17,"['1 Make the filling: In a medium skillet, combine the shredded sweet potatoes with the black beans, garlic powder, chili powder, salt, and 3 tablespoons of the bean liquid.', 'Simmer the mixture until the sweet potatoes are tender; 6 to 8 minutes. Lightly mash the black beans and stir in the minced cilantro.', '2 Warm the tortillas: Wrap tortillas in a damp towel and place in a 300\\xcb\\x9aF oven for roughly 10 minutes to warm. Alternatively, wrap the tortillas in damp paper towels and place in the microwave for 20 seconds or so.', '3 Assemble the taquitos: Place a tortilla in front of you. Scoop 2 to 3 tablespoons of the filling onto the third of the tortilla closest to you. Roll the edge closest to you over the filling and tuck the edge tightly under. Then, continue to roll.', ""Place the taquito seam side down on a baking tray lined with parchment. Stick with a toothpick if necessary to keep the filling from falling out. Repeat with remaining filling. (Depending on how much filling you've used with each taquito, you may have tortillas leftover.)"", 'At this point, the taquitos can be frozen for up to 6 months; see headnotes for detailed freezing and reheating instructions.', '4 Bake the taquitos: Preheat your oven to 425\\xcb\\x9aF. Brush with olive oil and bake for 18 to 22 minutes until tortillas are browning and crisp.', '5 Assemble the dip: While the taquitos are baking, in a small bowl combine the cashew cream with the cilantro, garlic, and salt.', ' 6 Serve: Serve the taquitos with the cashew dip drizzled on top, along with a sprinkle of cilantro and minced red onion, if desired.']",9
1444,Sweet Potato Pie with Pecan Topping Recipe,75,90,165,"['Pie Crust:', '1 1/4 cups (160g) all purpose flour', '1 Tbsp sugar', '1/2 teaspoon salt (skip the salt if using salted butter)', '10 Tbsp (140g) cold butter, cut into 1/2-inch cubes', '3 Tbsp ice water', 'Pie Filling:', '2 eggs', '2 pounds (900g) sweet potatoes (about 2 medium sized sweet potatoes)', '3 Tbsp melted butter', '1/4 cup (55g) brown sugar', '2 Tbsp granulated white sugar (can reduce to 1 Tbsp if you want less sugar)', '1 teaspoon ground cinnamon', '1/2 teaspoon ground nutmeg', '1/8 teaspoon ground ginger', '1 1/2 teaspoons vanilla extract', '1 Tbsp bourbon whisky (optional)', '7 ounces (210ml) sweetened condensed milk', 'Pie Topping', '3 Tbsp butter', '1/2 cup (64g) brown sugar', '1 Tbsp heavy whipping cream', '1 cup pecans (110g), half of them roughly chopped, the other half whole']",23,"['1 Make the pie dough: If you are making the pie crust from scratch, make the pie dough at least an hour in advance of making the pie. To make the dough, put the flour, sugar, and salt in a food processor and pulse a couple of times to blend.', 'Add half of the butter and pulse several times. Add the rest of the butter and pulse several more times, until the butter pieces are not bigger than the size of a pea.', 'Add 2 tablespoons of ice water and pulse a couple of times. Add another tablespoon, and maybe just a teaspoon more if needed, and pulse, just enough so that the dough holds together when you pinch it with your fingers.', 'Empty the food processor bowl onto a clean surface and gather the dough into your hands and form a ball. Flatten to a smooth disk about 6 inches wide. Wrap tightly in plastic wrap and chill for 1 hour.', '2 Bake the sweet potatoes: Pierce the sweet potatoes with the tines of a fork in several places.', 'Put on a foil lined baking sheet and bake in a 350\\xc2\\xb0F oven for 1 hour, or until cooked through and soft.', 'Remove the sweet potatoes from oven when done and let cool.', '3 Roll out the pie dough, line pie dish, freeze: Remove the dough disk from the refrigerator and let sit for 5 to 10 minutes before rolling it out. Place it on a clean, lightly floured surface. Roll out the dough into a 14-inch round, large enough for a 9-inch pie plate.', 'Place on dough on and in the pie dish, turn the edges under and crimp the edges. Poke the bottom of the crust a few times with tines of a fork.', 'Place into the freezer to chill.', '4 Mash the cooked sweet potatoes: When the cooked sweet potatoes are cool enough to handle, scoop out the flesh into a bowl. Mash with a potato masher. You should have 2 cups of sweet potato pur\\xc3\\xa9e.', '5 Beat eggs with sugars, spices, bourbon, sweetened condensed milk: In a separate large bowl, beat the eggs. Whisk in the butter, brown sugar, white sugar, cinnamon, nutmeg, ginger, vanilla extract, bourbon whisky (if using), and sweetened condensed milk.', '6 Combine egg mixture with mashed sweet potatoes, pour into pie shell: Whisk together the egg sugar mixture with the mashed sweet potato until smooth. Pour into the frozen, unbaked pie shell. Smooth surface so that it is even.', '7 Bake: Bake at 350\\xc2\\xb0F for one hour or until the filling has set. Remove from oven and let sit to cool down for 30 minutes or so.', '8 Make pecan topping: Melt 3 Tbsp butter in a small saucepan over medium heat. Add 1/2 cup of brown sugar and cook, stirring, until smooth, a couple of minutes. The sugar should bubble up a bit.', ""Stir in 1 Tbsp of heavy whipping cream. The mixture should bubble up a lot. As soon as you've mixed in the cream, add the pecans. Stir to coat the pecans with the sugar mixture."", 'As soon as the pecans are coated with the sugar mixture, pour them over the top of the pie. Use the back of a metal spoon to spread them out in an even layer on the top of the pie.', 'Let the pie cool for a few minutes before serving.']",18
1445,Maple-Glazed Yams with Pecan Topping Recipe,15,45,60,"['3 pounds of yams (red-fleshed sweet potatoes), peeled, cut into 1/4 inch-thick rounds', 'Salt', '1 teaspoon orange zest (optional)', '1/2 cup maple syrup', '6 Tbsp chilled butter, cut into 1/2 inch pieces (divided 2 Tbsp and 4 Tbsp)', '1 1/2 cups pecans, divided (3/4 cup and 3/4 cup)', '1/3 cup brown sugar, packed']",7,"['1 Preheat the oven to 400\\xc2\\xb0F.', '2 Cook yams in boiling water: Heat a large pot of salted water (add a tablespoon of salt for every two quarts of water) until boiling. Add the yam rounds. Cook the yams until the water starts to simmer again, about 4 minutes. Remove from heat, drain, then rinse in cold water.', '3 Layer yam rounds in baking dish, with butter, zest, maple syrup: Butter a baking dish. Arrange the yam rounds in the baking dish, overlapping the pieces, layering the yam rounds to fill up the dish.', 'Sprinkle each layer liberally with salt. Sprinkle the yam rounds with orange zest if using. Pour maple syrup over yams. Dot with 2 Tbsp of the butter.', '4 Bake 20 min: Cover with aluminum foil and bake until yams are almost tender, about 20 minutes.', '5 Make pecan topping: While the yams are baking put 3/4 cup pecans in a blender or spice grinder and grind into a coarse meal. Coarsely chop the other 3/4 cup of pecans.', 'Mix the ground pecans and brown sugar together in a medium bowl. Using your fingers, mix in the remaining 4 Tbsp of butter until the mixture resembles a coarse meal. Mix in the chopped pecans.', '6 Sprinkle topping over yams, bake 15 min more: Sprinkle the pecan mixture over the yams. Bake the yams, uncovered, until the topping browns, about 15 minutes.']",8
1446,"Sweet Potato Waffles with Fried Egg, Bacon, and Scallions Recipe",20,20,40,"['For the waffles:', '12 ounces bacon', '1 cup (140g) flour', '6 tablespoons (103g) cornmeal', '2 teaspoons baking powder', '1/2 teaspoon baking soda', '1/2 teaspoon salt', '3 large eggs', '3/4 cup sweet potato mash (See Recipe Note)', '1 1/2 cups buttermilk', '2 tablespoons melted butter', '3 scallions, thinly sliced', 'Cooking spray or vegetable oil (for the waffle iron) ', 'For the fried eggs:', '1 tablespoon unsalted butter', '4 or more large eggs (at least one per person)', 'Honey, for drizzling', 'Special equipment:', 'Waffle iron']",19,"['1 Cook the bacon: In a large skillet over medium heat, cook the bacon until brown and crisp. Drain on paper towels. Break each slice into a few pieces (large pieces or crumbles, whichever you like!).', ""2 Heat the waffle iron: Get the waffle iron heating so that it's piping hot when you're ready to make your first batch of waffles. Also, place a baking sheet in the oven and set the oven to its lowest temperature to keep the finished waffles warm before serving. "", '3 Mix the dry ingredients: In a bowl, whisk the flour, cornmeal, baking powder, baking soda and salt until combined.', '4 Separate the eggs and beat the whites: Separate the yolks and whites into separate bowls. With an electric mixer, beat the egg whites until soft peaks form. Set aside.', '5 Prepare the batter: In a large bowl, whisk the egg yolks, mashed sweet potato, buttermilk, and melted butter until smooth. Add the dry ingredients and stir until blended. Gently fold in the egg whites. Stir in the scallions, reserving a few for sprinkling over the top.', '6 Cook the waffles: Brush or spray the waffle iron with vegetable oil. Ladle the batter into the waffle iron\\xe2\\x80\\x94the amount will vary according to the size of your particular waffle iron; use enough to fill the mold. Top with a few bacon pieces and close the lid.', 'Bake the waffles until brown and crispy. Repeat until all the batter is used. Keep the finished waffles warm in the oven while you make the eggs.', '7 Fry the eggs: In a skillet over low heat, melt the butter. Swirl the pan to coat the bottom. Break the eggs into the skillet, and cover the pan.', 'Cook for 2 minutes, or until all but a thin rim of egg white around each yolk is opaque. Remove the pan from the heat, keep covered, and let sit for about 30 seconds to finish cooking.', '8 Serve the waffles: Drizzle a little honey on each waffle and top with a fried egg.']",10
1447,Sweet Potato Mash with Mint Recipe,10,45,55,"['3 pounds light yellow sweet potatoes (boniato if you can get them), peeled, cut into 2 inch chunks', '1/4 cup extra virgin olive oil', '1/2 cup to 1 cup (or more) water', '1/4 cup minced onion', '1/2 small garlic clove, minced', '1/4 cup chopped mint leaves, packed, (about 30-40 leaves)', '2 tablespoons minced cilantro, packed', 'Salt', 'Sugar', '1/4 teaspoon vanilla extract']",10,"['1 Roast the sweet potatoes: Rub olive oil all over the sweet potato pieces, sprinkle lightly with salt, and put them in a roasting pan, cook at 425\\xc2\\xb0F for 40 minutes, until cooked through and lightly browned and a fork easily pierces through the pieces.', '2 Mash the sweet potatoes, add water: Place cooked sweet potato pieces in a large bowl, add olive oil, mash with a potato masher until completely mashed. Slowly add water, stirring with a wooden spoon until the sweet potatoes reach desired consistency.', '3 Stir in the onions, garlic, mint, and cilantro. Stir in vanilla extract. Add more salt, and maybe a little sugar if you want, to taste.']",3
1448,Sweet Potato Jack-o-Lanterns with Cinnamon Sugar Recipe,25,35,60,"['One 1 1/2 to 2 pound sweet potato, in a even cylindrical shape if possible, wide enough for your cookie cutter form to cut out patterns', '3 Tbsp butter, melted (for dipping)', '6 Tbsp white granulated sugar (for dredging)', '1 teaspoon ground cinnamon', 'Equipment needed:', 'Pumpkin shaped cookie cutter (small enough to fit within a slice of sweet potato)', 'A sharp paring knife']",7,"['1 Peel the sweet potato. Cut into 1/4 inch rounds. Use pumpkin shaped cookie cutter to cut each round into a pumpkin shape. Use a paring knife to carefully cut out eyes and mouths. (This part is a bit challenging, if you find it too difficult, just skip.)', '2 Place the cut sweet potato rounds on a parchment or silpat lined baking sheet. Bake at 450\\xc2\\xb0F (230\\xc2\\xb0C) for 35 minutes (more or less depending on thickness of slice) until lightly browned on both sides and cooked inside. Remove from oven.', '3 Melt butter either on stove or in microwave and place in a small bowl.  Mix sugar and cinnamon in a separate bowl.', '4 Dip each sweet potato round into melted butter.  Then place the round in the cinnamon sugar to coat the jack-o-lanterns with cinnamon sugar.  Place the rounds on a rack over a baking sheet to dry.', 'Enjoy!']",5
1449,Pressure Cooker BBQ Chicken Stuffed Sweet Potatoes Recipe,5,45,50,"['For the chicken:', '1 1/2 pounds boneless skinless chicken breasts (if they\\xe2\\x80\\x99re more than 8 ounces, cut them in half)', '1/2 teaspoon salt', '1/2 teaspoon ground black pepper', '1 tablespoon vegetable oil', '1 medium yellow onion, sliced', '2 cloves garlic, chopped', '6 (4 1/2 to 6 ounces each) sweet potatoes', '1/2 cup water', '1/2 cup barbecue sauce (homemade or your favorite brand)', 'For the toppings:', '3/4 cup grated cheese (cheddar, Monterey Jack, or a blend)', '2 tablespoons chopped fresh cilantro', '2 green onions, sliced thinly']",14,"['1 Sear the chicken: Season the chicken breasts all over with the salt and pepper.', 'Select the Saut\\xc3\\xa9 setting on your electric pressure cooker and heat the oil for 3 minutes, until shimmering. Using a pair of tongs, lower the chicken breasts into the pot and sear them for 3 minutes per side (6 minutes total), until lightly browned. Transfer the chicken to a dish.', '2 Cook the onions and garlic: Add the onion to the pot and saut\\xc3\\xa9 for about 2 minutes, until it starts to soften. Add the garlic and saut\\xc3\\xa9 another 30 seconds or so, just until it is no longer raw.', '3 Assemble everything in the pressure cooker: Add the water and use a wooden spoon to nudge any browned bits off of the bottom of the pot. Add the chicken back to the pot, nestling it in with the onions and garlic.', 'Lower a tall metal steam rack into the pressure cooker, making sure all of its legs are touching the bottom of the pot. Arrange the sweet potatoes on top of the rack in a single layer.', '4 Pressure cook the potatoes and chicken: Secure the lid on your pressure cooker in its Sealing position. Cancel the Saut\\xc3\\xa9 program, then select the Manual or Pressure Cook program for 10 minutes at high pressure. (It will take about 10 minutes for the pot to come up to pressure before the cooking program begins.)', 'While the recipe cooks, line a sheet pan with foil and set it aside.', '5 Release the pressure: As soon as the cooking program ends, perform a quick pressure release by moving the Pressure Release to its Venting position, releasing the steam. (At this point, the pressure cooker can be left on the \\xe2\\x80\\x9cWarm\\xe2\\x80\\x9d setting for up to 10 hours.)', 'Use tongs to gently transfer the sweet potatoes to the foil-lined sheet pan. Remove the chicken to a cutting board or dish.', '  6 Make the BBQ sauce: Stir the barbecue sauce in with the liquid and onions in the pot. Cancel the Keep Warm program, select the Saut\\xc3\\xa9 setting, and let the mixture boil and reduce for 8 to 10 minutes, stirring occasionally, until thick and glazy (the timing will vary slightly depending on how much sugar is in your barbecue sauce).', '7 While the sauce is reducing, use a pair of forks to shred the chicken.', '8 Mix the chicken with the BBQ sauce: Turn off the Saut\\xc3\\xa9 program. Add the chicken back to the pot and toss to combine.', '9 Stuff the potatoes and broil: (You can skip this step if you like. Everything is already cooked through\\xe2\\x80\\x94it\\xe2\\x80\\x99s just to get the cheese bubbly and browned.)', 'Heat your broiler to high with a rack positioned a few inches below the heating element.', 'Split the sweet potatoes in half lengthwise, then stuff them with the chicken mixture. Top each sweet potato with two tablespoons of shredded cheese.', 'Broil for 2 to 3 minutes, until the cheese is bubbly and beginning to brown in spots. Remove from the oven, then sprinkle with cilantro and green onions. Serve hot.', 'Leftovers will keep for 3 to 4 days and can be reheated in the microwave.']",17
1450,Crispy Sweet Potato Pancake Lettuce Wraps Recipe,10,12,22,"['For the nuoc cham dipping sauce:', '1 tablespoon plus 1 teaspoon sugar', '1 1/2 to 2 tablespoons fresh lime juice', '1/4 cup warm water, or as needed', '1 teaspoon unseasoned Japanese rice vinegar (optional)', '1 1/2 to 2 tablespoons fish sauce', '1 Thai or serrano chile, thinly sliced (keep seeds intact); or 1 to 1 1/2 teaspoons chile garlic sauce or sambal oelek (optional, good for heat)', '1 garlic clove, minced (optional, good for pungency)', 'For the pancakes and garnishes:', '3 cups (12 ounces) grated white sweet potato (buy a one-pounder for easy prep)', '1 cup (3 1/2 ounces) grated carrot (start from a 4 ounce carrot)', 'Rounded 1/2 teaspoon fine sea salt', '3 tablespoons lightly packed, finely chopped green onion (green and white parts)', '1/4 teaspoon freshly ground black pepper', '2 teaspoons fish sauce', '1 tablespoon cornstarch', '3 tablespoons white or brown rice flour, such as Bob\\xe2\\x80\\x99s Red Mill (or all-purpose flour)', '1 large egg', 'About 1/3 cup canola or other neutral oil', 'Leaves from 1 head of soft-leaf lettuce, such as butter, Boston, or red leaf', '6 to 8 bushy sprigs mint, basil, or other soft leaf herbs', '10 to 12 sprigs cilantro']",22,"['1 Make the nuoc cham sauce: Combine 1 tablespoon of the sugar, 1 1/2 tablespoons of the lime juice, and the water.', 'Taste the limeade, and if needed, add the remaining 1 teaspoon sugar and/or 1 1/2 teaspoons lime juice; dilute with water if you go too far. If there\\xe2\\x80\\x99s an unpleasant tart-bitter edge, add the vinegar to rounds things out.', 'Finally, add the fish sauce to create a bold, forward finish. If desired, add the chiles and/or garlic. Set aside. You should have 1/2 cup of nuoc cham, and this can be made and refrigerated up to 8 hours before serving.', '2 Salt and squeeze out the sweet potato and carrot: In a large bowl, combine the grated sweet potato, carrot, and salt. Massage with both hands until wet and squishy, about 1 minute. Transfer the grated veggies to a piece of muslin or a non-terry dish towel, and wrap the veggies in the towel. Standing over the sink, firmly squeeze and twist to expel moisture.', 'Dump the veggies into a dry bowl.', '3 Assemble the pancake batter: Add the green onion, mixing with a fork to distribute well. Mix in the pepper, fish sauce, cornstarch, and rice flour. Add the egg, break it up with a fork, and mix well. Press the mixture down to compact it, and then divide into 8 portions like a pie, using a 1/4  cup measuring scoop.', '4 Fry the pancakes: Warm a large nonstick skillet over medium heat, then add about 2 tablespoons of oil to film the bottom. Fry in two batches, 4 pancakes at a time.', 'For each one, use a fork and your fingers to scoop up the 1/4 cup portions of the potato-and-carrot mixture (one wedge of the ""pie""). Deposit into the skillet, spreading and flattening the mixture with the measuring cup bottom and fork to make a 3 1/2-inch-wide pancake (mine often look like Australia).', 'Fry for about 3 minutes, until bits of the fringe-like edges are richly brown and crisp. Drizzle 2 to 3 teaspoons of oil on top of the pancakes, then wield 2 spatulas to carefully flip each one over. (The pancakes are delicate, so 2 spatulas are super handy.)', 'Fry for about 3 minutes longer, until crisp and brown underneath. Cool on a rack. Fry the remaining batch.', '5 Assemble and serve the lettuce wraps: Serve with the lettuce, herbs, and sauce. Invite guests to build their own lettuce leaf wraps containing a piece of pancake (pass scissors or use forks/fingers to break up the pancakes into smaller pieces suitable for wrapping up), with 2 or 3 herb leaves and/or torn cilantro sprigs. Dip in the sauce and eat. These are really best the day they are made.']",11
1451,Apple and Sweet Potato Matzo Bake Recipe,15,80,95,"['6 large eggs', '1/2 teaspoon salt', '1/2 teaspoon ground black pepper', '2 cups hot water', '6 sheets (6 ounces) matzo crackers, broken into 1-inch pieces', '1 1/2 pounds sweet potatoes, peeled and sliced into 1/8-inch-thick rounds', '2 large Fuji or gala apples, peeled, quartered, cored, and sliced into 1/4-inch-thick slices', '1 teaspoon cinnamon', '2 tablespoons margarine']",9,"['1 Preheat oven and prepare baking dish: Preheat the oven to 325\\xc2\\xba F. Grease a 9x13 baking dish with margarine, olive oil, or grapeseed oil.', '2 Beat the eggs and soak the matzo: In a medium bowl, beat the eggs, salt, and pepper until no streaks of yolk remain.', 'In separate large bowl, pour the hot water over the matzo crackers. Let sit for just a minute. Drain the excess water.', '3 Add the eggs mixture to the matzo: Pour the egg mixture over the drained matzo and gently fold to combine. You don\\xe2\\x80\\x99t want to break up or smush the matzo pieces too much, just coat them evenly in egg.', '4 Layer the potatoes and apples: Place half of the sweet potato slices in the baking dish in an even layer. Place half of the apple slices on top of the sweet potatoes, then sprinkle 1/2 teaspoon of the cinnamon over the apples. Spoon half of the matzo/egg mixture over the apples and spread it out in an even layer.', 'Repeat the layers of sweet potato, apple, cinnamon, and matzo/egg mixture once more, then cover the dish with aluminum foil, making sure the foil isn\\xe2\\x80\\x99t touching the matzo.', '5 Bake the casserole and dot with margarine: Bake the casserole, covered, for 1 hour. Remove from the oven, uncover, and poke with a paring knife or toothpick to make sure the sweet potatoes are softened and cooked through. (If they aren\\xe2\\x80\\x99t soft yet, re-cover the casserole and bake for another 10 minutes, or until the sweet potatoes are soft enough to easily pierce.)', 'Dot the top of the casserole with margarine and bake, uncovered, for another 5 minutes, until the margarine is melted and the matzo is lightly browned.', '6 Cool and cut: Remove the matzo bake from the oven, let stand for 15 minutes, then cut into slices and serve warm.']",9
1452,Saut\xc3\xa9ed Chard with Parsnip Recipe,10,8,18,"['2 tablespoons extra virgin olive oil', '2 cloves garlic, minced', '1 large bunch of Swiss chard, thoroughly rinsed, thick center stem removed, leaves cut into 1/2-inch wide ribbons', '1 medium sized parsnip root, peeled to remove the outer skin, then completely peeled into ribbons using the vegetable peeler (except for center if tough)', 'Salt', 'Pepper', 'A drizzle of balsamic vinegar or lemon juice']",7,"['1 Saut\\xc3\\xa9 garlic in olive oil: Heat olive oil in a large saut\\xc3\\xa9 pan on medium high heat. Add the minced garlic and cook for 1 minute, or until fragrant.', '2 Add chard and parsnip ribbons: Add the chard and ribbons of parsnip to the pan. Use tongs to turn over in the pan to coat with the olive oil and garlic. Keep turning until the chard begins to wilt. Sprinkle with salt and pepper. Lower the heat to low and cover the pan for a couple minutes.', '3 Sprinkle with balsamic: Drizzle with a little balsamic vinegar or lemon juice to serve.']",3
1453,Saut\xc3\xa9ed Swiss Chard with Mustard Seeds Recipe,5,8,13,"['1 large bunch of Swiss chard, rinsed', '1 tablespoon extra virgin olive oil', '1/4 cup sliced shallots or chopped onions', '1 tablespoon whole mustard seeds', 'Salt', '2 tablespoons seasoned rice vinegar (can sub with plain rice vinegar and large pinch of sugar)']",6,"['1 Prepare the chard leaves: Leaf by leaf, cut out the tough center stem. Slice the stems crosswise in 1/4-inch to 1/2-inch pieces. Keep separate from the leaves. Slice the leaves crosswise into 1-inch thick strips.', ' ', '  2 Saut\\xc3\\xa9 chard stems, shallots, mustard seeds: Heat oil in a large, wide, stick-free saut\\xc3\\xa9 pan on medium high heat. Add the chopped chard stems, the shallots or onions, and the mustard seeds. Sprinkle a little salt over the chard. Saut\\xc3\\xa9 until the onions or shallots become translucent.', '3 Add chopped chard leaf greens: When some of the mustard seeds may start to make a popping noise, add the chard leaf greens. Sprinkle on a little more salt and toss to coat with the oil and onion mixture.', '  4 Finish by steaming in pan: Reduce the heat to low and cover the pan. Let cook for a couple minutes only, lifting up the pan cover to turn the greens over in the pan after the first minute. The greens should cook down considerably. When they are just wilted, remove from heat and place in a serving bowl.', '  5 Sprinkle with seasoned rice vinegar right before serving.']",6
1454,"Chicken Stew with Coriander, Cilantro, and Chard Recipe",15,75,90,"['Broth', '10 cardamom pods (or 1 1/2 teaspoons cardamom seeds)', '10 black peppercorns', '1 cinnamon stick', '1 bay leaf', '1/2 red onion', '1/2 lemon', '1 whole 4 lb (2 kg)chicken, cut into parts', '9 cups water', '1 teaspoon Kosher salt, plus more to taste', 'Stew', '3 Tbsp unsalted butter', '6-8 garlic cloves, minced', '2 Tbsp ground coriander seeds', '1 teaspoon Kosher salt', '1/2 teaspoon ground white pepper', '4 cups roughly chopped cilantro, including tender stems, loosely packed (about 120 g)', '4-5 cups broth (you will make this in the recipe)', '1/2 red onion, finely chopped', '1/4 cup red wine vinegar', '1 Tbsp lemon juice', '2 pounds chard, ribs removed, leaves cut crosswise into 1 inch strips', 'Salt']",23,"['The Broth', ""1 Start making the broth: If you are using cardamom pods, break them open in a mortar and pestle or with the handle of a chef's knife. Crack the black peppercorns as well."", 'Put the crushed cardamom and black peppercorns, cinnamon stick, bay leaf, onion, lemon, and chicken into a large pot.', 'Add 9 cups of water. Bring to a boil, then lower the heat to a simmer. Skim any any frothy scum that collects on the surface of the broth.', '2 Remove the chicken: After about 20 minutes, remove the chicken breast pieces and set aside.', ""Once the broth has cooked for 45 minutes to an hour (the timing doesn't need to be precise), turn off the heat and remove the chicken legs and thighs from the pot."", '3 Strain the broth: Strain the broth through a fine-meshed strainer and reserve 4-5 cups. Add the salt to this both and taste.  Add more salt to taste. Save the remaining broth for another recipe (it will freeze well).', '4 Strip off usable meat from chicken: Remove and discard the chicken skin from the chicken parts . Strip off all the usable meat from the chicken and shred it by hand. Set it aside. Discard the bones.', 'The Stew', '1 Heat 2 Tbsp of the butter in a large pot over medium-high heat. Add the garlic cloves, ground coriander, salt, white pepper and stir to make a paste. Cook for 1-2 minutes, until fragrant, stirring often.', 'Add half the cilantro and cook until it wilts.', '2 Add the broth (four cups makes a rather dry stew, 5 cups is a little looser) heat it to a simmer and cook for 15-20 minutes.', '3 While the broth simmers, mix the vinegar, lemon juice and red onion together in a bowl. Set aside.', '4 Stir in the chard leaves a little at a time, adding more only when the previous batch has wilted. Add the shredded chicken and cook everything for 8-10 minutes.', '5 While the stew is in its final simmer, heat the last Tbsp of butter in a small pan over medium-high heat. Wilt the remaining cilantro in the butter and cook for a minute or two.', 'To serve, add the cilantro and the onion mixture to the stew, mix well and add salt to taste.', 'Serve with bread, rice or potatoes.']",17
1455,Swiss Chard Tzatziki (Yogurt Dip) Recipe,10,15,25,"['Tzatziki yogurt dip:', '3 to 4 large leaves of Swiss chard, ribs removed', '1 cup plain Greek yogurt', '1 1/2 Tbsp chopped fresh mint leaves', '1 garlic clove, finely chopped', '1/4 teaspoon salt', '1 Tbsp extra virgin olive oil', '1 teaspoon lemon zest', '1 Tbsp lemon juice', 'Pita chips:', '3 (9-inch diameter) pita breads, cut like a pie into triangles', 'Olive oil for drizzling on to the pita bread']",12,"['1 Blanch and chop the chard: Bring a 1 or 2 quart saucepan, half filled with water, to a boil. Add the chard leaves. Cook until tender, about 3 minutes.', 'While the chard is cooking, prepare a bowl with ice water for an ice bath. When the chard is cooked, remove it with a slotted spoon and put into the ice bath to stop the cooking.', 'When the chard has cooled, remove it from the ice water and bunch it into a ball. Wrap it in a paper towel and squeeze hard to remove excess moisture.', 'Chop up the chard.', '2 Combine tzatziki ingredients: Put the Greek yogurt, chopped chard, chopped mint, garlic, salt, olive oil, lemon zest and lemon juice in a medium bowl. Stir to combine. Chill until ready to use (can make up to 3 days ahead).', '3 Toast the pita bread: Cut the pita bread into triangles and layout in one layer in a broiling pan (use a sturdy sheet pan or broiling pan, not a thin cookie sheet or your cookie sheet will warp).', 'Drizzle olive oil on one side of the pita wedges. Use a pastry brush to spread the olive oil more evenly.', 'Place under a broiler. Broil for 5 minutes or until the pita bread starts to toast. Remove and let cool for a minute.', '4 Serve: Drizzle the tzatziki with a little olive oil and serve with toasted pita wedges.']",9
1456,Swiss Chard with Olives Recipe,5,10,15,"['1 ounce pitted green olives (about 10 medium sized), roughly chopped or sliced', '1/2 teaspoon minced fresh rosemary', '1 green onion or shallot, chopped', '1/2 teaspoon capers', 'Extra virgin olive oil', '1 large bunch of Swiss chard, rinsed and patted dry', 'Freshly ground black pepper to taste']",7,"['1 Make olive, rosemary, green onion, caper mixture: Mix together the olives, rosemary, green onion, and capers with a tablespoon of olive oil and let sit while you prep the chard.', '2 Prep chard leaves and stems: Use a knife to cut along the edges of the main stem of each leaf of chard, remove the stems. Cut the stems into 1/2-inch slices and set aside.', 'Cut the leaves separately into 1-inch thick crosswise ribbons. Keep the leaves and the stems separate as you will be cooking them separately.', '3 Saut\\xc3\\xa9 chard stems: Heat a large, stick-free saut\\xc3\\xa9 pan on medium high heat. Coat the bottom of the pan with about a tablespoon of olive oil, just enough to coat. When the oil is hot, add the chard stems. Cook for a couple of minutes, stirring often, until they begin to soften.', '4 Add olive mixture, then chard leaves: Stir in the olive mixture. Cook for a minute more, then add the chopped chard leaves to the pan.', 'Use tongs or two large spoons to toss the chard leaves in with the rest of the mixture, so that the chard gets coated with olive oil.', '5 Cover, reduce heat: Cover the pan and reduce the heat to low. Let cook a few minutes, lift the cover every once in a while to turn the leaves over in the pan. Once the chard has all wilted, remove from heat.', 'Sprinkle with black pepper to taste.']",8
1457,Grilled Swordfish Steaks with Lemon Oregano Marinade Recipe,70,15,85,"['Marinade ingredients:', '1/2 cup extra virgin olive oil', '1 1/2 tablespoons lemon juice', '2 teaspoons minced fresh oregano', '2 teaspoons minced fresh thyme', '2 large cloves garlic, crushed', '1 teaspoon lemon zest', '1 teaspoon dried oregano', '1 teaspoon fennel seeds, crushed', '1/2 teaspoon black pepper', '1/4 teaspoon salt', 'Fish:', '2 6-8-ounce swordfish steaks', 'Olive oil for grill grates', 'Slices of fresh lemon for garnish']",15,"['1 Make marinade: Place all marinade ingredients in a small bowl, mix to combine.', ""2 Marinate the swordfish: Rinse the swordfish steaks in cold water and pat dry. (Don\\'t remove the fish skin, it will help keep the steaks from falling apart when grilling. You can always remove after the fish is cooked before serving, if you want.)"", 'Place the fish in a non-reactive dish and cover with the marinade. Coat on all sides with the marinade. Cover and refrigerate for a half hour to an hour.', '3 Prepare the grill: Prepare your grill for high direct heat. You know the grill is hot enough when you place your hand one inch above the grill grates and you can only keep it there for 1 second.', ""Wipe the grill grates with a paper towel infused with olive oil to oil the grates so the swordfish steaks don\\'t stick when you turn them over."", '4 Grill the swordfish steaks: Brush off excess marinade (not all of it, just most) from the swordfish steaks. Place the swordfish steaks on the hot grill grates. Grill for about 5 to 7 minutes on one side, until you have good grill marks.', 'Turn over and cook for a few minutes longer, until the fish is just cooked through. Remove from heat and let rest a few minutes before serving.', 'Serve with slices of fresh lemon.']",8
1458,Pressure Cooker Shredded Chicken Taco Meat Recipe,5,40,45,"['For the spice rub:', '2 tablespoons chili powder', '2 teaspoons ground cumin', '1 teaspoon kosher salt', '1 1/2 teaspoons dried oregano', '1 teaspoon onion powder', '1 teaspoon garlic powder', '1/4 teaspoon ground cinnamon', '1/4 teaspoon allspice', '1/4 teaspoon cayenne', 'For the chicken:', '2 1/2 pounds (about 8 medium) boneless skinless chicken thighs', '3/4 cup (6 ounces) pineapple juice', '2 tablespoons ketchup', 'For the tacos:', '1 dozen corn tortillas', '1 to 2 cups shredded red cabbage', '1/2 cup sliced radishes', '2 large avocados, cut into chunks', '1/4 cup chopped cilantro', '2 limes, cut into wedges', 'Special equipment:', '6-quart Instant Pot or other electric pressure cooker']",23,"[' 1 Make the spice rub: In a small bowl, whisk together the ingredients for the spice rub.', '2 Combine everything in the pressure cooker: Add the chicken to the pressure cooker. Arrange the thighs in a single layer in the pot. Sprinkle with the spice blend, then pour over the pineapple juice and ketchup. Stir to coat the chicken evenly.', '  3 Pressure cook the chicken: Place the lid on your pressure cooker. Make sure that the pressure regulator is set to the \\xe2\\x80\\x9cSealing\\xe2\\x80\\x9d position. Select the \\xe2\\x80\\x9cPoultry\\xe2\\x80\\x9d or \\xe2\\x80\\x9cManual\\xe2\\x80\\x9d program and set the time to 15 minutes at high pressure.', 'It will take about 15 minutes for your pressure cooker to come up to pressure, and then the actual cooking will begin. The total time from when you seal the pressure cooker to the finished dish is about 30 minutes.', '4 Release the pressure: You can either perform a quick pressure release by moving the vent from \\xe2\\x80\\x9cSealing\\xe2\\x80\\x9d to \\xe2\\x80\\x9cVenting,\\xe2\\x80\\x9d or you can let the pot depressurize naturally (this takes about 15 minutes).', '5 Separate the chicken and cooking liquid: Use tongs or a slotted spoon to transfer the chicken thighs to a plate or cutting board.', '  6 Reduce the cooking liquid: Select the \\xe2\\x80\\x9cSaut\\xc3\\xa9\\xe2\\x80\\x9d program on the pressure cooker and let the cooking liquid reduce for 10 minutes.', '7  While the liquid is reducing, use a pair of forks to shred the chicken thighs.', '8 Toss the shredded chicken with the reduced liquid and serve: Return the chicken to the pot with the reduced cooking liquid and toss it to coat the chicken evenly. Serve it in tortilla shells with the fixings listed above.', 'Leftover shredded chicken will keep in the fridge for 3 to 4 days, or in the freezer for up to three months.']",10
1459,Pressure Cooker Taco Soup Recipe,10,50,60,"['For the soup:', '1 tablespoon olive oil', '1 pound lean (93 percent or higher) ground beef', '1 medium red or yellow onion, diced', '1/2 teaspoon kosher salt', '3 cups low sodium chicken broth', '1 (15-ounce) can diced tomatoes', '1 (15-ounce) can black beans, rinsed and drained', '1 (15-ounce) can kidney beans, rinsed and drained', '1 (4-ounce) can diced green chiles', '1 1/4 cups (6 ounces) corn kernels, fresh or frozen', '2 1/2 teaspoons chili powder', '1 teaspoon ground cumin', '1 teaspoon paprika', '1 teaspoon kosher salt', 'To serve:', '1 1/2 cups tortilla chips, lightly crushed', '3/4 cup sour cream', '1/2 cup chopped cilantro', '1/2 cup diced onion (red or white)', '6 lime wedges', 'Special equipment:', '6-quart pressure cooker']",23,"['1 Saut\\xc3\\xa9 the ground beef and onion: Heat the olive oil in the pressure cooker on its \\xe2\\x80\\x9cSaut\\xc3\\xa9\\xe2\\x80\\x9d setting. Add the ground beef, onions, and salt, and saut\\xc3\\xa9 for about three minutes, breaking up the meat with a spoon or spatula. It\\xe2\\x80\\x99s fine if the meat does not fully cook through.  ', '2 Add the rest of the ingredients and pressure cook the soup: Stir in the chicken broth, diced tomatoes and their liquid, black beans, kidney beans, green chiles, corn, spices, and salt.', 'Secure the lid on the pressure cooker and make sure it is set to its \\xe2\\x80\\x9cSealing\\xe2\\x80\\x9d position. Select the \\xe2\\x80\\x9cSoup,\\xe2\\x80\\x9d \\xe2\\x80\\x9cManual\\xe2\\x80\\x9d or \\xe2\\x80\\x9cPressure Cook\\xe2\\x80\\x9d setting, and set the time to 20 minutes at high pressure. The pot will take about 15 minutes to come up to pressure, and then the cooking time will begin.', '3 Release the pressure: When the cooking program ends, let the pressure release naturally for at least 15 minutes. At this point, you can either perform a quick pressure release by moving the pressure vent to its \\xe2\\x80\\x9cVenting\\xe2\\x80\\x9d position, or let the pressure release naturally the rest of the way.', 'You can also leave the soup on the pressure cooker\\xe2\\x80\\x99s \\xe2\\x80\\x9cKeep Warm\\xe2\\x80\\x9d setting for up to 10 hours.', '4 Serve: Ladle the soup into bowls and serve it topped with the chips, sour cream, cilantro, and diced onions on top, with wedges of lime on the side. Leftovers will keep refrigerated for about 1 week, or frozen for up to 3 months.']",6
1460,Spicy Lamb Stew Recipe,25,210,235,"['2-3 lbs of lamb shoulder stew meat, cut into 1\\xc2\\xbd-inch cubes', 'Extra virgin olive oil', '2 yellow onions, chopped', '4 cloves garlic, minced', '2 red bell peppers, chopped', '2 dry pasilla chiles, chopped, stems and most seeds removed', '1 Tbsp hot Hungarian paprika*', '1\\xc2\\xbd teaspoon ground cumin', 'Pinch of ground cardamon', '1\\xc2\\xbd cups chicken stock (use gluten-free stock for gluten-free version)', '14 oz of canned whole tomatoes, put through a food mill, or pur\\xc3\\xa9ed', '8-10 sprigs fresh flat leaf parsley', '4-5 sprigs of thyme', '1 bay leaf', '2/3 cup raisins', 'Salt and pepper', ""* Hot Hungarian paprika is not the regular Hungarian paprika which is sweet and mild. It is even hotter than cayenne. If you don't have access to hot paprika, I would substitute 1/2 with sweet paprika and 1/2 with chili powder.""]",17,"['1 Sear the lamb on all sides: Pat the lamb dry with a paper towel. Drying the lamb this way first will help the lamb pieces brown. Heat 2 tablespoons of olive oil in a large, heavy, high-sided pot, such as a Dutch oven, over medium high heat. When the pot is hot, add the lamb pieces in batches, being careful not to crowd them. Cook, turning as needed so that the lamb pieces brown evenly on all sides, for 6-8 minutes. Transfer to a bowl.', '2 Saut\\xc3\\xa9 onions, peppers, chiles, garlic: Return the pot to medium-high heat. Add the onions, dried peppers and red bell peppers and stir to coat with the oil in the pot. Cook, stirring occasionally, for 5 minutes. Add the garlic and cook 1 more minute.', '3 Make a bouquet garni with parsley, thyme, bay leaf: Make a bouquet garni by placing the parsley, thyme and bay leaf in the center of a doubled over cheesecloth square. Gather the ends and secure with kitchen string.', '4 Add spices, tomatoes, lamb, stock, raisins, herbs, simmer and cook: Stir in the paprika, cumin, and cardamom and cook for a minute. Add the pur\\xc3\\xa9ed (or cooked tomatoes put through a food mill) tomatoes, lamb, chicken stock, raisins and bouquet garni. Bring to a boil over high heat, decrease heat to low. Cook, partially covered, for about 3 hours, or until lamb is tender.', 'Season to taste with salt and pepper.', 'Serve over couscous or rice (gluten-free option).']",6
1461,Grilled Chicken Tarragon with Tomato Sauce Recipe,10,25,35,"['2 tablespoons chopped fresh tarragon (or 2 teaspoons dried tarragon)', '3 tablespoons extra virgin olive oil', '2 teaspoons minced garlic', '1 1/2 pounds of chicken breast cutlets', 'Salt', 'Pepper', '1 14-ounce can whole, peeled tomatoes', '1/4 water', '1 shallot, diced (about 3 Tbsp)', '2 teaspoons balsamic vinegar', 'Salt and pepper to taste']",11,"['1 Make garlic tarragon oil: In a medium bowl, combine 2 Tbsp olive oil, 1 teaspoon minced garlic, and 1 Tbsp of chopped fresh tarragon (or a teaspoon of dried tarragon).', '2 Prepare chicken cutlets: If your boneless, skinless chicken breasts are not already in cutlet form, slice them in half horizontally, or place them between two pieces of plastic wrap and use a meat pounder to pound them into an even 1/2-inch thickness.', 'Sprinkle the cutlets with salt and pepper. Add them to the olive oil, garlic, tarragon mixture. Let sit at room temperature while you prepare the sauce and heat the grill.', '3 Prepare your grill for high, direct heat.', '4 Make the tomato tarragon sauce: While the grill is heating (whether it be charcoal or gas), prepare the sauce. Place the canned tomatoes in a food processor or blender and pulse until pur\\xc3\\xa9ed.', 'In a medium saut\\xc3\\xa9 pan, heat a tablespoon of olive oil on medium heat. When the oil is hot, add the minced shallots and garlic and cook until just fragrant, less than a minute.', 'Add the pur\\xc3\\xa9ed tomatoes and water to the shallots and garlic. Add the balsamic vinegar and 1 Tbsp of chopped fresh tarragon (or a teaspoon of dry tarragon). Add salt and pepper to taste. (If the sauce seems too acidic, you can add a pinch of sugar to balance the acidity.)', 'Bring to a simmer and lower the heat to maintain a very low simmer while you grill the chicken.', '4 Grill the chicken: Grill the chicken cutlets until nicely browned and cooked through, about 2 minutes per side, less or more time depending on how thick the cutlets are.', 'Serve with tomato tarragon sauce.']",10
1462,Gluten-Free Apple Tart Recipe,45,105,150,"['For the paleo pie crust:', '2 cups finely ground almond flour (I used Bob\\xe2\\x80\\x99s Red Mill Superfine Almond Flour)', '1 cup arrowroot starch', '2 tablespoons maple sugar (or 3 tablespoons coconut sugar)', '1 1/2 tablespoons ground chia seeds (I used white chia seeds)', '1/2 tablespoon ground flax (I used golden flax seeds)', '2 teaspoons baking powder', '1/4 teaspoon salt', '4 tablespoons cold unsalted butter, ghee, lard, duck fat, refined coconut oil, or sustainable palm shortening', '1 large egg', '1 egg yolk', '3 to 6 tablespoons ice water', 'Extra arrowroot or tapioca starch for shaping and rolling', 'For the apple filling:', '6 medium baking apples (I like a mix of Granny Smiths and Honeycrisp)', '2 tablespoons unsalted butter, ghee, refined coconut oil, or palm shortening', '2 tablespoons maple sugar (or three tablespoons coconut sugar)', '2 tablespoons lemon juice', '1 tablespoon vanilla extract (optional)', 'Zest of one lemon', 'Special equipment:', 'Food processor', '9-inch tart pan']",23,"['1 Make the pie crust: Combine the almond flour, arrowroot, maple sugar, chia, flax, baking powder, and salt to the bowl of a food processor and pulse 5 to 6 times to combine. Add the butter and pulse another 4 to 5 times until the mixture starts to look like sandy, pea-sized gravel. Add the egg and egg yolk, then sprinkle 3 tablespoons water evenly over the top of the dough. Pulse a few times until the mixture just starts to clump together and form a ball.', '2 Chill the crust: Turn the pastry dough out onto a cutting board and use your hands to shape it into a chubby disk. Wrap tightly in plastic and refrigerate for at least one hour or up to three days.', '3 Roll out the crust: When ready to bake the tart, lay a sheet of parchment on your counter or other flat surface and sprinkle with arrowroot or tapioca starch. Place the chilled pie dough in the center of the parchment and roll into a circle about 12 inches in diameter.', '4 Transfer the crust to the tart pan: Flip your tart pan upside down and place it in the center of the rolled out pastry dough. There should be at least 1 1/2 inches of pie dough showing around the edge. Carefully, slide one hand palm side up under the parchment and place the other hand on the tart pan. Quickly, and with great confidence, flip the whole thing over.', 'Gently ease the crust into the tart dish and press it into the corners. Peel back the parchment and discard. Your pastry dough may break, but just press the cracks back together if it does. Use a paring knife to trim away the excess dough and then prick the bottom of the tart all over with the tines of a fork.', '5 Place the tart shell in the freezer to chill while you prepare the apples.', '6 Preheat oven to 350F.', ""7 Prepare the apples. Peel the apples and halve them lengthwise. Use a melon baller, paring knife, or small spoon to remove the core, seeds, and stem. Slice the apples very thinly (ideally 1/8-inch thick) using a chef's knife or mandoline."", '8 Prepare the glaze: In a small saucepan, melt butter (or other fat) with the sugar, lemon juice, and vanilla over medium heat. Whisk to combine while bringing to a simmer. Keep whisking until all sugar is dissolved.', '9 Assemble the tart: Find a few of your thinnest apple slices and set them aside. Remove the tart shell from the freezer and begin laying the apple slices in concentric circles, starting from the outer edge of the crust and spiraling inward.', 'When you get to the center, take your thinnest apple slices and fold them gently to form the center of the pattern. (You might have some apple slices leftover.)', 'Sprinkle the lemon zest evenly over the tart. Drizzle about half of the glaze evenly over the tart. (I dipped a pastry brush in the glaze and let it drip onto onto the apples.)', '10 Bake the tart for 40 minutes, turning the pan halfway through baking.', '11 Brush the rest of the glaze over the apple slices. Return to the oven and bake for 5 more minutes.', '12 Serve warm or at room temperature.']",15
1463,Chocolate Pecan Tart Recipe,60,45,105,"['1 prepared pastry crust (1/2 recipe of Perfect Pie Crust)', '2 cups (8 ounces) pecans', '8 tablespoons (1 stick) salted or unsalted butter (whichever you have handy), cut up into pieces', '1/4 cup granulated sugar', '1/4 cup packed brown sugar', '3 ounces good-quality bittersweet chocolate (60 to 70%), chopped into 1-inch pieces', '4 large eggs', '1/2 cup light corn syrup', '2 teaspoons vanilla extract', 'Powdered sugar, for sprinkling', 'Special equipment:', '10-inch tart pan with removable bottom', 'Ceramic pie weights or dried beans, for blind baking the crust', 'Wide metal spatulas (handy for transferring the tart to the serving plate)']",14,"['1 Roll out the pastry: Set the oven to 375F. On a lightly floured counter, roll the pastry dough to a 12-inch round, giving it a quarter-turn after every few rolls so it does not stick to the counter.', 'Lift the pastry onto the rolling pin and ease it into the tart pan. With floured fingertips, press the pastry into the corners and up the sides of the pan. With scissors or kitchen shears, trim the top edge of the pastry so it comes about 1/2-inch above the pan. Tuck the top 1/2-inch of the pastry onto itself to make a hem and crimp.', '2 Chill the pastry crust: Set the tart pan on a rimmed baking sheet and freeze for 15 minutes or refrigerate for at least 30 minutes, or until firm and cold (but not frozen).', '3 Blind bake the crust: Prick the chilled dough all over. Lay a piece of foil over the tart, shiny side down, and press it into the edges of the pan. Fill the foil with pie weights or dried beans. Bake the pastry for 15 minutes, or until the edges start to brown. Carefully lift out the foil and pie weights or beans. Continue baking the pastry for 5 minutes more, or until the surface starts to look baked.', '4 Set the tart crust aside to cool. Leave the oven on.', '5 Toast the nuts: Spread the nuts in a baking dish or on a baking sheet. Toast them in the oven, stirring several times, for 8 minutes or until they are aromatic. Leave the oven on.', '6 Begin making the filling: In a large saucepan, melt the butter over low heat just until it coats the bottom of the pan. Do not let the butter brown. Add the granulated sugar and brown sugar. Cook, stirring, until the sugar dissolves and combines with the butter in a smooth mixture. Add the chocolate and cook, stirring, until it melts. Remove the pan from the heat and let the mixture cool to lukewarm.', '7 Finish the filling: Stir the eggs into the lukewarm chocolate mixture one by one, followed by the corn syrup and vanilla.', '8 Assemble the tart: Leave the tart on the baking sheet used in the chilling step. Spread the toasted pecans an even layer in the bottom of the tart shell. Pour the chocolate filling over top and spread to the edges of the crust.', ""9 Bake the tart: Bake for 25 minutes, or until the filling is set in the middle and puffs slightly, and the pastry is browned at the edges. If the pastry seems like it's becoming too brown, cover the edges loosely with foil. Set on a rack to cool."", '10 Unmold the tart and serve: Set the cooled tart on a bowl so the outer ring falls off. Carefully use 2 wide metal spatulas to lift the tart from the bottom of the pan and transfer to a large platter. Sprinkle with powdered sugar and cut into slices.', 'If serving the next day, cover the tart loosely with foil and refrigerate. Let it come to room temperature before serving.']",12
1464,Sweet Tea Fried Chicken Recipe,45,1485,1530,"['For the brine:', '6 cups water', '8 bags black tea', '1 cup (200 g) white sugar', '1/4 cup (75 g) kosher salt', 'For the chicken:', '5 chicken legs, skin on', '5 chicken thighs, bone-in and skin on', '2 cups buttermilk', '1 tablespoon hot sauce, optional but recommended', '3 cups (420 g) all-purpose flour', '1 cup (160 g) cornmeal', '2 tablespoons cornstarch', '1 1/2 teaspoons garlic powder', '1 1/2 teaspoons onion powder', '1 teaspoon black pepper', '1 teaspoon kosher salt', '1/2 teaspoon cayenne pepper', '1/2 teaspoon paprika', '3 cups vegetable oil (corn, avocado, or peanut)', 'To finish:', 'Flaky sea salt, such as Maldon']",22,"['1 Make the tea brine: Bring the water to boil in a large stockpot. When it boils, remove from heat and add the tea bags, cover, and steep for 20 minutes.', 'Gently squeeze the bags to extract as much flavor as possible and remove them. Stir in the sugar and salt until they have dissolved. Leave uncovered for an hour or until it reaches room temperature.', '2 Brine the chicken: Place a gallon freezer-style resealable bag in a large bowl and open it up. Carefully pour the room temperature tea brine into the bag, holding onto the sides to minimize spilling (or just simply place it in a large bowl).', 'Place the chicken into the bag, and seal it, trying to squeeze out as much as air as possible. Refrigerate overnight (minimum 8 hours) or up to 24 hours.', '3 Preheat the oven to 400\\xc2\\xb0F. Place a wire rack over a rimmed baking sheet.', '4 Coat the chicken in breading: Combine the buttermilk and the hot sauce, if using, in a medium bowl. Whisk together the flour, cornmeal, cornstarch, garlic powder, onion powder, black pepper, salt, cayenne pepper, and paprika in a separate large bowl.', 'Remove one piece of chicken from the brine and dunk it in the buttermilk, turning the piece to coat it. Then coat the chicken in the flour mix, turning to coat completely. Move to a rimmed baking sheet and repeat with the remaining chicken. Discard the brine when done.', '5 Heat the oil: Pour the oil into an 11-inch cast iron skillet, straight sided saut\\xc3\\xa9 pan, or Dutch oven. Heat the oil to 375\\xc2\\xb0F.', 'If you don\\xe2\\x80\\x99t have a thermometer, drop a 1-inch cube of bread into the oil. The bread should brown in about 60 seconds. If it browns too fast, the oil is too hot. If the bread takes longer than a minute to brown, it isn\\xe2\\x80\\x99t hot enough.', '6 Fry the chicken legs: Once the oil is at the right temperature, use tongs to carefully move the chicken legs to the pan, one at a time, making sure part of the chicken is submerged before letting go\\xe2\\x80\\x94this minimizes splashing. (Do not drop the chicken pieces in the oil; it will splatter and possibly burn you.)', 'Fry the chicken on one side for 4 to 5 minutes or until the bottom part of the chicken is golden brown. Flip the chicken with the tongs and cook the other side for an additional 4 to 5 minutes. Move the legs to the baking sheet with the wire rack.', '7 Fry the chicken thighs: Repeat the process with the chicken thighs, this time frying each side 5 to 6 minutes. Move the thighs to the baking sheet along with the legs.', '8 Bake until cooked through: Move the entire sheet with chicken into the oven. Bake for an additional 15 to 18 minutes, or until the thermometer inserted into the thickest part of the thighs reads 165\\xc2\\xb0F. If you don\\xe2\\x80\\x99t have a thermometer, pierce the thigh with a sharp knife. The liquid that comes out should run clear and not look red.', '9 Serve: Move to a serving platter and sprinkle with flaky sea salt. Serve immediately.', 'Leftover fried chicken can be kept in an airtight container in the refrigerator for up to 3 days and is great cold. But if you want to reheat it, bring the chicken back to room temperature (about 30 minutes on your counter) while you preheat your oven to 400\\xc2\\xb0F. Place the chicken on a wire rack set on a rimmed baking sheet and reheat for about 8 to 12 minutes.']",15
1465,Coconut Golden Milk Recipe,5,10,15,"['1 (13.5-ounce) can full fat coconut milk', '1 to 2 tablespoons freshly grated ginger, to taste (from a 2-inch size knob)', '1 teaspoon ground turmeric', '1/4 teaspoon ground cinnamon', 'Pinch fine sea salt', 'Pinch ground black pepper', '1 teaspoon vanilla extract', '2 teaspoons maple syrup', 'Cinnamon sticks and/or ground cinnamon or turmeric, to serve (optional)']",9,"['1 Heat the coconut milk: In a small saucepan over medium-low heat, warm the coconut milk until you see a little bit of steam, about 2 to 3 minutes.', '2 Add the spices: Add the ginger, turmeric, cinnamon, sea salt, and black pepper, and gently whisk to combine. Add the vanilla extract, and whisk to combine. Take the milk off the heat, allow it to cool slightly, and add the maple syrup.', 'Taste the milk using a spoon, and adjust as needed. Does it need more spice? Add some ginger. Is it not sweet enough to your liking? Add a little more maple syrup. Do the flavors seem like they aren\\xe2\\x80\\x99t speaking loudly enough to you overall? Add another pinch of salt.', '3 Simmer: Let the golden milk come to a bare simmer\\xe2\\x80\\x94you might see some bubbles on the sides of the pot, you might see some frothy action on the surface\\xe2\\x80\\x94and then turn off the heat.', 'This step helps reintegrate the flavors after you\\xe2\\x80\\x99ve added the maple syrup and made any adjustment with spices. It also ensures you\\xe2\\x80\\x99ve got a hot beverage, not a lukewarm one.', '4 Strain and serve: Strain off any lingering fibrous bits of ginger through a fine mesh sieve. Pour it into your favorite mug, sprinkle it with a bit more of ground turmeric and/or cinnamon, and get cozy on the couch with a blanket and your mug.']",6
1466,Pressure Cooker Teriyaki Chicken Wings Recipe,5,40,45,"['3/4 cup soy sauce', '6 tablespoons mirin', '1/4 cup sake', '1/4 cup packed dark brown sugar', '1 teaspoon minced garlic, about 1 medium garlic clove', '1 teaspoon minced fresh ginger, from about a 1-inch knob', '3 pounds chicken wing drumettes and flats', 'To thicken sauce:', '4 to 5 teaspoons cornstarch', '4 to 5 teaspoons soy sauce', 'To serve:', '1/2 teaspoon sesame seeds', '1 green onion, thinly sliced']",13,"['1 Make the teriyaki sauce: Combine the soy sauce, mirin, sake, brown sugar, garlic, and ginger. Stir to mix in the sugar (it won\\xe2\\x80\\x99t completely dissolve and that\\xe2\\x80\\x99s OK).', '2 Pressure cook the wings: Combine the teriyaki sauce and wings in the pressure cooker. Toss the wings to coat. Seal the pressure cooker and make sure the steam valve is set to \\xe2\\x80\\x9csealing\\xe2\\x80\\x9d.', 'Press the \\xe2\\x80\\x9cPoultry\\xe2\\x80\\x9d button and adjust the time to 10 minutes. Make sure it is set to \\xe2\\x80\\x9chigh pressure.\\xe2\\x80\\x9d', 'The pressure cooker will come to pressure in 15 minutes, then cook for 10 minutes.', '3 Vent the pressure: Once the pressure cooker is done cooking, do a quick release of the pressure by carefully moving the steam valve to the \\xe2\\x80\\x9cventing\\xe2\\x80\\x9d setting. (I wear an oven mitt and use a wooden spoon to flick the valve because I\\xe2\\x80\\x99m overly cautious.)', '4 Get ready for broiling: While the steam is being released, turn your oven broiler on. Line a rimmed baking sheet with aluminum foil and lightly coat the foil with cooking oil spray.', '5 Broil the chicken wings: Once the steam has been released, open the pressure cooker. Using tongs, move the wings to the prepared baking sheet and place under the broiler for 4 to 5 minutes or until the chicken skin is starting to char.', 'Flip all the wings and repeat to char the other side.', '6 Reduce the teriyaki sauce: While the chicken wings are broiling, thicken the teriyaki sauce. Start by pressing the \\xe2\\x80\\x9csaut\\xc3\\xa9\\xe2\\x80\\x9d button on the pressure cooker.', 'If you plan on serving the wings at room temperature, stir together 4 teaspoons of cornstarch and 4 teaspoons of soy sauce in a small bowl until the cornstarch is dissolved, then add to the simmering teriyaki sauce.', 'If you plan on serving the wings hot, use all 5 teaspoons of both ingredients.', 'Cook the sauce until it starts to boil, stirring frequently, about 3 minutes.  The sauce should start to thicken a bit and look like maple syrup, but won\\xe2\\x80\\x99t look super thick. Don\\xe2\\x80\\x99t worry, it will thicken further as it cools.', '7 Toss the broiled wings with the teriyaki sauce: Turn the pressure cooker off. Once the wings are done in the broiler, transfer them back to the pressure cooker with the thickened sauce.', 'Toss to coat the wings, then move them to a serving platter.', '8 Serve: Sprinkle wings with sesame seeds and sliced green onions and serve hot or room temperature.']",15
1467,Green Chile Cornbread Recipe,10,35,45,"['1 1/4 cups (190 g) fine cornmeal', '1 1/4 cups (175 g) all purpose flour', '1 1/2 teaspoons salt', '1 teaspoon baking soda', '1 tablespoon baking powder', '1/4 cup (50 g) sugar', '1/2 cup (1 stick) softened unsalted butter', '1/2 cup (115 g) sour cream', '2 large eggs', '1 1/4 cups milk', '2 cups of chopped, roasted green chiles (Anaheim or Hatch) (3 7-ounce cans of chopped green chiles, drained)', '1 cup (130 g) corn kernels (if frozen, defrost)', '1 cup shredded cheddar cheese (4 ounces, 113 g)']",13,"['1 Preheat oven and prep baking dish: Preheat oven to 400\\xc2\\xb0F. Grease a 3-quart baking dish.', '2 Make the batter: In a large bowl whisk together the cornmeal, flour, salt, baking powder and baking soda.', 'In a separate bowl, beat the softened butter and sugar. Beat the sour cream and eggs into the butter sugar mixture.', 'Add the milk and the dry ingredients, a third at a time and alternating wet/dry.', 'Mix in the green chiles, corn, and shredded cheese. Pour mixture into prepared baking dish.', '3 Bake: Bake at 400\\xc2\\xb0F for 35 minutes, or until top is browned, the center springs back when pressed down, and a skewer inserted into the center comes out clean.', 'Let cool almost completely before serving.']",7
1468,Turkey White Chili Recipe,15,210,225,"['1/2 pound dry white beans, soaked overnight in water, drained OR 2 15-ounce cans white beans, drained', '3 cups turkey stock', '1 cloves garlic, minced', '1 medium onions, chopped (divided)', '1 tablespoon extra virgin olive oil', '1 jalape\\xc3\\xb1o or serrano pepper, stem and most seeds removed, chopped (optional)', '1 teaspoon ground cumin', '1 teaspoon dried oregano', 'Pinch of ground cloves', '1/4 tsp cayenne pepper', '2 4-ounce cans chopped green chilies', '2 cups diced cooked turkey', 'Salt to taste (about 1/2 teaspoon to 1 teaspoon)', 'Garnishes and extras', '1 1/2 cups grated Monterey Jack cheese', '1/3 cup (loose) chopped cilantro', '1/4 cup chopped green onions', '1 avocado, pitted, peeled, and chopped (or guacamole)', 'Chopped tomatoes or salsa', 'Corn tortilla chips and/or fresh warmed flour tortillas']",20,"['1a Cook beans if using dry beans: Combine soaked and drained beans, turkey stock, and half the onions in a large soup pot and bring to a boil.', 'Reduce heat and simmer until beans are very soft, 1 to 3 hours or more, depending on the type of white beans you are using.', 'Cannelli beans are tender and tend to cook rather quickly. Navy beans take longer. Add additional water (or watered-down stock), if necessary.', 'Or you can skip the soaking and cook the beans in turkey stock with the onions in a pressure cooker. Cook on high pressure for 30 minutes, then let release naturally for 10 minutes.', '1b If using canned beans:  Combine the beans and the turkey stock in a large soup pot and bring to a boil. Reduce to a simmer.', '2 Cook jalape\\xc3\\xb1o, onions, garlic, green chiles: Heat olive oil in a skillet on medium heat, cook chopped jalape\\xc3\\xb1o (if using) and (remaining) onions in oil until tender. Add the minced garlic and cook a minute more. Add green chilies and seasonings and mix thoroughly.', '3 Combine jalape\\xc3\\xb1o mixture and turkey to stock: Add the jalape\\xc3\\xb1o onion mixture to the stock and beans.', 'Add the turkey and salt to taste, and simmer for 10 minutes or more (up to an hour) until the beans are thoroughly soft and the stew has thickened.', '4 Serve: Serve topped with grated cheese. Garnish with cilantro, chopped fresh tomato, salsa, chopped green onions, and/or avocados. Serve with fresh warmed flour tortillas or tortilla chips.']",9
1469,Mexican Street Corn Nachos Recipe,15,20,35,"['2 tablespoons extra virgin olive oil', '1 pound frozen corn (about 3 cups), still frozen', '2 tablespoons mayonnaise', '14 ounce bag low salt tortilla chips', ""1 pound Monterey jack cheese, grated (do not buy pre-grated, it won\\'t melt properly)"", '1 tablespoon cornstarch', '1/2 cup cream', '1/2 cup milk', '1 clove garlic, minced', '1/4 cup crumbled Cotija cheese (can sub crumbled feta)', '1/8 teaspoon chipotle chili powder (can use regular chili powder or smoked paprika)', '2 tablespoons of Mexican crema or 2 Tbsp sour cream that have been slightly diluted with water', '1/2 lime, sliced into wedges', '2 tablespoons chopped cilantro']",14,"['1 Sear the corn, then mix with mayo: Heat oil on high heat in a large, cast iron pan. When the oil is almost smoking hot, add half of the frozen corn (not defrosted) to the pan. Spread it out in the pan and let sear.', 'Stir occasionally, until most of the corn kernels have browned a little on at least one side. You\\\'ll know the corn is ready when some of the kernels start ""popping"".', 'Remove the corn from the pan to a bowl, and repeat with the remaining frozen corn kernels.', 'Mix the corn with the mayonnaise and set aside.', '2 Toast tortilla chips: Preheat oven to 350\\xc2\\xb0F. Spread the tortilla chips out on a large sheet pan and place in the oven for 10 minutes, until lightly browned.', '3 Make cheese sauce: While the tortilla chips are toasting, make the cheese sauce. Set up a double boiler with an inch of water in the lower pan.', ""If you don\\'t have a double boiler, place an inch of water in a small saucepan and place a metal bowl over it so that steam from the boiling water below heats the bottom of the bowl. Do not let the bowl touch the water."", 'Place the grated monterey jack cheese in the top pan or bowl of the double boiler. Mix with the cornstarch. Pour in the cream and milk (can use half and half if you want). Add the minced garlic.', 'Heat the water in the double boiler to a boil. Let the cheese gently melt, stirring occasionally, until the sauce is smooth.', '4 Assemble nachos: Once the tortilla chips are lightly browned, remove them from the oven. Transfer to a large serving platter.', 'Pour the cheese sauce over the chips. Sprinkle the top with the toasted corn. Sprinkle with cotija cheese crumbles. Sprinkle with chipotle chili powder. Drizzle with the crema or diluted sour cream. Sprinkle with cilantro.', 'Sprinkle with a little lime juice and serve immediately with lime wedges.']",12
1470,Chicken Freezer Burritos Recipe,20,20,40,"['1 1/2 cups long grain white rice', '1 lime, juice only', '1/4 cup chopped cilantro', '2 red or green peppers, sliced', '1 yellow onion, sliced', '2 tablespoons olive oil, divided', '2 cups cooked chicken, shredded', '2 (15-ounce) cans black beans, drained and rinsed', '1/2 teaspoon salt', '1 teaspoon chili powder', '1 teaspoon ground cumin', '1 cup salsa verde, store-bought or homemade', '16 ounces grated colby jack cheese', '8 large 12-inch burrito-sized flour tortillas OR 32 small 8-inch flour tortillas', 'For the pickled jalapeno guacamole (Dad Add):', '2 ripe avocados', '1/4 cup pickled jalape\\xc3\\xb1os, chopped', '2 tablespoons minced cilantro', 'Pinch of salt', 'Special equipment:', 'Heavy-duty aluminum foil']",21,"['1 Make the cilantro rice: Rinse rice well in cold water, and then add to a medium pot. Cover the rice with 1 inch of cold water and place over medium heat. Once simmering, stir, turn heat down to low, and cover.', 'Cook until the rice has absorbed the water and is tender, about 8-10 minutes. If there is extra water, drain off. Otherwise, remove from heat, cover, and let steam for 5 minutes. Stir in lime juice and cilantro.', '2 Cook the peppers and onions: In a large skillet over medium-high heat, add 1 tablespoon olive oil, sliced peppers, and onions. Cook until peppers and onions start to caramelize in places, 8-10 minutes. Scoop out onto a plate and set aside.', '3 Make the chicken and bean filling: In the same skillet over medium heat, add 1 tablespoon olive oil, the shredded chicken, and beans. Stir together until warm. Add the salt, chili powder, and cumin, and then add the salsa verde. Remove from heat.', '4 Assemble the burritos: Wrap one 12-inch tortilla or four 8-inch burritos in a few paper towels. Microwave on high for 15 seconds to make the tortillas warm and flexible.', ""Then, in the lower-middle section of the tortilla, add 1/3 cup cilantro rice, 1/3 cup peppers and onions, 1/2 cup of the chicken and bean mixture, and 1/4 cup grated cheese. (If you're using smaller 8-inch tortillas, divide these amounts evenly among the four tortillas). Tightly roll the tortilla, folding over the ends, to form a burrito. Once formed, wrap the burrito in heavy-duty aluminum foil."", 'Repeat with the remaining tortillas.', '5 Freeze the burritos: Transfer the wrapped burritos to a freezer-safe plastic container or bag. Store in the freezer for up to 6 months (but ideally use within 3 months, or else they might have some freezer burn and off flavors).', '6 Reheat the burritos: To reheat a large burrito, unwrap from foil and place on a microwave-safe plate. Microwave on defrost for 7 minutes per side, or until the burrito has completely thawed. Transfer burrito to a nonstick skillet over medium-low heat and cook for 3-4 minutes per side, or until the burrito is crispy on the outside.', 'To reheat a large burrito in the oven, preheat the oven to 400\\xcb\\x9aF. Place the wrapped burrito on a baking sheet and heat in the oven for 45 minutes. Remove, unwrap the burrito, and put back in the oven for another 10 minutes to get a crispy exterior.', 'Serve burrito with sour cream, salsa, or Dad Add guacamole.', '7 Make the Pickled Jalape\\xc3\\xb1o Guacamole: Add the flesh of two ripe avocados to a bowl. Mash together with fork. Roughly dice pickled jalape\\xc3\\xb1os and transfer to bowl with avocados. Season with cilantro and a pinch of salt. Serve immediately.']",12
1471,Thai Green Curry with Chicken Recipe,5,30,35,"['For the green curry paste:', '2 teaspoons cumin seed, lightly toasted', '2 teaspoons coriander seed, lightly toasted', '2 medium mild green chilies, seeded and chopped', '1 medium shallot, chopped', '3-inch piece ginger, peeled and chopped', '2 cloves garlic', 'Zest of 1 lime', '4 fresh makrut (kaffir) lime leaves, torn', '1 5-inch piece lemongrass, pale yellow portion only, chopped', '1 bunch cilantro stems (reserve the leaves for the curry)', '1 teaspoon fish sauce', 'For the chicken curry:', '1 pound boneless, skinless chicken thighs', '1/2 teaspoon salt', '1 tablespoon coconut oil', '1 shallot, sliced thin', '1 can whole coconut milk, shaken', '1 medium bell pepper, cut into strips (or use a mix of colors as I did here)', '1/2 pound green beans, ends trimmed', '1/4 cup chopped Thai basil leaves, plus whole leaves for garnish', '1/4 cup chopped cilantro leaves', '4 large lime wedges, to serve', 'Cooked white or brown rice, to serve (optional)']",24,"['1 Toast the spices for the curry paste: Set a small skillet over medium heat. Add the cumin and coriander seeds and toast, shaking the pan often until the spices have darkened slightly and are fragrant, 1 to 2 minutes.', 'Set aside to cool, and then grind with a mortar and pestle or in a spice grinder.', '2 Make the green curry paste: Pulse to combine the cumin, coriander seed, and remaining curry paste ingredients in the bowl of a food processor. Scrape down sides, then process continuously until the mixture is smooth. Spoon into a container with a lid and refrigerate until needed.', 'This paste is best used right away, but will keep in the fridge for 3 days; it makes enough for two recipes and can also be frozen.', '3 Sear the chicken: Salt the chicken on both sides, then slice across the grain into 1/2-inch thick strips. Set a large skillet over high heat. Add the coconut oil, and then chicken.', ""Sear until golden on all sides, about 5 minutes total. (It's fine if the chicken is not totally cooked through at this point.) Transfer the chicken to a plate."", '4 Prepare the coconut curry: Lower the heat to medium high. Add shallot and cook for 1 minute. Stir in 2 heaping tablespoons of the green curry paste and cook 1 minute more.', 'Add 1/4 cup of the coconut milk, stirring well to scrape up any brown bits. Then add remaining coconut milk and bring mixture to a gentle boil.', '5 Simmer the curry with chicken and veggies: Add chicken pieces, sliced peppers, and green beans. Reduce the heat to medium-low and cook at a gentle simmer for 20 minutes.', 'At the end of cook time, stir in cilantro and basil.', '6 Serve the curry: Serve over rice. Garnish with fresh basil leaves and a lime wedge.']",11
1472,Easiest Turkey Brine Recipe,5,1450,1455,"['1 12- to 20-pound turkey, not kosher, saline-injected, or otherwise pre-salted', '3 oranges', '3 lemons', '1/2 cup fresh sage leaves', '2 bay leaves', '1 tablespoon whole peppercorns', '5 large garlic cloves, peeled and smashed', '4 quarts water', '250g kosher salt (1 cup Morton, or 1 3/4 cup Diamond Crystal, or 3/4 cup table salt), plus more if needed']",9,"['1 Prepare the turkey for brining: Remove the turkey from its package and pat dry. Remove the giblets and save for making gravy. Place the turkey in a large pot, brining bag, or other container large enough to keep the turkey submerged.', '2 Prepare the brine ingredients: Strip the peels from the oranges and lemons using a vegetable peeler. Try to remove just the peel, leaving behind as much of the bitter white pith as possible. Roughly chop the sage leaves. Make sure the bay leaves, peppercorns, and garlic cloves are measured out and ready to go. (Save the leftover oranges and lemons for stuffing the turkey during roasting!)', '3 Prepare the brine concentrate: Bring 1 quart (4 cups) of the water to a boil in a large saucepan or stock pot on the stovetop. Once boiling, add the salt and stir until dissolved. Add the orange and lemon peels, chopped sage, bay leaves, peppercorns, and garlic. Let the water return to a boil, then remove from heat.', '4 Cool and then dilute the concentrate to make the turkey brine: Let the brine concentrate and flavoring ingredients cool until no longer steaming, then stir in the remaining 3 quarts of water. (If your pan is too small, you can do this in a pitcher or other large container.) Check the temperature of the brine; it should be room temperature or lukewarm.', ""5 Pour the brine over the turkey: Make sure the turkey is submerged, though it\\'s ok if the boney tips of the legs stick out the top. If needed for larger turkeys, prepare additional brine solution (1/4 cup of salt dissolved in 4 cups of warm water) in order to cover the turkey. If the turkey is floating, weight it down with a plate or other heavy object."", '6 Brine for 12 to 24 hours: Cover the turkey and keep refrigerated during brining.', ""7 Remove the turkey from the brine and rinse: When you\\'re ready to begin roasting your turkey, remove it from the brine and rinse it with cool water. It\\'s ok if the water is tinged pink. Pat dry."", ""8 Roast the turkey as usual: There\\'s no need to salt the turkey before roasting, but otherwise, roast the turkey as usual following your favorite recipe. If desired, stuff the cavity of the turkey with leftover sage and the peeled lemons and oranges from preparing the brine. Roasting time may be shortened; begin checking the temperature of the turkey halfway through roasting.""]",8
1473,Homemade Apple Pie Recipe,75,55,130,"['3 pounds good cooking apples such as Granny Smith, Jonagold, Golden Delicious, Fuji, or Braeburn (about 6 to 8 apples, depending on the size of your apples and the size of your pie dish)', ""1 tablespoon lemon juice or apple cider vinegar (to toss with the sliced apples so they don't brown as you slice them)"", '1/2 cup to 2/3 cup sugar, depending on how sweet you like your pie', '3 tablespoons all-purpose flour for thickening', '1/2 teaspoon cinnamon', '1/4 teaspoon ground allspice', '1/4 teaspoon ground nutmeg', '1 tablespoon brandy (Optional. By the way, if you have Calvados apple brandy, use it!)', '1 teaspoon vanilla extract', '1 recipe double crust sour cream pie dough, OR all-butter crust, OR your favorite pie crust recipe', 'For the egg wash:', '1 large egg yolk', '1 tablespoon cream']",13,"['1 Peel, core, and slice the apples: Peel, core and slice or roughly chop the apples into 1/4-inch to 1/2-inch slices or chunks.', 'As you cut your apple slices, add them to a large bowl and sprinkle them with a little lemon juice or apple cider vinegar to help keep them from turning brown.', '2 Make the apple pie filling: Combine sugar, flour and spices (allspice, nutmeg, cinnamon) in a bowl. Add the flour mixture to the apple slices and use your hands to distribute the flour through the apples so they are well coated.', 'Then sprinkle with brandy and vanilla extract and stir to coat all the apples.', '3 Prepare oven: Place one oven rack in the lowest position and put a large rimmed baking sheet on it (to catch any drippings from the pie.) Position a second rack the next rung up (still in the lower third of the oven) and preheat to 375\\xc2\\xb0F.', '4 Roll out the dough and line bottom pie plate: Remove one disk of pie dough from the refrigerator. Let sit at room temperature for 5-10 minutes. Place disk on a lightly floured, clean, flat surface. Using a rolling pin, roll out the pie dough to a 12-inch circle, about 1/8 of an inch thick.', ""As you roll out the dough, check to make sure it isn't sticking. If and when it starts to stick, gently lift it up and sprinkle a little more flour on the table surface or on the pie dough to keep the dough from sticking."", 'Gently place the rolled out dough onto a 9-inch pie plate. Press down to line the pie dish with the dough.', '5 Place apple slices on top of the bottom crust: Arrange the apple slices in the dough-lined pie plate. Mound the apples in the center.', '6 Roll out top crust, place over apples, trim and crimp edges: Roll out the second disk of dough, again to 12-inches. Gently place the second round of pie dough over the apples. Trim excess dough with kitchen shears, leaving a 3/4 inch overhang from the edges of the pie pan.', 'Fold the dough under itself so that the edge of the fold comes right to the edge of the pan. Press the top and bottom dough rounds together as you flute edges using thumb and forefinger or press with a fork.', '7 Brush with egg wash, cut vents: Place egg yolk and cream in a small bowl and use a fork to stir until well combined. Use a pastry brush to brush the egg wash over the top and fluted edges of the pie. Use a sharp knife to cut slits in the top of the pie crust for steam vents.', '8 Bake: Place pie on oven rack centered over the baking sheet on the rack below it to catch any drippings. Bake the pie at 375\\xc2\\xb0F until crust begins to lightly brown, about 20 minutes, then reduce heat to 350\\xc2\\xb0F.', ""Bake until crust is golden and juices are bubbling, anywhere from an additional 45 minutes to an hour, depending on the type of apples you are using. (About halfway through baking check to make sure the pie isn't browning too much. When it's nicely browned, tent the pie with a large piece of aluminum foil to keep the pie from browning further.)"", '9 Let cool: Transfer the apple pie to a rack to cool for at least 1 hour. Serve slightly warm or at room temperature. Great with a side of vanilla ice cream.']",15
1474,Pressure Cooker Cheesecake Recipe,15,2200,2215,"['For the crust:', '8 graham cracker sheets', '1 tablespoon brown sugar', '2 tablespoons unsalted butter, melted', 'For the filling:', '2 (8-ounce) packages cream cheese, at room temperature', '1/4 cup heavy cream', '1/2 cup granulated sugar', '1 tablespoon all-purpose flour', '1 teaspoon vanilla extract', '2 large eggs, at room temperature', '1 large egg yolk, at room temperature', '1/2 cup sour cream', '1 tablespoon powdered sugar', 'Special equipment:', '7-inch round springform pan', 'Food processor', 'Trivet', '6-quart Instant Pot, or other electric pressure cooker']",19,"['1 Prepare the pan: Line the base of a 7-inch round springform pan with an 8-inch round of parch\\xc2\\xadment paper. Secure the collar on the springform pan, closing it onto the base so the parchment round is clamped in. Lightly grease the sides of the pan with butter or nonstick cooking spray. (I traced a circle on parchment using the bottom of the springform pan as the guide. This worked great! \\xe2\\x80\\x93Emma)', '2 Make the crust: To make the crust, in a food processor, process the graham crackers into fine crumbs. You should have 3/4 cup. (I recommend measuring out the crumbs as I had slightly more than 3/4 cup. \\xe2\\x80\\x93Emma) Add the brown sugar and melted butter and, using one-second pulses, process the mixture until a uniform, sandy texture forms.', 'Transfer the crumb mixture to the prepared pan and press firmly in an even layer onto the bottom and about 1/2 inch up the sides of the pan. Place the pan in the freezer to allow the crust to firm up a bit while you make the filling.', '3 Make the filling: To make the filling, in the now-empty food processor, combine the softened cream cheese, heavy cream, granulated sugar, flour, and vanilla. (I wiped the food processor clean before doing this step. \\xe2\\x80\\x93Emma)', 'Process the mixture in about 5 one-second pulses, just until it becomes a smooth filling, stopping to scrape down the sides of the bowl if necessary.', 'Add the eggs and the egg yolk one at a time, processing for 2 one-second pulses after each addition. Do not overprocess the filling, or you will end up with an overly fluffy cheesecake. Using a spoon or a rubber spatula, gently stir in any remaining streaks of egg yolk. It is fine if a few streaks of egg yolk remain.', 'Pour the filling into the prepared crust. Tap the pan firmly against the counter\\xc2\\xadtop a few times to remove any air bubbles in the filling.', '4 Make a sling for the cheesecake: Fold a 20-inch-long sheet of aluminum foil in half lengthwise twice to create a 3-inch-wide strip. Center it underneath the pan to act as a sling for lifting the pan in and out of the Instant Pot.', '5 Assemble everything in the pressure cooker: Pour 1 1/2 cups water into the pot and place the trivet in the pot.', 'Holding the ends of the foil sling, lift the cake pan and lower it into the pot. Fold over the ends of the sling so they fit inside the pot.', '6 Pressure cook the cheesecake: Secure the lid and set the Pressure Release to Sealing. Select the Manual setting and set the cooking time for 32 minutes at high pressure. (My Instant Pot took about 8 minutes to come up to pressure before the cooking time actually began. \\xe2\\x80\\x93Emma)', '7 Make the sour cream topping: While the cheesecake is cooking, in a small bowl, whisk together the sour cream and confectioners\\xe2\\x80\\x99 sugar.', '8 Release the pressure naturally and remove the cheesecake from the pot: When the timer goes off, leave the pot on its default Keep Warm setting for 20 minutes, letting the pressure release naturally.', 'Open the pot, taking care not to drip condensation from the lid onto the cheesecake. Wearing heat-resistant mitts, grasp the ends of the foil sling, lift the springform pan out of the Instant Pot, and transfer the cheesecake to a cooling rack.', 'Use a paper towel to dab up any moisture that may have settled on the top. (Be sure to dab up any water that pools on the sides too! \\xe2\\x80\\x93 Emma) The cake will be puffed up and jiggle a bit in the center when it comes out of the pot, but it will settle and set up as it cools.', '9 Add the sour cream topping: When the cheesecake has deflated about 1/2 inch, spread the sour cream mixture on top in a smooth, even layer. Let the cheesecake cool on the rack for 1 hour.', '10 Cover and refrigerate for at least 12 hours or for up to 24 hours before unmolding.', '11 Unmold and serve the cheesecake: To serve, unclasp the collar on the pan and lift it off, then use the parchment border to tug the cheesecake off the base of the pan onto a plate, where it can be sliced and served.', '(I ran a thin spatula between the cheesecake and the mold to make sure it released cleanly. You can also clean up any rough edges with the spatula before serving. Also, my leftover cheesecake kept just fine in the fridge for about a week! So good! \\xe2\\x80\\x93Emma)']",19
1475,Cranberry Glazed Meatballs Recipe,20,40,60,"['Cranberry Glaze', '1 cup sugar', '1 cup water', '1 12-ounce bag of cranberries, fresh or frozen (no need to defrost)', 'A pinch of salt', '1 teaspoon orange zest', '1 teaspoon minced ginger', '2 teaspoons apple cider vinegar or white vinegar', '1/8 to 1/4 teaspoon cayenne, to taste', 'Meatballs', '2 large slices white bread, crusts removed, bread torn into small pieces (approximately one cup, packed, or 2 ounces of bread, can sub 1/2 cup of plain breadcrumbs)', '2 Tbsp milk', 'A generous 1/4 cup ricotta cheese', '1 egg', '1 1/4 pounds ground turkey', '1 teaspoon kosher salt', '1 1/2 teaspoons dried thyme', '1 scant teaspoon fennel seeds', 'Flour for dusting (optional)', 'Vegetable oil']",20,"['1 Make the cranberry glaze by mixing all the glaze ingredients except the cayenne in a small pot. Mix well and simmer until most of the berries have burst, about 15 minutes.', 'Strain mixture through a fine mesh strainer into a bowl, pressing the cranberry mush against the strainer with the side of a rubber spatula. (Be sure to scrape the outside of the sieve with the spatula.) Add cayenne to taste.', '2 Prepare the meatballs: While the cranberries are cooking, prepare the meatballs. In a small bowl, put the torn bread and sprinkle it with the milk. Use a fork to pulverize the bread a bit. In a large bowl, use the same fork to whisk together the ricotta and the egg until smooth. Add the ground turkey, salt, thyme, fennel seeds and milk-sprinkled bread.', ""Gently mix with your (clean) hands until the ingredients are all incorporated. Don't overwork the meatball mixture or the meatballs will become too dense."", '3 Gently roll out small meatballs about an 1 inch wide with the palms of your hands and set them on a baking sheet or large plate.', '4 Brown the meatballs: Heat 2 Tbsp vegetable oil in a wide saut\\xc3\\xa9 pan on medium heat. Working in batches, add the meatballs, taking care not to crowd the pan, and brown all over. Use a fork to gentle nudge the meatballs, turning them.', 'Note that the meatballs will probably be a bit on the wet side, which may cause some splattering as you cook them in the oil. To reduce that, you may want to sprinkle some flour on the meatballs, or roll them in flour, before they go in the pan. Add more oil to the pan as needed.', '5 Add glaze and simmer: Once the meatballs are browned and the glaze has been strained, add the glaze to the pan with the meatballs. Let simmer, uncovered, until the glaze reduces a bit and the meatballs cook through, about 5 minutes.', 'Remove the meatballs to a serving dish. Pour over remaining cranberry glaze. If the glaze during this process is too thick, add a little water. If too thin, let simmer a little longer.']",9
1476,"Tilapia with Olives, Mushrooms, and Tomatoes Recipe",10,25,35,"['1 tablespoon extra virgin olive oil', '1 small onion, 1/4 inch slices, sliced lengthwise', '1 clove garlic, minced (1 teaspoon)', '1 14-ounce can crushed tomatoes, undrained', '1 cup sliced cremini or button mushrooms', '3/4 cup green pimento-stuffed olives, coarsely chopped', '1 Tbsp chopped fresh oregano or 1/2 teaspoon dried oregano, crushed', '1/4 teaspoon salt', '1/8 teaspoon freshly ground pepper', '4 tilapia fillets (6 to 8 ounces each)']",10,"['1 Cook the onions and garlic: Heat olive oil in a large skillet over medium heat. Add the sliced onions and cook until translucent, about 5 minutes. Add the garlic and cook a minute more.', '3 Make the sauce: Add the canned tomatoes and their juices. Add the sliced mushrooms, chopped olives, oregano, salt and pepper. Bring to a simmer.', '4 Add the fish: Lay the fish fillets gently on top of the onion tomato olive mixture and spread a little sauce over the fish.', ""Return to a simmer (it's just the juices from the tomatoes that are simmering). Lower the heat to low and cover the pan."", 'Cook or 8 to 10 minutes or until the fish easily flakes when tested with a fork.', '4 Serve: Use a wide spatula to lift the fillets from the pan to a serving plate. Spoon sauce over fish.', 'Serve with rice, and/or crusty bread.']",7
1477,Baked Tilapia with Sun-dried Tomato Parmesan Crust Recipe,15,15,30,"['1 cup fine breadcrumbs, seasoned or unseasoned, or 2 cups panko', 'An additional 2 teaspoons Italian seasoning if you are using unseasoned breadcrumbs or panko', '2 teaspoons onion powder', '1 teaspoon garlic powder', '2 teaspoons paprika', '1 teaspoon salt', '2 Tbsp grated parmesan cheese', '8 sun-dried tomatoes, packed in oil', '2 tablespoons extra virgin olive oil', '4 tilapia fillets, about 1 1/3 pounds', 'Flour for dusting, about 1/3 cup', '1 beaten egg', 'Optional berry sauce', '2 cups mixed berries (frozen work well)', '2 teaspoons sugar', '1/4 cup water']",16,"['1 Make breading: Place the breadcrumbs, seasoning, onion powder, garlic powder, paprika, salt, and Parmesan cheese in a food processor and pulse until well mixed. Add the sun-dried tomatoes and olive oil and pulse until the consistency of a coarse meal.', '2 Prep pan and preheat oven: Spread some olive oil along the bottom of a roasting pan and set aside. Preheat the oven to 350\\xc2\\xb0F.', '3 Dredge tilapia fillets in flour, egg, breading: Rinse off the tilapia fillets with water and pat dry. Spread flour on a plate. Place beaten egg in a shallow bowl next to the flour. Place breadcrumb mixture in a bowl next to the egg. Put a large plate next to the breadcrumb mixture.', 'Working one by one, dredge the tilapia fillets first in the flour until lightly coated, then dip in the beaten egg until coated and let the excess drip off.', 'Place a small handful of the breadcrumb mixture on the large plate and place the fillet on top of it. Sprinkle a generous amount of breadcrumb mixture over the top of the fillet and press down with your fingers. When both sides are well breaded, gently transfer the fillet to the roasting pan.', '4 Bake in oven: Place the baking pan with the tilapia fillets in the oven and bake at 350\\xc2\\xb0F for 15 minutes, until the tilapia is just cooked through, and the fillets easily flake with a fork. (If serving with berry sauce, you can make the sauce while the fish cooks.) Remove from oven and let sit for a minute or two before serving.', 'Serve with slices of lemon with which to drizzle over the fish, and/or the optional berry sauce.', '5 Make berry sauce (optional): Place the berries in a small saucepan. Add a 1/4 cup  of water and sprinkle with sugar. Bring to a simmer and gently crush the berries a little with a potato masher or the back of a fork, just enough to break up the larger berries. Cook gently uncovered for several minutes, until the sauce is reduced to a syrup.']",8
1478,Mushroom Toast with Fried Egg Recipe,15,10,25,"['3 tablespoons olive oil', '1 shallot, chopped', '1 clove garlic, chopped', '1 pound mushrooms, sliced (button, cremini, shiitake, baby portabella, or a mix)', '1/2 teaspoon salt, or more to taste', '1/4 teaspoon pepper, or more to taste', '1/4 cup chicken stock, or more if needed', '3 tablespoons chopped fresh parsley', '3 tablespoons butter, plus extra for buttering the toast', '4 large eggs', '4 slices bread, any favorite kind', 'Special equipment:', '12-inch nonstick skillet']",13,"['1 Cook the mushrooms: In a large nonstick skillet over medium heat, heat the oil. Add the shallot, garlic, mushrooms, salt, and pepper. Cook, stirring, for 5 minutes, or until the mushrooms release their juices.', 'Turn the heat to medium-high and continue cooking, stirring often, until all the mushroom liquid evaporates. This intensifies their flavor.', '2 Add the stock and parsley: Add the chicken stock and 1 tablespoon of the parsley. Cook, stirring often, for 1 minute. Add more chicken stock, if needed, to make a mixture that is a little saucy, but not overly liquidy. Transfer to a bowl, cover loosely, and keep warm. Wipe out the skillet.', '4 Fry the eggs: In the skillet, melt the butter over medium heat. Drop the eggs into the skillet and sprinkle them lightly with salt and pepper. Cook 1 minute. Cover the skillet and cook 2 minutes more, or until the whites are just set but the yolk is still runny. (Cook a little longer if you prefer more firmly-set yolks.)', '5 While the eggs are frying, toast the bread: Transfer to individual plates when done and butter. Cut in half, if desired.', '4 Serve: Divide the mushrooms among the plates. Top with an egg. Sprinkle with the remaining 2 tablespoons parsley, to garnish.']",6
1479,Heath Bar Cookies Recipe,20,42,62,"['2 1/2 cups all-purpose flour', '1 teaspoon salt', '1 teaspoon baking soda', '1 cup (2 sticks) unsalted butter', '3/4 cup brown sugar', '3/4 cup granulated sugar', '2 eggs', '1 teaspoon vanilla', '1 1/2 cups chopped Heath Bar pieces (Eight 1.4 ounce bars)', '1/2 cup chopped walnuts']",10,"['1 Whisk dry ingredients: In a medium bowl, vigorously whisk together the flour, salt, and baking soda. Set aside. In a separate bowl, combine Heath Bar pieces and chopped walnuts. Set aside.', '2 Whisk butter, sugars, vanilla, then add eggs: In a large bowl, beat together the butter, brown and white sugars, and vanilla. Beat in the eggs one at a time.', '3 Make and chill dough: Add the flour mixture a third at a time, beating after each addition. Beat in the Heath bar walnut mixture. Chill cookie dough for at least 30 minutes (better an hour or longer).', '4 Spoon out dough balls onto cookie sheet: Preheat oven to 350\\xc2\\xb0F. On cookie sheets lined with parchment paper or Silpat, spoon out the cookie dough in small 1-inch diameter balls (size of a large marble).', ""Place dough balls 3 inches away from each other on the cookie sheets. (Make sure there is plenty of room between the cookie balls, and that the cookie balls aren't too big. These cookies spread!)"", '5 Bake: Bake at 350\\xc2\\xb0F for 10-12 minutes, until the edges are just starting to brown. Remove from oven and let cool for a few minutes. Then transfer the cookies to a wire rack to cool completely.']",6
1480,Chocolate and Hazelnut Matzo Toffee Recipe,10,135,145,"['4 sheets (4 ounces) plain matzo crackers', '1 cup (8 ounces) margarine', '1 cup (200 grams) brown sugar', '1 (10 to 12-ounce) bag semi-sweet chocolate chips', '1 cup chopped roasted hazelnuts, pecans, walnuts, or almonds', '1 teaspoon flaky salt (optional)', 'Special equipment:', 'Small offset spatula']",8,"['1 Prepare the oven and the baking sheet: Preheat the oven to 400\\xc2\\xbaF. Line a baking sheet with aluminum, then parchment. Place the matzo crackers on the baking sheet in a single layer, breaking two of the pieces so it all fits in the pan.', '2 Make the toffee: In a medium saucepan, combine the margarine and sugar over medium heat. Let the mixture come up to a boil, stirring occasionally, then continue to boil for about 3 minutes or until a candy thermometer measures at soft crack stage (270-289\\xc2\\xbaF).', 'It takes about 10-11 minutes total for the mixture to get up to temperature\\xe2\\x80\\x94your timing may vary depending on the size and thickness of your saucepan and the power of your stove. A thermometer is the easiest way to ensure consistent results.', '3 Add the toffee to the matzo: Pour the toffee mixture evenly over the matzo. Working quickly, use an offset spatula to spread it out in an even layer.', 'Place the baking sheet in the oven, and bake for 4 to 5 minutes, or until the butter/sugar has become bubbly all over.', '4 Add the chocolate and the nuts: Remove the matzo toffee from the oven and sprinkle the chocolate chips evenly over the top. Wait about 3 minutes for the chips to melt (I like to leave the baking sheet on the stove on top of the warm oven for this step). Use an offset spatula to spread the chips out in an even layer over the toffee.', 'Before the chocolate cools, sprinkle the toasted nuts and salt (if using) over the top. Tap the sheet pan against the counter a few times to help the nuts settle into the chocolate\\xe2\\x80\\x94this will help them adhere better when the toffee has set up.', '5 Cool and cut the toffee: Let the toffee cool completely\\xe2\\x80\\x94this will take about 2 to 3 hours, depending on how hot it is in your kitchen. Cut it into squares and serve.', 'The toffee will keep in a tightly lidded container or zip-top bag for up to 2 weeks, or frozen for up to 2 months.']",9
1481,Homemade Cup of Noodles Recipe,5,4,9,"['For Noodle Cups with Chicken in a Spicy Broth: ', '2 teaspoons low-sodium chicken bouillon paste (such as Better Than Bouillon)', '1/2 teaspoon finely grated fresh ginger', '2 teaspoons sweet Thai chili sauce', '1 teaspoon rice wine vinegar', '1/2 teaspoon chili garlic paste', '1/3 cup shredded chicken', '1/2 cup shredded Napa cabbage', '1 cup cooked brown rice ramen noodles', '1 tablespoon thinly sliced scallions', '1/4 cup herb leaves such as mint, cilantro, or Thai basil', 'Very hot or boiling water', 'For Noodle Cups with Miso and Tofu:', '2 teaspoons white miso paste', '2 teaspoons low-sodium soy sauce', '1/2 teaspoon finely grated fresh ginger', '1/2 teaspoon toasted sesame oil', '1/4 teaspoon Sriracha', '1/2 cup (1/2-inch) cubes firm tofu', '1/3 cup thinly sliced snow peas', '1 cup uncooked thin rice vermicelli', 'Small handful spinach leaves', '1 tablespoon finely sliced scallions', 'Very hot or boiling water']",24,"['1 Layer the ingredients into the jar: For making either of the versions here, layer the ingredients into the jar in the order listed: paste and seasoning ingredients, followed by the protein, vegetables, noodles, and scallions (and the spinach leaves, for the Miso and Tofu Noodle Cups).', ""If you're making the Chicken in Spicy Broth, wrap the herbs in plastic wrap to make an airtight package. Place on top of the other ingredients."", '2 Close the jar with a lid and refrigerate for up to 4 days.', ""3 When you're ready to eat, heat the soup: Remove the herb package from the Chicken with Spicy Broth. Pour enough boiling water over the ingredients to come to the top of the jar. Cover with the lid and let steep for 4 to 5 minutes. (If you're making Noodles Cups with Tofu and Miso, the noodles should be soft and no longer crunchy; steep for longer if needed.)"", 'Remove the lid and stir the contents with chopsticks or a fork to distribute the flavorings. Transfer to a bowl and top with the fresh herbs.']",5
1482,Easy Tomato Soup Recipe,20,20,40,"['5 tablespoons butter', '1 large onion, yellow or white, diced', '4 large cloves garlic, minced', '1 1/2 teaspoons kosher salt', '1 1/2 teaspoons freshly cracked pepper', '3 tablespoons flour', '1 (28 oz) can crushed or diced tomatoes', '1 (8 oz) can tomato sauce', '4 cups (32 oz) low sodium chicken stock', '1 tablespoon sugar']",10,"['1 Saut\\xc3\\xa9 the onions and garlic: In a Dutch oven set over medium heat, add the butter. Once it starts to foam, add the onion, garlic, salt, and pepper. Stir until both have softened and are fragrant, about 7 minutes.', '2 Make the roux: Add flour. Stir to make a paste. Continue stirring until the flour has taken on a light brown color. Stir and scrape with wooden spoon, 5-7 minutes. The onion paste should look golden with a little brown caramelization.', '3 Add tomatoes and stock: Add crushed tomatoes, tomato sauce, chicken stock, and sugar. Stir to combine. Cover the pot and bring to a boil over medium high heat, then reduce heat to medium and let simmer uncovered for about 20 minutes.', '4 Pur\\xc3\\xa9e and serve: Pur\\xc3\\xa9e the soup with an immersion blender. Alternatively, fill a countertop blender less than halfway with the hot soup. Remove the center lid insert. This allows the hot steam to escape. Cover the hole with a folded kitchen towel and place your hand over the top. Blend. Repeat as necessary until all of the soup has been pur\\xc3\\xa9ed.', 'Ladle into bowls, topped with freshly cracked pepper, slivered basil, and of course, grilled cheese sandwiches.']",5
1483,Slow Cooker Meatballs in Tomato Sauce Recipe,30,480,510,"['For the sauce:', '1 28-oz can crushed tomatoes', '1 15-oz can crushed tomatoes or tomato sauce', '3/4 medium onion, finely diced', '1 bay leaf', '1 teaspoon sugar', '1/2 teaspoon crushed red pepper flakes', '1/2 teaspoon salt', '1/2 teaspoon freshly ground pepper', 'For the meatballs:', '3/4 cup bread crumbs', '1/2 cup milk', '4 cloves minced garlic', '1/4 medium onion, finely diced', '1/4 cup chopped fresh parsley leaves', '1 3/4 teaspoon freshly ground pepper', '1 3/4 teaspoon kosher salt', '1 teaspoon dried oregano', '1/2 cup shredded Pecorino Romano or Parmesan cheese', '1 large egg', '1 pound 90/10 ground beef', '1 pound ground Italian turkey sausage', 'Special equipment:', '6- to 8-quart slow cooker']",24,"['1 Make the sauce: Set your slow cooker to low, then add the crushed tomatoes, onion, bay leaf, sugar, red pepper flakes, salt, and pepper. Give it a quick stir to combine everything.', '2 Soak the breadcrumbs: In a medium-sized bowl, combine the breadcrumbs and milk.', '3 Add the other meatball ingredients: In the same bowl with the breadcrumbs, add the garlic, onion, parsley leaves, pepper, salt, oregano, cheese, and egg. Mix it all together with a fork. Add the beef and turkey. Use your hands to mix everything together just enough to be combined.', '4 Shape the meatballs: These can be quite sticky. If you keep your hands wet with water, it is much easier to roll the meat into balls. Alternatively, you can use a small #40 cookie scoop. I like to make meatballs that are smaller than a golf ball.', 'Pinch off about a tablespoon of meat, roll it in your hands and place it directly into the sauce. Repeat until all the meatballs are made. Some of the meatballs will not be submerged in the sauce. That\\xe2\\x80\\x99s ok. They will fall into the sauce as they cook. Do not worry.', '5 Cover and cook: Secure the lid to your slow cooker and let it cook for as little as 5 hours on high or as many as 8 to 10 hours on low.', '6 Serve: Serve these over spaghetti, on a hoagie bun for a meatball sandwich, or as a party appetizer on their own.', 'If you want to thicken the sauce, you can transfer it to a skillet set over medium-high heat and reduce it until it reaches your desired consistency. If the sauce has some fat floating on the top, just stir it in.']",8
1484,Homemade Tomato Juice Recipe,15,30,45,"['3 pounds very ripe garden tomatoes, cored, roughly chopped', '1 1/4 cups chopped celery with leaves', '1/3 cup chopped onion', '2 Tbsp sugar (to taste)', '1 teaspoon salt', 'Pinch black pepper', 'A couple shakes of Tabasco sauce, about 6-8 drops (to taste)']",7,"['1 Put all ingredients into a large non-reactive pot (use stainless steel, not aluminum). Bring to a simmer and cook, uncovered, until mixture is completely soupy, about 25 minutes.', '2 Force mixture through a sieve, chinoise, or food mill. Cool completely.', 'Store covered and chilled. Will last for about 1 week in the refrigerator.']",3
1485,Buttery Tomato Pasta Recipe,5,20,25,"['1/2 pound of fusilli pasta or elbow macaroni', '1 14 ounce can of good quality whole tomatoes', '2 Tbsp butter', '2 teaspoons sugar (more or less to taste)', 'Salt', 'Pepper', 'Pinch of dried basil or fresh sliced basil (optional)']",7,"['1 Cook the pasta: Half fill a 4 quart pot with water. Add a tablespoon of salt. Bring salted water to boil. Add pasta. Cook until al dente, tender but still a little firm.', '2 Cook the tomatoes with butter and seasonings: While the pasta water is heating and the pasta is cooking, prepare the tomatoes. Shred the canned whole tomatoes with your fingers as you put them in a small saucepan. Add any tomato juice left in the can to the pot.', 'Add the butter. Heat to a simmer and stir to melt the butter. Simmer gently while the pasta is cooking.', 'Stir in sugar, salt, and pepper to taste. If you have fresh basil, thinly slice a couple leaves and stir in. If not, if you want you can add a pinch of dried basil.', '3 Drain the pasta, combine with the tomatoes: When the pasta is done, drain it. Stir in the cooked tomatoes and put in a serving bowl.', 'Serve immediately.']",6
1486,Fried Green Tomatoes Recipe,10,20,30,"['3 medium, firm green tomatoes', 'Salt', '1 cup all-purpose flour', '1 Tbsp Cajun seasoning (optional)', '1/2 cup milk or buttermilk', '1 egg', '1/3 cup cornmeal', '1/2 cup fine dry bread crumbs', '1/4 cup peanut oil or extra virgin olive oil']",9,"['1 Slice and salt green tomatoes: Cut unpeeled tomatoes into 1/2 inch slices. Sprinkle slices with salt. Let tomato slices stand for 5 minutes.', '2 Set out shallow bowls with coating ingredients: While the salted green tomato slices are resting, place in separate shallow bowls: the flour and Cajun seasoning (if using), buttermilk and egg, and breadcrumbs and cornmeal.', '3 Dip green tomato slices in flour, egg, then breadcrumbs: Heat the peanut oil in a skillet on medium heat. Beat the egg and the buttermilk together. Dip the green tomato slices in the flour-seasoning mix, then the buttermilk-egg mixture, then the cornmeal-breadcrumb mix.', '4 Fry the green tomatoes: In the skillet, fry half of the coated tomato slices at a time, for 3-5 minutes on each side or until brown.', 'Set the cooked tomatoes on paper towels to drain. These fried green tomatoes are fantastic with a little Tabasco sauce or remoulade.']",5
1487,Cod Saut\xc3\xa9ed in Olive Oil with Fresh Tomatoes Recipe,10,10,20,"['1 pound thin skinless fish fillets', 'Salt', '1/4 cup extra virgin olive oil', '2 large fresh tomatoes, cut into chunks', '2 teaspoons Italian seasoning', 'A splash of Tabasco or other hot sauce', 'Black pepper to taste']",7,"['1 Prep fillets: Remove any pin bones from the fillets and pat them dry. Salt the fish fillets well and set out on a cutting board.', '2 Saut\\xc3\\xa9 fish on one side: Heat the olive oil in a saut\\xc3\\xa9 pan and set it over medium heat for 2 minutes. Add the fish fillets, which should sizzle gently. Cook undisturbed for 90 seconds.', '3 Baste fish with hot pan oil: When you see the bottom of the fish fillets turn opaque, tilt the pan and, using a large spoon, baste the tops of the fish with the hot oil. Do this constantly until the top of the fillets begin to flake, about 3 minutes.', '4 Add tomato, seasonings: Add the tomato chunks, the Italian seasoning and the splash of Tabasco. Swirl around in the pan to combine and let this cook for 90 seconds. Turn off the heat.', ""5 Swirl tomatoes to emulsify sauce: Put a fish fillet on everyone's plate. Swirl the tomatoes in the pan and add black pepper to taste; this swirling should emulsify the sauce. Spoon out some tomatoes and sauce for everyone and serve at once."", 'Serve with crusty bread and a dry rose wine.']",6
1488,Pressure Cooker Green Beans with Tomatoes and Bacon Recipe,10,30,40,"['4 slices thick-sliced bacon (about 4 ounces), cut into 1-inch pieces', '1 medium onion, diced', '1 pound green beans, stem ends trimmed', '1 (14.5-ounce) can diced tomatoes', '1/3 cup water', '1/4 teaspoon salt', '1/4 teaspoon ground black pepper', '1/8 teaspoon cayenne pepper', '2 sprigs fresh thyme', 'Special equipment:', '6-quart Instant Pot, or other electric pressure cooker']",11,"['1 Cook the bacon and onions in the pressure cooker: Select the \\xe2\\x80\\x9cSaut\\xc3\\xa9\\xe2\\x80\\x9d setting and add the bacon to the pressure cooker. (If you are using a stovetop pressure cooker, use medium heat.)', 'Let the bacon cook until it has rendered some fat and begun to brown a bit, about 7 minutes. Add the onions and saut\\xc3\\xa9 until softened and translucent, about 3 more minutes.', '2 Stir in the rest of the ingredients and pressure cook: Add the green beans, diced tomatoes and their liquid, water, salt, pepper, cayenne, and thyme. Give everything a good stir so all of the green beans are coated with some of the cooking liquid.', 'Secure the lid on the pressure cooker. Make sure that the pressure regulator is set to the \\xe2\\x80\\x9cSealing\\xe2\\x80\\x9d position. Cancel the \\xe2\\x80\\x9cSaut\\xc3\\xa9\\xe2\\x80\\x9d program on the pressure cooker, then select the \\xe2\\x80\\x9cManual\\xe2\\x80\\x9d or \\xe2\\x80\\x9cPressure Cook\\xe2\\x80\\x9d setting. Set the cooking time to 7 minutes at high pressure. (For stovetop pressure cookers, cook for 6 minutes at high pressure.)', 'It will take about 10 minutes for your pressure cooker to come up to pressure, and then the 7 minutes of actual cooking will begin.', '3 Release the pressure: Perform a quick pressure release by immediately moving the vent from \\xe2\\x80\\x9cSealing\\xe2\\x80\\x9d to \\xe2\\x80\\x9cVenting\\xe2\\x80\\x9d (be careful of the steam!). The pot will take a couple minutes to fully release the pressure.', '4 Serve the green beans: Use a slotted spoon to gently transfer the green beans to a serving dish. Scoop up the tomatoes, bacon, and onions, and spoon them over the top of the beans. Serve hot.']",7
1489,Roasted Eggplant and Tomato Soup Recipe,20,50,70,"['12 plum tomatoes (about 3 lbs), cored, and cut in half lengthwise', '2 large carrots, cut into 3/4-inch pieces', '10 garlic cloves, peeled', '4 tablespoons extra virgin olive oil', 'Kosher salt and ground black pepper', '1 large eggplant (about 1 1/2 lbs), cut into 3/4-inch chunks', '1 can (15.5 oz) garbanzo beans, drained and rinsed', '2 teaspoons curry powder', '1/2 cup chopped fresh cilantro, for serving', 'Equipment needed:', '2 large rimmed baking sheets', 'Food processor or blender']",12,"['1 Prepare baking sheet with the tomatoes, carrots, and garlic: Preheat oven to 425\\xc2\\xb0F (220\\xc2\\xb0C). Place racks on the top third and bottom third of oven. Place the tomatoes, carrots, and garlic in a large bowl and sprinkle with 2 Tbsp of olive oil, 1 teaspoon of salt, and 1/4 teaspoon black pepper. Toss to coat the vegetables evenly.', 'Spread them out in an even layer in a rimmed baking sheet, with the tomatoes cut side down on the baking sheet.', '2 Prepare baking sheet with the eggplant and garbanzo beans: Place the chopped eggplant and garbanzo beans in the same bowl and sprinkle with the remaining 2 Tbsp of olive oil, the curry powder, a teaspoon of salt, and 1/4 teaspoon of black pepper. Toss to coat the eggplant pieces and garbanzo beans well.', 'Spread them out in a single layer on a second rimmed baking sheet.', '3 Roast the vegetables: Place the baking sheet with the tomatoes and carrots on the top rack and the eggplant and garbanzo beans on the lower rack in the oven.', 'Roast at 425\\xc2\\xb0F (220\\xc2\\xb0C) until cooked through and lightly browned, about 45 minutes. About halfway through the cooking turn the vegetables over so they brown on the other side.', '4 Remove skins from tomatoes, process tomatoes, carrots, garlic in a blender: Remove the vegetables from the oven when done. Use tongs or a fork to peel off the tomatoes skins (they should come off easily) and discard. Place the roasted tomatoes, carrots, garlic, and all of the juices from the roasting pan in a blender or food processor and blend until smooth.', '5 Stir in roasted eggplant and garbanzo beans, add water: Pour the tomato carrot pur\\xc3\\xa9e into a large pot. Stir in the roasted eggplant and garbanzo bean mixture. Add 3 to 4 cups of water to thin. Heat to a simmer on medium.', 'Season with salt and pepper. Sprinkle with fresh cilantro to serve.']",9
1490,Seared Okra and Tomatoes Recipe,10,20,30,"['5 tablespoons extra virgin olive oil', '1 celery rib, sliced thin', '1/2 onion, sliced thin', '1 jalape\\xc3\\xb1o chile, seeded, sliced thin', '3 garlic cloves, sliced thin', '1 tablespoon tomato paste', '2 tablespoons red wine vinegar', '1 1/2 cups chicken or vegetable broth (use vegetable broth for vegetarian version, and gluten-free broth for gluten-free version)', '1 teaspoon minced fresh rosemary', '1/2 to 3/4 pound fresh okra', '5 plum tomatoes, diced', 'Salt and pepper']",12,"['1 Saut\\xc3\\xa9 onion, jalape\\xc3\\xb1o, celery, then garlic: Heat 3 tablespoons of the olive oil in a large saut\\xc3\\xa9 pan or wide, shallow pot over medium-high heat. When the oil is hot, saut\\xc3\\xa9 the onion, jalape\\xc3\\xb1o and celery for 2 minutes, stirring once or twice. Add the garlic and saut\\xc3\\xa9 for another minute or two.', '2 Mix tomato paste, broth, vinegar, add to vegetables: While the vegetables are saut\\xc3\\xa9ing, mix the tomato paste, broth and vinegar until they are combined. Add to the pan with the vegetables and bring to a boil.', 'Add the rosemary and a pinch of salt.', '3 Slice okra on diagonal: As the sauce is boiling, slice the okra on the bias to create diagonal pieces. The reason for diagonal slicing is to expose as much of the interior of the okra as possible. Wait to cut the okra until the last minute because it helps make them less slimy.', '4 Sear the okra on high heat: Heat another pan over high heat for a minute or two. Add the remaining oil and get it almost smoking hot, which should take 1-2 minutes. Add the sliced okra and spread out in a single layer in the pan. Let the okra brown for at least a minute before you move them.', 'The goal is to cook the okra quickly at very high heat without moving it too much. The high heat sears the okra and helps limit the slime factor. Sear the okra for 3-4 minutes, stirring only 2-3 times.', ""5 Add seared okra to sauce, add tomatoes, simmer: As soon as the okra is done, add it to the boiling sauce. Add the diced tomatoes and reduce the heat to a simmer. Cook for 5 minutes, no longer. The tomatoes should still be a bit firm, and you don't want to cook the okra to the point it starts releasing slime."", '6 Turn off the heat, grind black pepper over everything and taste once more for salt. Add if needed.', 'Serve over steamed rice or with lots of crusty bread.']",9
1491,Pasta with Roasted Tomatoes and Creamy Herb Cashew Sauce Recipe,10,15,25,"['8 ounces spaghetti or fettuccine', '3 tablespoons olive oil, divided', '4 cups cherry tomatoes', '1 recipe cashew cream sauce (about 1 cup)', '3 tablespoons chopped basil', '1 tablespoons minced chives', '1 small clove garlic', '1/4 teaspoon sea salt', '1/4 teaspoon black pepper']",9,"['1 Cook the pasta: Bring a pot of salted water to a boil. Add the pasta, reduce to a simmer, and cook until the pasta is al dente. Drain the pasta and set aside. ', '2 Cook the tomatoes: In the same pot you cooked the pasta, add 1 tablespoon of olive oil over medium heat. Add the tomatoes and cook until them until they are hot and easily burst when pressed, 6 to 8 minutes.', '3 Make the sauce: Combine the cashew cream in a blender with the chopped basil, chives, garlic, 2 tablespoons olive oil, salt, and pepper. Blend until smooth.', '4 Assemble the pasta: Add the sauce to the pan with the tomatoes and pasta. Warm over low heat until the pasta sauce is hot. Add the pasta to the sauce and toss together to combine. Serve with an extra sprinkle of basil if desired.']",4
1492,Angel Hair Pasta with Quick Cherry Tomato Sauce Recipe,10,10,20,"['2 1/2 teaspoons salt', '1 pounds angel hair pasta (capellini or capelli d\\xe2\\x80\\x99Angelo), or another thin spaghetti', '4 tablespoons olive oil', '2 pints red and yellow cherry tomatoes', '1/2 teaspoon crushed red pepper', '1/4 teaspoon ground black pepper', '2 cloves garlic, very thinly sliced', '1 cup fresh basil leaves, removed from the stems', '1 cup grated Parmesan cheese']",9,"['1 Cook the pasta: Bring a large pot of water with 2 teaspoons of salt to a boil. Add the pasta and stir well until the water returns to a boil.', 'Cook for 3 to 4 minutes, stirring occasionally, or until the pasta is tender. With a ladle or a heat-proof liquid measuring cup, remove about 1/2 cup of the pasta cooking water and set aside.', 'Drain the pasta but do not rinse it; transfer to a bowl. Sprinkle with 1 tablespoon of the oil and toss well.', '2 Prep the tomatoes: Pierce small whole tomatoes with a skewer or the tip of a paring knife. Halve the tomatoes if they\\xe2\\x80\\x99re large.', '3 Make the sauce: In a deep skillet over medium-high heat, heat the remaining 3 tablespoons of oil. Add the cherry tomatoes \\xe2\\x80\\x93 they will splutter \\xe2\\x80\\x93 along with the remaining 1/2 teaspoon salt, red pepper, and black pepper.', 'Cook, shaking the pan, for 2 to 3 minutes, or until the tomatoes start to collapse and form juices. Add the garlic and continue cooking for 2 minutes more.', '4 Toss the pasta with the sauce: Add the pasta and 1/4 cup of the pasta water to the skillet with the tomato sauce. Toss well.', 'Add more pasta water if needed, a tablespoon at a time, to thin the mixture so the sauce coats the pasta. Add half the basil leaves and toss again.', '5 Serve: Divide the pasta among 4 to 6 large bowls. Add a few basil leaves on top of the pasta and sprinkle generously with Parmesan.']",9
1493,"Tomato, White Bean, Bacon Soup Recipe",15,45,60,"['1/4 pound bacon, diced', '1 large onion, chopped (about 2 cups)', '2 cloves garlic, minced', '2 cups peeled (about 3/4 lb), chopped potatoes (recommend Yukon Gold)', '6 cups peeled, chopped fresh tomatoes (or canned whole tomatoes with juice)*', '2 cups chicken stock or broth', '1 Tbsp dark brown sugar', '1 15-ounce can white beans, drained', 'Salt and pepper to taste', '* To peel fresh tomatoes, cut a shallow cross on one end, blanch in boiling water for about 30 seconds, remove from boiling water and the peels should easily come off.']",10,"['1 Cook bacon: Cook bacon on medium heat in a large thick-bottomed pot (5 to 6 quart) until lightly browned and fat is rendered.', 'Use a slotted spoon to remove bacon from the pan. Set on a plate lined with a paper towel. Drain off all but 1 Tbsp of bacon fat.', '2 Saut\\xc3\\xa9 onion and garlic, add potatoes: Add the chopped onion to the pot, cook in the bacon fat on medium heat until soft.', 'Add the minced garlic and cook a minute more.', 'Add the chopped peeled potatoes and cook a few minutes more.', '3 Add tomatoes, stock, simmer: Add the tomatoes and chicken broth. Bring to a boil, lower heat to maintain a simmer. Cover and cook until potatoes are cooked through, about 20 minutes (or longer).', '4 Add beans, blend half the soup: Stir in the brown sugar. Add half of the beans to the mixture. Use an immersion blender to blend about half of the soup mixture (or blend half of the soup in a standing blender and return to the pot).', '5 Add bacon, remaining beans: Add bacon to the soup and the rest of the beans. Add salt and pepper to taste.', 'Serve with crusty bread.']",9
1494,Stewed Tomatoes with Butter Toasted Croutons Recipe,5,30,35,"['Tomatoes:', '3 cups cored, peeled, roughly chopped, fresh, ripe tomatoes (about 2 pounds), OR one 28-ounce can of whole peeled tomatoes', '2 tablespoons unsalted butter', '4 teaspoons sugar', '1/2 teaspoon salt', '1/4 teaspoon freshly ground pepper', '6 basil leaves, chopped', 'Croutons', '2 or 3 slices of crusty French or Italian bread, cut into 3/4-inch cubes', '1 tablespoon unsalted butter', 'Garlic salt']",11,"['1 Cook the tomatoes with butter, sugar, and seasonings: Put peeled, chopped tomatoes, butter, sugar, salt and pepper into a small saucepan. Heat to a simmer, then reduce heat to medium-low. Let simmer for 20-30 minutes or until tomatoes are cooked, soft, and the flavors have blended.', 'Add chopped basil and add more butter, sugar, salt and pepper if needed for balance.', '2 Make the croutons on the stovetop: Melt 1 tablespoon butter in a small frying pan on medium heat. Add the bread cubes, and arrange in a single layer on the pan. Let gently cook on medium heat so that the bread dries out and gets slightly toasted. Turn pieces over to toast other sides.', 'Cook for about 10 minutes or until the croutons are crunchy dry, and slightly toasted. Sprinkle with garlic salt. Remove from heat.', 'Serve stewed tomatoes with a few croutons on top of each individual serving, and the rest of the croutons available in a small bowl to add as desired.']",5
1495,Cheesy Baked Zucchini Noodle Casserole Recipe,20,70,90,"['3 pounds zucchini (about 5 to 6 good sized zucchini, enough for 8 to 10 cups of salted zucchini noodles)', '3 teaspoons kosher salt', '1 tablespoon extra virgin olive oil', '8 ounces Italian sausage (in bulk, out of casings)', '1 1/2 cups diced onion', '3 cloves garlic, minced (about 1 Tbsp)', '1 15-ounce can crushed tomatoes', '1/2 cup thinly sliced fresh basil leaves', '1 1/2 teaspoons kosher salt', '3/4 cup ricotta cheese', '2 cups grated mozzarella cheese (about 8 ounces)', '1/2 cup grated Parmesan cheese', 'Special equipment:', 'A spiralizer for making zucchini noodles (I recommend the Paderno World Cuisine Spiral Vegetable Slicer or the Inspiralizer)']",14,"[""1 Spiralize the zucchini, toss with salt, let drain: Using a spiralizer, use the zucchini to make zucchini noodles (zoodles) with the device, following manufacturer's directions. You should have a generous 8 cups of zucchini noodles."", 'Place in a colander over a bowl. Snip zucchini noodles with scissors here and there to keep them from tangling too much.', 'Toss the zoodles with 3 teaspoons of kosher salt. Let the zoodles drain of excess moisture while you make the sauce.', '2 Lightly brown the sausage: Coat the bottom of a large saut\\xc3\\xa9 pan with olive oil. Break up the Italian sausage into small clumps in the pan. Heat on medium heat and gently cook the sausage until it is just cooked through and lightly browned. Remove to a bowl. Discard all but 1 Tbsp of rendered fat.', '3 Brown the onions and garlic: In the same pan, add the chopped onion. Cook until softened and lightly colored, about 5 to 6 minutes. Add the minced garlic and cook a minute more.', '4 Add tomatoes, cooked sausage, then simmer, add basil: Add the canned crushed tomatoes and cooked sausage to the pot with the onions. Bring to a simmer and lower the heat to maintain a low simmer. Cook for 5 to 6 additional minutes.', 'Stir in thinly sliced basil and 1 1/2 teaspoons of kosher salt.', '5 Squeeze moisture out of zoodles: While the sauce is simmering, use a clean dish towel (or several paper towels) to squeeze more moisture out of the zucchini noodles.', '6 Add zoodles to sauce, place in casserole: Add the zucchini noodles to the pot with the tomato sausage sauce. Gently stir to combine so that all of the noodles are coated with sauce.', 'Transfer into an oiled 8x13 casserole dish and spread into an even layer.', '7 Top with ricotta, Mozzarella, and Parmesan, and bake: Arrange the ricotta in clumps on the casserole. Press the ricotta into the zucchini noodles to penetrate the casserole a bit. Mix the grated mozzarella cheese and Parmesan cheese together and sprinkle over the top in an even layer.', 'Bake at 350\\xc2\\xb0F, uncovered, for 35 minutes, or until the top is lightly browned and bubbly. Let cool for 10 minutes before serving.']",12
1496,Tuna Pasta with Tomato and Olives Recipe,10,20,30,"['12 ounces short pasta (shells, macaroni, rigatoni)', 'Salt for pasta water', '3 tablespoons extra virgin olive oil (plus 2 Tbsp if you are using tuna packed in water)', '1/4 cup chopped shallots (can sub onion)', '2  teaspoons minced garlic', '1/2 teaspoon red pepper flakes', '2 5-ounce cans tuna packed in olive oil, drained', '1 14-ounce can crushed tomatoes', '1/4 cup chopped kalamata olives', '1 teaspoon capers', '1/2 teaspoon black pepper', '1/4 teaspoon salt (more to taste)', '1/4 cup shredded Parmesan', '1 Tbsp chopped fresh parsley']",14,"['1 Bring pasta water to a boil: Bring 4 quarts of salted water to a boil (add 1 Tbsp salt for every 2 quarts of water). While the water is heating, prep the ingredients and start the sauce.', '2 Saut\\xc3\\xa9 shallots, garlic, red pepper flakes: Heat 3 Tbsp of olive oil in a large saut\\xc3\\xa9 pan on medium heat. Once the oil is hot, add the chopped shallots, minced garlic, and red pepper flakes at the same time to the pan. Let cook for about 30 seconds.', '3 Add drained canned tuna: Drain the canned tuna and add it to the pan. If you are using tuna packed in water and not olive oil, add 2 or 3 more Tbsp of olive oil to the pan.', 'Break up any chunks of tuna with a fork or wooden spoon. Let simmer for a minute.', '4 Add tomatoes, olives, capers, salt, pepper: Stir in the crushed tomatoes, olives, capers, salt, and pepper.', 'Bring to a simmer and reduce heat to the lowest setting to gently cook while you cook the pasta.', '5 Cook pasta: Add dry pasta to the pot of boiling salted water. Cook uncovered at a vigorous full boil until al dente\\xe2\\x80\\x94cooked, but still a little firm to the bite, about 13-14 minutes.', 'Before draining, remove a cup of the pasta water and set aside.', '6 Stir cooked pasta into sauce: Drain the pasta and stir into the sauce. Toss with grated Parmesan and chopped fresh parsley. If the pasta seems a little dry after a few minutes, add back in some of the reserved pasta water.']",9
1497,Roasted Tomato Soup with Chipotle Recipe,10,60,70,"['3 pounds fresh plum or garden tomatoes, cored and sliced in half', '1 onion, peeled and quartered lengthwise (root end to top)', '4 to 5 cloves garlic, left in the skins', '1 red bell pepper, cored and sliced in half', 'Extra virgin olive oil', 'Salt', '1 to 2 chipotle chiles (canned in adobo), roughly chopped', '2 cups chicken stock (or vegetable broth for vegetarian option)', 'Sliced fresh basil or chopped fresh cilantro for garnish', 'Sour cream for garnish']",10,"['1 Roast the tomatoes, bell pepper, garlic, onions: Preheat oven to 400\\xc2\\xb0F. Coat the bottom of a rimmed baking pan or baking sheet with olive oil.', 'Arrange the tomatoes and red bell pepper cut side down on the sheet. Place the garlic cloves and onion on the baking sheet. Paint olive oil over the vegetables and sprinkle everything with salt.', 'Bake in the oven 45 minutes, or until the skins of the tomatoes and peppers start to blacken.', '2 Pur\\xc3\\xa9e the roasted vegetables with chipotle: Remove the baking sheet from the oven and allow it to cool for 10 minutes. Pick the tomato and red pepper skins off the tomatoes and peppers and discard. Peel the skins off the garlic and discard. Reserve the baking sheet.', 'Put the roasted tomatoes, onions, peeled garlic, roasted peppers, and chipotle into a food processor or blender. Add any of the tomato liquid that may be left in the baking pan. Scrape up any browned bits on the pan (not blackened bits) and add those to the food processor bowl as well.', 'Pulse until you have a rough pur\\xc3\\xa9e, about 60 seconds.', '3 Add stock and simmer: Pour the pur\\xc3\\xa9e into a medium pot. Add 2 cups of stock. Heat the soup to a simmer. Add salt to taste.', '4 Serve: Garnish with a dollop of sour cream that has been lightly thinned with water, and freshly sliced basil or chopped cilantro.']",8
1498,Tomato Tortellini Soup with Italian Sausage Recipe,10,35,45,"['16 ounces ground mild Italian sausage', '1/2 large yellow onion, diced small', '3 cloves garlic, minced', '1 teaspoon dried oregano', '1/4 cup white wine (or substitute chicken stock)', '1 tablespoon tomato paste', '1 28-ounce can crushed tomatoes', '1 15-ounce can tomato sauce', '4 cups chicken stock, store-bought or homemade', '1 teaspoon sugar', '8 ounces frozen cheese tortellini', '1 cup packed baby spinach leaves', '8 large fresh basil leaves, cut into thin ribbons', '1/3 cup heavy cream']",14,"['1 Cook the sausage and onion: In a Dutch oven or large soup pot set over medium heat add the sausage, breaking it up as you cook it. This should take about 7 minutes. Once browned, use a slotted spoon to remove from pan to paper towel lined plate.', 'Leave the fat in the pan and add onion, garlic, and oregano to the pot. Saut\\xc3\\xa9 for about 2 minutes, until onions are translucent.', '2 Deglaze the pot: Add 1/4 cup white wine (or chicken stock) to the pot to deglaze it (a.k.a. scrape up any brown bits stuck to the bottom from the sausage). Let the wine reduce by half and the onion soften. This should take about 3-5 minutes. Add 1 tablespoon tomato paste. Stir continuously, letting it cook for about 2 minutes.', '3 Add tomatoes and stock: Add crushed tomatoes, tomato sauce, chicken stock, and sugar. Stir to combine. Cover the pot and bring to a boil, about 10 minutes.', '4 Add tortellini and finish soup: Add the cheese tortellini to the soup. Stir and cook for 10 minutes if using frozen, or until the tortellini is cooked through according to the instructions on the package.', 'Reduce the heat to medium-low, add the Italian sausage back into the pot. Add the spinach. Stir to wilt. Add the basil and stir in the heavy cream just before serving.']",6
1499,Flourless Lemon Almond Cake Recipe,20,40,60,"['4 eggs (large), separated into 4 egg yolks and 4 egg whites, room temperature (see how to separate eggs)', '2 Tbsp lemon zest, packed', '1/2 cup (100 g) white sugar, divided 1/4 cup (50 g) and 1/4 cup (50 g)', '1 1/2 cup lightly scooped (144 g) finely ground blanched almond flour', '1 teaspoon baking powder (make sure your baking powder is fresh!)', '1/4 teaspoon ground cardamom', '1 teaspoon white or cider vinegar', 'Pinch of salt', 'Powdered sugar for sprinkling', 'Special equipment:', '8 or 9-inch springform pan']",11,"['1 Preheat oven, prepare pan: Preheat the oven to 350\\xc2\\xb0F (175 \\xc2\\xb0C).  Place a round of parchment paper on the bottom of a 8 or 9-inch springform pan, and grease it and the sides of the pan with butter or cooking spray.', '2 Beat egg yolks, lemon zest, 1/4 cup sugar: In a large bowl, beat together with a wooden spoon the egg yolks, lemon zest, and 1/4 cup sugar until smooth.', '3 Whisk almond flour, baking powder, cardamom, beat into egg yolk mixture: In a separate bowl, whisk together the almond flour, ground cardamom, and baking powder. Add the flour mixture to the egg yolk mixture and beat until well combined. The mixture should resemble a thick paste.', '4 Whip egg whites to soft peaks: With an electric mixer with a very clean bowl and clean whisk attachment, beat the egg whites, starting on low speed and gradually increasing the speed.', 'When bubbles start to form, add a pinch of salt and the teaspoon of vinegar (both the salt and the vinegar will help the beaten egg whites maintain better structure, as will the sugar in the next step).', 'As the egg whites begin to increase in volume, sprinkle in the remaining 1/4 cup of sugar, a little at a time, as you continue to beat the egg whites. Beat until soft peaks form.', '5 Fold beaten egg whites into almond mixture: Stir a third to a half of the beaten egg whites into the almond mixture to loosen it and make it lighter.', 'Then gently fold the remaining whipped egg whites into the batter, a large scoopful at a time.', '6 Scoop batter into pan, bake: Gently scoop the batter into the prepared springform pan and place in the oven. Bake at 350\\xc2\\xb0F (175 \\xc2\\xb0C) for 30 minutes.', 'Remove from the oven and let cool. Run a sharp knife around the edge of the cake helping it to separate from the side of the pan.', 'Release the springform pan sides, and gently move the cake (on parchment) to a cake serving plate. Sprinkle with a little powdered sugar before serving.']",11
1500,Chocolate Ganache Torte Recipe,15,60,75,"['For the shell:', 'One 9-ounce box \\xe2\\x80\\x9cNabisco\\xe2\\x80\\x99s Famous\\xe2\\x80\\x9d chocolate wafers, or your favorite chocolate nut cookies', '2/3 cup pecans', '4 Tbsp (2 ounces, 1/2 stick) butter, melted (you may need less)', 'For the filling:', '1 1/2 to 2 pounds of the best available semi-sweet or bittersweet chocolate, well chopped into small pieces (use brick chocolate, not chips)', '1/2 cup (4 ounces, 1 stick) butter, melted', '1 cup (or more) heavy whipping cream', 'For the sauce:', '1/2 cup (4 ounces, 1 stick) butter, melted', '2 1/4 cups (a pound) cane sugar (white granulated sugar)', '1 cup heavy whipping cream', 'Special equipment:', '9 inch spring-form pan']",14,"['1 Preheat the oven to 350\\xc2\\xb0F.', '2 Prepare the crust. Process the wafers and pecans in a food processor (or chop by hand) until fine, then add enough melted butter so that it holds together when you press a little in your fist.', 'Press this mixture evenly into the spring-form pan along the bottom and halfway up the sides.', 'Bake in a 350\\xc2\\xb0F oven at for 20 minutes, then set aside to cool.', '3 While the crust is baking, prepare the ganache filling. In double boiler (or a heat proof bowl set over a pot of simmering water), melt the butter and then add the chocolate.', 'When chocolate has melted and is swirl-able, slowly add the whipping cream, stirring slowly, until mixture is blended and smooth. Pour ganache mixture into the prepared shell.', '4 Refrigerate for at least four hours.', '5 Prepare the caramel sauce before serving (the sauce, served warm, should accompany the torte, served cold): Melt the butter over medium high heat in a thick bottomed, high sided pot (at least 3-qt).', 'Add the sugar. Stir to combine. Increase the heat to high. Stir as the sugar melts. It will take a few minutes.', 'Once the mixture is melted, there may still be some lumps. Use a whisk and whisk to dissolve the lumps.', 'When the mixture is brown and smooth, and the sugar all dissolved, remove from heat.', 'Slowly add the cream, a quarter cup at a time, stirring briskly until well blended and smooth. Note that the mixture will bubble up and steam significantly as you add the cream. This is why we are using a high sided pot. Protect your hands with oven mitts or use a long handled wooden spoon to stir.', 'The mixture will be very hot. Let cool until warm, but not hot, before serving.', 'One nine-inch torte has been known to serve twenty adults, so be careful...']",14
1501,Cheesy Tortellini Casserole Recipe,10,50,60,"['1 1/2 pounds (24 ounces) prepared frozen cheese tortellini', 'Salt', '12 ounces cremini or white button mushrooms, roughly chopped or sliced into 1/4-inch slices', '1 tablespoon butter', '3 cloves garlic, minced (about 1 tablespoon)', '1 28-ounce can crushed tomatoes', '1 large bunch Swiss chard, ribs removed, leaves chopped (about 2 cups), OR 2 cups fresh chopped spinach, OR 1/2 cup frozen spinach', '1 1/2 teaspoons dried basil, or 1 tablespoon finely chopped fresh basil', '1/4 teaspoon fennel seeds, crushed', 'Pinch of red pepper flakes', '1/2 cup grated Parmesan cheese', '4 to 6 ounces Mozzarella cheese slices, enough to cover the surface of the casserole']",12,"['1 Pre-heat oven to 400\\xc2\\xb0F.', '2 Boil the tortellini: Heat a large pot with 3 quarts of water and 1 1/2 tablespoons of salt on high heat. When the water starts to boil, add the tortellini. Once the water returns to a boil, cook for an additional 2 minutes, until al dente.', 'You want the pasta cooked al dente because it will continue to cook when baked in the casserole. Remove from heat and drain. Set aside.', '3 Saut\\xc3\\xa9 the mushrooms: While you are preparing the pasta, start on the sauce. Heat a large thick bottomed stick-free (hard anodized aluminum or cast iron are best) pan on medium heat.', 'Add the mushrooms. ""Dry"" saut\\xc3\\xa9 them for 5 to 10 minutes with no added fat. As the mushrooms heat they will release water and cook in their own juices.', 'Once the mushrooms are well coated with the water that they are releasing, stir in a tablespoon of butter.', '4 Finish the sauce: Add the garlic, crushed fennel seeds, and red pepper flakes to the mushrooms and cook a minute more.', 'Add the crushed tomatoes and the dried or fresh basil. Increase the heat to bring to a simmer, then lower the heat to maintain a low simmer for 5 minutes.', 'Add the chopped chard and cook for 5 more minutes until the chard begins to wilt.', 'Stir in the grated Parmesan cheese. Add 1/2 teaspoon of salt (more or less to taste).', '5 Assemble the casserole: Stir the cooked tortellini into the sauce and remove from heat. Spread the tortellini mixture into a 9x13 casserole dish in an even layer. Arrange a layer of sliced Mozzarella cheese over the top of the tortellini.', '5 Bake: Cover with foil. (Either cover the casserole in a way that the foil is not touching the cheese or spread a little olive oil over the inside of the foil so that the casserole cheese does not stick to the foil while it cooks. You can also use stick-free foil.)', 'Bake at 400\\xc2\\xb0F for 20 minutes. Remove foil and broil for 4 to 5 minutes more until top is lightly browned and bubbly.']",13
1502,How to Make Corn Tortillas,15,15,30,"['2 cups masa harina', '1 1/2 to 2 cups very warm water']",2,"['MAKE THE MASA DOUGH', '1 Mix masa flour with warm water: To make 16-18 tortillas, start with putting 2 cups of masa flour in a large bowl.', 'Add 1 1/2 to 2 cups of very warm water to the masa flour (according to the directions on the package, some brands may call for different amounts of water).', 'Mix in and let sit for 5 minutes or so.', '2 Knead the dough: Begin working the masa with your hands to make the dough. Work the dough for several minutes.', 'Press the dough with your fingers and the palms of your hands as if you were kneading bread dough.', 'The dough will be a little gritty at first, but should become more pliable as you kneed it.', 'If at any point through the tortilla making process the dough seems too dry or too wet, add a little more water or masa to the dough.', '3 Form balls of dough: Pinch off a piece of the masa dough and rub it between your hands to shape it into a ball the size of a plum, or slightly large golf ball.', 'Make about 16-18 balls from the dough.', 'PRESSING THE TORTILLAS', '4 Prepare the press with two sheets of plastic: Cut two pieces of plastic from a plastic freezer bag into the shape of the surface of the tortilla press.', '5 Place ball of dough between the plastic sheets and press: Open the tortilla press and lay one piece of plastic on the press. Place the masa ball in the center.', 'Place another piece of plastic over the masa ball.', 'Gently close the press and press down, until the dough has spread to a diameter of 4 to 5 inches.', 'COOKING THE TORTILLAS', '6 Heat a griddle or a large skillet on high heat. A well seasoned cast iron griddle or large cast iron pan works well for this.', '7 Remove the raw tortilla from the plastic: Working one at a time, hold a tortilla in your hand, carefully removing the plastic on each side.', '8 Lay the tortilla down on the hot pan: Allow the tortilla to rest half on your hand, and half hanging down, and gently lay the tortilla down on to the skillet. Start working on pressing the next tortilla.', '9 Cook the tortilla on one side, then flip: Cook the tortilla on the hot pan for 30 seconds to a minute on each side. The tortilla should be lightly toasted and little air pockets forming.', '10 Keep the tortillas warm, covered: Remove the tortillas to a tortilla warmer lined with dish towel or paper towels, or wrap them in a dish towel to keep them warm.', 'Serve immediately or refrigerate and reheat.']",22
1503,Grilled Trout with Dill and Lemon Recipe,10,23,33,"['Extra virgin olive oil', '2 trout, boned (also called ""butterflied"") and cleaned, head and tail still on (or headless if you want)', 'Salt', 'Pepper', '6 paper thin slices of fresh lemon, seeded', 'Several sprigs of dill (or basil, tarragon, parsley, any tender fresh herb)', '1 teaspoon butter, cut into small cubes']",7,"['1 Prepare your grill for direct high heat, with one part of the grill cool.', '2 Make aluminum ""boats"" for the fish: While the grill is heating, make one or two ""boats"" with heavy duty aluminum foil. Double or triple layer the foil and make 1-inch rim around the edges.', 'Coat the bottom of the boat generously with olive oil so that the trout does not stick while it is cooking.', '3 Prep the trout: Rinse the trout with water and pat them dry. Open up the fish and sprinkle with salt and pepper. Add lemon slices to the inside of the fish in a single layer. Top with sprigs of dill and dots of butter. Close the fish over the stuffing. Brush both sides of the fish with olive oil. Place fish in the aluminum foil boat(s).', '4 Grill the trout: Place fish boats on the hot side of the grill. Cover and let cook for 3 minutes. The oil and the juice from the fish will get bubbly.', 'Move to the cool side of the grill. Cover and cook for 3-5 more minutes, until the fish are just cooked through. You can peek inside the fish for doneness. Once opaque, the fish should be removed from the grill.']",6
1504,Coconut Tuiles Recipe,30,9,39,"['1/4 cup (1/2 a stick) of unsalted butter, softened (see how to soften butter quickly)', '1/2 cup sugar', '2 large egg whites, lightly beaten', '3 Tbsp all-purpose flour', '2 cups sweetened shredded coconut, toasted lightly, divided']",5,"['1 Preheat oven to 400\\xc2\\xb0F.', '2 Beat butter, sugar, then beat in eggs: Using an electric mixer, beat the butter. Add the sugar and beat until light and fluffy. Add the egg whites a little at a time, beating slowly after each addition. Beat for 5 seconds or until the mixture is smooth.', '3 Add flour and coconut: Sprinkle flour over the mixture and fold it in gently with 1 1/2 cups of the coconut.', '4 Spoon onto baking sheets, sprinkle with coconut: Spoon rounded teaspoons of the mixture 3 inches apart on to baking sheets that have been greased or using Silpat.', 'With the remaining 1/2 cup coconut, sprinkle a little over the center of each round.', '5 Bake: Bake the rounds at 400\\xc2\\xb0F on the middle rack of the oven for 6 to 9 minutes, or until the edges are lightly browned.', '6 Drape cooling cookies over rolling pins: Let the cookies stay on the baking sheets for half a minute, or until they are just firm enough to hold their shape. Then drape them over the side of a rolling pin or bottle.', '(If the cookies have become too firm to drape, put them in the warm oven for a few minutes to soften.)', 'Let the cookies cool completely.']",9
1505,Roast Beef Tenderloin with Saut\xc3\xa9ed Mushrooms Recipe,15,45,60,"['1 3/4 to 2 pound piece of beef tenderloin (preferably a piece cut from the center of the tenderloin), trimmed of excess fat and silverskin', '1 teaspoon kosher salt', '1/2 teaspoon coarse black pepper', '1 1/2 tablespoons extra virgin olive oil', '  1 pound cremini mushrooms, sliced into 1/8 to 1/4-inch thick slices', '3 Tbsp butter', '1 teaspoon salt (use 1/2 teaspoon if using salted butter)', '2 Tbsp minced shallots', '2 Tbsp minced garlic', '1 1/2 teaspoons of Herbs de Provence or a teaspoon of dried tarragon']",10,"['1 Salt and pepper roast, let sit at room temp: Remove roast from refrigerator 1 to 2 hours before cooking so that it has time to come close to room temperature. Sprinkle all sides with salt and pepper and set aside.', '2 Sear roast on stovetop: When ready to cook the tenderloin roast, preheat oven to 425\\xc2\\xb0F. Heat olive oil in a cast iron or thick-bottomed saut\\xc3\\xa9 pan that can take the heat, on high heat. When the oil is hot, place the roast in the pan and brown it on all sides, including the ends, about 10 minutes.', '3 Finish cooking in oven: When sufficiently browned, remove the roast from the pan (do not clean out the pan) and place on a roasting pan.', ""Place in the oven and roast at 425F until the internal temperature is 130\\xc2\\xb0F for rare (140\\xc2\\xb0F for medium), about 20 minutes (or longer if your roast wasn't at room temp to begin with. Use a meat thermometer!"", '4 Let roast rest before slicing: Remove from oven and loosely tent with foil to rest for 15 to 20 minutes before slicing.', '5 Saut\\xc3\\xa9 shallots, garlic, mushrooms: While the roast is resting, prepare the mushrooms. Add 3 Tbsp of butter to the same pan you used to sear the beef roast. Heat on medium heat to melt the butter. Add the minced shallots and garlic, and cook for half a minute.', 'Stir the mushrooms into the pan and cook until they start to give off steam. Then add salt, pepper, and herbs de provence. Continue to cook until just cooked through.', 'Add a few tablespoons of warm water to the pan to scrape up any remnants from the bottom of the pan (can also use white wine or marsala). Remove from heat.', '6 Slice the roast: Use a sharp knife to slice the roast across the grain into 1/4 to 1/2-inch thick slices. Serve with the saut\\xc3\\xa9ed mushrooms.']",9
1506,Chocolate Fondue Recipe,5,10,15,"['12 ounces of milk or dark chocolate (chips or roughly chopped if from a block)', '1 cup (8 ounces) of heavy whipping cream', 'A pinch of salt', 'Dip-ables such as strawberries, banana pieces cut into 1-inch chunks, dried appricots, candied ginger, apple pieces', 'Special equipment:', 'Fondue Pot']",6,"['1 Heat the cream with a pinch of salt over medium heat in a small saucepan until tiny bubbles show and begins to lightly and slowly simmer.', '2 Remove from heat, add the chocolate, and whisk until smooth and full incorporated.', '3 Immediately transfer to a fondue pot heated at low or with a low flame, or serve straight from the pot.', 'Arrange the dip-ables on a platter or plates around the chocolate pot. Use a fondue fork, bamboo skewer, seafood fork, or salad fork to dip the fruit pieces and other dippables into the hot melted cream chocolate mixture. Eat immediately.', 'If the fondue begins to feel a little stiff, add a tablespoon of heavy cream and stir. It will help it go a little longer. Eventually, it will cook down though and you may need to start a new pot.', 'Variations', ""Add a tablespoon or two of Bailey's Irish Cream to the chocolate. Other liquors such as Grand Marnier, Amaretto, or Kirsch are equally yummy."", 'Add a 1/2 teaspoon of cinnamon and ancho chili pepper for a nice Mexican Chocolate.', 'The contents of a vanilla pod or some vanilla extract are always a decadent touch to chocolate.', 'A good pinch of espresso powder can do wonders!', 'Orange zest or grapefruit zest is nice way to create a slightly fruity chocolate.', 'A few tablespoons of Torani flavoring syrups (the kind used for coffee or Italian sodas) can add a nice dimension of flavor as well.', 'Add a teaspoon of peppermint extract for peppermint chocolate fondue.', 'White chocolate is always a nice change, and spiked with a little liquor or citrus zest becomes heavenly.', 'Steeping the cream for an hour beforehand and while heating it can add a nice subtle flavor, lemongrass for white chocolate or a bag of Earl Grey tea for dark chocolate are particularly stylish and contemporary.']",15
1507,Lamb Chops with Rosemary and Garlic Recipe,10,40,50,"['1 pound lamb rib chops', '2 tablespoons minced fresh rosemary', '2 teaspoons salt', '1 teaspoon freshly ground black pepper', '1 garlic clove, minced', '4 tablespoons extra virgin olive oil, divided']",6,"['1 Marinate the lamb chops: In a small bowl, mix the rosemary, salt, pepper, garlic, and 2 tablespoons of the olive oil together. Coat the lamb chops with the mixture, massaging it into the meat with your fingers. If you are working with double rib chops, cover and let stand at room temperature for 30 to 45 minutes.', 'If you are working with single rib chops, and you want the result to be rare, let the chops sit in the rub in the refrigerator, do not let come to room temp or the thin ribs will easily overcook when you sear them in the next step.', 'You can also marinate the chops in the fridge for up to 24 hours. (Allow double rib chops to stand at room temperature 30 to 40 minutes before cooking.)', '2 Sear the lamb chops: Heat the remaining 2 tablespoons olive oil in an oven-proof saut\\xc3\\xa9 pan over high heat. When the oil is shimmering hot, sear the chops. Sear double rib chops on all sides about 2 to 3 minutes per side. If you are working with single rib chops, sear only on two sides, and only a minute (or less) on each side if you want the result to be rare or medium rare.', '3 Check for doneness: At this point, if you want your lamb chops rare, they are likely cooked enough.', 'If you would like your chops more cooked, you can put them in a 400\\xc2\\xb0F oven for 3 to 5 minutes, or keep them in the hot pan, lower the heat to warm, and cover the pan for a few minutes.', 'Note that rib chops are so small, and cook so quickly, checking for internal temperature with a thermometer can be impractical. For this reason I use the finger test to check the doneness of the chops. That said, if you have an instant read thermometer and want to check thick chops, aim for 125\\xc2\\xb0F for rare, 135\\xc2\\xb0F medium-rare, and 140\\xc2\\xb0F for medium.', '4 Rest the chops: When done, remove the chops from the pan, cover with foil and let rest 3 to 5 minutes before serving.']",8
1508,Chocolate Orange Shortbread Cookies Recipe,35,15,50,"['1 cup all-purpose flour', '3/4 cup unsweetened natural cocoa powder', '1/2 teaspoon kosher salt', '12 tablespoons unsalted butter, room temperature', '1/2 cup + 2 Tablespoons granulated sugar', '1 teaspoon pure vanilla extract', '1 Tablespoon of orange zest']",7,"['You may find the dough getting too soft. If it does, place it in the freezer for ten minutes to firm it up before you continue rolling or cutting. (The dough is very hard to work with when soft.)', '5 Cut into desired shapes and place on the baking sheets about 1-inch apart.', '6 Bake: Bake at 325\\xc2\\xb0F for 13-15 minutes, rotating the pans halfway through baking. It can be difficult to tell when these cookies are done, so when they smell like freshly baked cookies and the edges are slightly firm but still give a bit then consider them done (simply enough, it takes some judgment on your part).', 'Remove the pans and allow the cookies to cool for a minute or two before moving to a wire rack to cool completely.']",4
1509,Chocolate Pavlova with Whipped Cream and Raspberries Recipe,30,90,120,"['For the meringue:', '1 1/2 cups (300 grams) sugar', '4 1/2 teaspoons cornstarch', '6 egg whites, at room temperature', 'Pinch of salt', '1/2 teaspoon cream of tartar', '1 teaspoons vanilla', '1/4 cup (21 grams) Dutch processed cocoa powder', '4 tablespoons sliced almonds', 'For the filling:', '1/2 cup (2 ounces, 57 g) finely chopped bittersweet chocolate', '1 1/2 cups (355 ml) heavy whipping cream', '2 tablespoons sugar', '1 teaspoon vanilla extract', '3 (6-ounce) packages of raspberries, about 5 to 6 cups (500 g)', 'Powdered sugar (for sprinkling)', 'Special equipment:', 'Stand mixer']",18,"[""1 Preheat the oven to 275\\xc2\\xbaF (135\\xc2\\xb0C). Line a baking sheet with parchment. With a sharpie or pencil and using a 9-inch pie or cake pan as a guide, trace a 9-inch (23 cm) circle on the parchment paper and then flip the paper, so the ink-side is facing down (and doesn't touch your food), but you can still see the outline through the paper."", '2 Mix the sugar and cornstarch: In a small bowl, whisk the sugar and cornstarch until combined.', '3 Beat the egg whites: In the squeaky-clean bowl of an electric mixer on medium speed, slowly beat the egg whites until foamy. Sprinkle with a pinch of salt and the cream of tartar.', 'Continue beating just until soft peaks begin to form. With the mixer on medium speed, add the sugar 1 tablespoon at a time. When all the sugar has been added, increase the mixer speed to high and beat for 5 minutes, or until the meringue is shiny and forms stiff peaks.', 'Dip your index finger into the meringue and rub it between your finger and thumb. If it feels gritty, continue to beat for another 30 to 60 seconds, or until it feels perfectly smooth between your fingers and all the sugar has been dissolved.', '4 Mix in the vanilla and cocoa powder: With the mixer on low speed, mix in the vanilla.', 'Remove the bowl from the stand and sift the cocoa powder over the meringue. With a spatula, gently fold in the cocoa powder until the mixture looks steaked with ribbons of cocoa powder. Avoid deflating the meringue.', ""5 Bake the meringue: Scrape the meringue into the center of the circle on the baking sheet. With the back of a large spoon, spread it into a 9-inch circle. Mound the edges slightly higher, so there's a bowl-like indentation in the middle. Sprinkle with the almonds."", 'Bake at 275\\xc2\\xb0F (135\\xc2\\xb0C) for 30 minutes. Turn the oven down to 250\\xc2\\xbaF (120\\xc2\\xb0C) and bake for another 45 to 55 minutes, or until the edges and sides look crisp and the top looks dry. It should still feel slightly soft in the center when you press it gently with your finger.', 'Remove from the oven and let cool completely. Transfer to a serving platter. Store at room temperature for up to 2 days, loosely wrapped in foil.', '6 Top with chocolate: Preheat the oven to 350\\xc2\\xbaF. Sprinkle the chocolate over the indentation in the middle of the meringue. Place in the oven for 2 to 3 minutes, or until the chocolate melts.', 'With the back of a spoon or a small offset spatula, spread the chocolate across the middle of the pavlova in an even layer. Place in the freezer for 10 minutes to allow the chocolate to harden. (Make the whipped cream while you wait.)', '7 Make the whipped cream: In a mixer bowl on medium speed, beat the cream, sugar and vanilla together until soft peaks form.', '8 Fill and finish the pavlova: Spread the whipped cream over the top of the meringue to cover the chocolate. Arrange the raspberries on top. Sprinkle with powdered sugar. Serve immediately, or refrigerate, uncovered, for up to 3 hours.', 'The pavlova is best eaten on the day you serve it, but leftovers will keep for a few days, refrigerated.']",15
1510,Roast Quail with Balsamic Reduction Recipe,10,20,30,"['4 whole quail', '1 tablespoon extra virgin olive oil', 'Salt', '1 celery stick', '1/2 cup chicken stock', '1/2 cup inexpensive balsamic vinegar']",6,"['1 Defrost frozen quail: If you are working with frozen quail, either defrost overnight in the refrigerator, or place the package in a large bowl and cover with a couple inches of room temperature water for 20 minutes.', ""2 Truss the quail: Pre-heat the oven to 500\\xc2\\xb0F. Truss the quail with kitchen string. Cut off a length of string about 18 inches long. Cross the middle of the string over the quail's legs and bring the string around to the front of the bird, making sure it holds the wings close to the bird's flanks. Tie the string tightly around the neck."", '(Chowhound has an excellent video on how to truss a chicken, and quail are the same, only smaller.)', 'Allow the quail to come to room temperature for at least 20 minutes.', '3 Arrange quail in roasting pan: Pat the quail dry with paper towels. Coat the quail with the olive oil and salt well. When the oven is hot, arrange the quail, breast side up, in a small roasting pan. Use pieces of the celery stick to keep the birds upright while they roast.', '4 Roast quail: Roast quail for 10-12 minutes in a 500\\xc2\\xb0F oven. Remove the birds from the pan and set aside on a plate to rest for 10 minutes, loosely tented with foil.', '5 Make balsamic reduction: As the quail are resting, make the sauce by putting the roasting pan on a burner set to medium heat. Discard the celery sticks.', 'Add the chicken stock and deglaze the pan by scraping all the browned bits off the bottom. Bring this to a simmer and pour into a small pot or saut\\xc3\\xa9 pan.', ""Add the balsamic vinegar, increase the heat to high and boil down to a syrup. Halfway through the boil, pour any accumulated juice from the resting quail into the sauce. When the sauce thickens and will coat the back of a spoon, it's ready."", '6 Serve: Serve the quail with the sauce drizzled over everything. Serve with a side of polenta, or rice pilaf.']",10
1511,Red Velvet Cookies Recipe,15,13,28,"['3/4 cup (170 g) unsalted butter, room temperature', '4 ounces (115 g) cream cheese, room temperature', '1 cup (200 g) white sugar', '1 cup (220 g) packed dark brown sugar', '1 teaspoon baking soda', '1 teaspoon kosher salt', '2 teaspoons vanilla extract', '1 large egg', '1 large egg yolk', '1 tablespoon red food coloring, preferably McCormick brand', '2 3/4 cups (385 g) all-purpose flour', '1/4 cup (25 g) natural cocoa powder (not Dutch process)', '2 cups (340 g) white chocolate baking chips, divided']",13,"['1 Preheat the oven to 350\\xc2\\xb0F. Line two baking sheets with a silicon baking mat or parchment paper.', '2 Begin making the batter: Place the butter, cream cheese, both sugars, baking soda, salt, and vanilla extract in the bowl of a stand mixer fitted with a paddle attachment. Mix on medium speed until the mixture is creamy, uniform in color, and clings to the side of the bowl, about 1 to 2 minutes.', '3 Add the egg and egg yolk: Scrape down the sides of the bowl with a spatula and add the egg. Mix to incorporate on medium speed. Repeat with the egg yolk, and then the red food coloring, mixing on slow speed to avoid splattering the red food coloring.', '4 Add the flour and cocoa powder: Mix on low until the dry ingredients are just absorbed.', '5 Add the white chips: Add 1 1/2 cups of the baking chips to the dough, reserving 1/2 cup of chips for topping the cookies. Slowly mix in until the baking chips are evenly distributed.', '6 Shape the cookies: Wet your hands under water then slightly dry them with a paper towel. With your hands still moist, roll out 1-inch balls (heaping tablespoons) of dough, placing them on the prepared baking sheet.', '7 Bake the cookies: Bake the cookies, one baking sheet at a time, for 11 to 13 minutes or until the edges of the cookie are dry and set. The cookies will look a bit puffy and plump.', '8 Top with chips: While the cookies are still warm, press several white chips into the top of the cookies while they are still hot and puffy. Let the cookies cool on the baking sheet for 5 minutes before transferring the cookies to a wire cooling rack. The cookies will deflate a bit and flatten slightly as they cool. Repeat with the remaining dough.']",8
1512,Homemade Vanilla Cake Recipe,15,30,45,"['2 1/4 cups (288g) cake or all-purpose flour', '1 1/2 cups (300g) sugar', '2 teaspoons baking powder', '1/2 teaspoon baking soda', '1/4 teaspoon kosher salt', '1/4 cup (57g) very soft unsalted butter', '1 cup whole milk', '1/4 cup neutral oil', '3 large eggs', '1 1/2 tablespoons (4 1/2 teaspoons) vanilla extract', '1 batch Vanilla Buttercream Frosting', 'Special equipment:', 'Parchment paper']",13,"['1 Preheat the oven and prepare the pan: Preheat the oven to 350\\xc2\\xb0F. Butter or spray a 9x13-inch pan and line with the bottom with parchment paper. If you plan to turn the cake out instead of serving it from the pan, lining it with parchment will ensure the cake releases from the pan easily.', '2 Combine the dry ingredients: Whisk the flour, sugar, baking powder, baking soda, and kosher salt together in a large mixing bowl.', '3 Add the butter: Mix the softened butter into the dry mixture with a hand mixer on low speed until the butter is completely combined and the mixture has a sandy texture.', '4 Combine the wet ingredients: In medium-sized bowl or 4-cup measuring cup, whisk the milk, oil, eggs, and vanilla together until the ingredients are thoroughly combined and homogeneous.', '5 Add the wet to dry ingredients: Pour wet ingredients into the flour and butter mixture and beat with the hand mixer until just a few streaks of flour remain. Finish mixing the batter with a silicone spatula. Pour the batter into the prepared pan.', '6 Bake and cool: Bake the cake for 25-30 minutes until the top of the cake springs back to the touch and a toothpick inserted in the center comes out clean. Remove from the oven and cool completely on a rack before turning out and/or frosting.']",6
1513,Vanilla Ice Cream Recipe,0,345,345,"['1 1/2 cups milk', '2 1/2 cups heavy cream (separated into 1 1/2 cups and 1 cup)', '2 vanilla beans, split in half lengthwise', '8 large egg yolks', '3/4 cup granulated sugar', '1/4 teaspoon salt', 'Special equipment:', 'An ice cream maker, or a KitchenAid mixer with an ice cream attachment']",8,"['1 Infuse the milk and cream with vanilla: Put the milk and 1 1/2 cups of the cream, half of the sugar, and the salt into a saucepan on medium heat. Use the tip of a sharp knife to scrape out the tiny seeds from the vanilla beans, and stir both the seeds and the pods into the milk cream mixture.', 'Heat until steamy, but not simmering. Remove from heat, cover, and let stand while the vanilla infuses, about 20 to 30 minutes.', '2 Beat egg yolks with half of the sugar: In a medium bowl, beat together the yolks and the remaining half of the sugar. You can use a hand mixer or beat by hand using a whisk. Beat until velvety smooth and creamy.', '3 Prepare a bowl over an ice bath: Fill a large bowl half way with ice and cold water. Set a smaller metal bowl inside of it, and place the remaining cup of cream inside to chill. Place a strainer over the smaller bowl. Set aside.', '4 Temper the eggs: Reheat the milk/cream mixture until it is just barely steamy (not boiling!). Vigorously whisk the eggs while you slowly dribble half of the milk/cream mixture into it. Pour the egg mixture into the pot with the remaining cream and milk.', ""5 Cook custard until thickened: Cook over medium high heat, stirring constantly, until the mixture thickens and coats the back of your spoon (about 180\\xc2\\xb0F on an instant read thermometer). You can run your finger in a line over the back of the coated spoon. If the mixture doesn't run, but stays in place on the spoon, it should be thick enough."", ""6 Strain the custard: Remove from heat and immediately pour the custard through the the strainer you've placed over the bowl with cream in the ice bath. This will strain out the vanilla beans, and quickly lower the temp of the custard to stop it from cooking further."", '7 Chill the custard: Let the custard cool completely, stirring to help chill it quickly. Put into the refrigerator and let chill for at least an hour, preferably several hours.', ""8 Process in ice cream maker: Freeze custard in an ice cream maker according to manufacturer's instructions. (Take care not to over churn the ice cream or it will get a grainy texture.)"", '9 Freeze: If you serve the ice cream immediately, it will have the consistency of soft serve ice cream. Freeze it for at least an hour in an airtight plastic container to have a firmer texture. If it has been frozen for more than a day, you may need to let it sit at room temperature for a few minutes to soften before serving it.', 'Serve with caramel sauce.']",11
1514,Vanilla Buttermilk Layer Cake Recipe,20,35,55,"['3 cups (374 grams) all-purpose flour', '2 cups (397 grams) granulated sugar', '2 teaspoons baking powder', '1/2 teaspoon baking soda', '3/4 teaspoon Kosher salt', '1 cup (227 grams) unsalted butter, softened', '5 large eggs, room temperature', '1 1/4 cups buttermilk', '1 tablespoon vanilla extract', 'Special equipment:', 'Stand mixer', '3 9x2-inch cake pans']",12,"['1 Heat the oven and prep the pans: Preheat the oven to 350\\xc2\\xb0F. Spray 3 9x2-inch baking pans with nonstick spray (or butter and flour) and line the bottoms with parchment rounds.', '2 Mix together the butter and dry ingredients (reverse cream): In the bowl of a stand mixer, combine the flour, sugar, baking powder, baking soda, and Kosher salt on low speed with the paddle attachment (you can also use a hand mixer).', 'Add the softened butter and mix on medium speed until the butter is incorporated and the mixture becomes sandy in texture, about 30 to 45 seconds.', ' 3 Mix in the liquid ingredients: Whisk the eggs, buttermilk, and vanilla extract together in a large measuring cup. With the mixer on low speed, add the liquid mixture to the butter-flour mixture in two separate additions. Beat well after each addition and scrape down the sides and bottom of the bowl. Continue mixing until you get a smooth batter.', ' 4 Bake the cakes: Divide the batter evenly between the cake pans and smooth the tops. Tap the pans against the counters once or twice to force out any large air bubbles.', 'Bake on a single rack in the center of the oven for 20 to 35 minutes -- begin checking at 20 minutes and continue baking until the cakes pull away from the sides, the top springs back when touched, and a toothpick inserted in the center comes out clean.', '5 Cool the cakes: Set the cakes in the pans on wire racks and cool for 15 minutes. Turn the cakes out of the pans and allow to cool completely.']",7
1515,Gluten-Free Vanilla Birthday Cake Recipe,20,140,160,"['4 tablespoons flax meal', '10 tablespoons water', '3 cups (444g) Bob\\xe2\\x80\\x99s Red Mill Gluten-Free 1:1 Flour Blend', '1 teaspoon kosher salt', '4 teaspoons baking powder', '1 teaspoon baking soda', '1 1/4 cup non-dairy milk, such as soy milk or oat milk, plus more if needed to thin batter', '2 tablespoons apple cider vinegar', '3/4 cup vegetable oil', '1 3/4 cups (375g) granulated sugar', '1 tablespoon pure vanilla extract', '1 batch Vegan Chocolate Frosting', 'Sprinkles to top, optional']",13,"['1 Prepare the pan: Spray a 9x13-inch baking pan with nonstick cooking spray and set aside.', '2 Prepare the flax ""egg"": Combine the flax meal with 10 tablespoons of water in a small bowl. Stir. Let stand for 7 to 10 minutes to thicken. This will be used as an egg replacer in this recipe. (Read more about how to make flax eggs.)', '3 Mix dry ingredients: In a small mixing bowl, whisk together the flour, salt, baking powder, and baking soda and set aside.', '4 Mix milk and vinegar: In a separate small mixing bowl, stir together the milk and vinegar and set aside for 5 to 10 minutes. You\\xe2\\x80\\x99ll notice the milk may start to look a little curdled, which is what we\\xe2\\x80\\x99re going for.', '5 Beat together the sugar, oil, and vanilla: In the bowl of a stand mixer fitted with the paddle attachment (or using electric hand beaters), beat the oil, sugar, and vanilla extract until combined, about 1 minute. The mixture will be granular and look like wet sand.', 'Slowly add the flax egg mixture, beating well until combined. Scrape down the sides of the bowl as needed.', '6 Beat in the dry ingredients: At low speed, slowly add the dry ingredients in four additions, alternating with the milk mixture, until the flour and milk are fully incorporated.', 'The batter should be thin enough that it slips off the paddle or beaters; if it\\xe2\\x80\\x99s too thick or chunky, add additional nondairy milk 1 tablespoon at a time, until the batter is pourable.', '  7 Rest batter: Place the bowl, uncovered, in the refrigerator for 15 minutes to  help sufficiently hydrate the starches and gums in the batter.', '8 Preheat the oven to 350\\xc2\\xb0F while the batter is resting.', '9 Spread batter into pan: Transfer the batter to the pan and use a silicone spatula or wooden spoon to spread it evenly.', '10 Bake for 35 to 40 minutes, or until a toothpick comes out clean and sides of the cake are pulling away from the pan just a bit.', '  11 Cool: Allow the cake to cool completely in the pan before frosting, at least 90 minutes.', '12 Make the Vegan Chocolate Fudge Frosting: Prepare the frosting as directed in the recipe.', '13 Frost the cake: Spread the frosting on top of the completely cooled cake. Decorate with sprinkles, if desired, and serve.', ""The cake is best enjoyed the day it\\'s made. If you have leftovers, cover and store at room temperature for up to 2 days.""]",16
1516,Minestrone Soup Recipe,15,45,60,"['1/4 cup extra virgin olive oil', '3/4 cup chopped onion', '3/4 cup chopped carrot', '3/4 cup chopped celery', '1 Tbsp minced garlic', '1 bay leaf', '2 sprigs fresh thyme or a teaspoon of dried thyme', '1/4 teaspoon fennel seeds, crushed', '1 Yukon gold potato, peeled and cut into 3/4-inch chunks', '2 cups sliced savoy or curly cabbage', '1 zucchini, cut into 3/4-inch chunks', '2 medium fresh ripe tomatoes (romas if available), cored, peeled, chopped', '6 cups chicken stock (or vegetable stock for vegetarian version)', '1 15-ounce can cannellini or great northern white beans, drained (about 1 1/2 cups cooked white beans)', '1/4 cup chopped fresh parsley', 'Salt', 'Freshly ground black pepper', 'Parmesan cheese, grated for garnish']",18,"['1 Saut\\xc3\\xa9 onions, carrots, celery, garlic in olive oil: Heat oil in a 4 to 5-quart thick-bottomed pot on medium-high heat. Add the onion, carrot, and celery. Cook until lightly browned, about 8 minutes. Add the garlic and cook a minute more.', '2 Add herbs, potato, vegetables, stock: Add the bay leaf, thyme, fennel seeds. Add the potato, cabbage, zucchini, and tomatoes. Add the chicken stock.', '3 Simmer until vegetables are cooked through: Bring to a boil and reduce heat to a simmer. Partially cover and simmer for 20 minutes, until the vegetables are tender and cooked through.', '4 Add beans, parsley, salt, pepper: Add the beans and parsley to the soup. Season to taste with salt and pepper. Bring to a simmer and cook for 5 more minutes. Remove bay leaf and thyme sprigs.', 'Serve with a sprinkle of grated Parmesan cheese.']",5
1517,Cream of Celery Soup Recipe,15,45,60,"['3 tablespoons butter, divided into 2 Tbsp and 1 Tbsp', '1 cup chopped onion', '1 1/2 cups sliced leeks, white and light green parts only', '1 large bunch or 2 small bunches celery (5 cups chopped for the soup, 1 1/2 cups diced for the topping)', '2 cloves garlic, minced', '2 bay leaves', '4 cups chicken stock', '1/2 teaspoon to 1 1/2 teaspoons of salt, to taste', '1/4 to 1/3 cup of cream', 'Freshly ground black pepper to taste', 'Fresh chopped chives or parsley for garnish']",11,"['1 Saut\\xc3\\xa9 onions, leeks, 5 cups chopped celery: Melt 2 tablespoons butter in a thick-bottomed 4 to 5 quart pot on medium heat. Add the diced onion, the leeks, and 5 cups of the chopped celery.', 'Cook on medium heat for 10 minutes until softened. Add the minced garlic and cook for a minute more.', '2 Add stock, bay leaves, salt, then simmer: Add the chicken stock and bay leaves to the pot. Taste for salt and add salt. (If you are using unsalted butter and unsalted stock, you will need to add more salt than you expect, if not, maybe just a little salt will be needed.)', 'Increase heat to bring to a boil, reduce heat to low and cover to maintain a simmer. Simmer for 15 minutes.', '3 Braise remaining celery to soften: While the soup is simmering, prepare the extra celery that will be added later to the soup. In a separate small saut\\xc3\\xa9 pan, melt 1 tablespoon of butter on medium heat. Add 1 1/2 cups diced celery to the butter.', 'Ladle 1/2 cup of the simmering stock from the soup pot into the saut\\xc3\\xa9 pan. Simmer on low for 5 or 6 minutes to soften the celery. Set aside.', ""4 Pur\\xc3\\xa9e soup: Remove the soup pot from heat, let cool slightly. Remove and discard the bay leaves. Working in batches, pur\\xc3\\xa9e the soup in a blender, filling the blender no more than a third full at a time (keep your hand on the lid so the hot liquid doesn't explode). Return the pur\\xc3\\xa9ed soup to the pot."", '5 Stir in the cream and the braised diced celery.', 'Taste for salt and add more if needed. Sprinkle with freshly ground black pepper and chopped chives or parsley to serve.']",9
1518,Kale and Roasted Vegetable Soup Recipe,15,100,115,"['3 medium carrots, peeled and quartered lengthwise', '2 large tomatoes, quartered', '1 large onion, cut into 8 wedges or 4 or 5 slices', '1/2 small butternut squash, peeled, seeded, cut lengthwise into 1/2 inch thick wedges', '6 garlic cloves', '1 tablespoon extra virgin olive oil', '6 cups or more of vegetable broth', '4 cups of finely chopped kale', '3 large fresh thyme sprigs', '1 bay leaf', '1 15 oz can of Great Northern white beans, drained']",11,"['1 Preheat oven to 400\\xc2\\xb0F. ', '2 Roast the carrots, tomatoes, onion, squash, garlic: Rub rimmed baking sheet with a thin coat of olive oil. Place carrots, squash, tomatoes, onion, and garlic on the baking sheet and sprinkle with a little more olive oil and salt and pepper. Rub the oil over all of the vegetables so that they are well coated.', 'Roast vegetables about 45 minutes, stirring once or twice, until they are cooked through and nicely browned.', '3 Further cut the squash and carrots: Remove the roasted squash and carrots from the pan to a cutting board. Cut into 1/2-inch pieces and set aside.', '4 Pur\\xc3\\xa9e the roasted garlic, tomatoes, onions: Remove the roasted garlic from their peelings and place in a food processor. Add the roasted tomatoes and onions. Pulse in the processor until almost smooth.', '5 Deglaze the roasting pan: Add a little water or broth to the baking sheet and scrape up any browned bits.', '6 Start soup with browned bits, broth, pur\\xc3\\xa9ed vegetables: Add the browned bits, the broth, and the pur\\xc3\\xa9ed vegetables to a large pot. Add the chopped kale, thyme, and bay leaf to the pot. Heat on high to bring to a boil, lower the heat to reduce to a simmer. Simmer uncovered until the kale is tender, about 30 minutes.', '7 Add roasted carrots, squash, beans: Add the roasted carrots and squash to the soup. Add the drained white beans to the soup. Simmer for 8 to 10 minutes and add more broth or water to the soup if it needs thinning.', 'Season with salt and pepper. Discard thyme sprigs and bay leaf.', 'Can be made a day ahead.']",10
1519,Creamy Asparagus Soup Recipe,15,30,45,"['2 lbs asparagus, trimmed of woody stem bottoms', '1 large yellow onion, chopped (1 1/2 to 2 cups chopped)', '1 teaspoon minced garlic, or 1 Tbsp minced green garlic', '3 Tbsp butter', '4 cups chicken broth or vegetable broth (vegetarian option)', '1 cup water', '2 sprigs of fresh thyme', '1 bay leaf', '1/4 cup chopped fresh parsley', '1/4 cup heavy cream or full-fat sour cream', '1 Tbsp dry vermouth', '1 teaspoon lemon juice', '1/2 teaspoon black pepper (more to taste)', '1 teaspoon salt (more to taste)']",14,"['1 Cut asparagus tips and reserve, cut the rest of asparagus into 1/4-inch rounds: Cut tips from the asparagus 1 1/2 inches from top and reserve. Chop the rest of the asparagus stalks into 1/4-inch rounds.', '2 Saut\\xc3\\xa9 onions, garlic: Melt the butter in a 4 to 5 quart pot on medium heat. Add the onions and cook until translucent, about 5 minutes.', 'Add the garlic (or green garlic) and cook a minute more.', '3 Add asparagus: Add the chopped asparagus (not the spear tips) to the onions. Sprinkle with salt and pepper to taste. Cook another 5 minutes.', '4 Add the broth, water, thyme sprigs and bay leaf to the pot. Increase the heat to a boil, then reduce to a simmer. Simmer, covered, until the asparagus are tender, about 10 minutes.', '5 At the end of cooking, stir in the chopped parsley.', '6 Blanch asparagus tips: While the soup is cooking, blanche the asparagus tips in a small pot of boiling, salted water, until the tips are just tender, about 2-4 minutes, depending on the size of the asparagus.', 'Drain. Rinse with cool water to stop the cooking. Set aside.', '7 Pur\\xc3\\xa9e the soup: Remove bay leaf and thyme sprigs. Use either an immersion blender or an upright blender (working in batches) to pur\\xc3\\xa9e the soup. If you use an upright blender, work in small batches, fill no more than a third the blender bowl at a time, and hold down the lid while blending.', 'For a creamy texture, if you want, press the pur\\xc3\\xa9ed soup through a sieve or food mill.', '8 Stir in cream, vermouth, lemon juice: Stir in the cream (or full-fat sour cream). Stir in the vermouth and lemon juice. Season with salt and pepper to taste.', 'Garnish with asparagus tips.']",12
1520,White Bean and Vegetable Soup Recipe,15,110,125,"['2 15-oz cans cannellini or white kidney beans (or 1/2 lb dried beans, soaked overnight in water), drained', '1 tablespoon extra virgin olive oil', '1/2 large yellow onion, chopped', '1 tablespoon chopped fresh thyme', '2 garlic cloves, minced', '1/8 head of green cabbage, cut into 1/2 inch pieces', '1 cups chopped fresh tomatoes', '2 celery stalks, cut into 1/2 inch pieces', '1 1/2 carrots, cut into 1/2 inch pieces', '5 cups (or more) vegetable stock', '1 medium potato, cut into 1/2 inch pieces', '1/4 cup chopped fresh basil', '1/4 head of red cabbage, cut into 1/2 inch pieces', '2 zucchini or summer squash, cut into 1/2 inch pieces', '2 teaspoons salt', '1/2 cup grated Parmesan cheese', 'Tabasco sauce (optional)']",17,"['1 Cook onions, with thyme and garlic: Heat olive oil in a large pot over medium heat. Add onion, thyme, and garlic. Saut\\xc3\\xa9 5 minutes.', '2 Add green cabbage, tomatoes, celery, and carrots. Saut\\xc3\\xa9 10 minutes.', '3 Add beans, 5 cups of stock, potatoes, and basil. Bring to a boil. Reduce heat, cover and simmer for one hour.', '4 Add red cabbage and zucchini. Add salt. Cover and simmer until vegetables are tender, about 20 minutes longer.', '5 Serve: To serve, stir in the cheese. Sprinkle in a dash of Tabasco hot sauce if you want to give the soup a little zip.', 'Serve with ground pepper and bread.']",6
1521,Spring Minestrone Soup Recipe,20,40,60,"['2 tablespoons extra virgin olive oil', '6 green onions', '2 green garlic stalks, or 2 large garlic cloves', '1 pound baby potatoes, or Yukon gold potatoes cut into 1-inch chunks', '1 15-ounce can of diced tomatoes', '4 cups vegetable stock or chicken stock (use vegetable stock if cooking vegetarian or vegan)', 'Salt', '1/2 pound artichoke hearts (fresh or frozen), chopped roughly', '1 15-ounce can of chickpeas (garbanzo beans), rinsed and drained', '1 cup peas (fresh or frozen)', '1/2 pound asparagus, cut into 1-inch chunks', '2 cups greens (dandelion, chard, spinach, kale, arugula, etc), sliced into thin ribbons', 'Up to 1/4 cup pesto', 'Grated parmesan or pecorino cheese for garnish (omit for vegan version)', '1 teaspoon black pepper']",15,"['1 Prep green onions, green garlic, potatoes, artichoke hearts: Chop the green onions and green garlic and separate the white and light green parts from the green tops. If you are using regular garlic cloves, put them with the white parts of the green onions.', 'Scrub potatoes and cut them into 1-inch chunks. Either trim fresh artichokes down to their hearts and chop the hearts (see How to Trim Artichokes) or chop up defrosted frozen artichoke hearts.', '2 Saut\\xc3\\xa9 white parts of green onions and garlic, add potatoes: In a large pot set over medium-high heat, warm the olive oil for 1 minute. Add the white parts of the green onions as well as the garlic and saut\\xc3\\xa9 for 1 minute.', 'Add the potatoes, and cook 1 minute more.', '3 Add tomatoes, stock, salt, then simmer: Add the diced tomatoes with their liquid and the quart of vegetable or chicken stock.', 'Bring to a simmer, add salt to taste, then cover and cook over medium-low heat for 10 minutes.', '4 Add artichoke hearts (if using fresh) and cook another 5 minutes', '5 Add the chickpeas and green peas and cook another 5 minutes.', '6 Add the asparagus and artichoke hearts (if using frozen), then the greens: Add the asparagus and artichoke hearts (if using frozen artichoke hearts). Cook 2 minutes.', 'Add the greens and the green parts from the green onions and green garlic, if using. Stir well to combine and cook 1 minute.', '7 Add pesto, salt, pepper: Turn off the heat and stir in the pesto. Add black pepper and more salt to taste (depending on how salty your stock is, you may need to add 1 to 2 teaspoons of salt).', 'Serve topped with grated cheese.']",12
1522,Celery Root Fennel Soup Recipe,20,40,60,"['2 Tbsp butter', '2 cups thinly sliced onions (sliced across the grain)', '4 cloves garlic, sliced', '2 medium fennel bulbs, thinly sliced', ""2 medium celery roots (about 1 1/2 pounds), peeled and thinly sliced (See TheKitchn's guide to peeling celery root)"", '1 medium russet potato, peeled and thinly sliced', '2 bay leaves', '7 cups chicken stock', '2 1/2 teaspoons kosher salt (less or more to taste)', '1/4 teaspoon black pepper', '1/4 cup whipping cream', 'Fennel fronds for garnish']",12,"['1 Cook onions: Melt butter in a large (6-8 quart) thick-bottomed pot on medium high heat. Stir in the onions and cook until softened, about 4 to 5 minutes.', '2 Add the garlic and the sliced fennel, lower the heat to medium and cook for 10 to 12 minutes or until softened.', '3 Add the sliced celery root, sliced potato, 2 bay leaves, stock and salt. Increase heat to high, bring to a simmer, reduce heat to low, and maintain a simmer, partially covered for another 10 to 12 minutes, until all of the vegetables are soft enough to pur\\xc3\\xa9e.', '4 Pur\\xc3\\xa9e the soup: Either working in batches with a standing blender (do not fill blender bowl more than a third full at a time), or with an immersion blender, pur\\xc3\\xa9e the soup until smooth. (Note that an immersion blender will take several minutes longer than a standing blender to pur\\xc3\\xa9e the soup to smoothness.)', '5 Stir in cream and black pepper. Adjust salt to taste. Garnish with fennel fronds.']",5
1523,Vegetable Soup with Sweet Basil Recipe,15,40,55,"['2 small leeks, white part only', '1 large potato, peeled', '1 small onion', '2 stalks celery', '1 medium zucchini', '12 green beans', '2 medium carrots, peeled', '6 tablespoons extra virgin olive oil', '3 tablespoons water', '2 quarts chicken stock (or 2 qts water, 4 bouillion cubes, a pinch of thyme, and 1/2 bay leaf OR you can use vegetable broth for a vegetarian option)*', '4 to 6 ripe tomatoes, peeled and seeded', '4 medium garlic cloves', '30 fresh basil leaves, washed and dried', 'Salt', '1/2 teaspoon freshly ground black pepper', 'A few drops of Tabasco sauce', '*Use gluten-free stock or bouillon for gluten-free version.']",17,"['1 Prep vegetables: Cut the leeks, potato, onion, celery, zucchini, green beans, and carrots into 1/4 inch diced cubes.', '2 Cook the vegetables: In a 6-quart stockpot, combine 3 tablespoons of the olive oil with the 3 tablespoons of water. Add the vegetables and cook over medium-low heat until all the water evaporates. Do not brown the vegetables.', '3 Add stock and simmer: Add the stock to the pot and bring to a boil. Reduce to a simmer and cook for 30 minutes.', '4 Make the basil pistou: Put the tomatoes, basil, garlic, and remaining 3 tablespoons of olive oil into a food processor. Pulse until pur\\xc3\\xa9ed.', '5 Stir the pur\\xc3\\xa9e into the cooked soup. Do not let the soup return to a boil. Season, to taste, with salt, pepper, and a few dashes of Tabasco. Serve the soup hot or cold.']",5
1524,Summer Pea Soup Recipe,5,20,25,"['1 large shallot, minced (about 3 Tbsp)', '1 1/2 tablespoons unsalted butter', '2 cups low sodium chicken broth or vegetable broth (for vegetarian option)', '2 sprigs of mint, about 6 inches in total stem length', ""1 pound of frozen petite peas (available at Trader Joe's)"", '1/4 cup heavy cream', 'Salt and freshly ground pepper to taste', 'Cr\\xc3\\xa8me fra\\xc3\\xaeche for garnish (can substitute sour cream diluted with cream)', 'Strips of fresh mint for garnish']",9,"['1 Cook the shallots in butter: In a medium saucepan (2 1/2 to 3 quart) melt the butter on medium heat. Add shallots and cook until softened, but not browned, a couple minutes.', '2 Add broth and mint, then peas: Add the broth and mint sprigs to the shallots, increase the heat and bring to a boil. Add the frozen peas and salt and pepper to taste. Return to a boil, reduce heat and simmer until the peas are just tender, 3-5 minutes.', '3 Discard the mint and pur\\xc3\\xa9e the soup in a blender until completely smooth.', '4 Blend in the cream. Taste and correct seasoning.', 'Reheat to serve warm, or chill to serve cold. Serve garnished with cr\\xc3\\xa8me fra\\xc3\\xaeche and mint strips.']",5
1525,Vegetable Lentil Soup Recipe,15,60,75,"['2 tablespoons olive oil', '1 large yellow onion, finely diced', '2 tablespoons tomato paste', '1 teaspoon dried thyme', '1 clove garlic, finely diced', '3 stalks celery, finely diced', '3 carrots, peeled and finely diced', '2 cups (12 ounces) small green French lentils', '8 cups water or vegetable stock', '1 tablespoon low-sodium soy sauce', '1 1/2 teaspoon salt', '1/8 teaspoon pepper', '3 tablespoons lemon juice', '1/2 bunch kale, stemmed and thinly sliced crosswise']",14,"['1 Caramelize the onions: In a soup pot over medium heat, add the oil. Once the oil shimmers, add the onions and cook, stirring occasionally for 10 minutes, or until deep, golden brown.', '2 Cook the tomato paste and vegetables: Push the onions to the side of the pot and in the space you made, add the tomato paste. Stir for 2 to 3 minutes, or until the tomato paste darkens to a ruddy brown. Add the thyme, garlic, celery, and carrots. Cook and stir for 2 minutes.', '3 Simmer the soup: Add the lentils, 8 cups water, soy sauce, salt and pepper to the pot. Adjust the heat to medium so the soup is just at a gentle simmer. Simmer for 55 to 60 minutes, or until the lentils are soft.', '4 Finish the soup and serve: Scoop out 2 cups of the soup and pur\\xc3\\xa9e it in a blender until smooth, or use an immersion blender and pur\\xc3\\xa9e just until the soup takes on a little body and thickens, but you still have texture. Return the blended soup to the pot and stir in the lemon juice. Add the sliced kale and simmer for 1 to 2 minutes, or until the kale softens.', 'Taste, and add more salt, pepper, and lemon juice if you like. Serve with a nice slice of crusty bread or a side salad.']",5
1526,How to Caramelize Onions,10,0,10,"['Several medium or large onions, yellow, white, or red', 'Extra virgin olive oil', 'Butter (optional)', 'Salt', 'Sugar (optional)', 'Balsamic vinegar (optional)']",6,"['1 Cut the onions root to tip: Slice 1/2-inch off the stem ends of the onions and the roots off of the root end. Place the onions cut side down on the cutting board. Cut them in half through the root end. Peel back the peels from the onions.', 'Lay the onions cut side down and make angled cuts into each onion, aimed at the center, cutting almost all the way, but not completely through the root end.  Make the cuts to your desired level of thickness.', 'The root end will help hold the onion together as you cut it, making it easier to cut. Then cut a V in the root end to cut out the tough root holding the slices together.', '2 Heat olive oil and butter, add onion slices: Use a wide, thick-bottomed saut\\xc3\\xa9 pan for maximum pan contact with the onions. Coat the bottom of the pan with olive oil, or a mixture of olive oil and butter (about 1 teaspoon per onion). Heat the pan on medium high heat until the oil is shimmering. Add the onion slices and stir to coat the onions with the oil. Spread the onions out evenly over the pan and let cook, stirring occasionally.', 'Depending on how strong your stovetop burner is you may need to reduce the heat to medium or medium low to prevent the onions from burning or drying out.', 'After 10 minutes, sprinkle some salt over the onions, and if you want, you can add some sugar to help with the caramelization process. (I add only about a teaspoon of sugar for 5 onions, you can add more.) One trick to keeping the onions from drying out as they cook is to add a little water to the pan.', '3 Cook, stirring every few minutes: Let cook for 30 minutes to an hour more, stirring every few minutes. As soon as the onions start sticking to the pan, let them stick a little and brown, but then stir them before they burn.', ""The trick is to leave them alone enough to brown (if you stir them too often, they won't brown), but not so long so that they burn. After the first 20 to 30 minutes you may want to lower the stove temperature a little, and add a little more oil, if you find the onions are verging on burning."", 'A metal spatula will help you scrape up the browned bits from the bottom of the pan as the caramelization proceeds. As the onions cook down, you may find you need to scrape the pan every minute, instead of every few minutes.', 'Continue to cook and scrape, cook and scrape, until the onions are a rich, browned color. At the end of the cooking process you might want to add a little balsamic vinegar or wine to help deglaze the pan and bring some additional flavor to the onions.', 'Store refrigerated for several days in an air-tight container.']",11
1527,Roasted Kabocha Squash Soup Recipe,15,90,105,"['A half a large kabocha squash, seeded (about 3 to 4 pounds for the half)', '1 tablespoon extra virgin olive oil', 'Salt', '1 1/2 tablespoons extra virgin olive oil', '2 cups chopped or sliced onions', '2 ribs of celery, sliced', '3 cloves garlic, chopped (about 1 Tbsp)', '1 1/2-inch piece of fresh ginger root, peeled and grated', '1 1/4 teaspoon ground cumin', '1/2 teaspoon ground coriander', '4 cups of chicken stock', '2 teaspoons kosher salt', '1/4 teaspoon black pepper', 'Garnish with lime juice and chopped fresh cilantro']",14,"[""1 Roast the squash: Preheat oven to 400\\xc2\\xb0F. Use a heavy chef's knife or cleaver (it helps if you have a rubber mallet as well) to cut the kabocha squash half into a few large pieces. (Kabocha squash is thick and meaty and can be a challenge to cut. So take care! Make sure the squash is stable on your cutting board before you start to cut it.)"", 'Scoop out the seeds (you can toast them like pumpkin seeds!) and stringy insides. Place the squash pieces on a foil or silpat lined roasting pan. Rub olive oil over all sides, and sprinkle with salt.', 'Put the squash pieces skin side up on the pan. Roast for 45 minutes to an hour, until completely cooked through, soft, and caramelized at the edges. Remove from oven and let sit.', '2 Saut\\xc3\\xa9 onions, celery, garlic, ginger, cumin, coriander: Heat olive oil on medium high heat in a large (4 to 6 quart) thick-bottomed pan. Add the onions and celery. Lower the heat to medium and cook until softened, 8 to 10 minutes.', 'Add the garlic, ginger, cumin, and coriander and cook 2 minutes more.', '3 Add squash, stock, salt, pepper, then simmer: Once squash is cool enough to handle, remove and discard the skin. Place the roasted kabocha squash flesh into the pot with the onions and celery mixture. Add the stock, salt and pepper. Increase heat to high to bring the soup to a simmer, then lower the heat to low, partially cover and cook 8 to 10 minutes.', '4 Pur\\xc3\\xa9e the soup: Remove from heat. Use an immersion blender (or work in batches with a standing blender, only filling the blender bowl 1/3 of the way each time) to pur\\xc3\\xa9e the soup.', 'Add more salt to taste. Sprinkle with lime juice and chopped cilantro to serve.']",8
1528,Baba Ganoush (Eggplant Dip) Recipe,10,60,70,"['1-2 globe eggplants (totaling 2 pounds or 900 g)', '3 tablespoons extra virgin olive oil', '2-3 tablespoons roasted tahini (sesame paste)', '1-2 garlic cloves (more or less depending on how garlicky you want your baba ghanouj to be), finely chopped', '1/2 teaspoon ground cumin', 'Juice of one lemon (about 2 1/2 tablespoons)', 'Salt and cayenne pepper to taste', '1 tablespoon chopped parsley']",8,"['1 Roast the eggplants: Preheat oven to 400\\xc2\\xb0F. Poke the eggplants in several places with the tines of a fork. Cut the eggplants in half lengthwise and brush the cut sides lightly with olive oil (about 1 tablespoon).', 'Place on a baking sheet, cut side down, and roast until very tender, about 35-40 minutes. Remove from oven and allow to cool for 15 minutes.', 'Alternate Grilling Instructions: Preheat grill. Poke the eggplants in a few places with a fork, then rub the eggplants with 1 tablespoon of the olive oil.', 'Grill over high heat, turning as each side blackens. Put the charred eggplants in a paper bag, close the bag and let the eggplants steam in their skins for 15-20 minutes.', '2 Scoop the eggplant flesh into a large bowl and mash well with a fork.', '3 Add garlic, olive oil, tahini, cumin, lemon juice, salt, cayenne: Combine the eggplant, minced garlic, remaining olive oil (about 2 tablespoons), tahini, cumin, 2 tablespoons of the lemon juice, the salt, and a pinch of cayenne.', ""Mash well. You want the mixture to be somewhat smooth but still retaining some of the eggplant's texture."", '4 Cool and season to taste: Allow the baba ganoush to cool to room temperature, then season to taste with additional lemon juice, salt, and cayenne.', 'If you want, swirl a little olive oil on the top. Sprinkle with fresh chopped parsley.', 'Serve with pita bread, crackers, toast, sliced baguette, celery, or cucumber slices.']",10
1529,How to Cook a Whole Butternut Squash in the Pressure Cooker,5,0,5,"['1 medium (2 1/2 to 3 pound) butternut squash', 'Special equipment:', '6-quart Instant Pot or other pressure cooker']",3,"['1 Prepare the squash for steaming: Lay the squash on its side on a cutting board \\xe2\\x80\\x94 you can hold onto it with a kitchen towel for extra stability. Slice off the stem, then cut the squash in half through the middle, where the thinner neck meets the larger bottom. Cut each section in half again, then scoop out the seeds.', '2 Pressure-steam the squash: Place a wire metal trivet in your electric pressure cooker and pour in 1 1/2 cups of water. Arrange the pieces of squash on top of the trivet in a single layer. It\\xe2\\x80\\x99s fine if they overlap a bit.', 'Secure the lid on your pressure cooker, and make sure the pressure release valve is set to its sealing position. Select the \\xe2\\x80\\x9cSteam\\xe2\\x80\\x9d or \\xe2\\x80\\x9cManual\\xe2\\x80\\x9d setting, and set the cooking time to 7 minutes at high pressure. (If you\\xe2\\x80\\x99re using a stovetop pressure cooker, steam the squash at high pressure for 6 minutes.)', 'The pot will take about 10 minutes to come up to pressure, and then the cooking program will begin.', '3 Remove the squash from the pressure cooker and cool: At the end of cooking, move the pressure release valve to its venting position. When the pressure has fully released, open the pot.', ""If, after 7 minutes, the squash is not as tender as you'd like, add another 1/2 cup of water to the Instant Pot, lock on the lid, and set the pressure cooking time for another 2 minutes. If necessary, keep cooking under pressure in increments of 2 minutes until tender. You may need up to 12 minutes total pressure cooking time. Some butternut squash cook faster than others."", 'Use a pair of tongs to transfer the squash to a cutting board to cool.', ""4 Scoop the squash from the skin: When it's cool enough to handle, use a big spoon to scoop the squash from the outer skin. At this point, it's ready to be added to any recipe calling for cooked squash.""]",8
1530,French Green Beans with Butter and Herbs Recipe,15,10,25,"['1 pound thin green beans (haricot vert), trimmed', '1/4 cup red onion, chopped fine', '3 Tbsp butter', '2 Tbsp parsley, chopped fine', '2 Tbsp fresh thyme leaves', '2 Tbsp tarragon or basil, chopped fine', '2 Tbsp chives, chopped fine', 'Salt and pepper to taste', 'Lemon wedges']",9,"['1 Blanch the green beans: Bring a large pot of salty water to a boil. Prepare a large bowl of ice water. Boil the beans for 2 minutes.', 'Plunge them into the ice water to stop the cooking and set the color. Drain the beans and pat dry on a cloth or paper towel.', '2 Saut\\xc3\\xa9 onions: Heat the butter over medium-high heat in a large saut\\xc3\\xa9 pan. Cook the onions until translucent, about 2-3 minutes.', '3 Add green beans: Add the green beans and saut\\xc3\\xa9 for 2-3 minutes, stirring often.', '4 Add seasonings: Add all the herbs and some salt and pepper and toss to combine. Cook for 1 minute more.', 'Serve hot or at room temperature, with lemon wedges.']",6
1531,Cauliflower Chickpea Curry Recipe,10,30,40,"['1 tablespoon extra virgin olive oil or vegetable oil', '2 teaspoons of yellow curry powder', '1 medium yellow onion, cut in half and then sliced across the grain (about 1 1/2 cups sliced onion)', '1-inch piece of ginger root, peeled and grated (1 teaspoon grated)', '1 1/2 cups cooked chickpeas (garbanzo beans) (a 15-ounce can, rinsed and drained)', '1 head cauliflower, cored, florets separated (see How to Cut and Core Cauliflower)', '1 15-ounce can of whole, peeled tomatoes', '1 teaspoon Kosher salt', '1/8 teaspoon freshly ground black pepper', '1 bay leaf', '1/2 cup water', '1/2 cup (packed) roughly chopped cilantro (leaves and young stems)', '2 teaspoons minced fresh mint leaves']",13,"['1 Saut\\xc3\\xa9 curry powder and onion: Heat the oil in a thick-bottomed pot (with lid) on medium heat. Add the curry powder to the oil and let cook for a minute until fragrant.', 'Add the sliced onion, toss with the curried oil. Let cook until softened about 6 to 8 minutes.', '2 Add ginger, chickpeas, tomatoes, cauliflower, bay leaf, salt, pepper, water: Once the onions have softened, add the ginger and the chickpeas, toss to coat with everything.', 'Add the tomatoes, shredding the whole tomatoes with your fingers as you add them to the pot. Include any tomato juice from the can.', 'Add the cauliflower florets, the salt, pepper, bay leaf, and water.', '3 Simmer until cauliflower is cooked through: Bring to a simmer. Lower the heat and cover. Cook 15 to 18 minutes until the cauliflower is cooked through and tender.', '4 Toss with cilantro and mint to serve: Remove from heat. Toss with fresh chopped cilantro and minced mint.', 'Serve with rice or rice pilaf. If you want dollop a little sour cream or plain yogurt over it (non-vegan option).']",8
1532,Indian Spiced Lentil Burgers with Cilantro Chutney Recipe,35,12,47,"['For the Chutney:', '1/2 small bunch cilantro, stems and leaves coarsely chopped to make 2 packed cups ', '1 small jalapeno pepper, seeded and coarsely chopped', '3 tablespoons lime juice, from about 1 lime', '1 tablespoon oil ', '1/4 teaspoon table salt', 'For the burgers:', '1 cup dry red lentils ', '2 teaspoons table salt, divided', '1/2 red onion, thickly sliced', '1 clove garlic, sliced', '2-inch piece ginger root, unpeeled, cut into thin slices', '1 medium carrot, thinly sliced', '2 tablespoons olive oil, plus more for broiling the burgers', '1 teaspoon ground turmeric', '1 teaspoon ground coriander', '1/2 teaspoon ground cumin', '2 large eggs', '6 tablespoons fine, dry breadcrumbs', 'To serve:', '4 hamburger buns or similar rolls', '4 tablespoons Greek yogurt', '1 cucumber, thinly sliced', '4 lettuce leaves, a handful of sprouts, or greens of your choice']",24,"['1 Make the chutney: In a food processor, puree the cilantro, jalapeno, lime juice, 1 tablespoon oil, and 1/4 teaspoon salt until smooth \\xe2\\x80\\x9cish\\xe2\\x80\\x9d, scraping down the sides of the bowl two or three times. The mixture will still have some texture but should be predominately smooth. ', 'Transfer to a small bowl. Don\\xe2\\x80\\x99t wipe out the food processor. You\\xe2\\x80\\x99ll use it again in a second.', '2 Pick over the lentils: Spread the lentils on a baking sheet and pick out small stones or pieces of dirt if there are any. Place them in a sieve and run them under cold water to rinse them. Drain. ', '3 Cook the lentils: In a large saucepan, bring 4 cups water and 1 teaspoon salt and the lentils to a boil. Adjust the heat to a low boil and cook for 5 to 6 minutes, or until tender, but not mushy. ', 'At this point they should still hold their shape somewhat, though you will notice that the outer husks may have separated. Drain well in a fine-mesh colander or sieve. ', '4 Chop the vegetables: While the lentils are cooking and draining, pulse the onion, garlic, ginger, and carrot in the food processor until finely chopped.', '5 Cook the vegetables and spices: In a large skillet over medium heat, heat 2 tablespoons of the oil. Add the chopped vegetables and cook for 4 to 5 minutes, or until softened. Add the turmeric, coriander, cumin, and 3/4 teaspoon salt and cook for 30 seconds to bloom the spices. Turn off the burner and remove the pan from the heat.', '6 Mash the lentils: Stir the well-drained lentils into the still-warm vegetables in the skillet. With a fork or potato masher, mash about half the mixture, leaving the other half intact.', 'Clear a space on one side of the skillet and add the eggs. Beat them well with a fork, and stir them into the lentils. Add the breadcrumbs and stir again. Let the mixture cool enough for you to handle and form into patties.', '7 Form the patties: Line a baking sheet with foil and lightly brush it with oil. Form the lentil mixture into 4 patties that are about 4-inches across. Refrigerate the patties, uncovered, for 30 minutes.', '8 Cook the burgers: Set a rack 4 inches from the broiler element and preheat the broiler. Brush the tops with oil. Broil for 5 to 6 minutes, or until golden brown. Turn carefully, brush with more oil, and brown on the other side (another 5 to 6 minutes.)', '9 Serve the burgers: On four buns, place the burgers. Spread each with the about 1 tablespoon of the chutney and dollop 1 tablespoon of yogurt on top. Top with sliced cucumbers and lettuce or greens of your choice.']",12
1533,Venison Sauerbraten Recipe,0,300,300,"['3-4 pound roast of venison (or beef chuck)', '1/4 cup melted butter or extra virgin olive oil', '8 gingersnap cookies', '3 Tbsp butter', '2 Tbsp flour', 'Salt', 'Marinade Ingredients:', '1 bottle of red wine', '1/2 cup red wine vinegar', '2 cups water', '1 Tbsp black peppercorns', '1 Tbsp juniper berries', '1 Tbsp mustard seed', '6-8 cloves', '3-5 bay leaves', '1 Tbsp dried thyme', '2 celery stalks, chopped', '2 carrots, peeled and chopped', '1 medium onion, chopped']",19,"['1 Marinate the venison: Put marinade ingredients (wine, vinegar, water, peppercorns, juniper, mustard, cloves, bay leaves, thyme, celery, carrots and onion) in a pot and bring to a boil.', 'Turn off heat and allow the marinade to cool.', 'Submerge the venison in the marinade and refrigerate for at least 24 hours, and up to 5 days. Three days is a good length of time for this.', 'When you are ready to cook, remove the roast from the marinade and sprinkle it all over with salt. Set it aside for 15-20 minutes or so.', '2 Preheat the oven to 275\\xc2\\xb0F. Actually, 225\\xc2\\xb0F is a better temperature, but the roast can take up to 8 hours to properly cook then; this is what I do at home on weekends. At 275\\xc2\\xb0F, the roast will probably take about 5 hours to cook. You can go up to 300\\xc2\\xb0F \\xe2\\x80\\x93 a typical venison roast will be ready in 3 1/2 hours at this temperature \\xe2\\x80\\x93 but you will get gray, not pink, meat. It will still taste good, though.', '3 Brown venison in butter or oil (optional): Now you have an optional step: You can, if you choose, brown the venison in butter or oil. I chose not to because if you then simmer the venison at a low enough temperature, it will remain pink all the way through. If you brown the outside, you will get a gray ring around the edge of the venison when you cut into it. Either way is fine.', '4 Cook the venison in the marinade: Pour the marinade into a Dutch oven or other lidded, oven-proof pot and bring it to a boil. Add the venison to the pot. Cover and put in the oven.', 'If the venison is not submerged by the marinade, turn the roast over every hour. This is also a good way to test for doneness \\xe2\\x80\\x93 you want the roast to almost be falling apart.', 'The roast should take between 3 1/2 to 8 hours to cook, depending on the oven temperature. At 275\\xc2\\xb0F, it should take about 5 hours to cook.', '5 Remove roast from oven and coat with oil or melted butter: When the roast is done (completely tender), take it out of the pot and coat it with some of the 1/4 cup olive oil or melted butter. Reserve the rest of the oil or butter for later. Wrap it in foil.', '6 Make the sauerbraten sauce: Sauerbraten is all about the sauce. Strain the cooking liquid through a fine-meshed sieve into a bowl.', 'Take the 8 gingersnap cookies and pulverize them in a blender. You want it to look like a rough meal or coarse flour.', 'In a medium-sized pot, melt 3 tablespoons of butter over medium-high heat. When it is frothing and totally melted, whisk in 2 tablespoons flour. Cook the roux until it is the color of coffee-and-cream, stirring often.', 'Slowly whisk in the strained cooking liquid, one cup at a time. The mixture will turn to clay at first, then loosen into a silky sauce.', 'Taste for salt \\xe2\\x80\\x93 it will probably need it \\xe2\\x80\\x93 and add enough to your taste.', 'Whisk in 4 tablespoons of the pulverized gingersnaps. They will not dissolve completely at first, but keep stirring and they will disappear.', 'Taste the sauce. Add another tablespoon of gingersnaps if you want, or add a tablespoon of sugar.', 'The sauce should taste sour, warm (a pumpkin pie sort of spicy warm) and a little zippy and sweet.', '7 To serve, slice the roast into 1/4 inch thick slices. Venison can be dry \\xe2\\x80\\x93 it has zero fat \\xe2\\x80\\x93 so one trick I do is to coat each slice in melted butter before I serve it. You\\xe2\\x80\\x99ll need about 1/2 stick melted to do this trick.', 'Serve with lots of sauce, some braised onions, and either mashed potatoes, egg noodles, or spaetzle. A hearty red wine would be an ideal match here, as would a dark, malty beer.']",20
1534,Easy Lemon Pudding Recipe,5,130,135,"['2 cups (473ml) heavy whipping cream', '2/3 cup (135g) granulated sugar', 'Finely grated zest of 1 lemon', '6 tablespoons (89ml) lemon juice', '1 cup (about 150g) blueberries, raspberries, sliced strawberries or blackberries, to garnish']",5,"['1 Warm the cream and sugar: In a medium saucepan over medium heat, stir together the cream, sugar and lemon zest. Bring to a boil. Adjust the heat to a gentle boil, and cook, stirring often, for 5 minutes.', 'Watch carefully and stir frequently to keep the cream from boiling over.', '2 Add the lemon juice and continue to simmer for 5 more minutes. Stir frequently.', '3 Take the pan off the heat and let the cream cool for 5 minutes.', '4  Strain and chill. Strain the mixture through a fine-mesh strainer into a 4-cup liquid measuring cup or other container for easy pouring.', 'Pour into 4 four-ounce ramekins or pretty stemmed glasses.', '5 Refrigerate, uncovered, for 2 to 3 hours, or until set. This pudding can also be prepared and refrigerated up to 2 days in advance. Top each glass with berries just before serving.']",7
1535,Chocolate Raspberry French Toast Recipe,5,15,20,"['For the French Toast:', '1/2 cup white sugar', '1/2 cup unsweetened cocoa, Dutch-processed preferred (see note above)', '1/2 teaspoon kosher salt', '2 teaspoon vanilla extract', '2 cups real milk, whole preferred but any dairy milk will work', '8 large eggs', '12 thick slices of bread, challah preferred', 'To Fry:', '4 tablespoons butter, divided', '4 tablespoons vegetable oil, divided', 'For the Chocolate Maple Syrup:', '3 ounces (85 g) dark chocolate, chopped (can use semi-sweet chocolate chips)', '1/4 teaspoon kosher salt', '1 cup (11 ounces or 315 g) maple syrup, not pancake syrup']",15,"['1 Preheat the oven to 200\\xc2\\xb0F or the lowest temperature available. ', '2 Mix together dry and wet ingredients: Place the sugar, cocoa, salt, and vanilla in a large bowl.', 'Pour in half the milk and whisk until the dry ingredients dissolve. Whisk in the remaining milk. Beat in the eggs.', ' 3 Soak the bread with the chocolate milk mixture: Place the bread in a 9 x 13 x 2-inch baking pan. Pour the chocolate milk batter all over the bread. Poke the bread with a fork, and flip to make sure it gets completely coated.', 'Set aside for 10 to 15 minutes, periodically flipping the bread to ensure it absorbs the batter evenly. You want the bread to feel heavy and saturated, but not falling apart.', ' 4 Make the chocolate maple syrup: While the bread is absorbing the batter, make the chocolate maple syrup by placing the chocolate and salt in a heatproof bowl.', 'Place the maple syrup in a small saucepan and heat until it starts to boil and bubble at the edges of the pan. Pour the hot syrup over the chocolate and then stir together with a whisk until the chocolate is melted.', ' 5 Warm the butter and oil: In a large skillet place 1 tablespoon butter and 1 tablespoon oil in the pan over high heat. Warm until the butter has melted and starts to foam.', ' 6 Fry the French toast: Reduce heat to medium-low and place three of the pieces of bread in the pan (or however many will comfortably fit, don\\xe2\\x80\\x99t overcrowd the pan). Don\\xe2\\x80\\x99t use a high heat, as the sugar in the batter tends to burn easily.', 'Fry for about 2 to 3 minutes, or until the bottom of the toast looks dry and slightly puffy. Flip the toast and repeat on the other side, frying another 2 to 3 minutes.', 'Unlike regular French toast, chocolate French toast is dark so it\\xe2\\x80\\x99s hard to tell if it\\xe2\\x80\\x99s done. Just touch and poke the top of the toast once you\\xe2\\x80\\x99ve flipped it. If it\\xe2\\x80\\x99s a little \\xe2\\x80\\x9cbouncy\\xe2\\x80\\x9d and has a slight glossy slick feel without being wet or moist, that side is done.', ' 7 Keep toast warm until ready to serve: Once your first batch of toast is done, move it to a wire rack on top of a baking pan and place it in the oven to keep warm. Repeat with the remaining toast, using the remaining butter and oil.', ' 8 Serve: To serve, dust the toast with powdered sugar. Top with whipped cream, raspberries, and chocolate maple syrup. Serve with a glass of real milk!']",13
1536,Peanut Butter Blossom Cookies Recipe,10,12,22,"['1 stick (1/2 cup) unsalted butter, at room temperature', '1/2 cup (129 g) peanut butter', '1/2 cup (100 g) granulated sugar, plus more for rolling', '1/2 cup (110 g) packed brown sugar', '1 large egg', '1 1/2 cups (187 g) all-purpose flour', '1 teaspoon baking powder', '1/2 teaspoon kosher salt', '24 chocolate kiss candies, unwrapped']",9,"['1 Preheat the oven to 350\\xcb\\x9aF and line two baking sheets with parchment paper.', '2 Mix the wet and dry ingredients separately: Mix together the butter, peanut butter, and both sugars in a bowl with a wooden spoon (or you can use an electric or stand mixer) until smooth and combined; add in the egg and mix until smooth.', 'In a separate bowl, combine the flour, baking powder, and salt.', '3 Make the cookie dough: Slowly, in a couple of additions, add the flour mixture to the peanut butter mixture and combine to form the cookie dough.', '4 Shape the cookie: Add a few tablespoons of sugar to a small bowl. Scoop into balls with about 1 1/2 tablespoons of dough. Roll between your hands to form a ball, and then coat it with sugar.', 'Place the balls on the prepared baking sheet a couple of inches apart.', '5 Bake the cookies: Bake the cookies on the middle rack about 12 minutes, until slightly spread out, domed on the top, and golden on the bottom. Immediately press a chocolate kiss in the center of each cookie.', '6 Cool and store: Let the cookies cool for a couple of minutes on the baking sheet before transferring to a rack to finish cooling completely. These cookies will keep for a few days stored in an airtight container at room temperature.']",8
1537,Easy Dump Cake from Scratch Recipe,15,35,50,"['For the fruit:', '3 pounds (1.36 kilograms) fresh or frozen fruit (like berries, sliced peaches, sliced apples, sliced plums, etc.)', '1/2 cup (100 grams) sugar, plus more to taste', '2 1/2 tablespoons cornstarch', '1/8 teaspoon kosher salt', 'For the cake:', '1 cup (200 grams) sugar', '1 1/4 cups (175 grams) all-purpose flour', '1 teaspoon baking powder', '1/4 teaspoon kosher salt', '3/4 cup (170 grams) melted unsalted butter', 'Vanilla ice cream, to serve']",12,"['1 Preheat the oven to 375\\xc2\\xb0F.', ""2 Prepare the fruit: Combine the fruit, sugar, cornstarch, and salt in a 9x13 baking dish, stirring to coat the fruit in the sugar and cornstarch. Add up to an extra 1/4 cup sugar, as needed, if using very tart fruits. (Frozen fruit is fine; it doesn't not need to be thawed before baking.)"", 'Spread the mixture into an even layer.', '3 Add the cake topping: Whisk together the flour, sugar, baking powder, and kosher salt for the cake layer in a mixing bowl. Sprinkle the mixture evenly over the top of the fruit. Drizzle the melted butter evenly over the top.', '4 Bake the cake: Bake for 35 to 45 minutes, or until the fruit is bubbling through the center and the top is golden (frozen fruit might take an extra 10 minutes or so). If you notice a few dry pockets of flour toward the end of cooking, push them down into the fruit with a spoon so they cook.', 'Serve warm with vanilla ice cream. Leftover cake can be covered and refrigerated for a few days.']",6
1538,Easy Graham Cracker Crust,10,10,20,"['12 rectangular graham cracker sheets (about 6 ounces), broken into pieces equaling  about 1 1/2 cups', '2 tablespoons sugar', '1/8 teaspoon salt', '8 tablespoons (1 stick) unsalted butter, melted', 'Optional:', '2 teaspoons finely grated lemon or orange zest', '1 teaspoon vanilla extract', 'Special equipment:', 'Food processor', '9-inch pie plate']",10,"['1 Preheat the oven to 350\\xc2\\xb0F. Set a rack in the middle position.', '2 Make the crumbs: In a food processor, pulse the graham crackers until finely ground. You should have about 1 1/2 cups.', 'By hand: Enclose the broken graham crackers in a heavy-duty plastic freezer bag. Seal the bag and roll over with a rolling pin to crush the graham crackers until they are fine crumbs.', '3 Mix the crust: Add the butter, sugar, salt, and optional orange zest and vanilla (if using) to the food processor. Pulse until combined.', '4 Press the crust into the pie pan: Spread the crumbs evenly over the bottom of the pie pan. With your fingers, press it into the sides of the pan all around, and then into the bottom of the pan.', 'Cover a dry measuring cup with plastic wrap (to keep it from sticking to the crumbs). Gently re-press the crumbs into the pan to make them even and compact, starting with the sides first. Tamp down the crumbs on the bottom so the crumbs are even and compact.', ""5 Chill the crust (optional): If you want to use this immediately and/or are filling it with something that doesn't need baking, such as our Lemon Icebox Pie, you don't have to bake first. Place the assembled crust in the freezer for 15 minutes to allow the butter to become firm. Remove and fill according to recipe directions."", '6 Bake the crust (optional):  If you want to bake this crust for the toasty flavor it imparts before filling it, put it in the center of the oven for 10 minutes, or until the edges are just slightly browned. Set the pie pan on a rack to cool to room temperature and use according to your recipe directions.']",8
1539,Homemade Pepperoni Pizza Recipe,10,15,25,"['16 ounces pizza dough, store-bought or homemade (I like this no-knead version, though note that this recipe makes enough dough for 2 pizzas)', '1/2 cup pizza sauce (see below)', '18-20 slices pepperoni', '12 ounces mozzarella cheese, grated', '1/2 teaspoon ground black pepper', '1 teaspoon fresh oregano, optional', 'Flour for rolling and shaping dough', 'For the Quick Pizza Sauce:', '1/2 cup tomato sauce (no salt)', '1/2 teaspoon kosher salt', '1/2 teaspoon ground black pepper', '1/2 teaspoon granulated garlic', '1/2 teaspoon granulated onion', '1/4 teaspoon red pepper flakes', '1 teaspoon olive oil', 'For the Honey Butter (Dad Add):', '1/4 cup softened butter', '2 tablespoons honey', 'Special equipment:', 'Pizza stone, recommended', 'Pizza peel, recommended']",21,"['1 Preheat the oven: Preheat oven to 500\\xc2\\xb0F. If you are using a pizza stone, preheat it in the oven for at least 20 minutes so it is nice and hot as well.', '2 Make the sauce: If you are using my sauce recipe, stir together the ingredients. The sauce recipe makes just enough for one large pizza. You can easily double it if you are making more than one pizza.', ""3 Roll out the dough: Roll out dough on a lightly floured surface. If it's hard to roll, let it rest for 5 minutes so it can come to room temperature. For a large pizza, I like to roll my dough into about a 14-inch diameter circle."", '4 Add the toppings: Transfer the dough to a lightly dusted pizza peel. Alternatively, fit it into a large cast-iron.', 'Add sauce in a light layer all over the pizza, leaving about 1/4-inch crust around the edges. Chop half of the pepperoni and sprinkle it over the sauce. Top the pizza with grated cheese and the rest of the pepperoni. Season with black pepper.', ""5 Cook the pizza: If you're using a pizza stone, carefully slide pizza into the center of the preheated pizza stone. Cook for 6 minutes, then rotate the pizza halfway so it cooks evenly. Cook for another 6-8 minutes, or until the crust is golden brown and charred in spots."", ""If you're using a skillet, press the dough into a cast iron skillet and add toppings. Place the skillet over a high heat burner for 2 minutes to get it preheated and get the crust cooking right away. Then transfer to a 500\\xcb\\x9aF oven and bake for 10 to 12 minutes, or until the crust is golden brown."", '6 Slice and serve! Use pizza peel to slide pizza out onto a cutting board. Let the pizza rest for a minute and slice into pieces. Season with fresh oregano (optional). Serve while warm with a side salad.', '7 Make the honey butter (optional): Stir together the softened butter and honey, then serve alongside the pizza for crust dipping.', 'Store leftover pizza in the fridge for up to three days. Reheat pizza in a sturdy skillet over medium heat with a drizzle of oil. Cover skillet with a lid and cook until the cheese has melted and crust is crispy.']",10
1540,Oven-Baked Bacon,5,20,25,"['12 strips bacon', '1/2 teaspoon ground black pepper (optional)', 'Special equipment:', 'Wire baking rack']",4,"['1 Prep the bacon: If you have an oven-safe baking rack, place it inside a sheet pan. (For even easier clean-up, you can also line the sheet pan with foil.)', 'Lay out the bacon strips on the wire rack. Make sure they don\\xe2\\x80\\x99t overlap. Sprinkle bacon strips with black pepper, if you want.', '2 Bake the bacon: Place the bacon in a cold oven, and set the oven temperature to 375\\xc2\\xb0F. Bake the bacon in the oven for 15-20 minutes total.', 'If you are doing more than one pan of bacon, rotate sheet pans from top to bottom halfway through. If you are not using a baking rack, flip the bacon strips halfway through cooking.', ""Start checking the bacon around 18 minutes, as some bacon cooks faster depending on the fat content. The bacon is done when it turns a dark tan color. Remember that the bacon crisps up as it cools, so don't worry if it's not completely crispy when you take it out of the oven."", '3 Drain and cool: When the bacon comes out of the oven, place it on a few paper towels to drain and cool. If you like, pour off the bacon grease from the pan and save it for cooking. (I love to cook eggs in my bacon grease!)', ""4 Store the bacon: Bacon can be kept in the fridge for a few days and reheats well in a skillet over low heat. You can also freeze the bacon if you made a big batch. Just make sure to freeze the strips individually, or in between pieces of parchment paper, so they don't stick together.""]",7
1541,Angel Food Cake Recipe,20,45,65,"['1 cup (130 g) cake flour', '1 cup (115 g) powdered sugar', '12 egg whites', '1 1/2 teaspoons cream of tartar', '1/2 teaspoon table salt', '2 teaspoons vanilla extract', '1/2 teaspoon almond extract', '3/4 cup (180 g) granulated sugar', 'Special equipment:', 'Angle food cake pan']",10,"['1 Preheat oven to 325\\xc2\\xb0F.', '2 Combine the cake flour and powdered sugar: Sift together the cake flour and powdered sugar into a bowl or a piece of parchment.', '3 Begin whisking the egg whites by hand: In the bowl of a stand mixer, add egg whites, cream of tartar, salt, and the vanilla and almond extracts. Hold the whisk of the stand mixer in your hand. Manually and aggressively whisk the egg whites for about a minute. This just helps get everything started.', '4 Continue whisking the egg whites with a mixer: Set the bowl into the stand mixer base fitted with the whisk attachment. Whisk at medium speed until the egg whites have thickened and are frothy, about one minute.', 'Continue whipping at medium speed, and slowly sprinkle the granulated sugar over the whipped egg whites a little at a time, until the sugar is incorporated and the eggs are white, shiny, and hold medium stiff peaks.', 'To test this, stop the mixer, detach the whisk and the bowl from the mixer. Lift the mixer out of the egg whites, and turn it upside down. A short tip of egg white should fall over when you pull the whisk from the bowl.', '5 Fold in the flour mixture: Remove the bowl of the stand mixer from the base, and slowly shake the flour a little a time, about a 1/4 of the flour, over the surface of the egg whites. Use a spatula to fold the flour into the egg whites. Repeat this process until all of the flour is incorporated.', '6 Bake: Scoop the mixture into an un-greased angel food cake pan. Bake for 40 minutes. The top should be springy, dry, golden, and slightly cracked.', '7 Cool the cake upside down: Let the cake cool upside down on a bottle or the feet of the pan for 90 minutes to 2 hours. This allows the cake to cool and maintain its structure. If you flip the cake over too soon, it will compress or collapse.', 'Once the cake pan is completely cool to the touch and you\\xe2\\x80\\x99ve patiently waited at least 90 minutes, slide a knife around the edges and the center tube. Turn it upside down. Remove the base from the sides. The cake will still be attached to the base. Slide a knife between the base and the cake.', '8 Serve: Eat with berries, whipped cream, or out of hand while standing in the kitchen. Store covered on the counter for up to a week.']",11
1542,Lemon Meringue Pie Recipe,15,90,105,"['1 frozen pie crust (see pie crust recipe for instructions to make your own, use a butter crust or butter and shortening crust recipe)', 'For the lemon filling:', '5 large egg yolks', '6 tablespoons cornstarch', '1 1/3 cup (266 g) sugar', '1/4 teaspoon salt', '1 1/2 cups water', '1/2 cup lemon juice', '2 teaspoons lemon zest', '2 tablespoons butter', 'For the meringue:', '1 tablespoon cornstarch', '1/3 cup cold water', '1/4 teaspoon cream of tartar (can use vinegar instead of cream of tartar, see method instructions)', '1/2 cup plus 2 tablespoons (128 g) white granulated sugar', '5 large egg whites (room temperature)', '1/2 teaspoon vanilla extract']",17,"['1 Pre-bake the pie shell: If you are using a packaged frozen pie crust, please follow the directions on the package to pre-bake. If you are using a homemade crust, please follow these instructions:', 'Preheat oven to 375\\xc2\\xb0F. Line a frozen pie shell with aluminum foil so that the foil extends over the edges (will make convenient handles). Fill two-thirds of the way with pie weights or dry beans.', 'Bake for 20 minutes. Then remove the foil and the pie weights. Poke the bottom of the crust in several places with the tines of a fork. This will help prevent the bottom from bubbling up.', 'Put the crust back in the oven and bake for 15 minutes more, or until the crust is lightly browned. Remove from oven and set aside.', '2 Make the lemon filling: Whisk the egg yolks in a medium bowl and set aside.', 'In a medium-sized saucepan, add 6 tablespoons cornstarch, 1 1/3 cup sugar, 1/4 teaspoon salt, and 1 1/2 cups water, and whisk to combine. Bring to a boil on medium heat, whisking constantly. Let simmer for a minute or two until the mixture begins to thicken.', ""Once the cornstarch mixture has thickened up well (consistency of Cream of Wheat) remove from heat. Take a spoonful of the cornstarch mixture and whisk it into the beaten egg yolks to temper the yolks. Continue to whisk in spoonfuls of the cornstarch mixture until you've used about half of the cornstarch mixture."", 'Then add the egg yolk mixture back to the pot with the cornstarch. Return to a boil, on medium to medium high heat, stirring constantly. Cook 3 to 4 minutes. (The starch will keep the eggs from curdling.)', 'Remove from heat and stir in the lemon juice, lemon zest, and butter.', '3 Preheat oven to 325\\xc2\\xb0F.', '4 Prepare cornstarch mixture for the meringue: In a small saucepan, whisk together 1 tablespoon cornstarch and 1/3 cup of cold water until the cornstarch dissolves. Heat on medium heat and whisk until the mixture bubbles and thickens. Remove from heat and set aside.', '5 Whisk together the sugar and cream of tartar: Whisk together 1/2 cup plus 2 tablespoons of sugar and 1/4 teaspoon of cream of tartar, set aside. (If you do not have cream of tartar, instead add a teaspoon of white vinegar to the egg whites with the vanilla in the next step.)', '6 Make the meringue: Place egg whites and 1/2 teaspoon vanilla extract in the bowl of your mixer. Start beating the egg whites on low speed and gradually increase the speed to medium.', 'Once the egg whites are frothy, slowly add in the sugar and cream of tartar, a spoonful at a time. Beat until the egg whites form soft peaks.', 'Add the cornstarch water mixture (it should look like a gel) a spoonful at a time, as you continue to beat the egg whites. Increase the speed to high and continue to beat until the egg whites have formed stiff peaks. Do not over-beat, or your meringue will be grainy.', '7 Fill pie shell with filling: Heat the lemon filling again, until it is bubbling hot.', 'Scoop the steaming hot filling into the pre-baked pie shell, spreading it evenly.', '8 Top with meringue: Working quickly, use a rubber spatula to spread the meringue mixture evenly around the edge of the pie.', 'Make sure the mixture attaches to the crust with no gaps. The crust will help anchor the meringue and help keep it from shrinking.', 'Fill in the center with more meringue mixture. Use the back of a spoon to create peaks all over the meringue.', '8 Bake: Bake the pie for 20 minutes at 325\\xc2\\xb0F, until the meringue is golden brown.', 'Transfer to a wire rack and let cool completely to room temperature. If the pie is even remotely warm when you cut into it, the lemon base may be runny. To help firm up the base, after the pie has cooled down, you can place the pie on top of a cooling pack covered with a tea towel.', 'Best eaten the same day.']",23
1543,How to Fry an Egg,0,4,4,"['1 large egg', '1 to 2 teaspoons butter or olive oil, depending on your pan type', 'Special equipment:', '8- or 10-inch nonstick skillet, well-seasoned cast iron skillet, or stainless steel skillet']",4,"[""1 Heat the pan: Melt the butter or heat the oil  in your skillet over low heat for 1 minute. Use 1 teaspoon of butter or oil per egg if using a nonstick skillet or well-seasoned cast iron skillet. Use 2 teaspoons of butter or oil if you're using a stainless steel skillet."", 'Swirl the pan to coat the bottom.', '2 Cook the egg on the heat: Break the egg into the skillet, and cover the pan with a lid. Cook for 1 1/2 to 2 minutes, covered, or until all but a thin rim of egg white around each yolk is opaque.', '3 Finish cooking the egg off the heat: Remove the pan from the heat, keep covered, and let sit for about 30 seconds to finish cooking.', 'If you want to make an over-easy egg, use a thin spatula and slide it directly under the yolk. Gently lift the egg and flip it over, and let it cook for 10 to 15 seconds. Add a few more seconds a piece for both over-medium and over-hard.', '4 Serve: Remove the lid. Slide a spatula directly under the yolk when removing from the pan and serve.']",6
1544,Hearty Roasted Vegetable and Chicken Stew Recipe,50,25,75,"['8 ounces baby bella mushrooms, quartered', '4 large carrots, peeled and cut into 1/2-inch thick rounds', '1 1/2 pounds Yukon gold potatoes, cubed (about 5 medium-sized potatoes)', '5 tablespoons olive oil, divided', '1 1/2 teaspoons kosher salt, divided', '1 1/2 teaspoons freshly ground black pepper, divided', '1/2 teaspoon harissa powder', '4 chicken thighs, skin-on and bone-in (about 1 1/2 pounds)', '1/4 cup all-purpose flour', '1/2 large yellow onion, chopped', '3 large cloves garlic, minced', '1/2 teaspoon ground cumin', '1 teaspoon ground turmeric', '1/3 cup white wine', '6 cups (48 ounces) chicken stock', '2 bay leaves', '3 large kale leaves (any variety),  stripped from the stem and torn']",17,"['1 Preheat the oven to 425\\xc2\\xb0F.', '2 Roast the veggies: Spread chopped mushrooms, carrots, and potatoes on a baking sheet in three separate rows, keeping each vegetable separate from the others\\xe2\\x80\\x94this will come in handy later when you have to add them to the soup in separate steps.', 'Drizzle 3 tablespoons of olive oil over the vegetables, then sprinkle with 3/4 teaspoon of salt, 3/4 teaspoon freshly ground pepper, and 1/2 teaspoon harissa. Toss each individual row to coat.', ""Roast veggies in oven for 20 to 25 minutes. When they are fork tender, set them aside while you finish the soup base. (Note: You don't actually want the veggies to brown too much for this recipe; you want the colors to stay vibrant.)"", 'While the vegetables roast, cook the chicken and begin assembling the stew.', '3 Cook the chicken: Heat 2 tablespoons oil in Dutch oven or large heavy-bottomed soup pot set over medium heat. Trim the chicken of excess fat and skin. Sprinkle the four chicken thighs with 3/4 teaspoon salt and 3/4 teaspoon freshly ground pepper.', 'Once the oil begins to shimmer, add the thighs skin side down. Cook the thighs for 7 minutes, until the skin has a nice golden brown color.', 'Flip the chicken and cook for another 5 minutes. A few bits of skin may stick to the pan when you flip. That\\xe2\\x80\\x99s ok.', 'After cooking, the skin should be crisp and golden, and you should have about a 1/4 cup of fat in the pan. (Just eyeball it; you\\xe2\\x80\\x99ll be fine!) The chicken will not be completely cooked, which is ok; transfer it to a plate.', '4 Make the roux: Sprinkle 1/4 cup all-purpose flour over the chicken fat. Use a sturdy wooden spoon to stir continuously and scrape the brown bits (the fond) off the bottom of the pan.', 'Continue cooking until the color deepens and it looks like golden paste, about 6 minutes. This is the roux that will thicken your soup.', '5 Cook the onion and garlic. Add the chopped onion, minced garlic, turmeric, and cumin to the pan with the roux. Continue to stir and scrape the bottom of the pan. The roux will get crumbly, and the color will continue to deepen. That\\xe2\\x80\\x99s ok.', 'Keep stirring and scraping the bottom of the pan for about 5 minutes until the onions are cooked through.', '6 Stir in the wine and stock: Slowly add 1/3 cup of white wine, scraping the bottom of the pan to release any brown bits, and stir for another minute.', 'Slowly pour in the stock, you guessed it, while stirring! Add the bay leaves and bring it to a gentle simmer.', '7 Add the chicken and simmer: Remove the skin from the chicken thighs and discard. Add the thighs to the pot of simmering stock.', 'Cover with a lid, but leave it slightly ajar. Continue to simmer over medium low heat for 25 minutes, stirring occasionally. Don\\xe2\\x80\\x99t let it boil.', '8 Add half the roasted potatoes and carrots and puree: Use tongs to remove bay leaves and chicken from the pot and transfer to a plate.', 'Add half of the roasted potatoes and half of the carrots to the pot (reserve the mushrooms). Use an immersion blender to puree the vegetables into the soup.', '9 Finish the stew: After pureeing, add the remaining vegetables, including all of the mushrooms, and let them warm through.', 'When the chicken has cooled enough to handle, use two forks to shred it into bite-sized pieces. Discard the bones. Add the chicken back to the pot.', 'Stir in the kale. Let everything warm through over low heat for a couple of minutes and make sure the kale is wilted.', '10 Serve:  Ladle into bowls and serve with fresh crusty bread. Leftovers will keep in the refrigerator for about a week, or up to 1 month frozen.']",23
1545,Chocolate Crinkles Recipe,15,260,275,"['1 cup natural unsweetened cocoa powder', '1 1/2 cups white granulated sugar', '1/2 cup vegetable oil', '4 large eggs', '2 teaspoons vanilla extract', '2 cups all-purpose flour', '2 teaspoons baking powder', '1 teaspoon espresso powder (optional)', '1/2 teaspoon salt', '1 cup powdered sugar']",10,"['1 Beat together cocoa powder, white sugar, vegetable oil: In the bowl of an electric mixer fitted with the paddle attachment (or beat by hand with a wooden spoon) beat together the cocoa powder, white sugar, and vegetable oil until it comes together into a shiny, gritty, black dough of sorts.', '2 Add eggs, one at a time, add vanilla: Add the eggs, one at a time, mixing for 30 seconds each. Add the vanilla and beat in thoroughly.', '3 Whisk together flour, baking powder, salt, espresso powder: In a separate bowl, whisk together the flour, baking powder, salt, and espresso powder if using.', '4 Beat dry ingredients into cocoa oil mix: Mix into the chocolate mixture on low speed until just combined. Do not over-beat.', '5 Cover and chill: Cover the dough with plastic wrap and chill the dough for four hours or overnight.', '6 Get ready for baking: Preheat the oven to 350\\xc2\\xb0F and line two baking sheets with parchment paper. Place the powdered sugar in a wide bowl.', ""7 Roll the cookies: Using a rounded teaspoon, scoop out clumps of the chilled dough and roll them into 1-inch (2.5 cm) sized balls using your hands. Do several at a time and drop them into the powdered sugar as you go. The dough will be quite sticky, so it's useful to roll the dough in batches."", 'Roll the balls in the powdered sugar and place on the cookie sheets spaced a few inches apart. (You should be able to get 12 to 16 on each sheet).', '7 Bake: Bake at 350\\xc2\\xb0F for 10 to 13 minutes. Allow to cool a minute or two on the sheets before transferring to a wire rack to cool completely. Repeat with any remaining batter.', '8 Store: Store these cookies in an airtight container on the counter. They will keep for at least a week before starting to become crumbly and dry.']",10
1546,Chili Mac and Cheese Recipe,10,45,55,"['2 cups uncooked elbow pasta', '1 tablespoon vegetable oil', '1 yellow onion, diced', '2 tomatoes, diced (or 1 15-oz can whole tomatoes, drained and diced)', '1 pound ground beef', '1 teaspoon black pepper', '1 tablespoon chili powder', '1 tablespoon kosher salt', '2 tablespoons unsalted butter', '2 tablespoons all-purpose flour', '2 cups whole milk', '3 cups (12 ounces) shredded cheese, either a Mexican cheese blend (see Recipe Note) or cheddar', '1 tablespoon yellow mustard', 'For the breadcrumbs:', '2 tablespoons unsalted butter', '1/2 teaspoon chili powder', '1/4 teaspoon kosher salt', '1/2 cup breadcrumbs', 'Special equipment:', 'Large (12-inch) oven-safe skillet, or 9x13 baking dish']",20,"['1 Heat the oven to 400\\xc2\\xb0F. ', '2 Cook the pasta: Bring a large pot of salted water to a boil, and cook the pasta until al dente. Drain, rinse with cold water, and set aside.', '3 Make the chili: Heat the oil in a large (12-inch) oven-safe skillet over medium heat. Add the onions and cook until softened, 2 to 3 minutes. Add the tomatoes and cook until they have broken down slightly and some of the liquid has evaporated, 3 to 5 minutes more.', 'Add the ground beef, black pepper, 1 tablespoon chili powder, and 1 tablespoon salt to the onion-tomato mixture. Cook, breaking up the ground beef with a wooden spoon, until brown and fully cooked, 5 to 8 minutes. Remove from heat.', '4 Make the cheese sauce: Melt 2 tablespoons of butter in a saucepan over medium heat. Add the flour and cook, stirring occasionally, until bubbly and slightly golden, 1 to 2 minutes.', 'Slowly whisk the milk into the butter-flour mixture. At first, the mixture will seize up and look crumbly, but will smooth out as you keep adding milk and whisking.', ""Once all the milk is added, bring to a simmer. Whisk frequently and scrape along the bottom of the pan, so it doesn't burn."", 'Cook until the sauce has thickened slightly and seems creamy, 10 to 15 minutes. Remove from the heat, and add the shredded cheese and mustard. Stir until the cheese has melted. Taste and add salt and pepper as needed.', ""5 Assemble the mac and cheese: Combine the cooked pasta, chili mixture, and cheese sauce \\xe2\\x80\\x93 you can do this in your skillet if it's big enough, otherwise use a large bowl. Mix until evenly combine, then transfer back to the skillet used to cook the chili. (Or transfer to a baking dish if your skillet isn't big enough.)"", '6 Top with toasted breadcrumbs: Melt the 2 tablespoons of butter and mix with the breadcrumbs, 1/2 teaspoon chili powder, and 1/4 teaspoon salt. Sprinkle evenly over top the chili mac and cheese.', '7 Bake the mac and cheese: Place the chili mac and cheese in the oven and bake until golden on top and the cheese sauce is bubbling, about 20 minutes.', 'Leftovers can be kept refrigerated for about a week. Reheat individual portions in the microwave, or larger amounts in a low oven. Leftovers can also be frozen in individual portions for up to 3 months; reheat in the microwave or in a low oven.']",12
1547,How to Do a New England Clambake at Home Recipe,10,20,30,"['4 pounds total steamer clams and mussels (you can use all clams if you prefer)', '2 tablespoons olive oil', '4 linguica, chorizo, or other fresh sausages of your choice', '4 hot dogs (optional, but so good)', '1 cup white wine', '2 cups water', '1 teaspoon salt', '2 pounds small red potatoes', '6 shallots, peeled', 'Small handful of fresh thyme sprigs', '2 bay leaves', '4 ears corn on the cob, husked', '4 ounces (1 stick) butter, melted, for dipping']",13,"['1 Scrub the clams and remove beards from the mussels: Rinse the clams under cold running water, using a scrub brush to clean off excess sand if necessary. Pull the beards off the mussels if there are any (this is the bristly material that protrudes from the shell).', ""Discard clams or mussels with cracked shells or that don't close tightly when tapped lightly against the counter."", '2 Brown the sausages: In a large soup pot, stockpot, or lobster pot, heat the oil over medium heat. Prick the sausages in several places with the tip of knife, then add them to the pot with the hot oil. Cook, turning occasionally for 5 minutes, or until golden brown. Transfer to a plate.', '3 Heat the wine and water: In the same pot, add the wine and water and increase the heat to high. Bring to a boil. Add the salt and adjust the heat to a simmer.', '4 Cook the potatoes and shallots: Add the potatoes, shallots, thyme, and bay leaves to the pot. Cover the pot and cook for 6 minutes.', '5 Add the remaining ingredients in layers: Working in layers, add the sausages, hot dogs, clams, mussels, and finally, the corn to the pot. Cover and cook for 10 to 14 minutes, or until the clams and mussels open.', '6 To serve the clambake: With a large slotted spoon, remove the corn, mussels, clams, sausages and potatoes from the pot and transfer to a large serving platter. Discard any clams or mussels that have not opened.', 'Pour the broth into cups for dipping, being careful to leave behind any sand at the bottom of the pot. Pour the melted butter into 4 small ramekins and let diners help themselves to everything.']",8
1548,Sous Vide Korean BBQ Chicken Recipe,20,185,205,"['10 to 12 chicken bone-in, skin-on chicken thighs (4 to 5 pounds)', '1/2 cup hoisin sauce', '1/3 cup gochujang Korean chili sauce', '3 tablespoons apple cider vinegar', '3 tablespoons honey', '1 tablespoon soy sauce', 'Sesame seeds, garnish', 'Scallions, garnish', 'Special equipment:', 'Gallon-sized zip-top bag, such as Ziploc', 'Joule sous vide immersion circulator']",11,"['1 Make the Korean BBQ sauce: Combine the hoisin sauce, gochujang, vinegar, honey, and soy sauce in a medium bowl. Stir together well and set aside.', '2 Prepare the chicken: Rub the chicken with 1/3 cup or so of the sauce \\xe2\\x80\\x93 enough so that all of the thighs are coated with a little sauce. Reserve the remaining sauce for basting the chicken later.', 'Place the thighs in a plastic freezer bag. Make sure the chicken is in a single layer; use two bags if you need to rather than overlapping the chicken.', '3 Seal the chicken: With your hands, press out as much air as possible from the bag and partially seal the top. Slowly submerge the plastic bag in a pot filled with water up to the top of the bag, pressing out as much air as possible. Seal the bag the bag once you reach the top. (Read more here.)', 'At this point you can dry the bag and freeze the chicken for up to 3 months before cooking.', '4 Heat the sous vide water bath: When you are ready to cook, add your Joule or other immersion circulator to the pot of water and heat to 158 degrees F.', '5 Cook the chicken sous vide: Add chicken to the pot of hot water, making sure all of the chicken thighs are fully submerged in the water. Cook for 3 to 5 hours; the chicken is ready any time within this time frame. (Cook for at least 4 hours if cooking from frozen.)', 'Make sure your cooking bags are completely submerged in the water throughout the cooking time. I also like to rotate them once halfway through to make sure they are cooking evenly.', '5 Heat a gas or charcoal grill to high heat: About 500\\xc2\\xb0F or until you can hold your hand 1 inch over the grates for 1 to 2 seconds.', '6 Finish the chicken on the grill: Remove the chicken from bags and transfer to a platter. Place the chicken skin-side up on the grill, and grill for 1 to 2 minutes. Baste with some of the extra sauce, then flip the chicken skin-side down.', ""Baste with some more sauce and grill for another 1 to 2 minutes. You should have some nice grill marks on both sides at this point. Continue to baste with BBQ sauce and flip a few times if you like. Remember, the chicken is already cooked at this point, so we're only grilling to sear the outside."", '7 Serve! When chicken is grilled on both sides, remove it from the grill and transfer to a clean platter. Garnish with sesame seeds and scallions, and serve immediately.']",12
1549,How to Make Fluffy Buttermilk Pancakes Recipe,10,15,25,"['2 1/2 cups all-purpose flour', '1 1/2 tablespoons sugar', '2 1/2 teaspoons baking powder', '3/4 teaspoon baking soda', '1/4 teaspoon salt', '2 1/4 cups buttermilk', '1 large egg', '3 tablespoons melted unsalted butter', '2 teaspoons vanilla extract', 'Special equipment:', '10-inch square nonstick griddle pan']",11,"['1 Sift together the dry ingredients: In a medium bowl sift together flour, sugar, baking powder, baking soda, and salt. Make sure there are no clumps.', '2 Whisk together the wet ingredients: In a small bowl, whisk egg until the yolk and the white are combined. Add buttermilk, melted butter, and extract. Whisk until combined.', '3 Make the pancake batter: Add the wet ingredients to dry ingredients and gently stir until just combined. If adding berries or chocolate, add them when the batter is not quite fully mixed. Continue mixing just until combined. Don\\xe2\\x80\\x99t over mix, or your pancakes will be rubbery not light and fluffy.', '  4 Heat the skillet: Set a large, flat-bottomed non-stick or well-seasoned cast iron skillet over medium heat. Add butter. Once the butter has melted and sizzles on the pan, scoop a rounded 1/4 cup of batter onto the pan. Add additional scoops to cook more pancakes, spaced a few inches apart.', 'Cook until you see bubbles forming in the center of the pancake and the edges look slightly drier than the middle, about 3 minutes. Flip and cook for about 2 minutes on the other side. The cakes should be lightly golden on both sides with crispy edges.', '  5 Serve: Serve with maple syrup or powdered sugar and fruit. If feeding a crowd keep warm on a plate in a low oven until ready to serve.', 'To freeze and reheat: Let the pancakes cool to room temperature, then layer between sheets of parchment paper and seal in a gallon-sized, zip-top bag.', ""To reheat, spread a few frozen pancakes on a plate in a single layer (it's ok if they overlap a little) and zap in the microwave for about 30 to 45 seconds, then pop them in the toaster. The microwave thaws them, and then the toaster to finishes the job and also provides the crisp fresh-off-the-griddle edges.""]",8
1550,How to Make Lemon Curd,5,20,25,"['4 large eggs', '1 cup sugar', '3/4 cup of lemon juice, from about 4 large lemons', 'Zest of four lemons', '1/2 cup unsalted butter, cut into cubes', 'Pinch of salt']",6,"['1 Get organized: Once you start making the lemon curd, it\\xe2\\x80\\x99s best not to pause. Make sure all of your ingredients and equipment are prepped and ready so you can quickly grab each as you need it. Set a fine mesh sieve over a medium sized bowl, and set this next to your stove. Have a whisk and a rubber spatula ready to go.', '2 Heat the curd on the stovetop: In a medium sauce pan, whisk the eggs and sugar together. Set over medium heat. Continue whisking until fully combined and uniform in consistency.', 'Continue whisking and the add the juice, zest and a pinch of salt. Once that looks well incorporated, add the butter a piece or two at a time while whisking continuously. Let each piece partially melt before adding more. As you whisk, make sure you get into the nooks and crannies of your pot.', '3 Continue cooking the curd until thickened: Continue to cook the curd, whisking occasionally until it thickens to a pudding-like consistency, about 10 minutes total from the start of cooking. Remove from heat. (The curd will continue to thicken as it cools.)', '4 Strain the curd: Strain your curd through the fine mesh sieve to remove the zest and any cooked eggy bits. Use a spatula to push the curd through, then stir for another two minutes to help it cool down more quickly.', '5 Cool and refrigerate: Transfer the curd to a jar with an airtight lid, but leave it uncovered as it cools (I use Ball or Weck canning jars) on the counter top for about 15 minutes. Once at room temp, cover tightly with the lid and transfer to fridge or freezer.', '6 Store the curd: Lemon curd will keep in your refrigerator for up to a month according to the National Center for Home Food Preservation. You can also store it in the freezer for up to 1 year. To thaw, transfer your curd from the freezer to the fridge 24 hours before you need it.']",7
1551,Asparagus Mimosa with Hard Boiled Eggs and Capers Recipe,15,10,25,"['1 pound asparagus', 'Salt', '1 hard boiled egg, peeled', 'Caper vinaigrette:', '1 tablespoon minced shallots', '1 teaspoon Dijon mustard', '1 tablespoon red wine vinegar', '1/4 teaspoon salt', 'Pinch freshly ground black pepper', '1 Tbsp chopped capers', '1/2 cup extra virgin olive oil']",11,"['1 Prep the asparagus: Break off the tough woody ends of the asparagus. If the asparagus are thick, use a vegetable peeler to peel off the skin of the bottom 1 to 2 inches of the asparagus.', '2 Prepare a bowl filled with ice water.', '3 Simmer the asparagus: Add enough water to cover the bottom of a wide saut\\xc3\\xa9 pan by about an inch and a half deep. Add a teaspoon of salt to the water. Bring the water to a simmer. Add the asparagus to the water.', 'Return to a simmer and cook uncovered for 2 to 5 minutes, depending on how thick they are. Remove from heat and drain when they are just cooked through, but are still a little firm.', '4 Shock the asparagus in ice water: Place the asparagus in the ice water to shock them and keep them from cooking further. Asparagus will start to turn olive green if they cook too long, so you want to stop the cooking as soon as you take them out of the boiling water.', '5 Make the vinaigrette: In a medium bowl, whisk together the shallots, mustard, vinegar, salt, black pepper, capers. Whisk in the olive oil.', '6 Grate the egg: Using a box grater, grate the hard boiled egg.', '7 Drizzle asparagus with vinaigrette, sprinkle with eggs: Place the asparagus in a serving dish. When you are ready to serve, drizzle with vinaigrette and sprinkle with the sieved eggs.']",8
1552,Walnut Snowball Cookies Recipe,10,35,45,"['1 cup all-purpose or cake flour', '1 1/2 cups walnuts, finely chopped', '2 to 3 Tbsp sugar', '1 teaspoon vanilla extract', '8 tablespoons (4 ounces) unsalted butter, at room temperature', 'Pinch of salt', 'Powdered sugar, to coat (about 1 cup)']",7,"['1 Make the cookie dough: Mix all the dry ingredients (flour, walnuts, salt, sugar) in a large bowl. Add the vanilla extract. Add the butter in little pieces, and combine everything together with your (clean!) hands until the mixture looks like a coarse meal with nut bits in it.', '2 Chill the dough: Chill the dough for at least 30 minutes in the fridge or up to overnight.', '3 Preheat the oven to 300\\xc2\\xb0F. Line a baking sheet with parchment or silicon baking mats.', '4 Form the dough into balls: Form the dough into small balls no larger than a walnut and place on the cookie sheet, spaced at least an inch apart from each other.', '3 Bake for 35 minutes.', '4 Roll in powdered sugar: When they are still warm, but cool enough to touch, roll the cookies in some powdered sugar. Set aside on a rack to cool completely. When cool, dust again in powdered sugar.']",6
1553,Mexican Wedding Cookies Recipe,10,78,88,"['For the cookie dough:', '1 cup (115 g) pecan pieces', '1 cup (225 g or 2 sticks) unsalted butter at room temperature', '3/4 cup (85 g) powdered sugar, sifted', '2 teaspoons vanilla extract', '2 cups (280 g) all-purpose flour', '1/2 teaspoon kosher salt', 'To roll the cookies:', '1 1/4 cup (145 g) powdered sugar']",9,"['1 Toast the nuts on the stovetop: Place the nuts in a medium skillet and place over medium heat. Toast the nuts, stirring frequently, until they darken slightly and smell fragrant and nutty, about 5 minutes.', 'Remove the pan from heat and let the nuts cool in the pan.', '2 Crush the nuts: Once the toasted nuts are warm to the touch, but not hot, pour them into a quart-size sealable freezer bag. Seal the bag, and then use a rolling pin to roll and crush the nuts until they are crushed into a chunky powder. Set aside until needed.', '(Alternatively, pulse in a food processor until powdery. Be careful of over-processing or the nuts will turn into nut butter!)', '3 Mix the butter and sugar: Place the butter and 3/4 cup powdered sugar in the bowl of stand mixer fitted with a paddle attachment. Beat together on medium speed until the sugar is absorbed into the butter and the buttery paste clings to the side of the bowl. Add the vanilla and beat for an additional 30 seconds to incorporate.', '4 Add the flour and salt: Mix on low speed. As the dry ingredients start to absorb into the butter-sugar mixture, you can increase the speed back to medium. Once all the flour is mixed in and a dough has formed, stop the mixer.', '5 Empty the crushed nuts into the bowl with the dough: Mix on low speed to incorporate.', '6 Chill the dough: Scrape the dough onto a piece of plastic wrap and flatten into a disk about 1-inch thick. Wrap tightly with the plastic wrap and place in the refrigerator for at least 1 hour or until the dough is firm.', ""7 About 10 minutes before you're ready to bake, preheat the oven to 350F. Line 2 baking sheet with parchment paper or a silicon baking mat."", '8 Roll the cookies: Place the 1 1/4 cups of powdered sugar for coating the cookies into a shallow bowl. Remove the chilled dough out of the refrigerator and form into 1-inch balls of dough. (If your dough chilled longer than 1 hour, you may need to let it soften for a few minutes at room temperature.)', 'Roll the balls of dough in powdered sugar and place on the baking mat, spaced slightly apart.', '9 Bake for 17 to 19 minutes, or until the cookies start to brown slightly on top and are golden brown on the bottoms. Let the cookies cool on the baking sheet for 10 minutes after baking.', '10 While the cookies are still warm, roll each cookie in the powdered sugar again. Return the cookies to the cooling rack and let cool completely before serving.', 'Store at room temperature in an airtight container. They will keep well for at least a week.']",14
1554,Beef Roulades with Walnut Parsley Pesto Recipe,30,35,65,"['Pesto:', '1 cup chopped parsley', '1/2 cup shelled walnuts, about 1 3/4 ounces', '1/4 cup grated parmesan or pecorino cheese', '2 garlic cloves, roughly chopped', '1/4 teaspoon salt', '1/4 cup extra virgin olive oil', 'Flank steak roulade:', '1/2 pound thin-cut bacon', '1 1/2 to 1 3/4 pounds flank steak', 'Salt and black pepper', 'Lemon wedges to serve']",12,"['1 Make the pesto: Put the parsley, cheese, garlic, salt and walnuts into a food processor. Pulse to combine. Turn the machine on again and slowly pour in the olive oil, just to combine. Reserve.', '2 Cook the bacon in a large pan \\xe2\\x80\\x94 you will be searing the roulade in this later, so it needs to be wide \\xe2\\x80\\x94 over medium-low heat until it is about half-cooked. You want it cooked, but still limp. Do not crisp it up or it will break when you try to wrap it inside the roulade. When the bacon is ready, set it aside on paper towels.', '3 Pound the meat thin: Place heavy duty plastic wrap (or two layers of plastic wrap) on a large work surface and place the flank steak on it. Cover with more plastic wrap.', 'Using a rubber mallet, the flat side of a meat mallet or an empty wine bottle, pound the flank steak until it is 1/2 inch thick or thinner. Flip the meat from time to time to pound everything evenly.', ""Once the meat is as thin as you want it, if you have a meat mallet with a tenderizing side (the pointy side), remove the plastic wrap and pound this on both sides for a minute or two. If you don't have a meat mallet, you can skip this step."", '4 Find the grain of the steak: Look at your steak. You will be rolling it up with the grain of the meat facing side to side. You do this because when you slice it later, the beef will be more tender when you cut across the grain.', 'Arrange the meat until the grain faces side to side, and if it is not squarish or rectangular, cut it to fit. Sprinkle on some salt and black pepper.', '5 Layer with pesto and bacon: Spread a thin layer of pesto on the meat, leaving about 1/2 inch free on all sides of the meat. Lay down the bacon across the grain of the beef. Preheat the oven to 350\\xc2\\xb0F.', '6 Carefully roll  the roulade up tightly, as you would a carpet. If you want, cut off any bacon that is extending beyond the steak.', 'Tie off the meat with 6 to 8 lengths of string, each about an inch or so apart.', '7 Sear the tied roulade in the pan with the bacon fat. You want to quickly brown the surface, not cook the inside of the roulade.', ""8 Roast: Put the roulade in a roasting pan on a rack, seam side down. If you don't have a rack, improvise with celery stalks. Roast this for 20-25 minutes, or until the interior of the meat is 130\\xc2\\xb0F when tested with a meat thermometer."", '(Note that the ends of the roulade will be far hotter than the center \\xe2\\x80\\x94 so always test the temperature from the center of the roulade.)', 'Remove the meat from the oven and let it rest for 10 minutes before slicing.', '9 Slice the roulade so each serving is wrapped in string. You can either let everyone cut their own string at the table, or cut it yourself and secure the roulades with toothpicks if you want. Serve with lemon wedges to add a little tartness to the dish.']",15
1555,Walnut Maple Pie Recipe,10,40,50,"['1 9-inch pie shell, frozen for at least 30 minutes (see pie crust recipe)', '2 cups roughly chopped walnuts', '2 eggs, beaten', '1 cup maple syrup (dark robust)', '1 Tbsp dark rum (optional)', '1/2 teaspoon vanilla extract', '2 Tbsp melted butter', '2 Tbsp all purpose flour', '1/4 teaspoon salt', '1/8 teaspoon ground cinnamon', '1/8 teaspoon of ground nutmeg']",11,"['1 Make egg, maple syrup base: Preheat oven to 375\\xc2\\xb0F. In a bowl, mix together the beaten eggs, maple syrup, rum (if using), vanilla extract, melted butter. Sprinkle with flour, salt, cinnamon and nutmeg. Whisk until smooth.', '2 Pour base over walnuts in pie shell: Spread the chopped walnuts over the bottom of a prepared pie shell. Pour the maple syrup egg mixture over the walnuts.', '3 Bake: Place the pie in the preheated oven on the middle rack. Place a cookie sheet on the rack underneath to catch any drippings from the pie crust.', ""Bake at 375\\xc2\\xb0F for 40-45 minutes. After about 20 minutes (about halfway through the baking), you may want to tent the pie crust edges with foil, or use a pie protector, so that the edges don\\'t get burnt."", 'Don\\\'t worry if the surface of the pie ""cracks"" while cooking. The pie filling will puff up while hot (because of the eggs), and then deflate while it cools.', '4 Cool: Remove from the oven and let cool completely before serving.']",6
1556,Mini Apple Turnovers with Walnuts and Gorgonzola Recipe,30,20,50,"['1 1/2 cups peeled, cored, chopped apples (use a good cooking apple such as Jonagold, Pippin, Granny Smith, Jonathan, Golden Delicious, Gravenstein, Mcintosh)', '1/2 cup chopped walnuts', '1/4 cup crumbled gorgonzola cheese', '2 teaspoons chopped fresh thyme leaves (or 1/2 teaspoon dried thyme, crumbled)', '2 Tbsp honey', '2 7-ounce prepared puff pastry sheets (total 14 ounces)', '1 egg, beaten']",7,"['1 Pre-cook and chop apples: Place chopped apples in a bowl, microwave on high heat for 5 minutes until apples are cooked through. Remove from heat and let cool. Drain excess moisture.', 'Once cooled, chop further so that the pieces are between 1/4-inch and 1/2-inch square. (Note you can skip this step if you want; the main purpose is to get the apples to release some of their moisture before cooking into the pastry.)', '2 Make stuffing: Combine apples, walnuts, gorgonzola, thyme and honey in a small bowl.', '3 Cut and stuff puff pastry: Preheat oven to 400\\xc2\\xb0F. Working with one puff pastry sheet at a time (leave the second one in the refrigerator until using it) roll out the pastry to a size of 9-inches by 12-inches.', 'Cut into 12 3x3-inch squares (a pizza slicer works great for this).', 'Paint 1/2-inch of border around each square with beaten egg (this will help the pastry seal).', 'Place a heaping teaspoon of the apple walnut mixture in the center of the squares.', 'Fold over the squares into a triangle shape, stretching the dough if necessary to cover the filling. Use the tines of a fork to crimp the edges.', 'Place triangles on a silpat or parchment paper lined baking sheet, with space between the triangles.', 'Chill for 5 minutes in the refrigerator before baking, or chill while you prepare the second puff pastry sheet.', '4 Brush turnovers with egg wash: Whisk in a half teaspoon of water into the remaining beaten egg. Use a pastry brush to paint on the tops of the pastry triangles for a nice glaze.', '5 Bake: Place in 400\\xc2\\xb0F oven and bake for 15-20 minutes until nicely puffed up and lightly browned. Allow to cool for at least 20 minutes before serving.', 'Serve either warm or at room temperature. Can be made several hours in advance.']",13
1557,Honey Mulled Wine Recipe,0,10,10,"['1 (750ml) bottle of zinfandel, pinot noir, or other full-bodied robust red wine that you enjoy drinking', '3/4 cup of water', '3/4 cup of honey', '15 whole black peppercorns', '1 (3-inch) cinnamon stick, plus extra (optional) for serving', '1 star anise (or a couple cardamom pods or allspice berries)', 'Thin peels of lemon zest for garnish']",7,"['1 Combine the ingredients: Combine the wine, water, honey, peppercorns, cinnamon stick, and any other spices you are using in a 2-quart saucepan.', 'If you are unsure about the sweetness level, start with less honey and add more to taste.', '2 Warm over medium-low heat until steamy and lightly simmering.', '3 Serve: Strain into glass mugs. Serve with a thin strip of lemon zest and a bit of cinnamon stick.']",4
